"pcon24","loftins_n","cavitywallins_n","solidwallins_n","cavity_and_loftins_n","cavitywallins_noloftins_n","loftins_nocavitywallins_n","number_of_epcs","loftins_pct","cavitywallins_pct","solidwallins_pct","cavity_and_loftins_pct","cavitywallins_noloftins_pct","loftins_nocavitywallins_pct"
"E14001063",6127,8513,5084,2210,6303,3917,43956,0.139389389389389,0.193670943670944,0.115661115661116,0.0502775502775503,0.143393393393393,0.0891118391118391
"E14001064",5370,6508,3721,1869,4639,3501,28679,0.187245022490324,0.226925625021793,0.129746504410893,0.065169636319258,0.161755988702535,0.122075386171066
"E14001065",5596,8892,5829,2314,6578,3282,33334,0.167876642467151,0.266754664906702,0.174866502669947,0.0694186116277674,0.197336053278934,0.0984580308393832
"E14001066",4619,3734,9592,1017,2717,3602,34093,0.135482357082099,0.109523949197783,0.281348077317924,0.0298301704162145,0.0796937787815681,0.105652186665884
"E14001067",7825,8250,5594,2994,5256,4831,35881,0.218081993255483,0.229926702154344,0.155904239012291,0.0834424904545581,0.146484211699785,0.134639502800925
"E14001068",5555,3896,8110,1106,2790,4449,37048,0.149940617577197,0.105160872381775,0.218905204059598,0.0298531634636148,0.0753077089181602,0.120087454113582
"E14001069",5648,6028,3453,1749,4279,3899,39887,0.14160002005666,0.151126933587384,0.0865695590041868,0.0438488730664126,0.107278060520972,0.0977511469902475
"E14001070",4871,8564,3894,2000,6564,2871,36688,0.132768207588312,0.233427823811601,0.106138246838203,0.0545137374618404,0.17891408634976,0.0782544701264719
"E14001071",6032,5396,4079,1863,3533,4169,41937,0.143834799818776,0.128669194267592,0.0972649450366025,0.0444237785249302,0.0842454157426616,0.0994110212938455
"E14001072",6022,4428,6596,1410,3018,4612,38579,0.156095284999611,0.114777469607818,0.170973845874699,0.0365483812436818,0.0782290883641359,0.119546903755929
"E14001073",5588,6863,14903,1487,5376,4101,46097,0.121222639217303,0.14888170596785,0.323296526888952,0.032258064516129,0.116623641451721,0.0889645747011736
"E14001074",5725,5076,6653,1401,3675,4324,41434,0.138171549934836,0.122508085147463,0.160568615146981,0.033812810735145,0.0886952744123184,0.104358739199691
"E14001075",6063,5119,9764,1401,3718,4662,43782,0.138481567767576,0.116920195514138,0.223014024028139,0.031999451829519,0.0849207436846192,0.106482115938057
"E14001076",6776,12683,8031,3125,9558,3651,38249,0.177154958299563,0.331590368375644,0.209966273628069,0.0817014823916965,0.249888885983947,0.0954534759078669
"E14001077",6272,8216,2981,2595,5621,3677,35517,0.176591491398485,0.231325843962046,0.0839316383703579,0.0730636033448771,0.158262240617169,0.103527888053608
"E14001078",6531,7064,1377,2016,5048,4515,41567,0.157119830634879,0.169942502465898,0.0331272403589386,0.0485000120287728,0.121442490437126,0.108619818606106
"E14001079",6153,4667,7365,1413,3254,4740,44168,0.139309001992393,0.10566473464952,0.166749683028437,0.0319914870494476,0.0736732476000724,0.107317514942945
"E14001080",5934,6542,15019,1603,4939,4331,43458,0.136545630263703,0.150536149845828,0.34559804869069,0.0368861889640573,0.113649960881771,0.0996594412996456
"E14001081",3837,3430,23492,363,3067,3474,57478,0.0667559761995894,0.0596750060892863,0.408712898848255,0.00631545982810815,0.0533595462611782,0.0604405163714813
"E14001082",7508,8146,6465,2569,5577,4939,36820,0.203910917979359,0.22123845736013,0.17558392178164,0.0697718631178707,0.15146659424226,0.134139054861488
"E14001083",5856,6926,19317,984,5942,4872,43345,0.135102087899412,0.159787749452071,0.445656938516553,0.0227015803437536,0.137086169108317,0.112400507555658
"E14001084",6195,4819,10539,1430,3389,4765,41596,0.148932589672084,0.115852485815944,0.253365708241177,0.0343783056063083,0.0814741802096355,0.114554284065776
"E14001085",1998,3186,10995,282,2904,1716,53574,0.0372942098779259,0.0594691454810169,0.20523014895285,0.00526374734012767,0.0542053981408892,0.0320304625377982
"E14001086",1556,5496,14197,337,5159,1219,52651,0.029553094907979,0.104385481757232,0.269643501547929,0.00640063816451729,0.0979848435927143,0.0231524567434617
"E14001087",5359,4405,6347,1180,3225,4179,33428,0.160314706234295,0.131775756850544,0.189870767021658,0.0352997487136532,0.0964760081368912,0.125014957520641
"E14001088",7811,8273,6151,2702,5571,5109,35890,0.21763722485372,0.230509891334634,0.171384786848704,0.0752855948732237,0.15522429646141,0.142351629980496
"E14001089",5646,5930,12044,1565,4365,4081,31394,0.179843282155826,0.18888959673823,0.383640186022807,0.0498502898643053,0.139039306873925,0.129992992291521
"E14001090",5644,4901,4077,1543,3358,4101,37455,0.150687491656655,0.130850353757843,0.108850620744894,0.0411961019890535,0.0896542517687892,0.109491389667601
"E14001091",6171,4107,18635,847,3260,5324,44055,0.140074906367041,0.093224378617637,0.422993984791738,0.0192259675405743,0.0739984110770628,0.120848938826467
"E14001092",6564,7512,13811,1680,5832,4884,43454,0.151056289409491,0.172872462834262,0.317830349334929,0.0386615731578221,0.134210889676439,0.112394716251668
"E14001093",7282,7021,18021,1644,5377,5638,43933,0.165752395693442,0.159811531195229,0.41019279357203,0.0374206177588601,0.122390913436369,0.128331777934582
"E14001094",6719,4688,21377,1050,3638,5669,36199,0.185612862233763,0.129506339954142,0.590541175170585,0.0290063261416061,0.100500013812536,0.156606536092157
"E14001095",6067,7147,9314,1843,5304,4224,38272,0.158523202341137,0.186742265886288,0.243363294314381,0.0481553093645485,0.138586956521739,0.110367892976589
"E14001096",5482,5669,14419,1050,4619,4432,79458,0.0689924236703667,0.0713458682574442,0.181466938508394,0.013214528430114,0.0581313398273302,0.0557778952402527
"E14001097",5641,7104,6785,1730,5374,3911,38434,0.146771088099079,0.18483634282146,0.176536400062445,0.0450122287557891,0.139824114065671,0.10175885934329
"E14001098",7172,5915,21379,1353,4562,5819,40300,0.177965260545906,0.146774193548387,0.530496277915633,0.0335732009925558,0.113200992555831,0.14439205955335
"E14001099",6219,5356,16003,1376,3980,4843,37084,0.167700355948657,0.144428864200194,0.431533815122425,0.0371049509222306,0.107323913277964,0.130595405026426
"E14001100",6302,4546,20656,1098,3448,5204,35274,0.178658502012814,0.128876793105403,0.585587117990588,0.0311277428134036,0.0977490502919998,0.14753075919941
"E14001101",5857,6192,12168,1420,4772,4437,42350,0.138299881936246,0.146210153482881,0.287319952774498,0.033530106257379,0.112680047225502,0.104769775678867
"E14001102",6084,10916,2881,2853,8063,3231,38816,0.156739488870569,0.281224237427865,0.0742219703215169,0.0735006183017312,0.207723619126134,0.0832388705688376
"E14001103",5523,9767,5471,2151,7616,3372,40839,0.135238375082642,0.239158647371385,0.133965082396729,0.0526702416807463,0.186488405690639,0.0825681334018952
"E14001104",7191,12406,1451,3445,8961,3746,38000,0.189236842105263,0.326473684210526,0.0381842105263158,0.0906578947368421,0.235815789473684,0.0985789473684211
"E14001105",9462,20439,3468,5057,15382,4405,51465,0.183853104051297,0.397143689886331,0.0673856018653454,0.0982609540464393,0.298882735839891,0.0855921500048577
"E14001106",4293,5394,6594,1158,4236,3135,33402,0.1285252380097,0.161487336087659,0.197413328543201,0.0346685827195976,0.126818753368062,0.0938566552901024
"E14001107",5076,6623,3695,1624,4999,3452,40471,0.125423142497097,0.163648044278619,0.0912999431691829,0.0401274987027748,0.123520545575844,0.0852956437943219
"E14001108",8373,11142,4632,3379,7763,4994,44336,0.188853302057019,0.251308191988452,0.104474918801877,0.0762134608444605,0.175094731143991,0.112639841212559
"E14001109",5189,4333,8215,1054,3279,4135,42314,0.122630807770478,0.102401096563785,0.194143782199745,0.0249090135652503,0.0774920829985348,0.0977217942052276
"E14001110",7216,9257,4145,2658,6599,4558,40586,0.177795298871532,0.228083575617208,0.102128812891145,0.0654905632484108,0.162593012368797,0.112304735623121
"E14001111",6835,8836,2842,2653,6183,4182,44113,0.154942987327999,0.200303765329948,0.0644254528143631,0.0601410015188266,0.140162763811121,0.0948019858091719
"E14001112",6177,8294,2995,2490,5804,3687,35261,0.175179376648422,0.235217378973937,0.0849380335214543,0.0706162615921273,0.16460111738181,0.104563115056294
"E14001113",5922,6217,13060,1406,4811,4516,40793,0.145171965778442,0.152403598656632,0.320152967420881,0.0344666977177457,0.117936900938887,0.110705268060697
"E14001114",7950,6469,8640,2059,4410,5891,48905,0.162560065432982,0.13227686330641,0.176669052244147,0.0421020345567938,0.0901748287496166,0.120458030876189
"E14001115",7230,15048,2612,3436,11612,3794,47200,0.153177966101695,0.318813559322034,0.0553389830508475,0.0727966101694915,0.246016949152542,0.0803813559322034
"E14001116",6392,14320,2922,2872,11448,3520,44338,0.144165275835626,0.322973521584194,0.0659028372953223,0.0647751364518021,0.258198385132392,0.0793901393838243
"E14001117",6771,7561,1329,2375,5186,4396,37833,0.178970739830307,0.199851981074723,0.0351280628023154,0.0627758834879602,0.137076097586763,0.116194856342347
"E14001118",10251,9595,9845,3833,5762,6418,41457,0.24726825385339,0.231444629375015,0.237474974069518,0.092457244856116,0.138987384518899,0.154811008997274
"E14001119",7544,8220,8083,2341,5879,5203,39141,0.192739071561789,0.210009963976393,0.20650979791012,0.0598094070156613,0.150200556960732,0.132929664546128
"E14001120",10276,9036,11506,3971,5065,6305,41253,0.249097035367125,0.219038615373427,0.27891304874797,0.0962596659636875,0.12277894940974,0.152837369403437
"E14001121",5736,5279,4871,1636,3643,4100,36099,0.158896368320452,0.146236737859775,0.134934485719826,0.0453198149533228,0.100916922906452,0.113576553367129
"E14001122",6014,4336,24058,636,3700,5378,46062,0.130563154009813,0.0941339933133603,0.522296035777865,0.0138074768789892,0.0803265164343711,0.116755677130824
"E14001123",4721,5057,14122,991,4066,3730,42198,0.111877340158301,0.119839802834258,0.334660410445993,0.0234845253329542,0.0963552775013034,0.0883928148253472
"E14001124",4787,5193,14265,992,4201,3795,44248,0.108185680708733,0.117361236666064,0.322387452540228,0.0224190923883565,0.0949421442777075,0.0857665883203761
"E14001125",6773,7425,8321,2425,5000,4348,35316,0.191782761354627,0.210244648318043,0.235615585003964,0.068665760561785,0.141578887756258,0.123117000792842
"E14001126",7018,5753,6394,1987,3766,5031,42984,0.163270053973572,0.133840498790248,0.148753024381165,0.0462265028847943,0.0876139959054532,0.117043551088777
"E14001127",7190,5794,9029,1665,4129,5525,39749,0.180885053712043,0.145764673325115,0.227150368562731,0.0418878462351254,0.10387682708999,0.138997207476918
"E14001128",5180,4400,4659,1223,3177,3957,33045,0.156755938871236,0.133151762747768,0.14098955969133,0.0370101376910274,0.0961416250567408,0.119745801180209
"E14001129",6476,9055,8295,2538,6517,3938,38730,0.167208882003615,0.233798089336432,0.2141750580945,0.0655305964368706,0.168267492899561,0.101678285566744
"E14001130",6364,8646,20524,1929,6717,4435,45477,0.139938870198122,0.190118081667656,0.451305055302681,0.0424170459792862,0.14770103568837,0.0975218242188359
"E14001131",4526,2368,23216,324,2044,4202,46261,0.0978361903114935,0.0511878255982361,0.501848209074598,0.00700373965111001,0.0441840859471261,0.0908324506603835
"E14001132",6247,4814,17293,1328,3486,4919,42087,0.148430631786537,0.114382113241619,0.410886972224202,0.031553686411481,0.0828284268301376,0.116876945375056
"E14001133",5188,5877,10834,1493,4384,3695,35018,0.148152378776629,0.167827974184705,0.309383745502313,0.0426352161745388,0.125192758010166,0.10551716260209
"E14001134",5232,5465,11957,1355,4110,3877,36255,0.144311129499379,0.150737829264929,0.329802785822645,0.0373741552889257,0.113363673976003,0.106936974210454
"E14001135",5571,5214,11682,1497,3717,4074,40107,0.13890343331588,0.130002243997307,0.291270850474979,0.0373251552098137,0.0926770887874935,0.101578278106066
"E14001136",6768,4009,5348,1520,2489,5248,34176,0.198033707865169,0.117304541198502,0.156484082397004,0.0444756554307116,0.0728288857677903,0.153558052434457
"E14001137",5488,6880,12021,1790,5090,3698,33443,0.164100110636008,0.205723170768173,0.359447417994797,0.0535239063481147,0.152199264420058,0.110576204287893
"E14001138",5674,5756,6353,1752,4004,3922,31717,0.178894599110887,0.181479963426554,0.200302676797932,0.0552385156225368,0.126241447804017,0.12365608348835
"E14001139",6308,8172,6451,2464,5708,3844,36057,0.174945225614998,0.226641151510109,0.178911168427767,0.0683362453892448,0.158304906120864,0.106608980225754
"E14001140",5441,4578,11810,1166,3412,4275,34647,0.157041013651976,0.132132652177678,0.340866453083961,0.0336537073916934,0.0984789447859844,0.123387306260282
"E14001141",5064,4511,3907,1342,3169,3722,39979,0.126666499912454,0.112834237974937,0.0977263063108132,0.0335676230020761,0.0792666149728607,0.093098876910378
"E14001142",6954,10038,16065,2166,7872,4788,42861,0.162245397914188,0.234198922097011,0.374816266536012,0.0505354518093372,0.183663470287674,0.111709946104851
"E14001143",5758,4064,10415,1193,2871,4565,43780,0.131521242576519,0.0928277752398355,0.237894015532206,0.0272498857925994,0.0655778894472362,0.10427135678392
"E14001144",6092,8490,6528,2285,6205,3807,37016,0.164577480008645,0.22936027663713,0.176356170304733,0.0617300626755997,0.16763021396153,0.102847417333045
"E14001145",5523,11335,3719,2729,8606,2794,37804,0.146095651253836,0.299835996190879,0.0983758332451592,0.0721881282403978,0.227647867950481,0.0739075230134377
"E14001146",6017,3978,5459,1302,2676,4715,41699,0.144296026283604,0.0953979711743687,0.130914410417516,0.0312237703542051,0.0641742008201635,0.113072255929399
"E14001147",7012,6335,12727,1718,4617,5294,38192,0.183598659405111,0.165872434017595,0.33323732718894,0.0449832425638877,0.120889191453708,0.138615416841223
"E14001148",6670,6327,10141,1936,4391,4734,39387,0.16934521542641,0.160636758321274,0.257470739076345,0.049153273922868,0.111483484398406,0.120191941503542
"E14001149",4795,5131,12496,1076,4055,3719,46106,0.103999479460374,0.11128703422548,0.271027631978484,0.0233375265692101,0.0879495076562703,0.0806619528911638
"E14001150",6461,5126,5354,1723,3403,4738,37814,0.170862643465383,0.13555825884593,0.141587771724758,0.0455651346062305,0.0899931242396996,0.125297508859153
"E14001151",7186,9529,6163,2958,6571,4228,41270,0.1741216379937,0.230894111945723,0.149333656409014,0.071674339714078,0.159219772231645,0.102447298279622
"E14001152",5955,5369,9389,1373,3996,4582,40702,0.146307306766252,0.13190997985357,0.230676625227262,0.0337329860940494,0.0981769937595204,0.112574320672203
"E14001153",5267,6190,11758,1232,4958,4035,33727,0.156165683280458,0.183532481394728,0.348622765143653,0.0365285972662852,0.147003884128443,0.119637086014173
"E14001154",7664,7064,6649,2710,4354,4954,27938,0.27432171236309,0.252845586656167,0.237991266375546,0.0970005011095998,0.155845085546567,0.17732121125349
"E14001155",6660,4762,7364,1659,3103,5001,35630,0.186921133875947,0.133651417344934,0.206679764243615,0.0465618860510806,0.0870895312938535,0.140359247824867
"E14001156",4950,3728,4387,1299,2429,3651,32089,0.154258468634111,0.116176883044034,0.136713515534919,0.0404811617688304,0.0756957212752033,0.113777306865281
"E14001157",6738,7755,7334,2461,5294,4277,37202,0.181119294661577,0.208456534594914,0.197139938712972,0.0661523574001398,0.142304177194774,0.114966937261438
"E14001158",6172,8922,2169,2812,6110,3360,30085,0.205152069137444,0.296559747382416,0.0720957287684893,0.0934685058999501,0.203091241482466,0.111683563237494
"E14001159",6262,6507,6702,1968,4539,4294,40728,0.153751718719309,0.159767236299352,0.164555097230407,0.0483205657041839,0.111446670595168,0.105431153015125
"E14001160",3960,4655,40592,217,4438,3743,66653,0.0594121794967968,0.0698393170599973,0.609004845993429,0.00325566741181942,0.0665836496481779,0.0561565120849774
"E14001161",5561,6733,12434,1625,5108,3936,43149,0.12887900067209,0.156040696192264,0.288164268001576,0.0376602006999003,0.118380495492364,0.0912187999721894
"E14001162",6544,8295,4945,2599,5696,3945,33565,0.194964993296589,0.247132429614181,0.147326083718159,0.0774318486518695,0.169700580962312,0.117533144644719
"E14001163",5798,4604,8549,1419,3185,4379,37007,0.156673061853163,0.124408895614343,0.231010349393358,0.0383440970627179,0.0860647985516254,0.118328964790445
"E14001164",5597,4668,6128,1629,3039,3968,33482,0.167164446568305,0.139418194850965,0.183023714234514,0.0486530075861657,0.090765187264799,0.11851143898214
"E14001165",4975,5218,5783,1274,3944,3701,37640,0.132173219978746,0.138629117959617,0.153639744952179,0.0338469713071201,0.104782146652497,0.0983262486716259
"E14001166",7086,9364,3554,2873,6491,4213,42911,0.165132483512386,0.218219104658479,0.0828225862832374,0.066952529654401,0.151266575004078,0.0981799538579851
"E14001167",5797,5562,16523,1061,4501,4736,35401,0.163752436371854,0.157114205813395,0.46673822773368,0.0299709047767012,0.127143301036694,0.133781531595153
"E14001168",5666,4800,3607,1390,3410,4276,38576,0.146878888428038,0.12442969722107,0.0935037328909166,0.0360327664869349,0.0883969307341352,0.110846121941103
"E14001169",6414,7459,14180,1742,5717,4672,40193,0.159580026372751,0.185579578533575,0.352797750852138,0.0433408802527803,0.142238698280795,0.116239146119971
"E14001170",5211,7336,2695,2042,5294,3169,36526,0.142665498548979,0.200843234955922,0.0737830586431583,0.0559053824672836,0.144937852488638,0.0867601160816952
"E14001171",6772,7600,1308,2561,5039,4211,34290,0.197491980169146,0.221638961796442,0.0381452318460192,0.0746864975211432,0.146952464275299,0.122805482648002
"E14001172",2119,6914,43307,77,6837,2042,91679,0.0231132538531179,0.0754153077585925,0.472376443896639,0.000839886997022219,0.0745754207615703,0.0222733668560957
"E14001173",5261,6395,4675,1529,4866,3732,39569,0.132957618337588,0.161616416892011,0.118148045186889,0.0386413606611236,0.122975056230888,0.0943162576764639
"E14001174",9368,8229,6675,2890,5339,6478,41980,0.223153882801334,0.196021915197713,0.159004287756074,0.0688423058599333,0.12717960933778,0.154311576941401
"E14001175",4028,3855,28175,359,3496,3669,50841,0.0792273952125253,0.0758246297279754,0.554178714030015,0.00706123010955725,0.0687633996184182,0.0721661651029681
"E14001176",5872,7403,4736,2049,5354,3823,46490,0.126306732630673,0.159238545923855,0.101871370187137,0.0440739944073994,0.115164551516455,0.0822327382232738
"E14001177",4094,4280,11244,809,3471,3285,32654,0.125375145464568,0.131071231702089,0.344337600293992,0.0247749127212593,0.106296318980829,0.100600232743309
"E14001178",5374,5059,4325,1649,3410,3725,34928,0.153859367842419,0.144840815391663,0.12382615666514,0.0472114063215758,0.097629409070087,0.106647961520843
"E14001179",4984,4516,5569,1216,3300,3768,42510,0.117243001646671,0.106233827334745,0.13100446953658,0.0286050341096213,0.0776287932251235,0.0886379675370501
"E14001180",6540,5846,13243,1473,4373,5067,44896,0.145669992872416,0.130212045616536,0.294970598717035,0.0328091589451176,0.0974028866714184,0.112860833927299
"E14001181",6023,4824,15464,1231,3593,4792,39534,0.152349876056053,0.122021551069965,0.391156978803056,0.0311377548439318,0.0908837962260333,0.121212121212121
"E14001182",6065,4718,16481,1176,3542,4889,43768,0.138571559129958,0.107795649789801,0.376553646499726,0.0268689453481996,0.0809267044416012,0.111702613781758
"E14001183",3637,4980,1672,1109,3871,2528,36540,0.0995347564313082,0.136288998357964,0.0457580733442802,0.0303503010399562,0.105938697318008,0.0691844553913519
"E14001184",7257,8898,1266,2856,6042,4401,36640,0.198062227074236,0.242849344978166,0.0345524017467249,0.0779475982532751,0.164901746724891,0.120114628820961
"E14001185",6490,4734,10939,1368,3366,5122,43308,0.149856839383024,0.109310058187864,0.252586127274407,0.0315876974231089,0.0777223607647548,0.118269141959915
"E14001186",5864,8034,12753,1787,6247,4077,36408,0.161063502526917,0.220665787738958,0.350280158206987,0.0490826192045704,0.171583168534388,0.111980883322347
"E14001187",6004,7504,11916,2007,5497,3997,36829,0.163023704146189,0.203752477667056,0.323549376849765,0.0544950989709197,0.149257378696136,0.108528605175269
"E14001188",5496,4178,22213,585,3593,4911,50771,0.10825077307912,0.082291071674775,0.437513541194777,0.0115223257371334,0.0707687459376416,0.0967284473419866
"E14001189",6002,7383,15162,1730,5653,4272,38691,0.155126515210256,0.190819570442739,0.391874079243235,0.0447132408053552,0.146106329637383,0.1104132744049
"E14001190",5029,5615,13618,1130,4485,3899,40822,0.123193376120719,0.137548380775072,0.333594630346382,0.0276811523198275,0.109867228455245,0.0955122238008917
"E14001191",5210,4199,9614,1232,2967,3978,40056,0.130067904933094,0.104828240463351,0.240013980427402,0.030756940283603,0.0740713001797483,0.0993109646494907
"E14001192",5508,3470,5766,1086,2384,4422,38275,0.143905943827564,0.0906596995427825,0.1506466361855,0.0283736120182887,0.0622860875244938,0.115532331809275
"E14001193",5582,4779,11366,1201,3578,4381,40511,0.137789736121054,0.117967959319691,0.280565772259386,0.0296462689146158,0.0883216904050752,0.108143467206438
"E14001194",6611,4488,15184,1168,3320,5443,44189,0.149607368349589,0.101563737581751,0.343614926791735,0.0264319174455181,0.075131820136233,0.123175450904071
"E14001195",4834,3916,10206,1014,2902,3820,34613,0.139658509808453,0.113136682749256,0.294860312599312,0.0292953514575449,0.0838413312917112,0.110363158350909
"E14001196",4103,5243,6377,1266,3977,2837,31858,0.128790256764392,0.164574047335049,0.200169502165861,0.0397388411074142,0.124835206227635,0.0890514156569778
"E14001197",5896,5447,3706,1795,3652,4101,41858,0.140857183811936,0.13013044101486,0.0885374360934588,0.0428830808925414,0.0872473601223183,0.0979741029193941
"E14001198",6589,4955,11861,1417,3538,5172,45613,0.144454431850569,0.108631311248986,0.26003551619056,0.0310657049525355,0.0775656062964506,0.113388726898033
"E14001199",4800,4049,4428,1155,2894,3645,32168,0.14921661278289,0.125870430241234,0.137652325292216,0.0359052474508829,0.0899651827903507,0.113311365332007
"E14001200",5339,4254,10871,1157,3097,4182,37074,0.144009278739818,0.114743486000971,0.293224362086638,0.031207854561148,0.0835356314398231,0.11280142417867
"E14001201",6593,7457,5030,2503,4954,4090,32819,0.200889728510924,0.227215941984826,0.153264877052927,0.0762667966726591,0.150949145312167,0.124622931838264
"E14001202",7219,8422,9948,2115,6307,5104,41807,0.172674432511302,0.201449518023298,0.237950582438348,0.0505896141794436,0.150859903843854,0.122084818331858
"E14001203",5665,4847,6180,1562,3285,4103,38104,0.148672055427252,0.127204492966618,0.162187696829729,0.0409930715935335,0.0862114213730842,0.107678983833718
"E14001204",5374,5049,7273,1290,3759,4084,38636,0.139093073817165,0.130681229940988,0.188244124650585,0.0333885495392898,0.0972926804016979,0.105704524277876
"E14001205",5307,5791,23800,788,5003,4519,45594,0.116396894328201,0.12701232618327,0.52199850857569,0.0172829758301531,0.109729350353117,0.099113918498048
"E14001206",6608,6734,4664,1982,4752,4626,45297,0.145881625714727,0.148663266883017,0.102964876261121,0.0437556571075347,0.104907609775482,0.102125968607193
"E14001207",5969,7260,25921,1178,6082,4791,61811,0.0965685719370339,0.117454821957257,0.419359013767776,0.0190580964553235,0.0983967255019333,0.0775104754817104
"E14001208",6269,10252,13144,2193,8059,4076,40682,0.154097635317831,0.252003343001819,0.323091293446733,0.0539059043311538,0.198097438670665,0.100191730986677
"E14001209",5264,4217,19805,734,3483,4530,39165,0.134405719392315,0.107672666921997,0.50568109281246,0.0187412230307673,0.0889314438912294,0.115664496361547
"E14001210",6150,6500,1648,2250,4250,3900,33304,0.184662503002642,0.195171751141004,0.0494835455200577,0.0675594523180399,0.127612298822964,0.117103050684602
"E14001211",4697,6898,3022,1389,5509,3308,42595,0.110271158586689,0.161943890127949,0.0709472942833666,0.0326094612043667,0.129334428923583,0.0776616973823219
"E14001212",7108,7631,3912,2807,4824,4301,34090,0.20850689351716,0.223848635963626,0.114755060134937,0.0823408624229979,0.141507773540628,0.126166031094163
"E14001213",6700,3283,25148,540,2743,6160,37474,0.178790628168864,0.0876074078027432,0.671078614506058,0.0144099909270427,0.0731974168757005,0.164380637241821
"E14001214",6021,6065,3382,1952,4113,4069,32117,0.187470809851481,0.188840800821995,0.105302487779058,0.0607777812373509,0.128063019584644,0.12669302861413
"E14001215",6544,8625,6116,2821,5804,3723,33048,0.198015008472525,0.260984023238925,0.185064149116437,0.0853606874848705,0.175623335754055,0.112654320987654
"E14001216",7662,7719,16015,2195,5524,5467,48041,0.159488770008951,0.160675256551695,0.333361087404509,0.0456901396723632,0.114985116879332,0.113798630336587
"E14001217",5503,5371,3980,1627,3744,3876,35820,0.153629257398102,0.149944165270798,0.111111111111111,0.0454215522054718,0.104522613065327,0.10820770519263
"E14001218",8650,12243,3877,4126,8117,4524,34967,0.247376097463323,0.350130122687105,0.110875968770555,0.117996968570366,0.232133154116739,0.129379128892956
"E14001219",7128,11359,7989,2871,8488,4257,43637,0.16334761784724,0.260306620528451,0.18307858010404,0.0657927905218049,0.194513830006646,0.0975548273254348
"E14001220",5493,6541,651,2059,4482,3434,33503,0.163955466674626,0.195236247500224,0.0194310957227711,0.0614571829388413,0.133779064561383,0.102498283735785
"E14001221",6581,5320,22412,999,4321,5582,41300,0.159346246973366,0.128813559322034,0.542663438256659,0.0241888619854722,0.104624697336562,0.135157384987893
"E14001222",4839,3895,6870,1171,2724,3668,33583,0.144090760206057,0.115981300062532,0.204567787273323,0.034868832444987,0.0811124676175446,0.10922192776107
"E14001223",5230,6298,12873,1511,4787,3719,36781,0.142192980071232,0.171229710992088,0.349990484217395,0.041080992903945,0.130148718088143,0.101111987167287
"E14001224",6054,4346,6396,1400,2946,4654,40810,0.148345993629012,0.106493506493506,0.156726292575349,0.0343053173241852,0.0721881891693213,0.114040676304827
"E14001225",7027,8197,18767,1580,6617,5447,45473,0.154531260308315,0.180260814109472,0.412706441184879,0.034745893167374,0.145514920942098,0.119785367140941
"E14001226",5665,7454,8879,1964,5490,3701,34413,0.16461802225903,0.21660419027693,0.258012960218522,0.0570714555545869,0.159532734722343,0.107546566704443
"E14001227",6042,8957,9496,2435,6522,3607,36346,0.166235624277775,0.246437021955648,0.261266714356463,0.0669949925713971,0.179442029384251,0.0992406317063776
"E14001228",5906,4028,12022,1229,2799,4677,35825,0.164856943475227,0.112435450104676,0.335575715282624,0.0343056524773203,0.0781297976273552,0.130551290997906
"E14001229",5508,5559,13639,1178,4381,4330,46505,0.118438877540049,0.119535533813568,0.293280292441673,0.0253306096118697,0.0942049242016987,0.0931082679281798
"E14001230",6151,7431,10432,2139,5292,4012,36551,0.168285409427923,0.203304971136221,0.285409427922629,0.0585209706984761,0.144784000437745,0.109764438729447
"E14001231",7045,9003,7484,2598,6405,4447,38255,0.184158933472749,0.235341785387531,0.195634557574173,0.0679126911514835,0.167429094236048,0.116246242321265
"E14001232",5880,7257,4487,2159,5098,3721,42120,0.13960113960114,0.172293447293447,0.106528964862298,0.0512583095916429,0.121035137701804,0.0883428300094967
"E14001233",6807,7443,1621,2542,4901,4265,34320,0.198339160839161,0.216870629370629,0.0472319347319347,0.0740675990675991,0.14280303030303,0.124271561771562
"E14001234",6493,8268,3898,2582,5686,3911,35937,0.180677296379776,0.230069287920528,0.108467596070902,0.0718479561454768,0.158221331775051,0.108829340234299
"E14001235",6093,5917,5018,1834,4083,4259,36639,0.166298206828789,0.161494582275717,0.136957886405197,0.0500559513087148,0.111438630967002,0.116242255520074
"E14001236",5113,6517,11372,1557,4960,3556,36671,0.139428976575496,0.177715360911892,0.310108805323007,0.0424586185269014,0.135256742384991,0.0969703580485943
"E14001237",5593,5718,4129,1615,4103,3978,40809,0.137053101031635,0.140116150849077,0.101178661569752,0.0395746036413536,0.100541547207724,0.0974784973902816
"E14001238",6674,6449,25423,954,5495,5720,50869,0.131199748373273,0.12677662230435,0.499773929112033,0.0187540545322298,0.108022567772121,0.112445693841043
"E14001239",7468,11016,7915,3153,7863,4315,40346,0.185098894562038,0.273038219402171,0.196178059782878,0.0781490110543796,0.194889208347792,0.106949883507659
"E14001240",5994,5353,7116,1870,3483,4124,31939,0.187670246407214,0.167600738908544,0.222799711950906,0.0585491092394878,0.109051629669057,0.129121137167726
"E14001241",5470,5023,7981,1565,3458,3905,32925,0.166135155656796,0.152558845861807,0.242399392558846,0.0475322703113136,0.105026575550494,0.118602885345482
"E14001242",6743,11354,2873,3174,8180,3569,40703,0.165663464609488,0.27894749772744,0.070584477802619,0.0779795101098199,0.20096798761762,0.0876839544996683
"E14001243",5838,4177,7898,1228,2949,4610,39501,0.147793726741095,0.105744158375737,0.199944305207463,0.0310878205615048,0.0746563378142325,0.11670590617959
"E14001244",4639,6012,9239,1065,4947,3574,38767,0.119663631439111,0.155080351845642,0.238321252611757,0.0274718188149715,0.12760853303067,0.0921918126241391
"E14001245",6428,5943,11310,1631,4312,4797,38591,0.166567334352569,0.153999637221114,0.293073514550025,0.0422637402503174,0.111735896970796,0.124303594102252
"E14001246",7041,8557,10331,2648,5909,4393,35542,0.198103652017332,0.240757413763998,0.290670193011085,0.0745034044229363,0.166254009341061,0.123600247594395
"E14001247",6132,4427,7233,1501,2926,4631,35102,0.174690900803373,0.126118169904849,0.206056634949576,0.0427610962338328,0.0833570736710159,0.13192980456954
"E14001248",7767,6088,8104,1868,4220,5899,46275,0.167844408427877,0.131561318206375,0.175126958400864,0.0403673689897353,0.0911939492166397,0.127477039438142
"E14001249",6192,7868,5099,2420,5448,3772,34507,0.179441852377778,0.228011707769438,0.14776711971484,0.0701306981192222,0.157881009650216,0.109311154258556
"E14001250",5498,3934,7778,1224,2710,4274,38139,0.144156899761399,0.103149007577545,0.203938225962925,0.0320931330134508,0.0710558745640945,0.112063766747948
"E14001251",6405,10665,11337,2419,8246,3986,42003,0.152489107920863,0.253910434968931,0.269909292193415,0.0575911244434921,0.196319310525439,0.0948979834773707
"E14001252",6300,9114,1590,2460,6654,3840,36394,0.173105456943452,0.250425894378194,0.0436885200857284,0.0675935593779194,0.182832335000275,0.105511897565533
"E14001253",5848,3417,6875,1045,2372,4803,42181,0.138640620184443,0.0810080367938171,0.162988075199734,0.0247741874303596,0.0562338493634575,0.113866432754084
"E14001254",6280,6758,10150,1869,4889,4411,37507,0.167435412056416,0.180179699789373,0.270616151651692,0.0498306982696563,0.130349001519716,0.11760471378676
"E14001255",7127,6276,18120,1440,4836,5687,43596,0.163478300761538,0.143958161299202,0.415634461877236,0.0330305532617671,0.110927608037435,0.130447747499771
"E14001256",7460,4910,10881,1723,3187,5737,39749,0.187677677425847,0.123525120128808,0.273742735666306,0.043347002440313,0.0801781176884953,0.144330674985534
"E14001257",3086,3173,15703,331,2842,2755,54862,0.0562502278444096,0.0578360249352922,0.286227261127921,0.0060333199664613,0.0518027049688309,0.0502169078779483
"E14001258",5729,8614,6319,2217,6397,3512,35570,0.161062693280855,0.242170368287883,0.177649704807422,0.0623278043294911,0.179842563958392,0.0987348889513635
"E14001259",3626,3087,25484,247,2840,3379,44138,0.0821514341383842,0.0699397344691649,0.577370972857855,0.00559608500611718,0.0643436494630477,0.076555349132267
"E14001260",2202,4447,17276,353,4094,1849,51298,0.0429256501228118,0.086689539553199,0.336777262271434,0.00688135989707201,0.079808179656127,0.0360442902257398
"E14001261",5130,6582,7235,1668,4914,3462,33372,0.153721682847896,0.197231211794319,0.21679851372408,0.0499820208558073,0.147249190938511,0.103739661992089
"E14001262",8486,8878,12092,2502,6376,5984,43907,0.193272143393992,0.202200104766894,0.275400277860022,0.0569840799872458,0.145216024779648,0.136288063406746
"E14001263",6193,5548,991,1847,3701,4346,38726,0.159918401074214,0.143262924133657,0.0255900428652585,0.0476940556731911,0.0955688684604658,0.112224345401023
"E14001264",4162,3448,33639,294,3154,3868,56223,0.0740266439001832,0.0613272148409014,0.598313857318179,0.00522917667146897,0.0560980381694324,0.0687974672287142
"E14001265",3716,4250,32630,258,3992,3458,54944,0.067632498543972,0.0773514851485149,0.593877402446127,0.00469569015725102,0.0726557949912638,0.062936808386721
"E14001266",5513,4787,6891,1516,3271,3997,37117,0.148530323032573,0.128970552576986,0.18565616833257,0.0408438181965137,0.0881267343804726,0.107686504836059
"E14001267",5938,9773,3925,2071,7702,3867,46952,0.126469585960129,0.208148747657182,0.0835960129493951,0.0441088771511331,0.164039870506049,0.0823607088089964
"E14001268",6709,6735,6564,2130,4605,4579,33179,0.202206214774406,0.202989842972965,0.197835980590132,0.0641972331896682,0.138792609783297,0.138008981584737
"E14001269",7242,6520,10265,1857,4663,5385,41513,0.174451376677185,0.157059234456676,0.247271938910703,0.044732975212584,0.112326259244092,0.129718401464601
"E14001270",5123,7527,12031,1674,5853,3449,31229,0.164046239072657,0.241025969451471,0.385250888597137,0.0536040219027186,0.187421947548753,0.110442217169938
"E14001271",5842,4188,19460,861,3327,4981,41594,0.140452949944704,0.100687599172958,0.467855940760687,0.0207001009761023,0.0799874981968553,0.119752848968601
"E14001272",5149,5451,6815,1227,4224,3922,41462,0.124186001640056,0.131469779557185,0.164367372533886,0.0295933625970768,0.101876416960108,0.0945926390429791
"E14001273",6398,5924,5704,1983,3941,4415,35460,0.180428652002256,0.167061477721376,0.160857304004512,0.055922165820643,0.111139311900733,0.124506486181613
"E14001274",8902,8094,15865,2341,5753,6561,47781,0.186308365249785,0.169397877817543,0.332035746426404,0.0489943701471296,0.120403507670413,0.137313995102656
"E14001275",7065,8322,1714,2579,5743,4486,35415,0.199491740787802,0.234985175772978,0.0483975716504306,0.0728222504588451,0.162162925314132,0.126669490328957
"E14001276",5961,9242,9866,2358,6884,3603,40399,0.147553157256368,0.228768038812842,0.24421396569222,0.0583677813807272,0.170400257432115,0.0891853758756405
"E14001277",5875,8370,4248,2493,5877,3382,31263,0.187921824520999,0.267728624892045,0.135879474138758,0.0797428269839747,0.18798579790807,0.108178997537025
"E14001278",7485,7473,4429,2366,5107,5119,40852,0.183222363654166,0.182928620385783,0.108415744639185,0.0579163810829335,0.125012239302849,0.125305982571233
"E14001279",5049,7496,15248,1172,6324,3877,53524,0.0943315148344668,0.140049323667887,0.28488154846424,0.0218967192287572,0.11815260443913,0.0724347956057096
"E14001280",6326,6416,5771,2212,4204,4114,33166,0.190737502261352,0.193451124645722,0.17400349755774,0.0666948079358379,0.126756316709884,0.124042694325514
"E14001281",6414,5740,7445,1646,4094,4768,36740,0.174578116494284,0.156232988568318,0.20264017419706,0.0448013064779532,0.111431682090365,0.129776810016331
"E14001282",7413,7027,9089,2334,4693,5079,39321,0.188525215533684,0.178708578113476,0.23114875003179,0.0593575951781491,0.119350982935327,0.129167620355535
"E14001283",5233,6239,6369,1596,4643,3637,39837,0.131360293194769,0.156613198785049,0.159876496724151,0.0400632577754349,0.116549941009614,0.0912970354193338
"E14001284",6000,8716,6902,2514,6202,3486,35286,0.170039108995069,0.247010145666837,0.195601655047328,0.0712463866689339,0.175763758997903,0.098792722326135
"E14001285",5036,4896,8658,1261,3635,3775,35273,0.142772091968361,0.138803050491878,0.245456865024239,0.0357497235846115,0.103053326907266,0.10702236838375
"E14001286",5923,7759,3374,1985,5774,3938,37774,0.156800974215069,0.205405834701117,0.0893206967755599,0.0525493725843173,0.1528564621168,0.104251601630751
"E14001287",5168,4178,10721,1217,2961,3951,32193,0.160531792625726,0.129779765787594,0.333022706799615,0.0378032491535427,0.0919765166340509,0.122728543472183
"E14001288",6117,3379,8204,1135,2244,4982,37112,0.164825393403751,0.0910487173959905,0.22106057339944,0.0305830998059927,0.0604656175899978,0.134242293597758
"E14001289",5451,4938,6035,1440,3498,4011,39177,0.139137759399648,0.126043341756643,0.154044464864589,0.0367562600505399,0.0892870817061031,0.102381499349108
"E14001290",1978,3710,24054,93,3617,1885,53107,0.0372455608488523,0.0698589639783833,0.452934641384375,0.00175118157681662,0.0681077824015666,0.0354943792720357
"E14001291",6994,7136,5806,2285,4851,4709,37961,0.184241721767077,0.187982402992545,0.152946445035695,0.060193356339401,0.127789046653144,0.124048365427676
"E14001292",5625,5679,12892,1421,4258,4204,32884,0.171055832623768,0.172697968616957,0.392044763410777,0.0432125045614889,0.129485464055468,0.12784332806228
"E14001293",5276,3077,26942,371,2706,4905,44314,0.1190594394548,0.0694362955273728,0.607979419596516,0.0083720720314122,0.0610642234959606,0.110687367423388
"E14001294",5993,7087,2408,2286,4801,3707,36613,0.16368502990741,0.193565127140633,0.0657689891568569,0.0624368393739928,0.13112828776664,0.101248190533417
"E14001295",4502,4811,2102,1200,3611,3302,40867,0.110162233587002,0.117723346465363,0.0514351432696308,0.0293635451586855,0.0883598013066778,0.0807986884283163
"E14001296",6535,10507,17670,2433,8074,4102,45881,0.142433687147185,0.229005470674135,0.385126740916719,0.0530284867374294,0.175976983936706,0.0894052004097557
"E14001297",6285,7942,12715,1756,6186,4529,41669,0.150831553433008,0.190597326549713,0.305142911996928,0.0421416400681562,0.148455686481557,0.108689913364852
"E14001298",6580,5284,4875,1709,3575,4871,41129,0.159984439203482,0.128473826253981,0.118529504729023,0.0415521894526976,0.0869216368012838,0.118432249750784
"E14001299",6905,8106,14687,2137,5969,4768,35441,0.194830845630767,0.228718151293699,0.414407042690669,0.0602973956716797,0.16842075562202,0.134533449959087
"E14001300",6168,4771,17231,1034,3737,5134,32585,0.189289550406629,0.146417063065828,0.5288015958263,0.0317323922050023,0.114684670860826,0.157557158201627
"E14001301",6407,3431,19439,732,2699,5675,37075,0.172811867835469,0.0925421443020904,0.524315576534053,0.0197437626432906,0.0727983816587997,0.153068105192178
"E14001302",6035,6094,12871,1636,4458,4399,47580,0.126839007986549,0.128079024800336,0.27051282051282,0.0343841950399327,0.0936948297604035,0.0924548129466162
"E14001303",5039,10900,4241,2534,8366,2505,31655,0.159184962881061,0.344337387458537,0.133975675248776,0.0800505449376086,0.264286842520929,0.0791344179434529
"E14001304",4833,9567,2783,2447,7120,2386,29860,0.161855324849297,0.320395177494977,0.0932016075016745,0.0819490957803081,0.238446081714668,0.0799062290689886
"E14001305",3364,4033,25555,162,3871,3202,48981,0.0686796921255181,0.082338049447745,0.521732916845307,0.00330740491210878,0.0790306445356363,0.0653722872134093
"E14001306",2352,5119,21302,257,4862,2095,56821,0.0413931468999138,0.0900899315393957,0.374896605128386,0.00452297566040724,0.0855669558789884,0.0368701712395065
"E14001307",3766,5742,3707,986,4756,2780,36877,0.102123274669848,0.155706809122217,0.100523361444803,0.0267375328795726,0.128969276242644,0.0753857417902758
"E14001308",8485,7651,11342,2269,5382,6216,36847,0.230276548972779,0.207642413222243,0.30781339050669,0.0615789616522376,0.146063451570006,0.168697587320542
"E14001309",5814,3959,6025,1359,2600,4455,35466,0.163931652850618,0.111628038121017,0.169881012800992,0.0383183894434106,0.0733096486776067,0.125613263407207
"E14001310",3063,5668,52280,268,5400,2795,82235,0.037246914330881,0.0689244239070955,0.635739040554508,0.00325895300054721,0.0656654709065483,0.0339879613303338
"E14001311",5776,3846,10148,1207,2639,4569,42210,0.136839611466477,0.0911158493248045,0.240416962805023,0.0285951196398958,0.0625207296849088,0.108244491826581
"E14001312",5968,7264,19533,1260,6004,4708,45802,0.130299986900135,0.158595694511157,0.426466093183704,0.0275097157329374,0.131085978778219,0.102790271167198
"E14001313",4920,5131,11274,1012,4119,3908,41328,0.119047619047619,0.124153116531165,0.272793263646922,0.0244870305845916,0.0996660859465738,0.0945605884630275
"E14001314",5856,5213,17287,1147,4066,4709,47298,0.12381073195484,0.110216076789716,0.365491141274473,0.0242504968497611,0.0859655799399552,0.0995602351050784
"E14001315",5283,5230,16771,1147,4083,4136,44759,0.118032127616792,0.11684800822181,0.374695591947988,0.025626131057441,0.0912218771643692,0.0924059965593512
"E14001316",5556,5425,3486,1844,3581,3712,27648,0.200954861111111,0.196216724537037,0.126085069444444,0.0666956018518518,0.129521122685185,0.134259259259259
"E14001317",5476,4689,3251,1329,3360,4147,41190,0.132944889536295,0.113838310269483,0.0789269240106822,0.0322651128914785,0.0815731973780044,0.100679776644817
"E14001318",5784,5842,7377,1813,4029,3971,35347,0.16363482049396,0.16527569524995,0.208702294395564,0.0512914815967409,0.11398421365321,0.112343338897219
"E14001319",8956,4537,14587,1163,3374,7793,48515,0.184602700195816,0.093517468824075,0.300669895908482,0.0239719674327528,0.0695455013913223,0.160630732763063
"E14001320",8128,4948,7918,1404,3544,6724,41522,0.195751649727855,0.119165743461298,0.190694089880064,0.0338134001252348,0.0853523433360628,0.16193824960262
"E14001321",6452,7795,7144,1977,5818,4475,36053,0.178958755166006,0.216209469392284,0.198152719607245,0.0548359359831359,0.161373533409148,0.12412281918287
"E14001322",6070,7304,5683,1995,5309,4075,33054,0.183638893931143,0.220971743208084,0.171930779935863,0.0603557814485388,0.160615961759545,0.123283112482604
"E14001323",10313,4876,13017,1214,3662,9099,59816,0.172412063661896,0.0815166510632607,0.217617359903705,0.0202955730908118,0.0612210779724488,0.152116490571085
"E14001324",5700,5219,5311,1546,3673,4154,35444,0.160817063536847,0.14724636045593,0.149842004288455,0.0436181017943799,0.103628258661551,0.117198961742467
"E14001325",7578,5765,9139,1705,4060,5873,39252,0.193060226230511,0.146871496993784,0.232828900438194,0.0434372770814226,0.103434219912361,0.149622949149088
"E14001326",5310,4069,12097,974,3095,4336,34642,0.153282143063334,0.117458576294671,0.349200392587033,0.0281161595750823,0.0893424167195889,0.125165983488251
"E14001327",5979,3318,19588,697,2621,5282,45144,0.132442849548113,0.073498139287613,0.433900407584618,0.0154394825447457,0.0580586567428673,0.117003367003367
"E14001328",7682,4753,16028,1088,3665,6594,47555,0.161539270318578,0.0999474292923983,0.337041320576175,0.0228787719482704,0.0770686573441278,0.138660498370308
"E14001329",6107,8434,5256,2337,6097,3770,40121,0.152214550983276,0.21021410234042,0.131003713765858,0.0582487973879016,0.151965304952519,0.093965753595374
"E14001330",7851,8547,4995,3034,5513,4817,36056,0.217744619480808,0.237047925449301,0.138534501885955,0.0841468826270246,0.152901042822276,0.133597736853783
"E14001331",6005,6016,21126,1163,4853,4842,44442,0.135119931596238,0.135367445209487,0.475361144862967,0.026168939291661,0.109198505917825,0.108950992304577
"E14001332",4382,3582,19917,466,3116,3916,53128,0.0824800481855142,0.0674220749887065,0.374887065201024,0.00877126938714049,0.058650805601566,0.0737087787983737
"E14001333",5455,4051,24564,593,3458,4862,40726,0.133943917890291,0.0994696262829642,0.603152777095713,0.0145607228797328,0.0849089034032313,0.119383195010558
"E14001334",6428,3838,25663,565,3273,5863,43071,0.149241949339463,0.0891086810150682,0.595830140930092,0.0131178751364027,0.0759908058786655,0.13612407420306
"E14001335",4999,5130,3793,1540,3590,3459,34455,0.145087795675519,0.148889856334349,0.110085618923233,0.0446959802641126,0.104193876070237,0.100391815411406
"E14001336",6519,3812,11551,1094,2718,5425,45078,0.144615998935179,0.0845645325879587,0.256244731354541,0.0242690447668486,0.0602954878211101,0.12034695416833
"E14001337",5078,6017,9643,1314,4703,3764,36408,0.139474840694353,0.165265875631729,0.264859371566689,0.0360909690177983,0.129174906613931,0.103383871676555
"E14001338",5408,4737,18230,822,3915,4586,70380,0.0768400113668656,0.067306052855925,0.259022449559534,0.0116794543904518,0.0556265984654731,0.0651605569764137
"E14001339",6426,5524,12620,1343,4181,5083,38723,0.165947886269142,0.142654236500271,0.325904501200837,0.0346822301991065,0.107972006301165,0.131265656070036
"E14001340",6545,4921,25704,1028,3893,5517,45809,0.142875854089808,0.107424305267524,0.561112445152699,0.0224410050426772,0.0849833002248466,0.12043484904713
"E14001341",5880,5582,15585,1248,4334,4632,38867,0.151285151928371,0.143617979262614,0.400982838912188,0.0321095016337767,0.111508477628837,0.119175650294594
"E14001342",5267,3986,7750,1179,2807,4088,36556,0.144080315132947,0.109038187985556,0.212003501477186,0.0322518875150454,0.076786300470511,0.111828427617901
"E14001343",6919,4985,7705,1652,3333,5267,40849,0.16937991138094,0.122034811133687,0.18862150848246,0.0404416264780044,0.0815931846556831,0.128938284902935
"E14001344",7313,5249,11370,1725,3524,5588,38752,0.188712840627581,0.135451073492981,0.293404211395541,0.0445138315441784,0.0909372419488026,0.144199009083402
"E14001345",6921,6996,4900,2370,4626,4551,32564,0.212535315071858,0.214838471932195,0.150472914875322,0.0727797567866355,0.14205871514556,0.139755558285223
"E14001346",6887,6693,13574,1911,4782,4976,44488,0.154805790325481,0.150445063837439,0.305115986333393,0.0429554037043697,0.10748966013307,0.111850386621111
"E14001347",6345,7022,7368,2049,4973,4296,37049,0.171259683122351,0.189532780911766,0.198871764420092,0.0553051364409296,0.134227644470836,0.115954546681422
"E14001348",6354,7333,6229,2305,5028,4049,38142,0.16658801321378,0.192255256672435,0.163310786010173,0.0604320696345236,0.131823187037911,0.106155943579256
"E14001349",5339,6040,7470,1711,4329,3628,42531,0.125531964919706,0.142014060332463,0.175636594484023,0.0402294796736498,0.101784580658814,0.0853024852460558
"E14001350",5819,6745,3643,2039,4706,3780,32229,0.180551677061032,0.209283564491607,0.1130348443948,0.0632660026684042,0.146017561823203,0.117285674392628
"E14001351",6076,5657,4428,1828,3829,4248,33299,0.18246794198024,0.169884981530977,0.132976966275264,0.0548965434397429,0.114988438091234,0.127571398540497
"E14001352",4036,7498,6434,1484,6014,2552,70414,0.0573181469594115,0.106484505922118,0.0913738745135911,0.0210753543329452,0.0854091515891726,0.0362427926264663
"E14001353",3766,7491,10018,1185,6306,2581,44770,0.084118829573375,0.167321867321867,0.223765914675006,0.0264686173777083,0.140853249944159,0.0576502121956667
"E14001354",4930,8839,10236,1771,7068,3159,37885,0.130130658571994,0.233311336940742,0.270186089481325,0.0467467335357001,0.186564603405042,0.083383925036294
"E14001355",6172,5378,7236,1567,3811,4605,39067,0.157985000127985,0.137660941459544,0.185220262625746,0.0401105792612691,0.0975503621982748,0.117874420866716
"E14001356",5483,4594,5284,1429,3165,4054,33717,0.162618263783848,0.136251742444464,0.156716196577394,0.0423821810955898,0.0938695613488745,0.120236082688258
"E14001357",5619,4152,7429,1372,2780,4247,34737,0.161758355643838,0.119526729423957,0.213864179405245,0.0394967901661053,0.0800299392578519,0.122261565477733
"E14001358",5596,7384,4470,1946,5438,3650,34006,0.1645591954361,0.217138152090808,0.13144739163677,0.0572251955537258,0.159912956537082,0.107333999882374
"E14001359",4997,3807,4082,1323,2484,3674,35813,0.139530338145366,0.106302180772345,0.113980956635858,0.0369418926088292,0.069360288163516,0.102588445536537
"E14001360",6260,5903,4594,2036,3867,4224,35900,0.174373259052925,0.164428969359331,0.127966573816156,0.0567130919220056,0.107715877437326,0.117660167130919
"E14001361",4948,4355,6120,1192,3163,3756,34874,0.141882204507656,0.124878132706314,0.17548890290761,0.034180191546711,0.0906979411596031,0.107702012960945
"E14001362",5161,4333,5704,1292,3041,3869,30227,0.170741390147881,0.143348661792437,0.188705462004168,0.0427432427961756,0.100605418996262,0.127998147351705
"E14001363",6608,7012,1434,2355,4657,4253,31733,0.20823748148615,0.220968707654492,0.0451895503104024,0.0742129644218952,0.146755743232597,0.134024517064255
"E14001364",5237,4079,6730,1298,2781,3939,32899,0.159184169731603,0.123985531475121,0.204565488312715,0.0394540867503572,0.0845314447247637,0.119730082981246
"E14001365",6419,3739,4896,1509,2230,4910,36222,0.177212743636464,0.103224559659875,0.135166473413947,0.041659764783833,0.0615647948760422,0.135552978852631
"E14001366",6166,8305,3267,2517,5788,3649,36859,0.167286144496595,0.225318104126536,0.0886350687756043,0.0682872568436474,0.157030847282889,0.0989988876529477
"E14001367",5735,6188,12534,1292,4896,4443,47410,0.120966040919637,0.130520987133516,0.264374604513816,0.0272516346762286,0.103269352457287,0.0937144062434086
"E14001368",5028,4634,4502,1173,3461,3855,35342,0.142266991115387,0.131118782185502,0.127383849244525,0.0331899722709524,0.0979288099145493,0.109077018844434
"E14001369",5864,4657,717,1087,3570,4777,52507,0.111680347382254,0.0886929361799379,0.0136553221475232,0.0207020016378769,0.0679909345420611,0.0909783457443769
"E14001370",6293,5919,5246,1694,4225,4599,38903,0.161761303755494,0.152147649281546,0.134848212220137,0.0435441996761175,0.108603449605429,0.118217104079377
"E14001371",6522,5353,17911,1206,4147,5316,41402,0.15752862180571,0.12929327085648,0.432611951113473,0.0291290275832085,0.100164243273272,0.128399594222501
"E14001372",8074,9403,8936,3028,6375,5046,38217,0.21126723709344,0.246042337179789,0.233822644372923,0.0792317555014784,0.166810581678311,0.132035481591962
"E14001373",6659,7233,1801,2542,4691,4117,29966,0.222218514316225,0.241373556697591,0.0601014483080825,0.0848294734031903,0.1565440832944,0.137389040913035
"E14001374",6970,8162,2256,2662,5500,4308,33932,0.205410821643287,0.240539903336084,0.0664859130024755,0.0784510196864317,0.162088883649652,0.126959801956855
"E14001375",6105,4252,8069,1329,2923,4776,41324,0.147734972413126,0.102894201916562,0.195261833317201,0.0321604878520956,0.0707337140644662,0.11557448456103
"E14001376",6385,6603,4323,2206,4397,4179,37911,0.168420774972963,0.174171084909393,0.114030228693519,0.0581889161457097,0.115982168763683,0.110231858827253
"E14001377",4896,7590,9066,1360,6230,3536,48904,0.100114510060527,0.155202028463929,0.185383608702765,0.0278095861279241,0.127392442336005,0.0723049239326027
"E14001378",4745,8267,9969,1237,7030,3508,46717,0.101569021983432,0.176959136930882,0.21339127084359,0.0264785838131729,0.150480553117709,0.0750904381702592
"E14001379",4892,5739,9840,1068,4671,3824,41623,0.117531172668957,0.137880498762703,0.236407755327583,0.0256588905172621,0.112221608245441,0.091872282151695
"E14001380",5479,5983,6616,1892,4091,3587,33025,0.165904617713853,0.18116578349735,0.200333080999243,0.0572899318697956,0.123875851627555,0.108614685844058
"E14001381",6590,6622,6925,2019,4603,4571,37007,0.178074418353285,0.178939119626017,0.1871267598022,0.0545572459264463,0.12438187369957,0.123517172426838
"E14001382",4524,5750,4689,1239,4511,3285,42767,0.105782495849604,0.134449458694788,0.10964061075128,0.0289709355344074,0.105478523160381,0.0768115603151963
"E14001383",4924,5611,6312,1274,4337,3650,44418,0.110855959295781,0.12632266198388,0.142104552208564,0.0286820658291684,0.0976405961547121,0.0821738934666126
"E14001384",5210,4324,4854,1299,3025,3911,37697,0.138207284399289,0.11470408785845,0.128763562087169,0.034458975515293,0.0802451123431573,0.103748308883996
"E14001385",8383,5966,9524,2233,3733,6150,45336,0.184908240691724,0.131595200282336,0.210075877889536,0.0492544556202576,0.0823407446620787,0.135653785071466
"E14001386",6759,4968,7177,1693,3275,5066,37274,0.181332832537426,0.133283253742555,0.192547083758116,0.0454204002790149,0.0878628534635403,0.135912432258411
"E14001387",7747,6536,9995,2248,4288,5499,41401,0.187121084031787,0.157870582836163,0.241419289389145,0.0542982053573585,0.103572377478805,0.132822878674428
"E14001388",6100,5091,4549,1669,3422,4431,35201,0.173290531518991,0.144626573108719,0.129229283258998,0.0474134257549501,0.0972131473537684,0.125877105764041
"E14001389",4863,6318,5196,1444,4874,3419,36056,0.134873530064344,0.1752274240071,0.144109163523408,0.0400488129576215,0.135178611049479,0.0948247171067229
"E14001390",6074,3934,8147,1255,2679,4819,40853,0.148679411548723,0.096296477614863,0.199422319046337,0.0307198981714929,0.0655765794433701,0.117959513377231
"E14001391",5198,4515,4642,1285,3230,3913,32449,0.160189836358593,0.139141421923634,0.143055255940091,0.0396006040247773,0.0995408178988567,0.120589232333816
"E14001392",5885,5612,2339,1732,3880,4153,35240,0.16699772985244,0.159250851305335,0.0663734392735528,0.0491486946651532,0.110102156640182,0.117849035187287
"E14001393",6662,5893,6950,1739,4154,4923,37835,0.176080348883309,0.155755253072552,0.183692348354698,0.0459627329192547,0.109792520153297,0.130117615964054
"E14001394",5291,6047,5487,1858,4189,3433,30492,0.173520923520924,0.198314311950676,0.179948839039748,0.06093401547947,0.137380296471206,0.112586908041453
"E14001395",6721,4426,7389,1678,2748,5043,33819,0.198734439220557,0.130873177799462,0.218486649516544,0.0496170791566871,0.0812560986427748,0.149117360063869
"E14001396",7856,4668,9431,1702,2966,6154,39354,0.199623926411546,0.118615642628449,0.239645271128729,0.0432484626721553,0.0753671799562941,0.156375463739391
"E14001397",5288,5603,7935,1359,4244,3929,39781,0.132927779593273,0.140846132575853,0.199467082275458,0.0341620371534149,0.106684095422438,0.0987657424398582
"E14001398",6236,4211,7847,1530,2681,4706,37976,0.164208974088898,0.110885822624816,0.206630503475879,0.0402886033284179,0.0705972192963977,0.12392037076048
"E14001399",5970,6167,5226,2101,4066,3869,34644,0.172324211984759,0.178010622329985,0.150848631797714,0.0606454220066967,0.117365200323288,0.111678789978063
"E14001400",6119,4837,6858,1581,3256,4538,33043,0.185182943437339,0.1463850134673,0.207547740822565,0.0478467451502588,0.0985382683170414,0.13733619828708
"E14001401",5567,4546,5264,1330,3216,4237,47602,0.116948867694635,0.0955001890676862,0.110583588924835,0.0279400025209025,0.0675601865467838,0.0890088651737322
"E14001402",5167,4764,4612,1497,3267,3670,38422,0.134480245692572,0.123991463224194,0.120035396387486,0.0389620529904742,0.0850294102337203,0.0955181927020978
"E14001403",6026,6444,2370,2030,4414,3996,40262,0.149669663702747,0.160051661616412,0.0588644379315484,0.0504197506333515,0.109631910983061,0.0992499130693955
"E14001404",6055,3932,6877,1122,2810,4933,39810,0.152097462949008,0.0987691534790254,0.172745541321276,0.0281838733986436,0.0705852800803818,0.123913589550364
"E14001405",8361,5692,9319,2013,3679,6348,44677,0.187143272824943,0.127403361908812,0.208586073371086,0.0450567406047855,0.0823466213040267,0.142086532220158
"E14001406",7500,6737,15431,1697,5040,5803,51340,0.14608492403584,0.131223217763927,0.300564861706272,0.0330541488118426,0.0981690689520841,0.113030775223997
"E14001407",5689,3753,3327,1165,2588,4524,39841,0.142792600587335,0.0941994427850707,0.0835069400868452,0.0292412339047715,0.0649582088802992,0.113551366682563
"E14001408",6887,5678,7003,1873,3805,5014,37607,0.183130800117,0.150982529848167,0.186215332251974,0.0498045576621374,0.101177972186029,0.133326242454862
"E14001409",6452,5257,11879,1397,3860,5055,46681,0.138214691201988,0.112615410980913,0.254471840791757,0.0299265225680684,0.0826888884128446,0.10828816863392
"E14001410",7518,5049,24395,1029,4020,6489,59235,0.126918207141048,0.0852367688022284,0.411834219633663,0.0173714864522664,0.067865282349962,0.109546720688782
"E14001411",6331,4409,9112,1132,3277,5199,43984,0.14393870498363,0.100240996726082,0.207166242269916,0.0257366315023645,0.0745043652237177,0.118202073481266
"E14001412",6217,3646,9977,978,2668,5239,45657,0.136167509910857,0.0798563199509385,0.218520708763169,0.0214205926802024,0.0584357272707361,0.114746917230655
"E14001413",5316,3347,9154,1029,2318,4287,36232,0.146721130492382,0.0923769043939059,0.252649591521307,0.0284003091190108,0.0639765952748951,0.118320821373372
"E14001414",5814,6823,13733,1659,5164,4155,30585,0.19009318293281,0.223083210724211,0.449010953081576,0.0542422756253065,0.168840935098905,0.135850907307504
"E14001415",6450,8268,6448,2259,6009,4191,35298,0.182729899711032,0.234234234234234,0.182673239277013,0.0639979602243753,0.170236274009859,0.118731939486656
"E14001416",5638,9753,2998,2416,7337,3222,36400,0.15489010989011,0.26793956043956,0.0823626373626374,0.0663736263736264,0.201565934065934,0.0885164835164835
"E14001417",6592,7815,9458,2449,5366,4143,30437,0.216578506423103,0.256759864638433,0.310740217498439,0.080461280678122,0.176298583960311,0.136117225744981
"E14001418",4662,5911,5890,1374,4537,3288,34684,0.134413562449544,0.170424403183024,0.169818936685503,0.0396148079806251,0.130809595202399,0.0947987544689194
"E14001419",6044,7462,10951,1622,5840,4422,43956,0.137501137501137,0.16976066976067,0.249135499135499,0.0369005369005369,0.132860132860133,0.100600600600601
"E14001420",5349,5820,7239,1394,4426,3955,37479,0.142719923156968,0.155286960697991,0.193148162971264,0.0371941620640892,0.118092798633902,0.105525761092879
"E14001421",3073,3588,15308,367,3221,2706,44246,0.0694526058852778,0.0810920761198752,0.345974777381006,0.00829453509921801,0.0727975410206572,0.0611580707860598
"E14001422",7227,8294,16254,1906,6388,5321,41558,0.173901535203812,0.199576495500265,0.391116030607825,0.0458636123008807,0.153712883199384,0.128037922902931
"E14001423",4334,3931,4887,1099,2832,3235,29849,0.145197494053402,0.131696204227947,0.163724077858555,0.0368186538912526,0.0948775503366947,0.108378840162149
"E14001424",7168,6903,11178,1905,4998,5263,39502,0.181459166624475,0.174750645536935,0.282973014024606,0.0482254063085413,0.126525239228394,0.133233760315933
"E14001425",7337,4914,10906,1481,3433,5856,49528,0.148138426748506,0.0992166047488289,0.220198675496689,0.0299022774995962,0.0693143272492328,0.11823614924891
"E14001426",7013,7489,3445,2021,5468,4992,38002,0.184542918793748,0.19706857533814,0.0906531235198147,0.0531814115046576,0.143887163833482,0.13136150728909
"E14001427",7886,6210,22800,1342,4868,6544,49754,0.158499819110021,0.124814085299674,0.458254612694457,0.0269727057121035,0.0978413795875708,0.131527113397918
"E14001428",4296,4845,7192,922,3923,3374,47516,0.0904116508123579,0.101965653674552,0.151359542048994,0.0194039902348683,0.0825616634396835,0.0710076605774897
"E14001429",6305,11105,1609,2871,8234,3434,41898,0.150484510000477,0.265048451000048,0.0384027877225643,0.068523557210368,0.19652489378968,0.0819609527901093
"E14001430",1742,5657,5878,439,5218,1303,79380,0.0219450743260267,0.0712648022171832,0.0740488788107836,0.00553036029226505,0.0657344419249181,0.0164147140337617
"E14001431",7216,14632,1703,4125,10507,3091,35449,0.203560044006883,0.412761996107083,0.0480408474145956,0.116364354424666,0.296397641682417,0.0871956895822167
"E14001432",7227,21716,5906,4880,16836,2347,49245,0.146756015839171,0.44097877957153,0.11993095745761,0.0990963549598944,0.341882424611636,0.0476596608792771
"E14001433",5941,10820,4174,2403,8417,3538,47588,0.124842397243002,0.22736824409515,0.0877111876943767,0.050495923342019,0.176872320753131,0.0743464739009834
"E14001434",3386,6160,19349,566,5594,2820,50634,0.0668720622506616,0.121657384366236,0.382134534107517,0.0111782596674172,0.110479124698819,0.0556938025832445
"E14001435",3864,3559,29921,151,3408,3713,52428,0.0737010757610437,0.0678835736629282,0.570706492713817,0.00288014038300145,0.0650034332799268,0.0708209353780423
"E14001436",4888,3902,6515,1079,2823,3809,34148,0.143141618835657,0.114267307016516,0.190787161766428,0.0315977509663816,0.0826695560501347,0.111543867869275
"E14001437",6514,5191,6585,1825,3366,4689,29979,0.217285433136529,0.173154541512392,0.219653757630341,0.0608759464958804,0.112278595016512,0.156409486640648
"E14001438",7731,7585,16335,2101,5484,5630,49514,0.156137658036111,0.153188997051339,0.329906693056509,0.0424324433493557,0.110756553701983,0.113705214686755
"E14001439",6859,6945,4372,2357,4588,4502,30585,0.224260258296551,0.227072094163806,0.142945888507438,0.0770639202223312,0.150008173941475,0.147196338074219
"E14001440",5498,5299,5759,1370,3929,4128,35843,0.15339117819379,0.147839187568005,0.160672934743186,0.0382222470217337,0.109616940546271,0.115168931172056
"E14001441",5549,6023,4047,1631,4392,3918,32880,0.168765206812652,0.183181265206813,0.123083941605839,0.0496046228710462,0.133576642335766,0.119160583941606
"E14001442",6576,8996,6812,2636,6360,3940,39187,0.167810753566234,0.229565927475949,0.173833158955776,0.0672672059611606,0.162298721514788,0.100543547605073
"E14001443",5621,7049,3980,2230,4819,3391,35350,0.159009900990099,0.199405940594059,0.112588401697313,0.0630834512022631,0.136322489391796,0.0959264497878359
"E14001444",5177,5345,8420,1260,4085,3917,36608,0.141417176573427,0.146006337412587,0.230004370629371,0.0344187062937063,0.111587631118881,0.10699847027972
"E14001445",5478,5923,21939,875,5048,4603,44097,0.124226137832506,0.134317527269429,0.497516837880128,0.0198426196793433,0.114474907590085,0.104383518153162
"E14001446",5780,6616,4423,1785,4831,3995,36630,0.157794157794158,0.180616980616981,0.120748020748021,0.0487305487305487,0.131886431886432,0.109063609063609
"E14001447",5603,6471,6980,1959,4512,3644,39770,0.140885089263264,0.162710585868745,0.17550917777219,0.0492582348503897,0.113452351018356,0.091626854412874
"E14001448",5739,4659,17033,1116,3543,4623,36340,0.157925151348376,0.128205833791965,0.468712162905889,0.0307099614749587,0.0974958723170061,0.127215189873418
"E14001449",6022,8044,2592,2365,5679,3657,33813,0.178097181557389,0.237896666962411,0.0766569071067341,0.0699435128500872,0.167953154112324,0.108153668707302
"E14001450",7591,8308,13336,2328,5980,5263,39005,0.194616074862197,0.212998333546981,0.341904883989232,0.0596846558133573,0.153313677733624,0.13493141904884
"E14001451",5283,4605,3835,1419,3186,3864,30416,0.173691478169385,0.15140057864282,0.126084955286691,0.0466530773277223,0.104747501315097,0.127038400841662
"E14001452",5725,4906,6213,1375,3531,4350,38880,0.147247942386831,0.126183127572016,0.159799382716049,0.0353652263374486,0.0908179012345679,0.111882716049383
"E14001453",5670,4091,8534,1213,2878,4457,39659,0.142968809097557,0.103154391184851,0.215184447414206,0.0305857434630223,0.0725686477218286,0.112383065634534
"E14001454",6045,7407,10797,1947,5460,4098,31600,0.19129746835443,0.234398734177215,0.341677215189873,0.0616139240506329,0.172784810126582,0.129683544303797
"E14001455",4966,5213,3569,1344,3869,3622,32889,0.150992733132658,0.158502842895801,0.108516525282009,0.0408647268083554,0.117638116087446,0.110128006324303
"E14001456",6441,8397,8333,2391,6006,4050,40571,0.158758719282246,0.206970496167213,0.205393014714944,0.058933721130857,0.148036775036356,0.0998249981513889
"E14001457",5632,4203,9137,1224,2979,4408,37947,0.148417529712494,0.110759743853269,0.24078319761773,0.0322555142699028,0.0785042295833663,0.116162015442591
"E14001458",5384,3754,7446,1168,2586,4216,36664,0.14684704342134,0.102389264673794,0.203087497272529,0.0318568623172594,0.070532402356535,0.11499018110408
"E14001459",4437,7212,7876,1470,5742,2967,70009,0.0633775657415475,0.103015326600866,0.112499821451528,0.0209973003470982,0.0820180262537674,0.0423802653944493
"E14001460",6174,6316,5122,2057,4259,4117,34731,0.177766260689298,0.181854827099709,0.147476317986813,0.0592266275085658,0.122628199591143,0.118539633180732
"E14001461",8978,5821,15769,1915,3906,7063,46149,0.194543760428178,0.126134910832304,0.341697544908882,0.0414960237491603,0.0846388870831437,0.153047736679018
"E14001462",4964,6693,7066,1337,5356,3627,37505,0.132355685908546,0.178456205839221,0.188401546460472,0.0356485801893081,0.142807625649913,0.0967071057192374
"E14001463",5377,8103,2948,2439,5664,2938,29017,0.185305165937209,0.27925009477203,0.101595616362822,0.0840541751387118,0.195195919633318,0.101250990798497
"E14001464",5183,4181,5193,1381,2800,3802,36582,0.141681701383194,0.114291181455361,0.141955059865508,0.0377508064075228,0.0765403750478377,0.103930894975671
"E14001465",6191,7199,6586,2271,4928,3920,30965,0.199935410947844,0.232488293234297,0.212691748748587,0.0733408687227515,0.159147424511545,0.126594542225093
"E14001466",6384,4378,10051,1073,3305,5311,39003,0.16367971694485,0.112247775812117,0.257698125785196,0.0275107043047971,0.0847370715073199,0.136169012640053
"E14001467",6872,2979,14232,716,2263,6156,45673,0.150460884986754,0.0652245309044731,0.311606419547654,0.0156766579817398,0.0495478729227333,0.134784227005014
"E14001468",6110,6527,7679,1634,4893,4476,29571,0.206621352000271,0.220723005647425,0.259680091982009,0.0552568394711034,0.165466166176321,0.151364512529167
"E14001469",5235,5577,7750,1242,4335,3993,41368,0.126547089537807,0.134814349255463,0.187342873718816,0.0300232063430671,0.104791142912396,0.0965238831947399
"E14001470",4801,4370,4545,1087,3283,3714,34433,0.13943019777539,0.12691313565475,0.131995469462434,0.0315685534225888,0.095344582232161,0.107861644352801
"E14001471",5486,4542,5710,1401,3141,4085,39722,0.138109863551684,0.114344695634661,0.143749055938774,0.035270127385328,0.0790745682493329,0.102839736166356
"E14001472",6801,7873,7750,2119,5754,4682,36563,0.18600771271504,0.215326969887591,0.211962913327681,0.0579547630117879,0.157372206875803,0.128052949703252
"E14001473",4980,4853,6846,1376,3477,3604,37935,0.131277184657968,0.127929352840385,0.180466587584025,0.0362725715038882,0.0916567813364966,0.0950046131540793
"E14001474",7025,6545,6770,2098,4447,4927,39423,0.178195469649697,0.166019836136266,0.171727164345687,0.0532176648149557,0.11280217132131,0.124977804834741
"E14001475",6690,5061,12213,1480,3581,5210,38043,0.175853639302894,0.13303367242331,0.321031464395552,0.0389033462134953,0.0941303262098152,0.136950293089399
"E14001476",5409,3139,3923,1009,2130,4400,37063,0.145940695572404,0.0846936297655344,0.105846801392224,0.0272239160348596,0.0574697137306748,0.118716779537544
"E14001477",6736,8448,7140,2321,6127,4415,43382,0.155271771702549,0.194735143607948,0.164584389839104,0.0535014522152045,0.141233691392744,0.101770319487345
"E14001478",5704,7203,16019,1361,5842,4343,38644,0.147603767725908,0.186393748059207,0.414527481627161,0.0352189214367043,0.151174826622503,0.112384846289204
"E14001479",5058,5900,6977,1546,4354,3512,32112,0.157511210762332,0.183731938216243,0.217270802192327,0.0481439960139512,0.135587942202292,0.109367214748381
"E14001480",6266,8121,3777,2438,5683,3828,32653,0.191896609806143,0.248706091323921,0.115670841882829,0.0746638899947937,0.174042201329127,0.11723271981135
"E14001481",6034,5608,5087,1775,3833,4259,36859,0.163704929596571,0.152147372419219,0.138012425730486,0.0481564882389647,0.103990884180254,0.115548441357606
"E14001482",5880,4656,6817,1464,3192,4416,35967,0.16348319292685,0.129451997664526,0.189534851391553,0.0407039786470932,0.0887480190174326,0.122779214279756
"E14001483",4212,3069,5551,892,2177,3320,37375,0.112695652173913,0.0821137123745819,0.148521739130435,0.023866220735786,0.058247491638796,0.0888294314381271
"E14001484",8530,8182,8496,2737,5445,5793,40659,0.20979364962247,0.201234658993089,0.208957426400059,0.067315969404068,0.133918689589021,0.142477680218402
"E14001485",7502,9453,5366,2900,6553,4602,40146,0.186867932048025,0.2354655507398,0.13366213321377,0.0722363373686046,0.163229213371195,0.11463159467942
"E14001486",6915,5503,9154,1901,3602,5014,36662,0.188614914625498,0.150100921935519,0.249686323713927,0.0518520538977688,0.0982488680377503,0.136762860727729
"E14001487",6992,4489,6431,1460,3029,5532,43861,0.159412690089145,0.10234604774173,0.146622284033652,0.0332869747611774,0.0690590729805522,0.126125715327968
"E14001488",5382,4062,4937,1273,2789,4109,34450,0.15622641509434,0.117910014513788,0.143309143686502,0.0369521044992743,0.0809579100145138,0.119274310595065
"E14001489",5111,3204,3594,1277,1927,3834,36275,0.140895933838732,0.0883252929014473,0.0990764989662302,0.0352033080634045,0.0531219848380427,0.105692625775327
"E14001490",5376,3874,5766,1326,2548,4050,35848,0.149966525329168,0.108067395670609,0.160845793349699,0.0369895112698058,0.0710778844008034,0.112977014059362
"E14001491",5323,6963,1595,2211,4752,3112,31890,0.166917529005958,0.218344308560677,0.0500156788962057,0.0693320790216369,0.14901222953904,0.0975854499843211
"E14001492",4877,6935,5864,1384,5551,3493,38110,0.12797166098137,0.181973235371294,0.153870375229599,0.0363159275780635,0.14565730779323,0.0916557334033062
"E14001493",7407,5090,9032,1875,3215,5532,34575,0.214229934924078,0.147216196673897,0.261229211858279,0.0542299349240781,0.0929862617498192,0.16
"E14001494",6309,4432,5517,1585,2847,4724,34113,0.184944156186791,0.129921144431742,0.161727200773899,0.0464632251634274,0.0834579192683141,0.138480931023364
"E14001495",6700,7026,4227,2268,4758,4432,34292,0.195380846844745,0.204887437303161,0.123264901434737,0.0661378747229674,0.138749562580194,0.129242972121778
"E14001496",5172,6522,7145,1772,4750,3400,32524,0.15902103062354,0.200528840241053,0.219683925716394,0.0544828434386914,0.146045996802361,0.104538187184848
"E14001497",7694,5091,6161,2062,3029,5632,40754,0.188791284291113,0.124920253226677,0.151175344751435,0.0505962604897679,0.0743239927369093,0.138195023801345
"E14001498",5557,4910,5669,1588,3322,3969,36395,0.152685808490177,0.134908641296881,0.155763154279434,0.0436323670833906,0.0912762742134909,0.109053441406787
"E14001499",6038,10418,2020,2472,7946,3566,45582,0.132464569347549,0.228555131411522,0.0443157386687728,0.0542319336580229,0.174323197753499,0.0782326356895266
"E14001500",6695,14007,3205,3099,10908,3596,46520,0.143916595012898,0.30109630266552,0.0688950988822012,0.0666165090283749,0.234479793637145,0.0773000859845228
"E14001501",6947,4653,16518,1267,3386,5680,40591,0.171146313222143,0.114631322214284,0.40693749846025,0.0312138158705132,0.0834175063437708,0.13993249735163
"E14001502",7696,4081,22124,1100,2981,6596,37395,0.205802914828186,0.109132236930071,0.59162989704506,0.0294156972857334,0.0797165396443375,0.176387217542452
"E14001503",6594,6124,25223,1045,5079,5549,47759,0.138068217508742,0.128227140434264,0.528130823509705,0.0218806926443183,0.106346447789945,0.116187524864423
"E14001504",6083,14390,3849,3451,10939,2632,38741,0.157017113652203,0.371441108902713,0.0993521075862781,0.0890787537750703,0.282362355127643,0.0679383598771328
"E14001505",6595,9931,8459,2566,7365,4029,38616,0.170784130930184,0.257173192459084,0.219054278019474,0.066449140252745,0.190724052206339,0.104334990677439
"E14001506",3967,5219,6554,1129,4090,2838,32560,0.121836609336609,0.160288697788698,0.201289926289926,0.0346744471744472,0.125614250614251,0.0871621621621622
"E14001507",5917,5913,8826,1716,4197,4201,36829,0.160661435281979,0.160552825219257,0.23964810339678,0.0465937169078715,0.113959108311385,0.114067718374107
"E14001508",6957,6022,8506,1739,4283,5218,43949,0.158297117113017,0.13702245784887,0.193542515188059,0.0395685908666864,0.0974538669821839,0.118728526246331
"E14001509",5945,9562,3594,2190,7372,3755,38103,0.156024460016272,0.250951368658636,0.0943232816313676,0.0574757893079285,0.193475579350707,0.0985486707083432
"E14001510",5185,8735,4468,1970,6765,3215,38498,0.134682321159541,0.226894903631357,0.116057977037768,0.0511714894280222,0.175723414203335,0.0835108317315185
"E14001511",8492,6872,13526,2302,4570,6190,40586,0.209234711476864,0.1693194697679,0.333267629231755,0.0567190656876756,0.112600404080225,0.152515645789188
"E14001512",4587,4097,3394,1206,2891,3381,42321,0.108385907705394,0.0968077313863094,0.0801965927081118,0.0284964911037074,0.068311240282602,0.0798894166016871
"E14001513",5704,4622,6190,1553,3069,4151,35500,0.160676056338028,0.130197183098592,0.174366197183099,0.0437464788732394,0.0864507042253521,0.116929577464789
"E14001514",5983,5600,6662,1992,3608,3991,27767,0.215471602981957,0.201678251161451,0.239925090935283,0.0717398350560017,0.129938416105449,0.143731767925955
"E14001515",5383,6729,5640,1770,4959,3613,36426,0.147779058913963,0.184730686872014,0.154834458902981,0.0485916652940208,0.136139021577994,0.0991873936199418
"E14001516",5865,8494,2912,2149,6345,3716,38383,0.152802021728369,0.22129588619962,0.0758669202511529,0.0559883281661152,0.165307558033504,0.0968136935622541
"E14001517",6000,10864,10189,2579,8285,3421,39808,0.15072347266881,0.272909967845659,0.255953577170418,0.0647859726688103,0.208123995176849,0.0859375
"E14001518",4930,4535,4945,1145,3390,3785,41436,0.118978665894391,0.109445892460662,0.119340669948837,0.0276329761559996,0.0818129163046626,0.0913456897383917
"E14001519",4238,3606,2200,985,2621,3253,31127,0.13615189385421,0.115847977639991,0.0706781893532946,0.0316445529604523,0.0842034246795387,0.104507340893758
"E14001520",7522,7866,14029,2279,5587,5243,45464,0.165449586486011,0.173016012669365,0.308573816646138,0.0501275734647193,0.122888439204645,0.115322013021292
"E14001521",6250,6911,7899,2056,4855,4194,36532,0.171082886236724,0.18917661228512,0.216221394941421,0.0562794262564327,0.132897186028687,0.114803459980291
"E14001522",5785,5468,3691,1772,3696,4013,30707,0.188393525906145,0.178070146872049,0.120200605725079,0.0577067118246654,0.120363435047383,0.13068681408148
"E14001523",5321,4692,4239,1560,3132,3761,29134,0.182638841216448,0.16104894624837,0.145500102972472,0.0535456854534221,0.107503260794947,0.129093155763026
"E14001524",5438,5285,7585,1515,3770,3923,35285,0.15411648009069,0.149780359926314,0.214963865665297,0.0429360918237211,0.106844268102593,0.111180388266969
"E14001525",3800,4442,15850,585,3857,3215,57417,0.0661824895065921,0.0773638469442848,0.276050647020917,0.0101886200950938,0.067175226849191,0.0559938694114983
"E14001526",5445,4335,6748,1400,2935,4045,39782,0.136870946659293,0.10896888039817,0.169624453270323,0.0351917952842994,0.0737770851138706,0.101679151374994
"E14001527",6011,4442,27586,558,3884,5453,46563,0.129093915770032,0.0953976333140047,0.592444644889719,0.0119837639327363,0.0834138693812684,0.117110151837296
"E14001528",5135,10849,6920,2341,8508,2794,36398,0.141079180174735,0.298065827792736,0.190120336282213,0.0643167206989395,0.233749107093796,0.0767624594757954
"E14001529",6752,6001,7427,1959,4042,4793,34860,0.193689041881813,0.172145725760184,0.213052208835341,0.0561962134251291,0.115949512335055,0.137492828456684
"E14001530",7073,5253,7691,1679,3574,5394,39696,0.178179161628376,0.132330713422007,0.193747480854494,0.0422964530431278,0.0900342603788795,0.135882708585248
"E14001531",6953,8829,5083,2411,6418,4542,41925,0.165843768634466,0.210590339892665,0.121240310077519,0.0575074537865236,0.153082886106142,0.108336314847943
"E14001532",6164,7605,2983,2296,5309,3868,32767,0.188116092410047,0.232093264564959,0.0910367137668996,0.0700704977568896,0.162022766808069,0.118045594653157
"E14001533",6499,6794,3903,2462,4332,4037,33118,0.196237695513014,0.205145238239024,0.117851319524126,0.0743402379370735,0.130805000301951,0.121897457575941
"E14001534",5021,7024,13764,1350,5674,3671,36852,0.136247693476609,0.19060023879301,0.373493975903614,0.0366330185607294,0.15396722023228,0.0996146749158797
"E14001535",5671,7175,7502,1839,5336,3832,32142,0.176435816066206,0.223228174973555,0.233401779603012,0.0572148590629083,0.166013315910646,0.119220957003298
"E14001536",4324,5905,2119,1521,4384,2803,37843,0.114261554316518,0.156039426049732,0.0559945036070079,0.0401923737547235,0.115847052295008,0.0740691805617948
"E14001537",6394,7977,5809,2123,5854,4271,41664,0.153465821812596,0.191460253456221,0.139424923195084,0.0509552611367127,0.140504992319508,0.102510560675883
"E14001538",5402,5538,4710,1573,3965,3829,33445,0.161518911645986,0.165585289280909,0.14082822544476,0.0470324413215727,0.118552847959336,0.114486470324413
"E14001539",6651,7997,5100,2502,5495,4149,36637,0.181537789666184,0.218276605617272,0.139203537407539,0.0682916177634632,0.149984987853809,0.113246171902721
"E14001540",6528,6428,7008,1841,4587,4687,44646,0.146216906329794,0.143977064014693,0.156968149442279,0.0412354970210097,0.102741566993684,0.104981409308785
"E14001541",5287,4846,2688,1326,3520,3961,41811,0.126449977278707,0.115902513692569,0.0642893018583626,0.0317141422113798,0.0841883714811892,0.0947358350673268
"E14001542",5895,5548,3328,1796,3752,4099,35746,0.164913556761596,0.1552061769149,0.093101326022492,0.0502433838751189,0.104962793039781,0.114670172886477
"E14001543",5412,4931,4520,1438,3493,3974,39693,0.136346459073388,0.124228453379689,0.113873982818129,0.0362280502859446,0.0880004030937445,0.100118408787444
"E14001544",7585,5190,10079,1758,3432,5827,42290,0.179356821943722,0.122724048238354,0.238330574603925,0.0415701111373847,0.0811539371009695,0.137786710806337
"E14001545",5666,6346,4186,2021,4325,3645,32184,0.176050211285111,0.197178722346508,0.130064628386776,0.0627951777280636,0.134383544618444,0.113255033557047
"E14001546",6209,4850,8868,1401,3449,4808,41623,0.14917233260457,0.116522115176705,0.213055281935468,0.0336592749201163,0.0828628402565889,0.115513057684453
"E14001547",4844,6251,6966,1293,4958,3551,37008,0.130890618244704,0.168909424989192,0.188229571984436,0.0349383916990921,0.133971033290099,0.0959522265456118
"E14001548",7213,5658,9122,1961,3697,5252,36476,0.197746463428007,0.155115692510144,0.250082245860292,0.053761377344007,0.101354315166137,0.143985086084
"E14001549",5937,5928,6007,1920,4008,4017,30653,0.193684141845823,0.193390532737416,0.195967768244544,0.0626366097934949,0.130753922943921,0.131047532052328
"E14001550",5528,2369,28617,343,2026,5185,45268,0.122117168861006,0.0523327737032783,0.632168419192365,0.00757709640364054,0.0447556772996377,0.114540072457365
"E14001551",8211,10817,13541,2994,7823,5217,44680,0.183773500447628,0.242099373321397,0.303066248880931,0.0670098478066249,0.175089525514772,0.116763652641003
"E14001552",7524,5885,9940,2032,3853,5492,39806,0.189016731146058,0.147842033864242,0.249711098829322,0.0510475807667186,0.096794453097523,0.13796915037934
"E14001553",5669,5064,26604,390,4674,5279,57091,0.0992976125834195,0.0887004956998476,0.465992888546356,0.00683119931337689,0.0818692963864707,0.0924664132700426
"E14001554",6135,5748,9280,1711,4037,4424,38163,0.160757802059587,0.150617089851427,0.243167465870084,0.0448340015197967,0.10578308833163,0.11592380053979
"E14001555",6933,6367,12027,1846,4521,5087,41264,0.168015703761148,0.154299146956185,0.291464715005816,0.0447363319115936,0.109562815044591,0.123279371849554
"E14001556",5616,6087,18922,1245,4842,4371,39368,0.142653932127616,0.15461796382849,0.480644178012599,0.0316246697825645,0.122993294045926,0.111029262345052
"E14001557",4554,6489,8237,1241,5248,3313,36854,0.123568676398763,0.176073153524719,0.223503554566668,0.0336734140120475,0.142399739512672,0.0898952623867151
"E14001558",6265,6577,12821,1750,4827,4515,39287,0.159467508336091,0.167409066612365,0.326342046987553,0.0445439967419248,0.122865069870441,0.114923511594166
"E14001559",2145,4494,19595,306,4188,1839,49724,0.0431381224358459,0.090378891480975,0.394075295631888,0.00615396991392487,0.0842249215670501,0.036984152521921
"E14001560",5379,6197,6393,1347,4850,4032,44821,0.120010709265746,0.138261082974499,0.142634033154102,0.0300528769996207,0.108208205974878,0.0899578322661252
"E14001561",6494,4076,15541,905,3171,5589,37562,0.172887492678771,0.108513923646238,0.413742612214472,0.0240934987487354,0.0844204248975028,0.148793993930036
"E14001562",6073,6895,9645,1607,5288,4466,42567,0.142669203843353,0.161979937510278,0.226583973500599,0.0377522493950713,0.124227688115207,0.104916954448282
"E14001563",6939,3182,26610,506,2676,6433,47736,0.145361990950226,0.0666582872465225,0.557440925087984,0.0105999664823194,0.0560583207642031,0.134762024467907
"E14001564",6306,7431,4148,1894,5537,4412,37255,0.169265870352973,0.199463159307476,0.11134075962958,0.0508388135820695,0.148624345725406,0.118427056770903
"E14001565",6052,8049,4486,2250,5799,3802,40284,0.150233343262834,0.199806374739351,0.111359348624764,0.0558534405719392,0.143952934167411,0.0943799026908946
"E14001566",6059,5255,9614,1347,3908,4712,44977,0.13471329790782,0.116837494719523,0.213753696333682,0.0299486404162127,0.0868888543033106,0.104764657491607
"E14001567",3786,5077,1639,1005,4072,2781,35465,0.106753136895531,0.143155223459749,0.0462145777527139,0.0283377978288453,0.114817425630904,0.0784153390666855
"E14001568",5708,4240,13850,1155,3085,4553,40429,0.141185782482871,0.104875213336961,0.342575873753988,0.0285686017462712,0.0763066115906899,0.1126171807366
"E14001569",6364,3664,5495,1496,2168,4868,33401,0.190533217568336,0.109697314451663,0.164516032454118,0.0447890781713122,0.0649082362803509,0.145744139397024
"E14001570",6069,5452,5029,1805,3647,4264,33388,0.181771894093686,0.163292200790703,0.150622978315562,0.0540613394033785,0.109230861387325,0.127710554690308
"E14001571",5787,3841,7996,1165,2676,4622,43002,0.134575136040184,0.0893214269103763,0.185944839774894,0.0270917631738059,0.0622296637365704,0.107483372866378
"E14001572",6175,4736,6826,1758,2978,4417,33425,0.18474195961107,0.141690351533283,0.204218399401645,0.0525953627524308,0.0890949887808527,0.132146596858639
"E14001573",6334,6836,3719,1948,4888,4386,44559,0.142148611952692,0.153414573935681,0.0834623757265648,0.0437173186112794,0.109697255324401,0.0984312933414125
"E14001574",5148,7555,6941,1733,5822,3415,36277,0.141908096038812,0.208258676296276,0.19133335171045,0.0477713151583648,0.160487361137911,0.0941367808804477
"E14001575",6855,6841,7129,2239,4602,4616,39174,0.174988512789095,0.174631132894267,0.18198294787359,0.0571552560371675,0.117475876857099,0.117833256751927
"E14001576",5636,7197,12680,1262,5935,4374,57361,0.0982549118739213,0.125468523909974,0.22105611826851,0.0220010111399732,0.103467512770001,0.0762539007339482
"E14001577",5486,7598,2791,1953,5645,3533,37078,0.14795835805599,0.204919359188737,0.0752737472355575,0.0526727439451966,0.152246615243541,0.0952856141107935
"E14001578",8446,6153,6033,2263,3890,6183,47191,0.178974804517811,0.130385031044055,0.127842173295756,0.0479540590366807,0.0824309720073743,0.13102074548113
"E14001579",6607,5043,8616,1732,3311,4875,37882,0.174410010031149,0.133123911092339,0.227443112824033,0.045720922865741,0.0874029882265984,0.128689087165408
"E14001580",7200,5722,13085,1715,4007,5485,40774,0.17658311669201,0.1403345269044,0.320915289154854,0.0420611173787217,0.0982734095256781,0.134521999313288
"E14001581",6662,5569,9530,1758,3811,4904,41365,0.161054031185785,0.134630726459567,0.23038800918651,0.04249969781216,0.0921310286474072,0.118554333373625
"E14001582",5361,4980,5937,1547,3433,3814,33603,0.159539326845817,0.148201053477368,0.176680653513079,0.04603755617058,0.102163497306788,0.113501770675237
"E14001583",6032,10055,8314,2515,7540,3517,35565,0.169604948685505,0.282721777027977,0.233769155068185,0.0707155911710952,0.212006185856882,0.0988893575144102
"E14001584",4888,5817,3511,1503,4314,3385,32969,0.148260487124268,0.176438472504474,0.106493979192575,0.0455882798992993,0.130850192605175,0.102672207224969
"E14001585",5641,8037,4876,2155,5882,3486,38188,0.147716560175972,0.210458782863727,0.127684089242694,0.0564313396878601,0.154027443175867,0.0912852204881115
"E14001586",6268,5790,22848,1028,4762,5240,44910,0.139568024938766,0.128924515698063,0.50875083500334,0.0228902248942329,0.10603429080383,0.116677800044534
"E14001587",5802,7060,4189,2032,5028,3770,37618,0.15423467488968,0.187676112499335,0.111356265617524,0.0540166941357861,0.133659418363549,0.100217980753894
"E14001588",6786,8362,8284,2448,5914,4338,39212,0.173059267571152,0.213251045598286,0.21126185861471,0.0624298684076303,0.150821177190656,0.110629399163521
"E14001589",5519,5562,8370,1570,3992,3949,29729,0.185643647616805,0.187090046755693,0.281543274244004,0.0528103871640486,0.134279659591645,0.132833260452757
"E14001590",6190,5676,3497,1964,3712,4226,36405,0.170031589067436,0.155912649361351,0.096058233759099,0.053948633429474,0.101964015931877,0.116082955637962
"E14001591",5531,4074,5000,1318,2756,4213,39062,0.141595412421279,0.104295734985408,0.128001638420972,0.0337412318877682,0.0705545030976397,0.107854180533511
"E14001592",6905,8940,5063,2470,6470,4435,39729,0.173802512018928,0.225024541267084,0.127438395126985,0.0621712099473936,0.162853331319691,0.111631302071535
"E14001593",5923,6062,2859,2000,4062,3923,35199,0.168271825904145,0.172220801727322,0.0812238984062047,0.0568197960169323,0.115401005710389,0.111452029887213
"E14001594",4691,5765,6248,1491,4274,3200,33912,0.138328615239443,0.169998820476527,0.184241566407172,0.043966737438075,0.126032083038452,0.0943618778013682
"E14001595",5517,5562,8589,1361,4201,4156,40989,0.134597087023348,0.135694942545561,0.209544024006441,0.033204030349606,0.102490912195955,0.101393056673742
"E14001596",6864,7309,14392,1851,5458,5013,40152,0.17095038852361,0.18203327356047,0.358437935843794,0.0460998206814106,0.13593345287906,0.1248505678422
"E14001597",6375,5168,9885,1388,3780,4987,41264,0.154493020550601,0.125242341993021,0.239555060100814,0.0336370686312524,0.0916052733617681,0.120855951919349
"E14001598",5843,8271,6705,2448,5823,3395,41718,0.14005944676159,0.198259743995398,0.160721990507695,0.058679706601467,0.139580037393931,0.0813797401601227
"E14001599",8716,10909,7011,3473,7436,5243,42494,0.205111309831976,0.256718595566433,0.164987998305643,0.0817291852967478,0.174989410269685,0.123382124535228
"E14001600",7929,8766,5743,2802,5964,5127,42610,0.186083079089416,0.205726355315654,0.134780567941798,0.0657592114527106,0.139967143862943,0.120323867636705
"E14001601",7248,5420,8361,1822,3598,5426,36667,0.19767093026427,0.147816838028745,0.228025199770911,0.0496904573594786,0.0981263806692666,0.147980472904792
"E14001602",5858,8461,5066,1939,6522,3919,50071,0.116993868706437,0.168980048331369,0.101176329611951,0.0387250104851111,0.130255037846258,0.0782688582213257
"E14001603",7311,6582,6406,2228,4354,5083,41570,0.175872023093577,0.158335337984123,0.154101515515997,0.0535963435169593,0.104738994467164,0.122275679576618
"E14001604",5712,5070,13047,1228,3842,4484,42891,0.133174791914388,0.11820661677275,0.304189690144786,0.0286307150684293,0.0895759017043203,0.104544076845958
"E14001605",5446,4684,2248,1547,3137,3899,30750,0.177105691056911,0.152325203252033,0.0731056910569106,0.0503089430894309,0.102016260162602,0.12679674796748
"W07000081",4923,7779,9674,1762,6017,3161,33611,0.146469905685639,0.231442087411859,0.287822439082443,0.0524233137960787,0.179018773615781,0.09404659188956
"W07000082",5064,4956,5518,1428,3528,3636,35092,0.144306394619856,0.141228770090049,0.157243816254417,0.0406930354496751,0.100535734640374,0.103613359170181
"W07000083",7242,6956,12509,2027,4929,5215,36664,0.197523456251364,0.189722888937377,0.3411793584988,0.0552858389701069,0.13443704996727,0.142237617281257
"W07000084",5118,7411,14595,1520,5891,3598,33397,0.153247297661467,0.22190615923586,0.437015300775519,0.0455130700362308,0.176393089199629,0.107734227625236
"W07000085",6356,6233,10084,1722,4511,4634,33757,0.188286873833575,0.184643185117161,0.29872322777498,0.0510116420298012,0.13363154308736,0.137275231803774
"W07000086",5617,6718,4180,2061,4657,3556,32858,0.17094771440745,0.204455535942541,0.127214072676365,0.0627244506665044,0.141731085276036,0.108223263740946
"W07000087",7076,7409,11433,2362,5047,4714,34530,0.204923255140458,0.214567043150883,0.33110338835795,0.0684042861280046,0.146162757022879,0.136518969012453
"W07000088",5056,7031,7087,1784,5247,3272,32708,0.154579919285802,0.214962700256818,0.216674819615996,0.0545432310138192,0.160419469242999,0.100036688271982
"W07000089",6502,8098,11267,2166,5932,4336,42952,0.151378282734215,0.188536040230955,0.262316073756752,0.0504283851741479,0.138107655056808,0.100949897560067
"W07000090",5444,8367,4122,2363,6004,3081,32172,0.169215466865597,0.260070869078702,0.128123834390153,0.0734489618301629,0.186621907248539,0.0957665050354345
"W07000091",5554,5995,13794,1430,4565,4124,47486,0.116960788442909,0.126247736174873,0.290485616813377,0.030114138904098,0.0961335972707745,0.0868466495388114
"W07000092",5994,8238,8986,2035,6203,3959,39665,0.151115593092147,0.207689398714232,0.226547333921593,0.0513046766670869,0.156384722047145,0.0998109164250599
"W07000093",7925,6556,12834,2261,4295,5664,36193,0.218964993230735,0.181139999447407,0.354598955599149,0.0624706434945984,0.118669355952809,0.156494349736137
"W07000094",6470,6173,7720,1890,4283,4580,34454,0.187786614036106,0.179166424798282,0.224066871771057,0.0548557496952458,0.124310675103036,0.13293086434086
"W07000095",7876,7914,11966,2207,5707,5669,41965,0.187680209698558,0.188585726200405,0.285142380555225,0.0525914452519957,0.135994280948409,0.135088764446563
"W07000096",7987,7656,15362,2194,5462,5793,36682,0.21773621939916,0.208712720135216,0.418788506624502,0.0598113516165967,0.148901368518619,0.157924867782564
"W07000097",6254,8512,5583,2706,5806,3548,32227,0.194060880628045,0.264126353678592,0.173239829956248,0.0839668600862631,0.180159493592329,0.110094020541782
"W07000098",5810,8332,9793,2421,5911,3389,32343,0.179637015737563,0.257613703119686,0.302785765080543,0.0748539096558761,0.18275979346381,0.104783106081687
"W07000099",5504,8576,14101,1781,6795,3723,38244,0.143918000209183,0.224244325907332,0.368711431858592,0.0465693965066416,0.17767492940069,0.0973486037025416
"W07000100",7826,8299,9384,2835,5464,4991,39658,0.197337233345101,0.209264208986837,0.236623127742196,0.0714862070704524,0.137778001916385,0.125851026274648
"W07000101",5110,5552,6278,1651,3901,3459,33701,0.151627548143972,0.164742885967775,0.186285273434023,0.048989644224207,0.115753241743568,0.102637903919765
"W07000102",6058,4339,8024,1404,2935,4654,34543,0.175375618793967,0.125611556610601,0.232290189039748,0.040644993196885,0.0849665634137162,0.134730625597082
"W07000103",5050,7863,8172,1870,5993,3180,34301,0.147226028395674,0.229235299262412,0.238243782980088,0.0545173610098831,0.174717938252529,0.0927086673857905
"W07000104",5999,10124,7090,2737,7387,3262,44540,0.134687920969915,0.227301302200269,0.159182757072295,0.0614503816793893,0.16585092052088,0.0732375392905254
"W07000105",4736,7432,6370,1790,5642,2946,34546,0.137092572222544,0.215133445261391,0.184391825392231,0.0518149713425577,0.163318473918833,0.0852776008799861
"W07000106",5913,7924,12418,1920,6004,3993,36644,0.161363388276389,0.216242768256741,0.338882218098461,0.0523960266346469,0.163846741622094,0.108967361641742
"W07000107",6595,8266,22402,1887,6379,4708,35998,0.183204622479027,0.229623867992666,0.622312350686149,0.0524195788654925,0.177204289127174,0.130785043613534
"W07000108",7704,11344,12838,2901,8443,4803,42811,0.179953750204387,0.264978626988391,0.299876200042045,0.0677629581182406,0.19721566887015,0.112190792086146
"W07000109",4622,6429,4806,1566,4863,3056,32077,0.144090781556879,0.20042397979861,0.149826978832185,0.0488200268104873,0.151603952988122,0.0952707547463915
"W07000110",5609,6730,7791,1911,4819,3698,36372,0.154212031232816,0.185032442538216,0.214203233256351,0.052540415704388,0.132492026833828,0.101671615528428
"W07000111",4027,3863,6349,943,2920,3084,33418,0.120503920043091,0.115596385181639,0.189987431922916,0.0282183254533485,0.0873780597282901,0.0922855945897421
"W07000112",5510,5885,7706,1703,4182,3807,29883,0.184385771174246,0.196934712043637,0.257872368905398,0.0569889234681926,0.139945788575444,0.127396847706054
,2690,5009,4497,844,4165,1846,73105,0.0367963887558991,0.0685178852335682,0.0615142603105123,0.0115450379590999,0.0569728472744682,0.0252513507967991
