"oslaua","loftins_n","cavitywallins_n","solidwallins_n","cavity_and_loftins_n","cavitywallins_noloftins_n","loftins_nocavitywallins_n","number_of_epcs","loftins_pct","cavitywallins_pct","solidwallins_pct","cavity_and_loftins_pct","cavitywallins_noloftins_pct","loftins_nocavitywallins_pct"
"E06000001",5149,5451,6815,1227,4224,3922,41462,0.124186001640056,0.131469779557185,0.164367372533886,0.0295933625970768,0.101876416960108,0.0945926390429791
"E06000002",7361,7655,11764,1703,5952,5658,59108,0.124534749949245,0.129508695946403,0.199025512620965,0.0288116667794546,0.100697029166949,0.0957230831697909
"E06000003",8141,7732,9712,1979,5753,6162,51697,0.157475288701472,0.149563804476082,0.187863899259145,0.0382807513008492,0.111283053175233,0.119194537400623
"E06000004",9407,8442,7763,2163,6279,7244,76293,0.123300958148192,0.11065235342692,0.10175245435361,0.0283512248830168,0.0823011285439031,0.094949733265175
"E06000005",5549,6048,14319,1250,4798,4299,44882,0.123635310369413,0.134753353237378,0.319036584822423,0.0278508087874872,0.106902544449891,0.0957845015819259
"E06000006",6621,7997,4619,1897,6100,4724,45404,0.145824156461986,0.176129856400317,0.101731125011012,0.041780459871377,0.13434939652894,0.104043696590609
"E06000007",13284,16565,9220,4472,12093,8812,82353,0.161305599067429,0.201146284895511,0.111957062887812,0.0543028183551297,0.146843466540381,0.107002780712299
"E06000008",9179,15065,8204,4088,10977,5091,55435,0.165581311445837,0.271759718589339,0.147993145124921,0.0737440245332371,0.198015694056102,0.0918372869126003
"E06000009",11936,24822,3809,6247,18575,5689,64231,0.18582927246968,0.386448910961997,0.0593015833476047,0.0972583332035933,0.289190577758403,0.0885709392660865
"E06000010",13107,12329,39449,2450,9879,10657,112512,0.116494240614334,0.109579422639363,0.350620378270762,0.0217754550625711,0.0878039675767918,0.0947187855517634
"E06000011",20999,17378,29037,4925,12453,16074,132189,0.158855880595208,0.13146328363177,0.219662755599936,0.0372572604377066,0.094206023194063,0.121598620157502
"E06000012",10092,8854,19406,2164,6690,7928,61838,0.163200620977393,0.143180568582425,0.313819981241308,0.0349946634755328,0.108185905106892,0.12820595750186
"E06000013",8477,9488,11775,2138,7350,6339,60109,0.141027134039828,0.157846578715334,0.195894125671696,0.0355687168310902,0.122277861884244,0.105458417208737
"E06000014",11158,9754,15295,2775,6979,8383,73641,0.151518854985674,0.132453388737252,0.207696799337326,0.0376828125636534,0.0947705761735989,0.11383604242202
"E06000015",14609,11422,28059,2985,8437,11624,97593,0.14969311323558,0.117037082577644,0.287510374719498,0.0305862100765424,0.0864508725011015,0.119106903159038
"E06000016",18971,12140,47713,2759,9381,16212,127341,0.148977941118728,0.095334574096324,0.374686864403452,0.021666234755499,0.073668339340825,0.127311706363229
"E06000017",2243,1567,3065,512,1055,1731,14751,0.152057487627957,0.106230086095858,0.207782523218765,0.0347095112195783,0.0715205748762796,0.117347976408379
"E06000018",19216,12403,42105,2944,9459,16272,143527,0.133884216906923,0.0864157963310039,0.293359437597107,0.0205118200756652,0.0659039762553387,0.113372396831258
"E06000019",13135,10166,14834,3324,6842,9811,70559,0.186156266386995,0.144078005640669,0.210235405830582,0.0471095111892175,0.096968494451452,0.139046755197778
"E06000020",9341,8372,5638,2380,5992,6961,71744,0.13019904103479,0.116692685102587,0.0785849687778769,0.0331735057983943,0.0835191793041927,0.0970255352363961
"E06000021",16470,17233,23243,5088,12145,11382,97450,0.16900974858902,0.176839404822986,0.238512057465367,0.0522113904566444,0.124628014366342,0.116798358132376
"E06000022",10796,11961,21252,3249,8712,7547,74087,0.145720571760228,0.161445327790301,0.286851944335713,0.0438538475036106,0.11759148028669,0.101866724256617
"E06000023",24328,20709,70613,5189,15520,19139,184732,0.131693480284953,0.112102938310634,0.38224563150943,0.0280893402334192,0.0840135980772146,0.103604140051534
"E06000024",14410,13139,16287,4407,8732,10003,85591,0.168358822773422,0.153509130632894,0.190288698578122,0.0514890584290404,0.102020072203853,0.116869764344382
"E06000025",16183,17788,14796,5259,12529,10924,100482,0.161053721064469,0.177026731155829,0.147250253776796,0.052337732131128,0.124688999024701,0.108715988933341
"E06000026",18724,18327,27957,4796,13531,13928,106737,0.175421831230033,0.171702408724247,0.26192416875123,0.0449328723872696,0.126769536336978,0.130488958842763
"E06000027",11047,14187,15494,4093,10094,6954,58524,0.188760166769189,0.242413368874308,0.264746087075388,0.0699371198140934,0.172476249060215,0.118823046955095
"E06000030",11450,14640,8410,3879,10761,7571,84481,0.135533433553107,0.173293403250435,0.0995490110202294,0.0459156496727075,0.127377753577728,0.0896177838803991
"E06000031",11119,8163,14537,2418,5745,8701,86177,0.129025145920605,0.0947236501618761,0.16868770089467,0.0280585306984462,0.0666651194634299,0.100966615222159
"E06000032",12791,12676,17698,3943,8733,8848,72361,0.176766490236453,0.175177236356601,0.244579262309808,0.0544906786805047,0.120686557676096,0.122275811555949
"E06000033",13496,7783,36795,2045,5738,11451,70513,0.191397330988612,0.110376809949938,0.52181867173429,0.0290017443591962,0.0813750655907421,0.162395586629416
"E06000034",9676,9242,11820,2824,6418,6852,58202,0.166248582522937,0.158791794096423,0.203085804611525,0.0485206693928044,0.110271124703618,0.117727913130133
"E06000035",17715,20948,23078,6493,14455,11222,101355,0.174781707858517,0.20667949287159,0.227694736322826,0.064061960436091,0.142617532435499,0.110719747422426
"E06000036",8131,8675,2334,2759,5916,5372,46935,0.173239586662405,0.184830084158943,0.0497283477149249,0.058783423884095,0.126046660274848,0.11445616277831
"E06000037",11142,10965,6818,3760,7205,7382,57988,0.192143202041802,0.18909084638201,0.117576050217286,0.0648410015865351,0.124249844795475,0.127302200455267
"E06000038",10956,11559,18767,3325,8234,7631,68584,0.159745713285898,0.168537851393911,0.273635250204129,0.0484806952058789,0.120057156188032,0.111265018080019
"E06000039",7911,10155,8259,2827,7328,5084,50327,0.157191964551831,0.201780356468695,0.164106741907922,0.0561726309933038,0.145607725475391,0.101019333558527
"E06000040",9690,11545,11435,3469,8076,6221,55123,0.17578869074615,0.209440705331713,0.20744516807866,0.0629319884621664,0.146508716869546,0.112856702283983
"E06000041",10950,11171,3952,3829,7342,7121,59941,0.182679634974391,0.186366593817254,0.0659314993076525,0.063879481490132,0.122487112327122,0.11880015348426
"E06000042",14624,13175,7184,3454,9721,11170,114747,0.127445597706258,0.114817816587798,0.0626073012802078,0.0301010048192981,0.0847168117684994,0.09734459288696
"E06000043",17209,25803,46164,6002,19801,11207,121085,0.142123301812776,0.213098236775819,0.381252838914812,0.0495684849485898,0.163529751827229,0.0925548168641863
"E06000044",14443,36348,7609,9005,27343,5438,84694,0.170531560677262,0.429168536141875,0.0898410749285664,0.106323942664179,0.322844593477696,0.0642076180130824
"E06000045",14215,27535,5646,6262,21273,7953,101575,0.139945852818115,0.271080482402166,0.0555845434408073,0.0616490278119616,0.209431454590204,0.0782968250061531
"E06000046",9872,20467,7024,4981,15486,4891,61515,0.160481183451191,0.332715597821669,0.114183532471755,0.0809721206209868,0.251743477200683,0.079509062830204
"E06000047",27529,34640,33072,7643,26997,19886,220297,0.124963117972555,0.157242268392216,0.150124604511183,0.0346940720935828,0.122548196298633,0.0902690458789725
"E06000049",24843,23934,28383,7353,16581,17490,155076,0.16019887023137,0.154337228197787,0.183026387061828,0.0474154608063143,0.106921767391473,0.112783409425056
"E06000050",20393,17711,23995,5520,12191,14873,128921,0.158182142552416,0.137378704788204,0.18612173346468,0.0428169188883114,0.0945617858998922,0.115365223664104
"E06000051",19981,15559,25295,5165,10394,14816,120246,0.166167689569715,0.129393077524408,0.210360427789698,0.0429536117625534,0.0864394657618549,0.123214077807162
"E06000052",43318,36199,59795,11752,24447,31566,243086,0.178200307710029,0.148914375982163,0.245982903170071,0.0483450301539373,0.100569345828225,0.129855277556091
"E06000053",234,239,336,70,169,164,997,0.234704112337011,0.239719157472417,0.337011033099298,0.0702106318956871,0.16950852557673,0.164493480441324
"E06000054",30302,27025,26121,8487,18538,21815,189269,0.160100174883367,0.142786193195928,0.138009922385599,0.0448409406717423,0.0979452525241852,0.115259234211625
"E06000055",9288,7274,13340,2256,5018,7032,69079,0.134454754701139,0.105299729295444,0.19311223381925,0.0326582608318013,0.0726414684636431,0.101796493869338
"E06000056",16793,15436,13489,4694,10742,12099,113562,0.147875169510928,0.135925749810676,0.11878093024075,0.0413342491326324,0.0945915006780437,0.106540920378296
"E06000057",17221,19141,20499,4814,14327,12407,127043,0.13555252945853,0.15066552269704,0.161354816873027,0.0378926820053053,0.112772840691734,0.0976598474532245
"E06000058",26492,48144,8287,11643,36501,14849,166180,0.159417499097364,0.289709953062944,0.0498676134312192,0.0700625827416055,0.219647370321338,0.0893549163557588
"E06000059",27272,28326,18642,9260,19066,18012,147800,0.184519621109608,0.191650879566982,0.126129905277402,0.0626522327469553,0.128998646820027,0.121867388362652
"E06000060",36870,38418,28512,12538,25880,24332,207474,0.177709014141531,0.185170189999711,0.137424448364614,0.0604316685464203,0.124738521453291,0.117277345595111
"E06000061",17549,12974,25242,3826,9148,13723,134858,0.130129469516084,0.0962048970027733,0.187174657788192,0.0283705823903662,0.0678343146124071,0.101758887125717
"E06000062",23071,17063,28761,5036,12027,18035,158168,0.145863891558343,0.107878964139396,0.181838298518031,0.0318395629963077,0.0760394011430884,0.114024328562035
"E06000063",17821,22065,26937,5734,16331,12087,107001,0.166549845328548,0.206213026046486,0.251745310791488,0.0535882842216428,0.152624741824843,0.112961561106906
"E06000064",16723,19624,25549,5200,14424,11523,95240,0.175587988240235,0.206047879042419,0.268259134817304,0.0545989080218396,0.15144897102058,0.120989080218396
"E06000065",42709,33552,64581,10096,23456,32613,253672,0.168363083036362,0.13226528745782,0.254584660506481,0.0397994260304645,0.092465861427355,0.128563657005897
"E06000066",39084,33055,43498,10977,22078,28107,229381,0.170389003448411,0.144105222315711,0.189632096817086,0.0478548790004403,0.0962503433152702,0.122534124447971
"E07000008",5782,6398,13611,1394,5004,4388,52422,0.110297203464194,0.122047995116554,0.259642898019915,0.0265918889016062,0.0954561062149479,0.0837053145625882
"E07000009",5070,3500,5603,1186,2314,3884,34125,0.148571428571429,0.102564102564103,0.164190476190476,0.0347545787545788,0.0678095238095238,0.11381684981685
"E07000010",6074,3934,8147,1255,2679,4819,40853,0.148679411548723,0.096296477614863,0.199422319046337,0.0307198981714929,0.0655765794433701,0.117959513377231
"E07000011",10673,8504,7981,2701,5803,7972,70365,0.151680522987281,0.120855538975343,0.113422866481916,0.0383855610033397,0.0824699779720031,0.113294961983941
"E07000012",8310,7361,6686,2278,5083,6032,61266,0.135638037410636,0.120148206182875,0.109130676068292,0.0371821238533608,0.0829660823295139,0.0984559135572748
"E07000032",6541,5172,13057,1443,3729,5098,47775,0.136912611198325,0.108257456828885,0.273301936159079,0.0302040816326531,0.0780533751962323,0.106708529565672
"E07000033",4183,3382,7110,811,2571,3372,34249,0.122134952845339,0.0987474086834652,0.207597302111011,0.0236795234897369,0.0750678851937283,0.0984554293556016
"E07000034",5486,5586,6640,1366,4220,4120,41707,0.131536672501019,0.133934351547702,0.159205888699739,0.0327522957776872,0.101182055770015,0.0987843767233318
"E07000035",4204,3417,9217,888,2529,3316,27634,0.152131432293551,0.123652022870377,0.333538394731128,0.0321343272779909,0.0915176955923862,0.119997105015561
"E07000036",6940,4922,13367,1528,3394,5412,41274,0.168144594660077,0.119251829238746,0.323860057178854,0.0370208848185298,0.0822309444202161,0.131123709841547
"E07000037",5168,4178,10721,1217,2961,3951,32193,0.160531792625726,0.129779765787594,0.333022706799615,0.0378032491535427,0.0919765166340509,0.122728543472183
"E07000038",5693,5098,4890,1436,3662,4257,36447,0.15619941284605,0.139874338079952,0.134167421186929,0.0393996762422147,0.100474661837737,0.116799736603836
"E07000039",4631,3414,5925,969,2445,3662,42557,0.108818760720915,0.0802218201470968,0.139225039358977,0.0227694621331391,0.0574523580139578,0.0860492985877764
"E07000040",10811,12413,9008,3816,8597,6995,63528,0.170176929857701,0.195394156907191,0.141795743609117,0.0600680015111447,0.135326155396046,0.110108928346556
"E07000041",8405,10419,8262,3032,7387,5373,50131,0.167660728890307,0.207835471065808,0.164808202509425,0.060481538369472,0.147353932696336,0.107179190520835
"E07000042",5771,4287,5448,1503,2784,4268,30653,0.188268684957427,0.139855805304538,0.177731380289042,0.0490327211039703,0.0908230842005676,0.139235963853456
"E07000043",7747,6536,9995,2248,4288,5499,41401,0.187121084031787,0.157870582836163,0.241419289389145,0.0542982053573585,0.103572377478805,0.132822878674428
"E07000044",8001,6715,8363,2309,4406,5692,39634,0.201872129989403,0.169425240954736,0.2110057021749,0.0582580612605339,0.111167179694202,0.143614068728869
"E07000045",9495,8631,10330,2683,5948,6812,52946,0.179333660710913,0.163015147508783,0.195104446039361,0.0506742718996714,0.112340875609111,0.128659388811242
"E07000046",5252,4226,7059,1361,2865,3891,29514,0.177949447719726,0.143186284475164,0.239174628989632,0.0461137087483906,0.0970725757267737,0.131835738971336
"E07000047",4453,3266,5677,1234,2032,3219,22034,0.202096759553417,0.148225469728601,0.257647272397204,0.0560043569029681,0.0922211128256331,0.146092402650449
"E07000061",7128,11359,7989,2871,8488,4257,43637,0.16334761784724,0.260306620528451,0.18307858010404,0.0657927905218049,0.194513830006646,0.0975548273254348
"E07000062",7420,6718,14819,1836,4882,5584,41245,0.179900594011395,0.162880349133228,0.35929203539823,0.0445144866044369,0.118365862528791,0.135386107406958
"E07000063",8541,9110,4836,3229,5881,5312,38188,0.223656646066827,0.238556614643343,0.126636639782131,0.0845553577039908,0.154001256939353,0.139101288362837
"E07000064",8427,8694,6689,2870,5824,5557,38828,0.21703409910374,0.223910579993819,0.172272586793036,0.0739157309158339,0.149994849077985,0.143118368187906
"E07000065",11952,12457,6960,4553,7904,7399,57954,0.206232529247334,0.214946336749836,0.120095247955275,0.078562308037409,0.136384028712427,0.127670221209925
"E07000066",11225,13661,5518,4181,9480,7044,62038,0.18093748992553,0.220203746091105,0.0889454850253071,0.0673941777620168,0.152809568329089,0.113543312163513
"E07000067",8753,8264,6664,2607,5657,6146,55845,0.156737398155609,0.147981018891575,0.119330289193303,0.0466827827021219,0.101298236189453,0.110054615453487
"E07000068",5465,6203,7022,1999,4204,3466,28473,0.191936220278861,0.217855512239666,0.246619604537632,0.070206862641801,0.147648649597865,0.12172935763706
"E07000069",7528,6968,6474,2673,4295,4855,27466,0.274084322435011,0.253695478045584,0.235709604602053,0.0973203233088182,0.156375154736765,0.176763999126192
"E07000070",10658,10482,9989,3355,7127,7303,65397,0.162973836720339,0.160282581769806,0.152744009664052,0.0513020474945334,0.108980534275273,0.111671789225805
"E07000071",10749,12018,7481,3618,8400,7131,73175,0.146894431158182,0.164236419542193,0.10223436966177,0.0494431158182439,0.114793303723949,0.0974513153399385
"E07000072",7670,9357,10774,2637,6720,5033,44935,0.170690998108379,0.208234115945254,0.239768554578836,0.0586847668855013,0.149549349059753,0.112006231222877
"E07000073",4935,8804,3028,1720,7084,3215,41437,0.119096459685788,0.212467118758597,0.0730747882327389,0.0415087964862321,0.170958322272365,0.077587663199556
"E07000074",4120,3667,3210,1172,2495,2948,22897,0.179936236188147,0.160151984976198,0.140193038389309,0.0511857448574049,0.108966240118793,0.128750491330742
"E07000075",5643,4522,6895,1613,2909,4030,27477,0.20537176547658,0.164574007351603,0.250937147432398,0.058703643046912,0.105870364304691,0.146668122429668
"E07000076",12673,11136,10349,3869,7267,8804,61132,0.2073055028463,0.182163187855787,0.169289406530132,0.0632892756657724,0.118873912190015,0.144016227180527
"E07000077",4422,4160,3833,1298,2862,3124,32273,0.137018560406532,0.128900319152233,0.11876801041118,0.0402193784277879,0.0886809407244446,0.0967991819787438
"E07000078",6751,7950,12873,2012,5938,4739,49835,0.135467041236079,0.159526437242902,0.258312431022374,0.0403732316644928,0.119153205578409,0.0950938095715862
"E07000079",6588,4999,8626,1546,3453,5042,37833,0.174133692807866,0.132133322760553,0.228002008828272,0.0408637961567943,0.0912695266037586,0.133269896651072
"E07000080",5688,5092,6874,1763,3329,3925,30575,0.186034341782502,0.166541291905151,0.224824202780049,0.0576614881439084,0.108879803761243,0.128372853638594
"E07000081",8814,7254,8448,2244,5010,6570,50972,0.17291846503963,0.142313426979518,0.165738052263988,0.0440241701326218,0.0982892568468963,0.128894294907008
"E07000082",8520,7171,9416,2406,4765,6114,43953,0.193843423657088,0.163151548244716,0.214228835346848,0.0547402907651355,0.10841125747958,0.139103132891953
"E07000083",5596,5089,3225,1673,3416,3923,37038,0.151088071710136,0.137399427614882,0.0870727361088612,0.0451698255845348,0.0922296020303472,0.105918246125601
"E07000084",11289,11172,3830,3464,7708,7825,67820,0.166455322913595,0.164730168092008,0.0564730168092008,0.051076378649366,0.113653789442642,0.115378944264229
"E07000085",8092,8325,4042,2695,5630,5397,45053,0.179610680753779,0.184782367433911,0.0897165560562005,0.0598184360641911,0.12496393136972,0.119792244689588
"E07000086",8177,9498,1142,3038,6460,5139,50436,0.162126259021334,0.188317868189389,0.0226425569037989,0.060234752954239,0.12808311523515,0.101891506067095
"E07000087",7715,8125,1403,2688,5437,5027,38080,0.202599789915966,0.213366596638655,0.036843487394958,0.0705882352941176,0.142778361344538,0.132011554621849
"E07000088",5316,8085,1495,2112,5973,3204,31981,0.166223695319096,0.252806353772552,0.0467465057377818,0.0660392107814015,0.186767142991151,0.100184484537694
"E07000089",5784,6069,2090,1873,4196,3911,34214,0.169053603787923,0.177383527211083,0.0610861051031741,0.0547436721809785,0.122639855030105,0.114309931606945
"E07000090",9375,10434,2063,3369,7065,6006,45678,0.205241035071588,0.228425062393275,0.0451639739042865,0.0737554183633259,0.154669644029949,0.131485616708262
"E07000091",13629,15395,4057,5204,10191,8425,63898,0.213293060815675,0.240930858555823,0.0634918150802842,0.0814422986634949,0.159488559892328,0.13185076215218
"E07000092",5035,7086,4797,1749,5337,3286,38518,0.130718105820655,0.183965938003012,0.124539176488914,0.0454073420219118,0.1385585959811,0.0853107637987434
"E07000093",7444,8416,2781,2661,5755,4783,47163,0.157835591459407,0.1784449674533,0.0589657146491953,0.0564213472425418,0.122023620210758,0.101414244216865
"E07000094",6797,7833,4652,2289,5544,4508,48089,0.14134209486577,0.162885483166629,0.0967372995903429,0.0475992430701408,0.115286240096488,0.0937428517956289
"E07000095",5844,7741,5944,2352,5389,3492,33401,0.174964821412533,0.23175952815784,0.177958743750187,0.0704170533816353,0.161342474776204,0.104547768030897
"E07000096",11272,10803,8578,3437,7366,7835,59541,0.189314925849415,0.181438000705396,0.144068792932601,0.0577249290404931,0.123713071664903,0.131589996808922
"E07000098",5994,8629,7038,2483,6146,3511,36119,0.165951438301171,0.238904731581716,0.194855893020294,0.0687449818655002,0.170159749716216,0.097206456435671
"E07000099",8981,7848,9799,2220,5628,6761,52760,0.170223654283548,0.148749052312358,0.185727824109174,0.0420773313115997,0.106671721000758,0.128146322971948
"E07000102",4795,6214,6601,1689,4525,3106,30688,0.15625,0.202489572471324,0.215100364963504,0.0550377997914494,0.147451772679875,0.101212200208551
"E07000103",5263,3822,13203,1004,2818,4259,37674,0.139698465785422,0.101449275362319,0.350453893932155,0.0266496788235919,0.074799596538727,0.11304878696183
"E07000105",7464,7650,5260,2211,5439,5253,49666,0.15028389642814,0.154028913139774,0.105907461845125,0.044517376072162,0.109511537067612,0.105766520355978
"E07000106",11009,12595,10854,4049,8546,6960,60362,0.182382956164474,0.208657764818926,0.179815115469998,0.0670786256253935,0.141579139193532,0.115304330539081
"E07000107",5677,4766,10371,1405,3361,4272,42289,0.134242947338551,0.112700702310293,0.245241079240464,0.0332237697746459,0.0794769325356476,0.101019177563906
"E07000108",8177,9352,11110,2406,6946,5771,46966,0.174104671464464,0.199122769663161,0.236554102968105,0.0512285483115445,0.147894221351616,0.122876123152919
"E07000109",6280,6758,10150,1869,4889,4411,37507,0.167435412056416,0.180179699789373,0.270616151651692,0.0498306982696563,0.130349001519716,0.11760471378676
"E07000110",9953,10632,10482,3128,7504,6825,66873,0.148834357663033,0.158987932349379,0.156744874613073,0.0467752306611039,0.112212701688275,0.102059127001929
"E07000111",7602,8848,7076,2828,6020,4774,37731,0.20147889003737,0.234502133524158,0.187538098645676,0.0749516312846201,0.159550502239538,0.12652725875275
"E07000112",8622,11897,8450,3509,8388,5113,46798,0.184238642677037,0.254220265823326,0.180563271934698,0.0749818368306338,0.179238428992692,0.109256805846404
"E07000113",9695,8937,9983,2902,6035,6793,54080,0.179271449704142,0.165255177514793,0.184596893491124,0.0536612426035503,0.111593934911243,0.125610207100592
"E07000114",10294,10750,19251,3147,7603,7147,63111,0.163109442094088,0.170334806927477,0.305033987735894,0.049864524409374,0.120470282518103,0.113244917684714
"E07000115",6942,6845,7267,2169,4676,4773,44496,0.15601402373247,0.153834052499101,0.16331805106077,0.0487459546925566,0.105088097806544,0.107268069039914
"E07000116",7625,6951,12567,2042,4909,5583,44378,0.171819369958087,0.156631664338186,0.283180855378791,0.0460137906169724,0.110617873721213,0.125805579341115
"E07000117",6038,8464,14357,1801,6663,4237,37914,0.159255156406604,0.223242074167854,0.37867278577834,0.047502241915915,0.175739832251939,0.111752914490689
"E07000118",6123,8560,3218,2454,6106,3669,41148,0.148804316127151,0.208029551861573,0.0782055020900165,0.0596383785360163,0.148391173325557,0.0891659375911344
"E07000119",5645,9751,2717,2624,7127,3021,34636,0.16298071370828,0.281527890056589,0.0784443931169881,0.0757593255572237,0.205768564499365,0.0872213881510567
"E07000120",5938,7368,12717,1918,5450,4020,30956,0.191820648662618,0.238015247447991,0.410808890037473,0.0619589094198217,0.176056338028169,0.129861739242796
"E07000121",10298,12068,12878,3711,8357,6587,54200,0.19,0.222656826568266,0.23760147601476,0.0684686346863469,0.154188191881919,0.121531365313653
"E07000122",6702,7739,15316,1748,5991,4954,35310,0.189804587935429,0.219173038799207,0.433758142169357,0.0495043896913056,0.169668649107901,0.140300198244123
"E07000123",7620,12996,4697,3085,9911,4535,60272,0.126426864879214,0.215622511282187,0.0779300504380143,0.0511846296787895,0.164437881603398,0.0752422352004247
"E07000124",3458,4475,5138,1275,3200,2183,22240,0.155485611510791,0.201214028776978,0.231025179856115,0.0573291366906475,0.143884892086331,0.0981564748201439
"E07000125",5463,4897,9983,1312,3585,4151,26871,0.203304677905549,0.182241077741803,0.371515760485282,0.048825871757657,0.133415205984146,0.154478806147892
"E07000126",6336,8266,2037,2595,5671,3741,38889,0.162925248785003,0.212553678418062,0.0523798503432847,0.0667283807760549,0.145825297642007,0.0961968680089485
"E07000127",6392,8776,3039,2351,6425,4041,42627,0.149951908414854,0.205878903042672,0.0712928425645717,0.0551528374035236,0.150726065639149,0.0947990710113309
"E07000128",7962,11846,2212,3634,8212,4328,43216,0.184237319511292,0.274111440207331,0.0511847463902258,0.0840892262125139,0.190022213994817,0.100148093298778
"E07000129",5677,4376,5699,1358,3018,4319,33295,0.170506081994293,0.13143114581769,0.171166841868148,0.0407869049406818,0.0906442408770086,0.129719177053612
"E07000130",9504,7290,13668,2253,5037,7251,64771,0.146732333914869,0.112550369764246,0.211020364051813,0.0347840854703494,0.077766284293897,0.11194824844452
"E07000131",4621,3738,5725,1198,2540,3423,36909,0.125199815763093,0.101276111517516,0.155111219485762,0.0324582080251429,0.0688179034923731,0.0927416077379501
"E07000132",6795,3989,8764,1320,2669,5475,42160,0.161171726755218,0.0946157495256167,0.207874762808349,0.0313092979127135,0.0633064516129032,0.129862428842505
"E07000133",3325,2303,4681,761,1542,2564,20082,0.16557115825117,0.114679812767653,0.233094313315407,0.0378946320087641,0.0767851807588886,0.127676526242406
"E07000134",6463,4132,7330,1195,2937,5268,41792,0.154646822358346,0.0988705972434916,0.175392419601838,0.028593989280245,0.0702766079632466,0.126052833078101
"E07000135",3548,3189,3951,1003,2186,2545,19018,0.186560100956988,0.167683247449784,0.207750552108529,0.0527395099379535,0.114943737511831,0.133820591019035
"E07000136",4059,3133,5449,992,2141,3067,28468,0.14258114374034,0.110053393283687,0.19140789658564,0.0348461430377968,0.0752072502458901,0.107735000702543
"E07000137",10810,8321,10896,2719,5602,8091,61286,0.176386124074014,0.135773259798323,0.177789380935287,0.0443657605325849,0.0914074992657377,0.132020363541429
"E07000138",5792,3407,11268,950,2457,4842,39787,0.145575187875437,0.0856309849950989,0.2832080830422,0.0238771458013924,0.0617538391937065,0.121698042074044
"E07000139",6758,3846,4827,1270,2576,5488,45487,0.148569921076351,0.0845516301360828,0.10611823158265,0.0279200650735375,0.0566315650625453,0.120649856002814
"E07000140",6207,3880,6009,1282,2598,4925,38419,0.161560686118847,0.100991696816679,0.156406986126656,0.0333689060100471,0.0676227908066321,0.1281917801088
"E07000141",8409,5271,10057,1569,3702,6840,61057,0.13772376631672,0.0863291678267848,0.16471493850009,0.0256972992449678,0.060631868581817,0.112026467071753
"E07000142",5838,4177,7898,1228,2949,4610,39501,0.147793726741095,0.105744158375737,0.199944305207463,0.0310878205615048,0.0746563378142325,0.11670590617959
"E07000143",9735,6085,6819,2494,3591,7241,54728,0.177879695950884,0.111186230083321,0.124598011986552,0.0455708229790966,0.0656154071042245,0.132308872971788
"E07000144",9222,6338,5383,2344,3994,6878,46641,0.197723033382646,0.135889024677859,0.115413477412577,0.0502562123453614,0.0856328123324972,0.147466821037285
"E07000145",7460,4910,10881,1723,3187,5737,39749,0.187677677425847,0.123525120128808,0.273742735666306,0.043347002440313,0.0801781176884953,0.144330674985534
"E07000146",12328,8158,13144,2996,5162,9332,64728,0.190458534173773,0.126035100729205,0.203065134099617,0.046285996786553,0.0797491039426523,0.14417253738722
"E07000147",9215,5417,11024,1975,3442,7240,46086,0.199952263160179,0.117541118777937,0.239204964631341,0.042854663021308,0.0746864557566289,0.157097600138871
"E07000148",9069,7513,17169,2029,5484,7040,62911,0.144156029947068,0.119422676479471,0.272909348126719,0.0322519114304335,0.0871707650490375,0.111904118516635
"E07000149",8634,5380,6261,2173,3207,6461,54449,0.158570405333431,0.0988080589175191,0.114988337710518,0.0399089055813697,0.0588991533361494,0.118661499752062
"E07000170",7252,5003,10576,1442,3561,5810,49597,0.146218521281529,0.100873036675605,0.213238703953868,0.0290743391737403,0.071798697501865,0.117144182107789
"E07000171",7167,5240,8433,1650,3590,5517,48918,0.146510486937324,0.107118034261417,0.172390531092849,0.033729915368576,0.0733881188928411,0.112780571568748
"E07000172",6291,5279,13189,1361,3918,4930,39996,0.157290729072907,0.131988198819882,0.32975797579758,0.034028402840284,0.097959795979598,0.123262326232623
"E07000173",7399,6769,12067,1885,4884,5514,44239,0.167250615972332,0.153009787743846,0.272768371798639,0.0426094622392007,0.110400325504645,0.124641153733131
"E07000174",6359,5551,7501,1611,3940,4748,41097,0.154731488916466,0.1350706864248,0.18251940530939,0.0391999416015768,0.0958707448232231,0.115531547314889
"E07000175",6719,5327,8434,1590,3737,5129,48697,0.13797564531696,0.109390722221081,0.173193420539253,0.0326508819845165,0.0767398402365649,0.105324763332443
"E07000176",6635,4991,9926,1493,3498,5142,45319,0.146406584434785,0.110130408879278,0.219025132946446,0.0329442397228535,0.0771861691564245,0.113462344711931
"E07000177",8618,7025,6851,2195,4830,6423,59830,0.144041450777202,0.117416012034097,0.114507772020725,0.0366872806284473,0.0807287314056493,0.107354170148755
"E07000178",7952,9553,15664,1990,7563,5962,58677,0.135521584266408,0.162806551118837,0.266952979872863,0.0339144809721015,0.128892070146736,0.101607103294306
"E07000179",9492,9199,7592,3112,6087,6380,53856,0.176247771836007,0.17080733808675,0.140968508615567,0.0577837195484254,0.113023618538324,0.118464052287582
"E07000180",7683,7478,5834,2261,5217,5422,54718,0.140410833729303,0.136664351767243,0.106619393983698,0.0413209547132571,0.0953433970539859,0.0990898790160459
"E07000181",7067,5293,7399,1736,3557,5331,44474,0.158901830282862,0.119013356118181,0.166366866034087,0.0390340423618294,0.079979313756352,0.119867787921033
"E07000192",6461,5126,5354,1723,3403,4738,37814,0.170862643465383,0.13555825884593,0.141587771724758,0.0455651346062305,0.0899931242396996,0.125297508859153
"E07000193",6445,4543,11134,1356,3187,5089,47465,0.135784262087854,0.0957126303592121,0.234572843147582,0.028568418834931,0.067144211524281,0.107215843252923
"E07000194",5603,5857,4511,1790,4067,3813,37596,0.149031811894882,0.155787849771252,0.119986168741355,0.0476114480263858,0.108176401744866,0.101420363868497
"E07000195",7424,7901,8109,2507,5394,4917,42852,0.17324745636143,0.184378792121721,0.189232707924951,0.0585036871091198,0.125875105012602,0.11474376925231
"E07000196",7004,6275,4602,2169,4106,4835,33836,0.206998463175316,0.185453363281712,0.136008984513536,0.0641033219056626,0.121350041376049,0.142895141269654
"E07000197",7956,6776,8237,2221,4555,5735,49612,0.160364427960977,0.13657985971136,0.166028380230589,0.0447673949850843,0.0918124647262759,0.115597032975893
"E07000198",6670,6172,7216,2208,3964,4462,30995,0.215195999354735,0.199128891756735,0.23281174382965,0.0712372963381191,0.127891595418616,0.143958703016616
"E07000199",4111,4332,3273,1160,3172,2951,26619,0.154438558924077,0.162740899357602,0.122957286148991,0.0435778954881851,0.119163003869417,0.110860663435892
"E07000200",6309,4432,5517,1585,2847,4724,34113,0.184944156186791,0.129921144431742,0.161727200773899,0.0464632251634274,0.0834579192683141,0.138480931023364
"E07000202",7344,7451,14097,2097,5354,5247,55750,0.131730941704036,0.133650224215247,0.252860986547085,0.0376143497757848,0.0960358744394619,0.0941165919282511
"E07000203",6001,3678,4903,1347,2331,4654,39299,0.152701086541642,0.0935901676887453,0.12476144431156,0.0342756813150462,0.0593144863736991,0.118425405226596
"E07000207",8553,10719,12928,3115,7604,5438,50874,0.168121240712348,0.210697016157566,0.25411801706176,0.0612297047607815,0.149467311396784,0.106891535951567
"E07000208",4295,6262,7648,1693,4569,2602,25929,0.165644644992094,0.241505650044352,0.294959311967295,0.065293686605731,0.176211963438621,0.100350958386363
"E07000209",8193,11761,8391,3171,8590,5022,50093,0.163555786237598,0.234783303056315,0.167508434312179,0.0633022578004911,0.171481045255824,0.100253528437107
"E07000210",6086,7654,5899,2397,5257,3689,30630,0.198694090760692,0.249885732941561,0.192588965066928,0.078256611165524,0.171629121776037,0.120437479595168
"E07000211",9416,12190,8480,3732,8458,5684,55183,0.170632259935125,0.220901364550677,0.153670514470036,0.0676295235851621,0.153271840965515,0.103002736349963
"E07000212",4954,6438,6791,1809,4629,3145,32432,0.152750370004933,0.198507646768624,0.209391958559447,0.0557782437099161,0.142729403058707,0.0969721262950173
"E07000213",6595,9931,8459,2566,7365,4029,38616,0.170784130930184,0.257173192459084,0.219054278019474,0.066449140252745,0.190724052206339,0.104334990677439
"E07000214",5863,7232,2632,2198,5034,3665,30747,0.190685270107653,0.235209939181058,0.0856018473346993,0.0714866491039776,0.163723290077081,0.119198621003675
"E07000215",5805,7768,5299,2509,5259,3296,28944,0.200559701492537,0.268380320619127,0.183077667219458,0.0866846323935876,0.181695688225539,0.11387506909895
"E07000216",8441,11140,6588,3405,7735,5036,45081,0.18724074443779,0.247110756194406,0.146136953483729,0.0755307113861716,0.171580044808234,0.111710033051618
"E07000217",6905,8940,5063,2470,6470,4435,39729,0.173802512018928,0.225024541267084,0.127438395126985,0.0621712099473936,0.162853331319691,0.111631302071535
"E07000218",4515,3544,5408,1115,2429,3400,23070,0.195708712613784,0.153619419159081,0.234416991764196,0.0483311660164716,0.105288253142609,0.147377546597313
"E07000219",7312,4932,10941,1609,3323,5703,48228,0.151613170772166,0.102264244837024,0.226859915401841,0.0333623621132952,0.0689018827237289,0.11825080865887
"E07000220",5843,4216,8821,1252,2964,4591,41879,0.139521000979011,0.100670980682442,0.210630626328231,0.029895651758638,0.0707753289238043,0.109625349220373
"E07000221",7768,5862,9025,1900,3962,5868,55972,0.138783677553062,0.10473093689702,0.161241334953191,0.0339455442006718,0.0707853926963482,0.10483813335239
"E07000222",8985,7270,12738,2053,5217,6932,60010,0.149725045825696,0.121146475587402,0.212264622562906,0.0342109648391935,0.0869355107482086,0.115514080986502
"E07000223",5603,7799,1728,2693,5106,2910,22700,0.246828193832599,0.343568281938326,0.0761233480176211,0.11863436123348,0.224933920704846,0.128193832599119
"E07000224",13190,16333,6400,5403,10930,7787,67449,0.19555516019511,0.24215333066465,0.0948865068422067,0.0801049681981942,0.162048362466456,0.115450191996916
"E07000225",8965,11146,6315,3494,7652,5471,50160,0.178728070175439,0.222208931419458,0.125897129186603,0.0696570972886762,0.152551834130781,0.109070972886762
"E07000226",7257,8898,1266,2856,6042,4401,36640,0.198062227074236,0.242849344978166,0.0345524017467249,0.0779475982532751,0.164901746724891,0.120114628820961
"E07000227",9315,10595,4019,3572,7023,5743,51620,0.180453312669508,0.205249903138318,0.0778574196048043,0.0691979852770244,0.136051917861294,0.111255327392484
"E07000228",10163,13070,5114,4273,8797,5890,56582,0.179615425400304,0.230992188328444,0.0903821003145877,0.0755187161994981,0.155473472128946,0.104096709200806
"E07000229",9570,13122,8614,3969,9153,5601,45273,0.211384268769465,0.289841627460076,0.190267930112871,0.0876681465774303,0.202173480882645,0.123716122192035
"E07000234",5674,5756,6353,1752,4004,3922,31717,0.178894599110887,0.181479963426554,0.200302676797932,0.0552385156225368,0.126241447804017,0.12365608348835
"E07000235",5379,4167,7226,1386,2781,3993,30741,0.17497804235386,0.13555186883966,0.23506066816304,0.0450863667414853,0.0904655020981751,0.129891675612374
"E07000236",4882,5481,3267,1442,4039,3440,28916,0.168833863604925,0.18954903859455,0.112982431871628,0.0498685848665099,0.13968045372804,0.118965278738415
"E07000237",6375,5168,9885,1388,3780,4987,41264,0.154493020550601,0.125242341993021,0.239555060100814,0.0336370686312524,0.0916052733617681,0.120855951919349
"E07000238",7560,6265,8350,2097,4168,5463,49209,0.153630433457294,0.127314109207665,0.169684407323864,0.0426141559470829,0.0846999532605824,0.111016277510212
"E07000239",7248,5420,8361,1822,3598,5426,36667,0.19767093026427,0.147816838028745,0.228025199770911,0.0496904573594786,0.0981263806692666,0.147980472904792
"E07000240",9216,9626,11785,2858,6768,6358,53155,0.173379738500611,0.181093029818455,0.221710093123883,0.0537672843570689,0.127325745461387,0.119612454143542
"E07000241",6785,7341,4230,2130,5211,4655,46481,0.145973623631161,0.157935500527097,0.0910049267442611,0.0458251758783159,0.112110324648781,0.100148447752845
"E07000242",7579,8351,8862,2301,6050,5278,53398,0.14193415483726,0.1563916251545,0.165961271957751,0.0430915015543653,0.113300123600135,0.0988426532828945
"E07000243",5061,7783,2198,1937,5846,3124,34183,0.148056051253547,0.227686276804259,0.0643009683175848,0.0566655940087178,0.171020682795542,0.0913904572448293
"E07000244",17909,12688,22292,4206,8482,13703,99223,0.180492426151195,0.127873577698719,0.224665652116949,0.0423893653689165,0.0854842123298026,0.138103060782278
"E07000245",12289,8749,9845,3092,5657,9197,72339,0.169880700590276,0.120944442140477,0.136095328937364,0.0427431952335531,0.0782012469069243,0.127137505356723
"E08000001",17835,23671,8773,6774,16897,11061,102253,0.174420310406541,0.231494430481257,0.0857969937312353,0.0662474450627365,0.165246985418521,0.108172865343804
"E08000002",11044,18354,9470,4778,13576,6266,69480,0.15895221646517,0.264162348877375,0.136298215313759,0.0687679907887162,0.195394358088659,0.0901842256764536
"E08000003",24018,42059,43513,8157,33902,15861,247367,0.0970946003306827,0.170026721430102,0.175904627537222,0.0329752958155292,0.137051425614573,0.0641193045151536
"E08000004",13395,20311,10231,5292,15019,8103,79343,0.168823966827571,0.255989816366913,0.128946472908763,0.0666977553155288,0.189292061051384,0.102126211512043
"E08000005",13050,16144,8138,4296,11848,8754,81798,0.159539353040417,0.197364238734443,0.0994889850607594,0.0525196215066383,0.144844617227805,0.107019731533778
"E08000006",12535,18785,16323,4870,13915,7665,130284,0.0962128887660803,0.144185011206288,0.125287832734641,0.0373798778054097,0.106805133400878,0.0588330109606705
"E08000007",18047,28156,16606,7884,20272,10163,101156,0.178407608050931,0.278342362291906,0.164162283996995,0.0779390248724742,0.200403337419431,0.100468583178457
"E08000008",12251,18511,10691,4628,13883,7623,85043,0.144056536105264,0.21766635701939,0.125712874663406,0.0544195289441812,0.163246828075209,0.0896370071610832
"E08000009",12580,23126,15515,5446,17680,7134,81379,0.154585335283058,0.284176507452783,0.190651150788287,0.0669214416495656,0.217255065803217,0.0876638936334927
"E08000010",18276,24101,14019,6842,17259,11434,115028,0.158883054560629,0.209522898772473,0.121874673992419,0.0594811698021351,0.150041728970338,0.0994018847584936
"E08000011",8751,7831,7240,2195,5636,6556,65836,0.132921198128683,0.118947080624582,0.109970229054013,0.0333404216538064,0.0856066589707759,0.099580776474877
"E08000012",27887,25226,78907,5339,19887,22548,219708,0.126927558395689,0.114816028546981,0.35914486500264,0.0243004351229814,0.0905155934239991,0.102627123272707
"E08000013",10536,17711,7720,4020,13691,6516,72086,0.146158754820631,0.245692644896374,0.107094304025747,0.0557667230807646,0.189925921815609,0.0903920317398663
"E08000014",16823,27940,19888,7018,20922,9805,104839,0.160465094096663,0.266503877373878,0.189700397752745,0.0669407377025725,0.199563139671306,0.09352435639409
"E08000015",19719,14973,46391,3620,11353,16099,122368,0.161145070606695,0.122360421025105,0.379110551778243,0.0295828974895397,0.0927775235355649,0.131562173117155
"E08000016",13527,11770,18604,3228,8542,10299,98012,0.13801371260662,0.120087336244541,0.189813492225442,0.0329347426845692,0.0871525935599722,0.10507896992205
"E08000017",16907,13612,27820,3766,9846,13141,117902,0.143398754898136,0.115451815914912,0.235958677545758,0.0319417821580635,0.0835100337568489,0.111456972740072
"E08000018",14419,12086,14567,3534,8552,10885,92596,0.155719469523522,0.130523996716921,0.157317810704566,0.0381657954987256,0.0923582012181952,0.117553674024796
"E08000019",31997,26187,46957,6425,19762,25572,207101,0.15449949541528,0.126445550721629,0.226734781580002,0.0310235102679369,0.0954220404536917,0.123475985147344
"E08000021",12361,18762,25104,3121,15641,9240,117064,0.105591813025354,0.160271304585526,0.214446798332536,0.0266606300826898,0.133610674502836,0.0789311829426638
"E08000022",8542,12284,13469,2324,9960,6218,82056,0.104099639270742,0.149702642098079,0.164143999220045,0.028322121478015,0.121380520620064,0.0757775177927269
"E08000023",7236,11224,8187,2078,9146,5158,62438,0.115890963836125,0.179762324225632,0.131122073096512,0.0332810147666485,0.146481309458983,0.0826099490694769
"E08000024",14566,17924,8115,4429,13495,10137,112106,0.129930601395108,0.159884395126041,0.0723868481615614,0.0395072520650099,0.120377143061032,0.0904233493300983
"E08000025",61861,60072,148161,14178,45894,47683,416464,0.14853864919897,0.144242959775635,0.355759441392293,0.0340437588843213,0.110199200891314,0.114494890314649
"E08000026",18628,15388,45188,3880,11508,14748,128198,0.145306479040235,0.120033073838905,0.352485998221501,0.0302656827719621,0.0897673910669433,0.115040796268273
"E08000027",17962,18549,23135,5179,13370,12783,117446,0.152938371677196,0.157936413330382,0.196984145905352,0.0440968615363656,0.113839551794016,0.108841510140831
"E08000028",15752,21586,30289,4436,17150,11316,112808,0.139635486844905,0.191351677186015,0.268500460960216,0.03932345223743,0.152028224948585,0.100312034607475
"E08000029",11912,15345,12553,3977,11368,7935,74204,0.160530429626435,0.206794781952455,0.169168777963452,0.0535954935043933,0.153199288448062,0.106934936122042
"E08000030",15362,17431,18033,4539,12892,10823,95047,0.161625301166791,0.183393479015645,0.189727187601923,0.0477553210516902,0.135638157963955,0.113869980115101
"E08000031",13153,14608,24562,3640,10968,9513,91252,0.144139306535747,0.160084162538903,0.269166703195546,0.0398895366676895,0.120194625871214,0.104249769868058
"E08000032",43357,42375,48526,14533,27842,28824,195261,0.222046389191902,0.217017223101387,0.248518649397473,0.0744285853293797,0.142588637772008,0.147617803862522
"E08000033",15498,15213,24819,4220,10993,11278,82099,0.188772092230112,0.185300673577023,0.302305752810631,0.0514013568983788,0.133899316678644,0.137370735331734
"E08000034",19564,23999,39276,5251,18748,14313,148211,0.132000998576354,0.161924553508174,0.26500057350669,0.035429219153774,0.1264953343544,0.09657177942258
"E08000035",57907,45061,67154,12398,32663,45509,321729,0.179986883370787,0.140058869421159,0.208728464017854,0.0385355376730105,0.101523331748148,0.141451345697777
"E08000036",16943,20178,22341,4334,15844,12609,155012,0.109301215389776,0.13017056743994,0.144124325858643,0.0279591257451036,0.102211441694837,0.0813420896446727
"E08000037",8687,10565,14604,2080,8485,6607,73909,0.117536429934108,0.142946055284201,0.197594338984427,0.0281427160427012,0.1148033392415,0.089393713891407
"E09000001",51,239,1400,1,238,50,7146,0.00713685978169605,0.033445284075007,0.195913797928911,0.000139938427092079,0.0333053456479149,0.00699692135460397
"E09000002",9737,12375,26059,2626,9749,7111,73421,0.132618733060024,0.168548507920077,0.354925702455701,0.0357663338826766,0.132782174037401,0.0968523991773471
"E09000003",19296,22519,57965,4094,18425,15202,152118,0.126848893622057,0.148036392800326,0.381052866853364,0.026913317293154,0.121123075507172,0.0999355763289026
"E09000004",13590,14932,29543,3750,11182,9840,79976,0.169925977793338,0.186706011803541,0.369398319495849,0.046889066720016,0.139816945083525,0.123036911073322
"E09000005",14007,11282,54019,1960,9322,12047,115085,0.121710040404918,0.0980318894729982,0.4693834991528,0.0170308902115827,0.0810009992614155,0.104679150193335
"E09000006",19602,24053,43479,5864,18189,13738,116247,0.16862370641823,0.2069128665686,0.374022555420785,0.0504443125413989,0.156468554027201,0.118179393876831
"E09000007",5084,7214,52809,272,6942,4812,101949,0.0498680712905472,0.0707608706313941,0.517994291263279,0.00266800066700017,0.068092869964394,0.0472000706235471
"E09000008",20265,22357,58030,4764,17593,15501,144097,0.140634433749488,0.155152432042305,0.402714837921678,0.0330610630339285,0.122091369008376,0.10757337071556
"E09000009",16607,20648,55347,3746,16902,12861,132027,0.125784877335696,0.156392253099745,0.419209707105365,0.0283729843138146,0.12801926878593,0.0974118930218819
"E09000010",17591,17646,53958,3380,14266,14211,113158,0.155455204227717,0.155941250287209,0.476837695964934,0.0298697396560561,0.126071510631153,0.125585464571661
"E09000011",10028,10419,35766,1853,8566,8175,111129,0.0902374717670455,0.0937559052992468,0.321842183408471,0.0166743154352149,0.0770815898640319,0.0735631563318306
"E09000012",6343,8481,47715,630,7851,5713,109743,0.0577986750863381,0.0772805554796206,0.434788551433804,0.00574068505508324,0.0715398704245373,0.0520579900312548
"E09000013",6254,6401,54790,626,5775,5628,95086,0.0657720379445975,0.0673180068569506,0.576215215699472,0.00658351387165303,0.0607344929852975,0.0591885240729445
"E09000014",12667,9135,63068,843,8292,11824,110951,0.114167515389677,0.0823336427792449,0.568431109228398,0.007597948643996,0.0747356941352489,0.106569566745681
"E09000015",12323,13088,34672,2850,10238,9473,79455,0.155094078409162,0.164722169781637,0.43637278962935,0.0358693600151029,0.128852809766535,0.11922471839406
"E09000016",13834,13062,35276,3297,9765,10537,84382,0.163944917162428,0.154796046550212,0.418051243156123,0.0390723140006162,0.115723732549596,0.124872603161812
"E09000017",16197,20887,28637,5495,15392,10702,100324,0.161446912005103,0.208195446752522,0.285445157689087,0.0547725369801842,0.153422909772338,0.106674375024919
"E09000018",11194,12438,32499,2618,9820,8576,93763,0.119386111792498,0.132653605366722,0.346607937032731,0.0279214615573307,0.104732143809392,0.0914646502351674
"E09000019",5541,8837,45585,404,8433,5137,101893,0.0543805757019619,0.0867282345205264,0.447381076227022,0.00396494361732406,0.0827632909032024,0.0504156320846378
"E09000020",3487,6309,56639,298,6011,3189,87932,0.0396556429968612,0.0717486239366783,0.644122731201383,0.00338898239548742,0.0683596415411909,0.0362666606013738
"E09000021",8364,10644,26888,1855,8789,6509,64436,0.129803215593767,0.16518716245577,0.417282264572599,0.0287882550127258,0.136398907443044,0.101014960581042
"E09000022",12538,12726,78395,1155,11571,11383,151576,0.0827175806196232,0.0839578825143822,0.517199292764026,0.0076199398321634,0.0763379426822188,0.0750976407874598
"E09000023",13941,12799,56373,2115,10684,11826,124571,0.111912082266338,0.102744619534242,0.452537107352434,0.0169782694206517,0.0857663501135898,0.0949338128456864
"E09000024",11801,9987,37968,1967,8020,9834,80770,0.146106227559738,0.123647393834344,0.470075523090256,0.0243531013990343,0.0992942924353101,0.121753126160703
"E09000025",15394,12961,49714,2215,10746,13179,131940,0.116674245869335,0.0982340457783841,0.376792481430953,0.0167879339093527,0.0814461118690314,0.0998863119599818
"E09000026",15662,11420,47430,2206,9214,13456,90294,0.173455600593616,0.126475734821804,0.525284072031364,0.0244313021906217,0.102044432631183,0.149024298402995
"E09000027",10268,10256,38078,1916,8340,8352,73268,0.140143036523448,0.139979254244691,0.519708467543812,0.026150570508271,0.11382868373642,0.113992466015177
"E09000028",9024,10839,45150,1227,9612,7797,132602,0.0680532721980061,0.0817408485543204,0.34049260192154,0.00925325409873154,0.0724875944555889,0.0588000180992745
"E09000029",10288,13214,25522,2582,10632,7706,70579,0.145765737684014,0.187222828320039,0.361608977174514,0.0365831196248176,0.150639708695221,0.109182618059196
"E09000030",4040,13114,24039,948,12166,3092,152343,0.0265191049145678,0.0860820648142678,0.157795238376558,0.00622279986609165,0.0798592649481762,0.0202963050484761
"E09000031",15460,8511,56691,1523,6988,13937,101783,0.151891769745439,0.0836190719471818,0.556979063301337,0.0149632060363715,0.0686558659108103,0.136928563709067
"E09000032",12751,11959,71458,1272,10687,11479,153380,0.0831333941843787,0.0779697483374625,0.465888642587039,0.00829312817838049,0.069676620159082,0.0748402660059982
"E09000033",3840,10255,67617,160,10095,3680,130451,0.0294363400817165,0.0786118925880216,0.518332553985788,0.00122651417007152,0.07738537841795,0.028209825911645
"W06000001",5510,5885,7706,1703,4182,3807,29883,0.184385771174246,0.196934712043637,0.257872368905398,0.0569889234681926,0.139945788575444,0.127396847706054
"W06000002",9324,9071,18097,2535,6536,6789,44734,0.2084320650959,0.202776411677918,0.404546877095721,0.056668305986498,0.14610810569142,0.151763759109402
"W06000003",9907,9187,15071,2736,6451,7171,48944,0.202415004903563,0.187704315135665,0.307923340961098,0.0559006211180124,0.131803694017653,0.146514383785551
"W06000004",7097,7466,10529,2142,5324,4955,37205,0.190753930923263,0.20067195269453,0.282999596828383,0.0575729068673565,0.143099045827174,0.133181024055906
"W06000005",8224,7820,9179,2307,5513,5917,53407,0.153987305034921,0.146422753571629,0.171868856142453,0.0431965847173591,0.10322616885427,0.110790720317561
"W06000006",5538,5358,8913,1327,4031,4211,45294,0.122267850046364,0.118293813750166,0.196781030600079,0.0292974786947499,0.0889963350554157,0.0929703713516139
"W06000008",5872,4928,9695,1607,3321,4265,28042,0.209400185436132,0.17573639540689,0.345731402895657,0.0573068967976606,0.118429498609229,0.152093288638471
"W06000009",9879,9927,12523,3489,6438,6390,47809,0.206634734045891,0.207638729109582,0.2619381288042,0.072977891192035,0.134660837917547,0.133656842853856
"W06000010",12886,15741,21226,4783,10958,8103,66873,0.192693613266939,0.235386478847966,0.31740762340556,0.0715236343516815,0.163862844496284,0.121169978915257
"W06000011",15966,22926,21196,6370,16556,9596,88677,0.18004668628844,0.258533779897831,0.239024775308141,0.0718337336626183,0.186700046235213,0.108212952625822
"W06000012",7091,11411,13564,2565,8846,4526,50099,0.141539751292441,0.227769017345656,0.270743927024492,0.0511986267190962,0.176570390626559,0.0903411245733448
"W06000013",8584,10866,11657,3055,7811,5529,50517,0.169922996219095,0.215095908308094,0.230754003602748,0.0604746916879466,0.154621216620148,0.109448304531148
"W06000014",7768,9525,10863,2662,6863,5106,50220,0.154679410593389,0.189665471923536,0.216308243727599,0.0530067702110713,0.136658701712465,0.101672640382318
"W06000015",20806,27376,34486,7107,20269,13699,145077,0.143413497659863,0.188699793902548,0.237708251480248,0.0489877789036167,0.139712014998932,0.0944257187562467
"W06000016",14426,18760,38343,4380,14380,10046,85646,0.168437521892441,0.219041169465007,0.447691661023282,0.0511407421245592,0.167900427340448,0.117296779767882
"W06000018",9213,13493,16315,3152,10341,6061,60517,0.152238214055555,0.222962142868946,0.269593667894972,0.0520845382289274,0.170877604640018,0.100153675826627
"W06000019",3571,5258,9928,1088,4170,2483,23105,0.154555291062541,0.227569790088725,0.429690543172474,0.0470893745942437,0.180480415494482,0.107465916468297
"W06000020",4622,6429,4806,1566,4863,3056,32077,0.144090781556879,0.20042397979861,0.149826978832185,0.0488200268104873,0.151603952988122,0.0952707547463915
"W06000021",5110,5552,6278,1651,3901,3459,33701,0.151627548143972,0.164742885967775,0.186285273434023,0.048989644224207,0.115753241743568,0.102637903919765
"W06000022",8125,13247,8899,3591,9656,4534,61569,0.131965761990612,0.215156978349494,0.144537023502087,0.0583248063148663,0.156832172034628,0.0736409556757459
"W06000023",9829,7440,13086,2362,5078,7467,48967,0.20072702023812,0.151939061000265,0.267241203259338,0.0482365674842241,0.103702493516041,0.152490452753895
"W06000024",3183,5294,7876,1060,4234,2123,23129,0.137619438799775,0.228890137922089,0.340524882182541,0.0458299105019672,0.183060227420122,0.0917895282978079
,2690,5009,4497,844,4165,1846,73105,0.0367963887558991,0.0685178852335682,0.0615142603105123,0.0115450379590999,0.0569728472744682,0.0252513507967991
