"msoa21","A_n","B_n","C_n","D_n","E_n","F_n","G_n","number_of_epcs","A_pct","B_pct","C_pct","D_pct","E_pct","F_pct","G_pct","ABC_n","ABC_pct","DEFG_n","DEFG_pct"
"E02000001",4,1836,2753,1717,664,114,58,7146,0.000559753708368318,0.256926952141058,0.385250489784495,0.2402742793171,0.0929191155891408,0.0159529806884971,0.00811642877134061,4593,0.642737195633921,2553,0.357262804366079
"E02000002",16,218,1044,1055,277,36,5,2651,0.00603545831761599,0.0822331195775179,0.393813655224444,0.397963032817805,0.104488872123727,0.013579781214636,0.001886080724255,1278,0.482082233119578,1373,0.517917766880422
"E02000003",14,208,968,1864,569,69,15,3707,0.00377663879147559,0.0561100620447801,0.261127596439169,0.502832479093607,0.153493390882115,0.0186134340437011,0.00404639870515241,1190,0.321014297275425,2517,0.678985702724575
"E02000004",4,70,669,840,258,26,7,1874,0.00213447171824973,0.0373532550693703,0.356990394877268,0.448239060832444,0.137673425827108,0.0138740661686233,0.00373532550693703,743,0.396478121664888,1131,0.603521878335112
"E02000005",40,358,660,1668,354,42,18,3140,0.0127388535031847,0.114012738853503,0.210191082802548,0.531210191082803,0.112738853503185,0.0133757961783439,0.00573248407643312,1058,0.336942675159236,2082,0.663057324840764
"E02000007",0,425,1057,1409,401,87,11,3390,0,0.125368731563422,0.311799410029499,0.415634218289086,0.118289085545723,0.0256637168141593,0.00324483775811209,1482,0.43716814159292,1908,0.56283185840708
"E02000008",1,78,1078,2228,490,31,13,3919,0.00025516713447308,0.0199030364889002,0.27507017096198,0.568512375606022,0.125031895891809,0.00791018116866548,0.00331717274815004,1157,0.295228374585353,2762,0.704771625414647
"E02000009",0,1148,1067,1511,352,31,13,4122,0,0.278505579815623,0.258854924793789,0.366569626394954,0.0853954391072295,0.00752062105773896,0.00315380883066473,2215,0.537360504609413,1907,0.462639495390587
"E02000010",4,79,813,1648,276,22,5,2847,0.00140498770635757,0.027748507200562,0.285563751317176,0.578854935019319,0.0969441517386723,0.00772743238496663,0.00175623463294696,896,0.314717246224096,1951,0.685282753775905
"E02000011",3,106,526,1100,319,34,10,2098,0.00142993326978074,0.0505243088655863,0.25071496663489,0.524308865586273,0.152049571020019,0.0162059103908484,0.00476644423260248,635,0.302669208770257,1463,0.697330791229743
"E02000012",2,68,757,1333,465,55,12,2692,0.000742942050520059,0.025260029717682,0.281203566121842,0.49517087667162,0.172734026745914,0.0204309063893016,0.00445765230312036,827,0.307206537890045,1865,0.692793462109956
"E02000013",0,103,679,1487,322,22,8,2621,0,0.0392979778710416,0.259061426936284,0.567340709652804,0.122853872567722,0.00839374284624189,0.00305227012590614,782,0.298359404807325,1839,0.701640595192675
"E02000014",3,33,879,1681,335,29,12,2972,0.00100942126514132,0.0111036339165545,0.295760430686406,0.565612382234186,0.112718707940781,0.00975773889636608,0.00403768506056528,915,0.307873485868102,2057,0.692126514131898
"E02000015",5,455,1166,1157,277,33,8,3101,0.00161238310222509,0.146726862302483,0.376007739438891,0.373105449854886,0.0893260238632699,0.0106417284746856,0.00257981296356014,1626,0.524346984843599,1475,0.475653015156401
"E02000016",79,2086,1558,896,209,19,4,4851,0.0162853019995877,0.43001443001443,0.321170892599464,0.184704184704185,0.0430839002267574,0.00391671820243249,0.000824572253143682,3723,0.767470624613482,1128,0.232529375386518
"E02000017",0,35,599,1446,467,41,12,2600,0,0.0134615384615385,0.230384615384615,0.556153846153846,0.179615384615385,0.0157692307692308,0.00461538461538462,634,0.243846153846154,1966,0.756153846153846
"E02000018",9,215,1054,1385,268,24,10,2965,0.003035413153457,0.0725126475548061,0.355480607082631,0.467116357504216,0.0903878583473862,0.00809443507588533,0.00337268128161889,1278,0.431028667790894,1687,0.568971332209106
"E02000019",0,1197,975,1285,232,17,6,3712,0,0.322467672413793,0.262661637931034,0.346174568965517,0.0625,0.00457974137931034,0.00161637931034483,2172,0.585129310344828,1540,0.414870689655172
"E02000020",43,1974,1028,1655,370,47,8,5125,0.00839024390243902,0.385170731707317,0.200585365853659,0.322926829268293,0.0721951219512195,0.00917073170731707,0.0015609756097561,3045,0.594146341463415,2080,0.405853658536585
"E02000021",0,627,694,1516,398,37,9,3281,0,0.191100274306614,0.211520877781164,0.462054251752514,0.121304480341359,0.0112770496799756,0.00274306613837245,1321,0.402621152087778,1960,0.597378847912222
"E02000022",39,4110,805,483,149,20,4,5610,0.00695187165775401,0.732620320855615,0.14349376114082,0.086096256684492,0.0265597147950089,0.0035650623885918,0.00071301247771836,4954,0.883065953654189,656,0.116934046345811
"E02000023",1,901,1005,755,117,19,4,2802,0.000356887937187723,0.321556031406138,0.358672376873662,0.269450392576731,0.0417558886509636,0.00678087080656674,0.00142755174875089,1907,0.680585296216988,895,0.319414703783012
"E02000024",3,494,1054,1535,717,118,30,3951,0.000759301442672741,0.125031637560111,0.266767906859023,0.388509238167553,0.181473044798785,0.0298658567451278,0.00759301442672741,1551,0.392558845861807,2400,0.607441154138193
"E02000025",5,249,1443,1256,440,57,11,3461,0.0014446691707599,0.0719445247038428,0.416931522681306,0.362900895694886,0.127130887026871,0.0164692285466628,0.00317827217567177,1697,0.490320716555909,1764,0.509679283444091
"E02000026",4,101,587,965,320,51,9,2037,0.00196367206676485,0.0495827196858125,0.288168875797742,0.47373588610702,0.157093765341188,0.0250368188512518,0.00441826215022091,692,0.339715267550319,1345,0.660284732449681
"E02000027",32,435,1104,1405,374,60,16,3426,0.00934033858727379,0.126970227670753,0.322241681260946,0.41009924109749,0.109165207238762,0.0175131348511384,0.00467016929363689,1571,0.458552247518973,1855,0.541447752481027
"E02000028",2,128,872,1047,389,53,10,2501,0.00079968012794882,0.0511795281887245,0.348660535785686,0.418632546981207,0.155537784886046,0.0211915233906437,0.0039984006397441,1002,0.400639744102359,1499,0.599360255897641
"E02000029",0,400,1142,1444,479,61,12,3538,0,0.113058224985868,0.322781232334652,0.408140192198982,0.135387224420577,0.0172413793103448,0.00339174674957603,1542,0.43583945732052,1996,0.56416054267948
"E02000030",30,244,777,1209,498,91,18,2867,0.0104638995465644,0.0851063829787234,0.271014998256017,0.421695151726543,0.173700732472968,0.0317404952912452,0.00627833972793861,1051,0.366585280781304,1816,0.633414719218696
"E02000031",144,863,918,1120,444,82,7,3578,0.0402459474566797,0.241196198993851,0.256567915036333,0.313024035774176,0.124091671324762,0.0229178311906093,0.0019564002235886,1925,0.538010061486864,1653,0.461989938513136
"E02000032",2,33,257,857,411,81,7,1648,0.00121359223300971,0.0200242718446602,0.155946601941748,0.52002427184466,0.249393203883495,0.0491504854368932,0.00424757281553398,292,0.177184466019417,1356,0.822815533980582
"E02000033",0,198,905,1273,421,53,10,2860,0,0.0692307692307692,0.316433566433566,0.445104895104895,0.147202797202797,0.0185314685314685,0.0034965034965035,1103,0.385664335664336,1757,0.614335664335664
"E02000034",1,239,1055,1432,508,91,18,3344,0.000299043062200957,0.0714712918660287,0.31549043062201,0.42822966507177,0.151913875598086,0.0272129186602871,0.00538277511961723,1295,0.387260765550239,2049,0.612739234449761
"E02000035",2,545,1710,1273,417,75,17,4039,0.000495172072295123,0.134934389700421,0.42337212181233,0.315177024015846,0.103243377073533,0.0185689527110671,0.00420896261450854,2257,0.558801683585046,1782,0.441198316414954
"E02000036",1,152,1116,1621,426,62,11,3389,0.000295072292711714,0.0448509884921806,0.329300678666273,0.478312186485689,0.12570079669519,0.0182944821481263,0.00324579521982886,1269,0.374446739451166,2120,0.625553260548835
"E02000037",42,1068,879,923,373,60,6,3351,0.0125335720680394,0.318710832587287,0.26230975828111,0.275440167114294,0.111310056699493,0.017905102954342,0.0017905102954342,1989,0.593554162936437,1362,0.406445837063563
"E02000038",2,205,1389,1439,564,79,19,3697,0.000540979172301866,0.0554503651609413,0.375710035163646,0.389234514471193,0.152556126589126,0.0213686773059237,0.00513930213686773,1596,0.431701379496889,2101,0.568298620503111
"E02000039",8,260,802,969,360,73,19,2491,0.00321156162183862,0.104375752709755,0.321959052589322,0.389000401445203,0.144520272982738,0.0293054997992774,0.00762745885186672,1070,0.429546366920915,1421,0.570453633079085
"E02000040",38,2723,741,964,284,41,2,4793,0.00792822866680576,0.568120175255581,0.154600459002712,0.201126643021072,0.0592530774045483,0.00855414145629042,0.000417275192989777,3502,0.730648862925099,1291,0.269351137074901
"E02000041",0,237,939,1487,488,66,15,3232,0,0.0733292079207921,0.290532178217822,0.460086633663366,0.150990099009901,0.0204207920792079,0.00464108910891089,1176,0.363861386138614,2056,0.636138613861386
"E02000042",8,288,2078,1803,574,60,15,4826,0.00165768752590137,0.0596767509324492,0.43058433485288,0.373601326150021,0.118939079983423,0.0124326564442603,0.00310816411106506,2374,0.491918773311231,2452,0.508081226688769
"E02000043",1,64,429,1139,466,58,12,2169,0.000461041954817888,0.0295066851083449,0.197786998616874,0.525126786537575,0.214845550945136,0.0267404333794375,0.00553250345781466,494,0.227754725680037,1675,0.772245274319963
"E02000044",1,168,1041,1443,347,44,4,3048,0.000328083989501312,0.0551181102362205,0.341535433070866,0.473425196850394,0.113845144356955,0.0144356955380577,0.00131233595800525,1210,0.396981627296588,1838,0.603018372703412
"E02000045",3,139,1858,1697,485,46,10,4238,0.000707881075979236,0.0327984898537046,0.438414346389807,0.400424728645588,0.114440773949976,0.0108541764983483,0.00235960358659745,2000,0.47192071731949,2238,0.52807928268051
"E02000046",0,172,1065,1339,425,57,11,3069,0,0.0560443141088302,0.347018572825024,0.436298468556533,0.138481590094493,0.0185728250244379,0.003584229390681,1237,0.403062886933855,1832,0.596937113066145
"E02000047",0,622,1678,1892,321,27,11,4551,0,0.136673258624478,0.368710173588222,0.415732805976708,0.0705339485827291,0.00593276203032301,0.002417051197539,2300,0.505383432212701,2251,0.494616567787299
"E02000048",0,462,1333,1261,462,77,10,3605,0,0.128155339805825,0.369764216366158,0.349791955617198,0.128155339805825,0.0213592233009709,0.00277392510402219,1795,0.497919556171983,1810,0.502080443828017
"E02000049",71,1265,1147,1160,306,42,12,4003,0.0177366974768923,0.316012990257307,0.286535098675993,0.289782663002748,0.0764426679990007,0.0104921309018236,0.00299775168623532,2483,0.620284786410192,1520,0.379715213589808
"E02000050",12,489,1402,1444,511,77,7,3942,0.0030441400304414,0.124048706240487,0.355657026889904,0.366311516996448,0.12962962962963,0.019533231861999,0.00177574835109082,1903,0.482749873160832,2039,0.517250126839168
"E02000051",1,543,1469,1405,505,85,20,4028,0.000248262164846077,0.13480635551142,0.364697120158888,0.348808341608739,0.125372393247269,0.0211022840119166,0.00496524329692155,2013,0.499751737835154,2015,0.500248262164846
"E02000052",0,251,1666,1865,630,78,19,4509,0,0.0556664448880018,0.369483255710801,0.413617210024396,0.139720558882236,0.0172987358616101,0.00421379463295631,1917,0.425149700598802,2592,0.574850299401198
"E02000054",0,184,1310,1052,384,62,8,3000,0,0.0613333333333333,0.436666666666667,0.350666666666667,0.128,0.0206666666666667,0.00266666666666667,1494,0.498,1506,0.502
"E02000055",2,605,2106,1836,655,84,17,5305,0.000377002827521206,0.114043355325165,0.39698397737983,0.346088595664467,0.123468426013195,0.0158341187558907,0.00320452403393025,2713,0.511404335532516,2592,0.488595664467483
"E02000056",2,126,705,1258,683,135,17,2926,0.000683526999316473,0.0430622009569378,0.240943267259057,0.429938482570062,0.233424470266576,0.0461380724538619,0.00580997949419002,833,0.284688995215311,2093,0.715311004784689
"E02000057",2,191,1110,1104,408,76,15,2906,0.000688231245698555,0.065726083964212,0.381968341362698,0.379903647625602,0.140399174122505,0.0261527873365451,0.00516173434273916,1303,0.448382656572608,1603,0.551617343427392
"E02000058",3,118,1034,1759,764,131,14,3823,0.000784724038713053,0.0308658121893801,0.270468218676432,0.46010986136542,0.199843055192257,0.0342662830238033,0.00366204551399425,1155,0.302118754904525,2668,0.697881245095475
"E02000059",0,2318,1543,1481,340,44,14,5740,0,0.40383275261324,0.268815331010453,0.25801393728223,0.0592334494773519,0.00766550522648084,0.0024390243902439,3861,0.672648083623693,1879,0.327351916376307
"E02000060",2,350,1510,1440,588,77,17,3984,0.000502008032128514,0.08785140562249,0.379016064257028,0.36144578313253,0.147590361445783,0.0193273092369478,0.00426706827309237,1862,0.467369477911647,2122,0.532630522088353
"E02000061",12,542,1510,1395,604,83,20,4166,0.0028804608737398,0.130100816130581,0.362457993278925,0.334853576572252,0.14498319731157,0.0199231877100336,0.00480076812289966,2064,0.495439270283245,2102,0.504560729716755
"E02000062",1,613,894,1214,296,34,16,3068,0.000325945241199478,0.19980443285528,0.291395045632334,0.395697522816167,0.0964797913950456,0.0110821382007823,0.00521512385919166,1508,0.491525423728814,1560,0.508474576271186
"E02000063",32,193,1112,1174,318,29,16,2874,0.011134307585247,0.0671537926235212,0.386917188587335,0.408489909533751,0.110647181628392,0.0100904662491301,0.00556715379262352,1337,0.465205288796103,1537,0.534794711203897
"E02000064",17,516,1328,899,321,23,9,3113,0.00546097012528108,0.16575650497912,0.426598136845487,0.288788949566335,0.103115965306778,0.00738837134596852,0.00289110183103116,1861,0.597815611949888,1252,0.402184388050112
"E02000065",1,33,1458,916,169,16,1,2594,0.00038550501156515,0.01272166538165,0.562066306861989,0.353122590593678,0.0651503469545104,0.00616808018504241,0.00038550501156515,1492,0.575173477255204,1102,0.424826522744796
"E02000066",0,621,1188,1846,431,17,4,4107,0,0.151205259313367,0.289262235208181,0.449476503530558,0.104942780618456,0.00413927440954468,0.000973946919892866,1809,0.440467494521549,2298,0.559532505478451
"E02000067",9,331,1555,1566,530,58,18,4067,0.00221293336611753,0.0813867715761003,0.382345709368085,0.38505040570445,0.13031718711581,0.0142611261372019,0.00442586673223506,1895,0.465945414310302,2172,0.534054585689698
"E02000068",9,576,1450,1032,322,40,7,3436,0.00261932479627474,0.167636786961583,0.422002328288708,0.30034924330617,0.0937136204889406,0.0116414435389988,0.0020372526193248,2035,0.592258440046566,1401,0.407741559953434
"E02000069",5,521,787,978,323,58,10,2682,0.00186428038777032,0.194258016405667,0.293437733035048,0.364653243847875,0.120432513049963,0.0216256524981357,0.00372856077554064,1313,0.489560029828486,1369,0.510439970171514
"E02000070",3,57,508,1128,462,67,13,2238,0.00134048257372654,0.0254691689008043,0.226988382484361,0.50402144772118,0.206434316353887,0.0299374441465594,0.00580875781948168,568,0.253798033958892,1670,0.746201966041108
"E02000071",2,28,655,1108,366,50,15,2224,0.000899280575539568,0.012589928057554,0.294514388489209,0.498201438848921,0.164568345323741,0.0224820143884892,0.00674460431654676,685,0.308003597122302,1539,0.691996402877698
"E02000072",166,1119,2017,1547,329,44,21,5243,0.0316612626358955,0.213427427045585,0.384703414075911,0.295060080106809,0.0627503337783712,0.00839214190349037,0.00400534045393859,3302,0.629792103757391,1941,0.370207896242609
"E02000073",2,29,346,1466,574,61,14,2492,0.000802568218298555,0.0116372391653291,0.13884430176565,0.588282504012841,0.230337078651685,0.0244783306581059,0.00561797752808989,377,0.151284109149278,2115,0.848715890850722
"E02000074",4,502,1432,1116,268,44,7,3373,0.00118588793359028,0.14882893566558,0.424547880225319,0.330862733471687,0.0794544915505485,0.013044767269493,0.00207530388378298,1938,0.574562703824489,1435,0.425437296175511
"E02000075",0,10,356,1116,401,49,11,1943,0,0.00514668039114771,0.183221821924858,0.574369531652084,0.206381883685023,0.0252187339166238,0.00566134843026248,366,0.188368502316006,1577,0.811631497683994
"E02000077",3,70,381,1196,441,45,21,2157,0.00139082058414465,0.0324524802967084,0.17663421418637,0.554473806212332,0.204450625869263,0.0208623087621697,0.00973574408901252,454,0.210477515067223,1703,0.789522484932777
"E02000078",1,24,387,1195,449,54,16,2126,0.000470366886171214,0.0112888052681091,0.18203198494826,0.5620884289746,0.211194731890875,0.0253998118532455,0.00752587017873942,412,0.19379115710254,1714,0.80620884289746
"E02000079",0,909,717,1302,515,82,23,3548,0,0.25620067643743,0.202085682074408,0.366967305524239,0.145152198421646,0.0231116121758737,0.00648252536640361,1626,0.458286358511838,1922,0.541713641488162
"E02000080",5,241,566,1309,603,84,20,2828,0.00176803394625177,0.0852192362093352,0.2001414427157,0.462871287128713,0.213224893917963,0.0297029702970297,0.00707213578500707,812,0.287128712871287,2016,0.712871287128713
"E02000081",0,184,648,1223,377,49,13,2494,0,0.0737770649558941,0.259823576583801,0.49037690457097,0.151162790697674,0.0196471531676022,0.00521251002405774,832,0.333600641539695,1662,0.666399358460305
"E02000082",4,97,332,1153,495,87,22,2190,0.00182648401826484,0.0442922374429224,0.151598173515982,0.52648401826484,0.226027397260274,0.0397260273972603,0.0100456621004566,433,0.197716894977169,1757,0.802283105022831
"E02000083",10,498,1105,1853,586,70,18,4140,0.00241545893719807,0.120289855072464,0.266908212560386,0.447584541062802,0.141545893719807,0.0169082125603865,0.00434782608695652,1613,0.389613526570048,2527,0.610386473429952
"E02000084",12,64,664,1377,676,101,17,2911,0.0041222947440742,0.0219855719683957,0.228100309172106,0.473033321882515,0.23222260391618,0.0346959807626245,0.00583991755410512,740,0.254208175884576,2171,0.745791824115424
"E02000085",0,45,484,1250,384,47,21,2231,0,0.0201703272075303,0.216943074854325,0.56028686687584,0.172120125504258,0.0210667861945316,0.00941281936351412,529,0.237113402061856,1702,0.762886597938144
"E02000086",6,46,381,959,402,46,9,1849,0.00324499729583559,0.0248783126014062,0.20605732828556,0.518658734451055,0.217414818820984,0.0248783126014062,0.00486749594375338,433,0.234180638182801,1416,0.765819361817198
"E02000087",6,273,690,1117,469,80,9,2644,0.00226928895612708,0.103252647503782,0.260968229954614,0.422465960665658,0.177382753403933,0.0302571860816944,0.00340393343419062,969,0.366490166414523,1675,0.633509833585477
"E02000088",2,23,399,1103,375,59,7,1968,0.00101626016260163,0.0116869918699187,0.202743902439024,0.560467479674797,0.190548780487805,0.029979674796748,0.00355691056910569,424,0.215447154471545,1544,0.784552845528455
"E02000089",3,107,308,1005,432,53,8,1916,0.00156576200417537,0.0558455114822547,0.160751565762004,0.524530271398747,0.225469728601253,0.0276617954070981,0.00417536534446764,418,0.218162839248434,1498,0.781837160751566
"E02000090",21,433,1450,1424,658,136,27,4149,0.00506146059291396,0.104362496987226,0.349481802844059,0.343215232586165,0.158592431911304,0.0327789828874428,0.00650759219088937,1904,0.458905760424199,2245,0.541094239575801
"E02000091",1,331,1292,1430,660,126,11,3851,0.000259672812256557,0.0859517008569203,0.335497273435471,0.371332121526876,0.171384056089327,0.0327187743443262,0.00285640093482212,1624,0.421708647104648,2227,0.578291352895352
"E02000092",0,119,1045,1077,254,47,16,2558,0,0.0465207193119625,0.40852228303362,0.42103205629398,0.0992963252541048,0.0183737294761532,0.00625488663017983,1164,0.455043002345582,1394,0.544956997654418
"E02000093",18,642,887,1146,400,29,5,3127,0.00575631595778702,0.205308602494404,0.283658458586505,0.36648544931244,0.127918132395267,0.00927406459865686,0.00159897665494084,1547,0.494723377038695,1580,0.505276622961305
"E02000094",0,922,583,1039,307,32,7,2890,0,0.319031141868512,0.201730103806228,0.359515570934256,0.106228373702422,0.0110726643598616,0.00242214532871972,1505,0.52076124567474,1385,0.47923875432526
"E02000095",2,65,694,1207,310,37,17,2332,0.000857632933104631,0.0278730703259005,0.297598627787307,0.517581475128645,0.132933104631218,0.0158662092624357,0.00728987993138937,761,0.326329331046312,1571,0.673670668953688
"E02000096",1,111,409,798,344,84,5,1752,0.000570776255707763,0.0633561643835616,0.233447488584475,0.455479452054795,0.19634703196347,0.0479452054794521,0.00285388127853881,521,0.297374429223744,1231,0.702625570776256
"E02000097",2,26,583,1081,309,48,15,2064,0.000968992248062015,0.0125968992248062,0.282461240310078,0.523740310077519,0.149709302325581,0.0232558139534884,0.00726744186046512,611,0.296027131782946,1453,0.703972868217054
"E02000098",1,334,842,928,351,49,9,2514,0.000397772474144789,0.13285600636436,0.334924423229913,0.369132856006364,0.139618138424821,0.0194908512330947,0.0035799522673031,1177,0.468178202068417,1337,0.531821797931583
"E02000099",3,168,782,950,309,28,9,2249,0.00133392618941752,0.0746998666073811,0.347710093374833,0.422409959982214,0.137394397510004,0.0124499777678968,0.00400177856825256,953,0.423743886171632,1296,0.576256113828368
"E02000100",2,120,354,726,334,53,4,1593,0.00125549278091651,0.0753295668549906,0.222222222222222,0.455743879472693,0.209667294413057,0.0332705586942875,0.00251098556183302,476,0.298807281858129,1117,0.701192718141871
"E02000101",0,256,1243,1092,337,55,9,2992,0,0.0855614973262032,0.415441176470588,0.364973262032086,0.112633689839572,0.0183823529411765,0.00300802139037433,1499,0.501002673796791,1493,0.498997326203209
"E02000102",0,99,932,1137,306,24,5,2503,0,0.0395525369556532,0.372353176188574,0.454254894127048,0.122253296044746,0.00958849380743108,0.00199760287654814,1031,0.411905713144227,1472,0.588094286855773
"E02000103",1,413,1098,1157,303,30,8,3010,0.000332225913621262,0.137209302325581,0.364784053156146,0.384385382059801,0.100664451827243,0.00996677740863787,0.0026578073089701,1512,0.502325581395349,1498,0.497674418604651
"E02000104",0,307,618,755,320,40,16,2056,0,0.14931906614786,0.300583657587549,0.367217898832685,0.155642023346304,0.0194552529182879,0.00778210116731518,925,0.449902723735409,1131,0.550097276264591
"E02000105",23,162,933,1168,391,44,12,2733,0.0084156604463959,0.0592755214050494,0.341383095499451,0.427369191364801,0.14306622758873,0.0160995243322356,0.00439077936333699,1118,0.409074277350896,1615,0.590925722649103
"E02000106",4,351,1223,1759,517,59,33,3946,0.0010136847440446,0.0889508362899138,0.309934110491637,0.445767866193614,0.131018753167765,0.0149518499746579,0.00836289913836797,1578,0.399898631525596,2368,0.600101368474405
"E02000107",3,169,1537,1829,647,86,26,4297,0.000698161508028857,0.0393297649522923,0.357691412613451,0.425645799394927,0.150570165231557,0.0200139632301606,0.00605073306958343,1709,0.397719339073772,2588,0.602280660926228
"E02000108",0,292,576,785,170,25,2,1850,0,0.157837837837838,0.311351351351351,0.424324324324324,0.0918918918918919,0.0135135135135135,0.00108108108108108,868,0.469189189189189,982,0.530810810810811
"E02000110",0,104,944,1183,399,37,15,2682,0,0.0387770320656227,0.351976137211037,0.441088739746458,0.148769574944072,0.0137956748695004,0.00559284116331096,1048,0.390753169276659,1634,0.609246830723341
"E02000111",3,267,1078,1130,355,34,8,2875,0.00104347826086957,0.0928695652173913,0.37495652173913,0.39304347826087,0.123478260869565,0.0118260869565217,0.00278260869565217,1348,0.468869565217391,1527,0.531130434782609
"E02000112",2,1704,892,1146,279,35,16,4074,0.000490918016691213,0.418262150220913,0.218949435444281,0.281296023564065,0.0684830633284242,0.00859106529209622,0.0039273441335297,2598,0.637702503681885,1476,0.362297496318115
"E02000113",5,104,1241,1114,235,14,11,2724,0.00183553597650514,0.0381791483113069,0.455580029368576,0.408957415565345,0.0862701908957416,0.00513950073421439,0.00403817914831131,1350,0.495594713656388,1374,0.504405286343612
"E02000114",1,358,1169,1761,465,36,14,3804,0.000262881177707676,0.0941114616193481,0.307308096740273,0.462933753943218,0.122239747634069,0.00946372239747634,0.00368033648790747,1528,0.401682439537329,2276,0.598317560462671
"E02000115",0,269,1649,1307,413,60,15,3713,0,0.0724481551306221,0.444115270670617,0.352006463775922,0.11123081066523,0.0161594398060867,0.00403985995152168,1918,0.516563425801239,1795,0.483436574198761
"E02000116",10,315,1303,1236,264,31,9,3168,0.00315656565656566,0.0994318181818182,0.411300505050505,0.390151515151515,0.0833333333333333,0.00978535353535354,0.00284090909090909,1628,0.513888888888889,1540,0.486111111111111
"E02000117",1,381,1748,1788,374,34,14,4340,0.000230414746543779,0.0877880184331797,0.402764976958525,0.411981566820276,0.0861751152073733,0.00783410138248848,0.0032258064516129,2130,0.490783410138249,2210,0.509216589861751
"E02000118",0,1033,660,1202,220,24,9,3148,0,0.328144853875476,0.209656925031766,0.381829733163914,0.0698856416772554,0.00762388818297332,0.00285895806861499,1693,0.537801778907243,1455,0.462198221092757
"E02000119",2,2691,1108,561,104,15,2,4483,0.00044612982377872,0.600267677894267,0.247155922373411,0.125139415569931,0.0231987508364934,0.0033459736783404,0.00044612982377872,3801,0.847869730091457,682,0.152130269908543
"E02000120",11,291,1743,1740,437,58,23,4303,0.00255635603067627,0.0676272368115268,0.405066232860795,0.404369044852429,0.101557053218685,0.0134789681617476,0.0053451080641413,2045,0.475249825702998,2258,0.524750174297002
"E02000121",0,1395,848,1034,267,31,9,3584,0,0.389229910714286,0.236607142857143,0.288504464285714,0.0744977678571429,0.00864955357142857,0.00251116071428571,2243,0.625837053571429,1341,0.374162946428571
"E02000122",1,223,819,1090,411,61,14,2619,0.000381825124093165,0.0851470026727759,0.312714776632302,0.41618938526155,0.156930126002291,0.0232913325696831,0.00534555173730431,1043,0.398243604429171,1576,0.601756395570829
"E02000123",1,430,2033,2733,713,102,25,6037,0.000165645188007288,0.071227430843134,0.336756667218817,0.452708298823919,0.118105019049197,0.0168958091767434,0.00414112970018221,2464,0.408149743249959,3573,0.591850256750041
"E02000124",14,467,1370,1753,532,68,26,4230,0.0033096926713948,0.110401891252955,0.32387706855792,0.414420803782506,0.125768321513002,0.0160756501182033,0.00614657210401891,1851,0.43758865248227,2379,0.56241134751773
"E02000125",1,87,970,1713,442,43,23,3279,0.000304971027752364,0.0265324794144556,0.295821896919793,0.522415370539799,0.134797194266545,0.0131137541933516,0.00701433363830436,1058,0.322659347362001,2221,0.677340652637999
"E02000126",0,1577,1205,519,78,10,4,3393,0,0.464780430297672,0.355142941349838,0.152961980548187,0.0229885057471264,0.00294724432655467,0.00117889773062187,2782,0.81992337164751,611,0.18007662835249
"E02000127",2,38,1226,1451,357,37,13,3124,0.000640204865556978,0.0121638924455826,0.392445582586428,0.464468629961588,0.114276568501921,0.0118437900128041,0.00416133162612036,1266,0.405249679897567,1858,0.594750320102433
"E02000128",0,99,621,1164,491,46,11,2432,0,0.0407072368421053,0.255345394736842,0.478618421052632,0.201891447368421,0.0189144736842105,0.00452302631578947,720,0.296052631578947,1712,0.703947368421053
"E02000130",3,279,993,1555,566,96,25,3517,0.000852999715666761,0.0793289735570088,0.282342905885698,0.442138185953938,0.160932613022462,0.0272959909013364,0.00710833096388968,1275,0.362524879158374,2242,0.637475120841626
"E02000131",2,813,1965,2127,468,50,29,5454,0.000366703337000367,0.149064906490649,0.36028602860286,0.38998899889989,0.0858085808580858,0.00916758342500917,0.00531719838650532,2780,0.50971763843051,2674,0.49028236156949
"E02000132",1,956,2544,1542,499,72,17,5631,0.000177588350204227,0.169774462795241,0.451784762919552,0.273841236014917,0.0886165867519091,0.0127863612147043,0.00301900195347185,3501,0.621736814064997,2130,0.378263185935003
"E02000133",5,538,1011,1323,680,162,17,3736,0.00133832976445396,0.144004282655246,0.270610278372591,0.354122055674518,0.182012847965739,0.0433618843683084,0.00455032119914347,1554,0.415952890792291,2182,0.584047109207709
"E02000134",1,438,1887,2150,881,146,35,5538,0.000180570603105814,0.0790899241603467,0.340736728060672,0.388226796677501,0.159082701336222,0.0263633080534489,0.0063199711087035,2326,0.420007222824124,3212,0.579992777175876
"E02000135",0,309,2138,1646,410,64,26,4593,0,0.0672762900065317,0.465490964511213,0.358371434792075,0.0892662747659482,0.0139342477683431,0.0056607881558894,2447,0.532767254517744,2146,0.467232745482256
"E02000136",1,137,533,837,319,38,7,1873,0.000533902829684997,0.0731446876668446,0.284570208222104,0.446876668446343,0.170315002669514,0.0202883075280299,0.00373731980779498,671,0.358248798718633,1201,0.641217298451682
"E02000137",7,224,1394,1247,487,109,14,3482,0.00201033888569787,0.064330844342332,0.400344629523262,0.358127512923607,0.139862148190695,0.0313038483630098,0.00402067777139575,1625,0.466685812751292,1857,0.533314187248708
"E02000138",4,350,1837,1404,516,75,11,4197,0.000953061710745771,0.0833928996902549,0.437693590659995,0.334524660471766,0.122944960686204,0.0178699070764832,0.00262091970455087,2191,0.522039552060996,2006,0.477960447939004
"E02000139",8,244,872,1212,579,88,18,3021,0.00264812975835816,0.0807679576299239,0.288646143661039,0.401191658391261,0.191658391261172,0.0291294273419398,0.00595829195630586,1124,0.372062231049321,1897,0.627937768950679
"E02000140",5,157,931,1229,291,32,10,2655,0.00188323917137476,0.0591337099811676,0.350659133709981,0.462900188323917,0.109604519774011,0.0120527306967985,0.00376647834274953,1093,0.411676082862523,1562,0.588323917137476
"E02000141",2,78,999,1281,506,55,21,2942,0.000679809653297077,0.026512576478586,0.33956492182189,0.435418082936778,0.17199184228416,0.0186947654656696,0.00713800135961931,1079,0.366757307953773,1863,0.633242692046227
"E02000142",1,217,961,1131,510,79,17,2916,0.000342935528120713,0.0744170096021948,0.329561042524005,0.387860082304527,0.174897119341564,0.0270919067215364,0.00582990397805213,1179,0.404320987654321,1737,0.595679012345679
"E02000144",0,719,1254,1520,618,99,20,4230,0,0.169976359338061,0.29645390070922,0.359338061465721,0.146099290780142,0.0234042553191489,0.00472813238770686,1973,0.466430260047281,2257,0.533569739952719
"E02000145",6,213,1303,1158,269,51,17,3017,0.00198873052701359,0.0705999337089824,0.431885979449785,0.383824991713623,0.0891614186277759,0.0169042094796155,0.00563473649320517,1522,0.504474643685781,1495,0.495525356314219
"E02000146",1,600,998,1410,655,107,33,3804,0.000262881177707676,0.157728706624606,0.262355415352261,0.370662460567823,0.172187171398528,0.0281282860147213,0.00867507886435331,1599,0.420347003154574,2205,0.579652996845426
"E02000147",2,125,773,851,530,110,10,2401,0.000832986255726781,0.0520616409829238,0.321949187838401,0.354435651811745,0.220741357767597,0.0458142440649729,0.0041649312786339,900,0.374843815077051,1501,0.625156184922949
"E02000148",1,112,518,918,475,72,16,2112,0.000473484848484848,0.053030303030303,0.245265151515152,0.434659090909091,0.224905303030303,0.0340909090909091,0.00757575757575758,631,0.298768939393939,1481,0.701231060606061
"E02000149",13,117,848,1310,423,71,10,2792,0.00465616045845272,0.0419054441260745,0.303724928366762,0.46919770773639,0.151504297994269,0.0254297994269341,0.00358166189111748,978,0.350286532951289,1814,0.649713467048711
"E02000150",48,314,678,987,367,48,16,2458,0.0195280716029292,0.127746135069162,0.275834011391375,0.401545972335232,0.149308380797396,0.0195280716029292,0.0065093572009764,1040,0.423108218063466,1418,0.576891781936534
"E02000151",1,37,302,1003,557,99,8,2007,0.00049825610363727,0.018435475834579,0.150473343298455,0.499750871948181,0.277528649725959,0.0493273542600897,0.00398604882909816,340,0.169407075236672,1667,0.830592924763328
"E02000152",12,546,798,891,287,33,5,2572,0.0046656298600311,0.212286158631415,0.310264385692068,0.346423017107309,0.111586314152411,0.0128304821150855,0.00194401244167963,1356,0.527216174183515,1216,0.472783825816485
"E02000153",1,78,277,930,482,73,18,1859,0.000537923614846692,0.041958041958042,0.149004841312534,0.500268961807423,0.259279182356105,0.0392684238838085,0.00968262506724045,356,0.191500806885422,1503,0.808499193114578
"E02000154",3,489,932,1221,517,79,23,3264,0.000919117647058824,0.149816176470588,0.285539215686274,0.374080882352941,0.158394607843137,0.024203431372549,0.00704656862745098,1424,0.436274509803922,1840,0.563725490196078
"E02000155",2,71,586,1195,419,51,15,2339,0.000855066267635742,0.0303548525010688,0.250534416417272,0.510902094912356,0.179136383069688,0.0218041898247114,0.00641299700726806,659,0.281744335185977,1680,0.718255664814023
"E02000156",0,234,737,1485,821,138,24,3439,0,0.0680430357662111,0.214306484443152,0.431811573131724,0.238732189589997,0.0401279441698168,0.00697877289909858,971,0.282349520209363,2468,0.717650479790637
"E02000157",0,89,479,1182,501,49,7,2307,0,0.0385782401387083,0.207628955353273,0.512353706111834,0.217165149544863,0.0212397052449068,0.00303424360641526,568,0.246207195491981,1739,0.753792804508019
"E02000158",5,200,668,926,341,39,8,2187,0.00228623685413809,0.0914494741655235,0.305441243712849,0.423411065386374,0.155921353452218,0.0178326474622771,0.00365797896662094,873,0.39917695473251,1314,0.60082304526749
"E02000159",2,190,479,931,471,84,14,2171,0.000921234454168586,0.0875172731460157,0.220635651773376,0.428834638415477,0.216950713956702,0.0386918470750806,0.0064486411791801,671,0.309074159373561,1500,0.690925840626439
"E02000160",4,176,395,959,510,108,10,2162,0.00185013876040703,0.0814061054579093,0.182701202590194,0.443570767807586,0.235892691951896,0.0499537465309898,0.00462534690101758,575,0.265957446808511,1587,0.734042553191489
"E02000161",2,34,614,1277,410,50,7,2394,0.000835421888053467,0.0142021720969089,0.256474519632414,0.533416875522139,0.171261487050961,0.0208855472013367,0.00292397660818713,650,0.271512113617377,1744,0.728487886382623
"E02000162",9,194,1084,834,324,54,13,2512,0.0035828025477707,0.0772292993630573,0.431528662420382,0.332006369426752,0.128980891719745,0.0214968152866242,0.00517515923566879,1287,0.51234076433121,1225,0.48765923566879
"E02000163",5,97,571,1062,372,60,13,2180,0.00229357798165138,0.0444954128440367,0.261926605504587,0.487155963302752,0.170642201834862,0.0275229357798165,0.00596330275229358,673,0.308715596330275,1507,0.691284403669725
"E02000165",2,96,635,990,260,32,8,2023,0.000988630746416213,0.0474542758279783,0.313890261987148,0.489372219476026,0.128521997034108,0.0158180919426594,0.00395452298566485,733,0.362333168561542,1290,0.637666831438458
"E02000166",2,168,801,1150,431,70,11,2633,0.000759589821496392,0.0638055450056969,0.304215723509305,0.436764147360425,0.163691606532472,0.0265856437523737,0.00417774401823016,971,0.368780858336498,1662,0.631219141663502
"E02000167",6,70,1021,1554,650,90,29,3420,0.00175438596491228,0.0204678362573099,0.298538011695906,0.454385964912281,0.190058479532164,0.0263157894736842,0.00847953216374269,1097,0.320760233918129,2323,0.679239766081871
"E02000168",12,189,1156,1401,420,54,11,3243,0.00370027752081406,0.0582793709528215,0.356460067838421,0.432007400555042,0.129509713228492,0.0166512488436633,0.00339192106074622,1357,0.418439716312057,1886,0.581560283687943
"E02000169",4,462,1054,1214,507,67,11,3319,0.00120518228382043,0.139198553781259,0.317565531786683,0.3657728231395,0.152756854474239,0.0201868032539922,0.00331425128050618,1520,0.457969267851763,1799,0.542030732148237
"E02000170",0,168,1333,1605,573,58,23,3760,0,0.0446808510638298,0.354521276595745,0.42686170212766,0.152393617021277,0.0154255319148936,0.00611702127659574,1501,0.399202127659574,2259,0.600797872340425
"E02000171",2,132,1095,1385,397,46,15,3072,0.000651041666666667,0.04296875,0.3564453125,0.450846354166667,0.129231770833333,0.0149739583333333,0.0048828125,1229,0.400065104166667,1843,0.599934895833333
"E02000172",4,416,1605,1338,284,20,6,3673,0.00108902804247209,0.113258916417098,0.436972502041928,0.364279880206915,0.0773209910155186,0.00544514021236047,0.00163354206370814,2025,0.551320446501497,1648,0.448679553498503
"E02000173",3,416,1666,1397,443,55,9,3989,0.000752068187515668,0.104286788668839,0.417648533467034,0.350213085986463,0.11105540235648,0.0137879167711206,0.002256204562547,2085,0.522687390323389,1904,0.477312609676611
"E02000174",9,181,1261,1435,311,29,13,3239,0.00277863538129052,0.0558814448903983,0.389317690645261,0.443037974683544,0.0960172892868169,0.00895338067304724,0.00401358443964187,1451,0.44797777091695,1788,0.55202222908305
"E02000175",3,594,2017,1756,461,50,27,4908,0.000611246943765281,0.121026894865526,0.410961695191524,0.357783211083945,0.0939282803585982,0.0101874490627547,0.00550122249388753,2614,0.532599837000815,2294,0.467400162999185
"E02000176",5,55,1283,1507,383,30,11,3274,0.0015271838729383,0.0167990226023213,0.391875381795968,0.460293219303604,0.116982284667074,0.00916310323762981,0.00335980452046426,1343,0.410201588271228,1931,0.589798411728772
"E02000177",2,476,1601,1318,275,22,5,3699,0.000540686672073533,0.128683427953501,0.432819680994863,0.356312516896458,0.0743444174101108,0.00594755339280887,0.00135171668018383,2079,0.562043795620438,1620,0.437956204379562
"E02000178",4,476,1894,1839,395,35,9,4652,0.000859845227858985,0.102321582115219,0.40713671539123,0.395313843508169,0.0849097162510748,0.00752364574376612,0.00193465176268272,2374,0.510318142734308,2278,0.489681857265692
"E02000179",2,152,1294,900,272,30,10,2660,0.00075187969924812,0.0571428571428571,0.486466165413534,0.338345864661654,0.102255639097744,0.0112781954887218,0.0037593984962406,1448,0.544360902255639,1212,0.455639097744361
"E02000180",3,639,1493,1276,287,37,10,3745,0.000801068090787717,0.170627503337784,0.398664886515354,0.340720961281709,0.0766355140186916,0.00987983978638184,0.00267022696929239,2135,0.570093457943925,1610,0.429906542056075
"E02000181",0,126,1548,1667,480,40,12,3873,0,0.0325329202168861,0.399690162664601,0.430415698424994,0.123934934159566,0.0103279111799639,0.00309837335398916,1674,0.432223082881487,2199,0.567776917118513
"E02000182",4,422,1583,1271,356,41,6,3683,0.00108607113765952,0.114580505023079,0.429812652728754,0.345099103991311,0.096660331251697,0.01113222916101,0.00162910670648928,2009,0.545479228889492,1674,0.454520771110508
"E02000183",2,446,1652,1238,352,44,25,3759,0.000532056397978186,0.118648576749135,0.439478584729981,0.329342910348497,0.0936419260441607,0.0117052407555201,0.00665070497472732,2100,0.558659217877095,1659,0.441340782122905
"E02000184",2,1228,1755,1097,188,13,4,4287,0.00046652670865407,0.286447399113599,0.409377186843947,0.255889899696758,0.0438535106134826,0.00303242360625146,0.000933053417308141,2985,0.6962911126662,1302,0.3037088873338
"E02000185",1,458,1811,1411,274,39,17,4011,0.00024931438544004,0.114185988531538,0.451508352031912,0.351782597855896,0.0683121416105709,0.00972326103216156,0.00423834455248068,2270,0.565943654948891,1741,0.434056345051109
"E02000186",1,877,1581,1201,377,45,22,4104,0.000243664717348928,0.21369395711501,0.385233918128655,0.292641325536062,0.0918615984405458,0.0109649122807018,0.00536062378167641,2459,0.599171539961014,1645,0.400828460038986
"E02000187",0,2010,1333,1038,344,184,6,4915,0,0.408952187182096,0.271210579857579,0.21119023397762,0.0699898270600203,0.0374364191251272,0.00122075279755849,3343,0.680162767039674,1572,0.319837232960326
"E02000188",0,420,1693,709,124,8,2,2956,0,0.142083897158322,0.572733423545332,0.239851150202977,0.0419485791610284,0.0027063599458728,0.0006765899864682,2113,0.714817320703654,843,0.285182679296346
"E02000191",1,260,1780,1021,269,41,16,3388,0.000295159386068477,0.076741440377804,0.525383707201889,0.301357733175915,0.0793978748524203,0.0121015348288076,0.00472255017709563,2041,0.602420306965761,1347,0.397579693034238
"E02000192",4,731,1759,1066,282,31,14,3887,0.00102907126318498,0.188062773347054,0.452534087985593,0.274247491638796,0.0725495240545408,0.00797530228968356,0.00360174942114741,2494,0.641625932595832,1393,0.358374067404168
"E02000193",9,608,2349,1243,392,87,11,4699,0.00191530112789955,0.129389231751436,0.499893594381783,0.264524366886572,0.0834220046818472,0.0185145775696957,0.00234092360076612,2966,0.631198127261119,1733,0.368801872738881
"E02000194",19,447,1630,1713,531,74,17,4431,0.00428797111261566,0.100880162491537,0.367862784924396,0.386594448205823,0.119837508463101,0.0167005190701873,0.00383660573234033,2096,0.473030918528549,2335,0.526969081471451
"E02000195",1,256,593,1261,515,90,17,2733,0.000365898280278083,0.0936699597511892,0.216977680204903,0.461397731430662,0.188437614343213,0.0329308452250274,0.00622027076472741,850,0.31101353823637,1883,0.68898646176363
"E02000196",0,182,757,896,348,51,14,2248,0,0.0809608540925267,0.336743772241993,0.398576512455516,0.154804270462633,0.0226868327402135,0.00622775800711744,939,0.41770462633452,1309,0.58229537366548
"E02000197",1,169,792,1309,479,59,11,2820,0.000354609929078014,0.0599290780141844,0.280851063829787,0.464184397163121,0.169858156028369,0.0209219858156028,0.00390070921985816,962,0.34113475177305,1858,0.65886524822695
"E02000198",21,268,1025,1472,477,67,24,3354,0.00626118067978533,0.0799045915324985,0.305605247465713,0.438878950506857,0.14221824686941,0.0199761478831246,0.00715563506261181,1314,0.391771019677996,2040,0.608228980322004
"E02000199",1,80,660,1420,467,39,17,2684,0.0003725782414307,0.029806259314456,0.245901639344262,0.529061102831595,0.173994038748137,0.0145305514157973,0.00633383010432191,741,0.276080476900149,1943,0.723919523099851
"E02000200",1,366,1283,1636,610,98,14,4008,0.000249500998003992,0.0913173652694611,0.320109780439122,0.408183632734531,0.152195608782435,0.0244510978043912,0.00349301397205589,1650,0.411676646706587,2358,0.588323353293413
"E02000201",7,385,1458,1662,599,92,23,4226,0.00165641268338855,0.0911026975863701,0.3450070989115,0.393279697113109,0.141741599621391,0.0217699952673923,0.00544249881684808,1850,0.437766209181259,2376,0.562233790818741
"E02000202",1,71,625,1331,408,52,20,2508,0.000398724082934609,0.0283094098883573,0.249202551834131,0.530701754385965,0.162679425837321,0.0207336523125997,0.00797448165869218,697,0.277910685805423,1811,0.722089314194577
"E02000203",0,193,845,1393,376,40,16,2863,0,0.0674118057981139,0.295144952846664,0.486552567237164,0.131330771917569,0.013971358714635,0.005588543485854,1038,0.362556758644778,1825,0.637443241355222
"E02000204",1,204,838,1245,386,42,9,2725,0.00036697247706422,0.0748623853211009,0.307522935779816,0.456880733944954,0.141651376146789,0.0154128440366972,0.00330275229357798,1043,0.382752293577982,1682,0.617247706422018
"E02000206",17,428,1432,1983,596,69,27,4552,0.00373462214411248,0.09402460456942,0.314586994727592,0.435632688927944,0.130931458699473,0.0151581722319859,0.00593145869947276,1877,0.412346221441125,2675,0.587653778558875
"E02000207",6,218,1210,1403,492,49,14,3392,0.0017688679245283,0.0642688679245283,0.356721698113208,0.413620283018868,0.145047169811321,0.0144457547169811,0.00412735849056604,1434,0.422759433962264,1958,0.577240566037736
"E02000208",0,1004,1440,1288,393,65,20,4210,0,0.238479809976247,0.342042755344418,0.305938242280285,0.0933491686460808,0.0154394299287411,0.00475059382422803,2444,0.580522565320665,1766,0.419477434679335
"E02000209",7,189,852,1306,335,45,15,2749,0.00254638050200073,0.0687522735540196,0.309930883957803,0.475081847944707,0.121862495452892,0.0163695889414332,0.00545652964714442,1048,0.381229538013823,1701,0.618770461986177
"E02000210",4,147,771,1551,432,62,24,2991,0.00133734536944166,0.0491474423269809,0.25777331995988,0.518555667001003,0.144433299899699,0.0207288532263457,0.00802407221664995,922,0.308258107656302,2069,0.691741892343698
"E02000211",8,195,524,1085,499,70,11,2392,0.00334448160535117,0.0815217391304348,0.219063545150502,0.453595317725753,0.208612040133779,0.0292642140468227,0.00459866220735786,727,0.303929765886288,1665,0.696070234113712
"E02000212",2,560,945,1322,422,45,24,3320,0.000602409638554217,0.168674698795181,0.284638554216867,0.398192771084337,0.12710843373494,0.0135542168674699,0.0072289156626506,1507,0.453915662650602,1813,0.546084337349398
"E02000213",1,1156,2841,1564,542,75,38,6217,0.000160849284220685,0.185941772559112,0.456972816470967,0.251568280521152,0.0871803120476114,0.0120636963165514,0.00611227280038604,3998,0.6430754383143,2219,0.356924561685701
"E02000214",1,93,348,792,355,50,9,1648,0.000606796116504854,0.0564320388349515,0.211165048543689,0.480582524271845,0.215412621359223,0.0303398058252427,0.00546116504854369,442,0.268203883495146,1206,0.731796116504854
"E02000215",1,1123,1830,2213,811,95,27,6100,0.000163934426229508,0.184098360655738,0.3,0.362786885245902,0.132950819672131,0.0155737704918033,0.00442622950819672,2954,0.484262295081967,3146,0.515737704918033
"E02000216",3,262,1279,1039,453,60,7,3103,0.000966806316467934,0.0844344183048663,0.412181759587496,0.334837254270061,0.145987753786658,0.0193361263293587,0.00225588140509185,1544,0.49758298420883,1559,0.50241701579117
"E02000217",0,1393,1958,1710,598,64,23,5746,0,0.242429516185172,0.34075878872259,0.297598329272537,0.104072398190045,0.0111381830838844,0.00400278454577097,3351,0.583188304907762,2395,0.416811695092238
"E02000218",5,50,511,741,321,35,4,1667,0.002999400119976,0.02999400119976,0.306538692261548,0.444511097780444,0.19256148770246,0.020995800839832,0.0023995200959808,566,0.339532093581284,1101,0.660467906418716
"E02000219",2,117,407,946,546,99,13,2130,0.000938967136150235,0.0549295774647887,0.191079812206573,0.444131455399061,0.256338028169014,0.0464788732394366,0.00610328638497653,526,0.246948356807512,1604,0.753051643192488
"E02000221",8,618,1295,1315,472,49,8,3765,0.00212483399734396,0.164143426294821,0.343957503320053,0.349269588313413,0.125365205843293,0.0130146082337317,0.00212483399734396,1921,0.510225763612218,1844,0.489774236387782
"E02000222",4,356,1079,1483,575,104,17,3619,0.00110527770102238,0.098369715390992,0.298148659850788,0.409781707654048,0.158883669521967,0.0287372202265819,0.00469743022934512,1439,0.397623652942802,2179,0.602100027631942
"E02000223",11,75,943,901,138,9,3,2080,0.00528846153846154,0.0360576923076923,0.453365384615385,0.433173076923077,0.0663461538461538,0.00432692307692308,0.00144230769230769,1029,0.494711538461538,1051,0.505288461538462
"E02000224",0,372,806,1460,639,93,20,3390,0,0.109734513274336,0.237758112094395,0.430678466076696,0.188495575221239,0.0274336283185841,0.00589970501474926,1178,0.347492625368732,2212,0.652507374631269
"E02000225",2,62,802,892,186,26,9,1979,0.00101061141990905,0.0313289540171804,0.405255179383527,0.450732693279434,0.0939868620515412,0.0131379484588176,0.0045477513895907,866,0.437594744820616,1113,0.562405255179384
"E02000226",13,107,338,1012,358,48,8,1884,0.00690021231422505,0.0567940552016985,0.179405520169851,0.537154989384289,0.190021231422505,0.0254777070063694,0.00424628450106157,458,0.243099787685775,1426,0.756900212314225
"E02000227",15,38,1399,1854,510,43,10,3869,0.00387697079348669,0.00982165934349961,0.361592142672525,0.479193590074955,0.131817006978547,0.0111139829413285,0.00258464719565779,1452,0.375290772809512,2417,0.624709227190488
"E02000228",11,268,468,907,525,100,7,2286,0.00481189851268591,0.117235345581802,0.204724409448819,0.39676290463692,0.229658792650919,0.0437445319335083,0.00306211723534558,747,0.326771653543307,1539,0.673228346456693
"E02000229",13,84,852,855,180,27,4,2015,0.00645161290322581,0.0416873449131514,0.422828784119107,0.424317617866005,0.0893300248138958,0.0133995037220844,0.00198511166253102,949,0.470967741935484,1066,0.529032258064516
"E02000230",30,1196,1306,1261,662,136,21,4612,0.00650477016478751,0.259323503902862,0.283174327840416,0.273417172593235,0.143538594969644,0.0294882914137034,0.00455333911535126,2532,0.549002601908066,2080,0.450997398091934
"E02000231",19,733,514,766,509,142,12,2695,0.00705009276437848,0.271985157699443,0.190723562152134,0.284230055658627,0.18886827458256,0.0526901669758813,0.00445269016697588,1266,0.469758812615955,1429,0.530241187384045
"E02000232",3,191,375,798,253,38,7,1665,0.0018018018018018,0.114714714714715,0.225225225225225,0.479279279279279,0.151951951951952,0.0228228228228228,0.0042042042042042,569,0.341741741741742,1096,0.658258258258258
"E02000233",4,194,487,924,394,67,8,2078,0.00192492781520693,0.0933589990375361,0.234359961501444,0.444658325312801,0.189605389797883,0.0322425409047161,0.00384985563041386,685,0.329643888354187,1393,0.670356111645813
"E02000234",37,1123,898,1027,513,95,22,3715,0.00995962314939435,0.30228802153432,0.241722745625841,0.276446837146703,0.138088829071332,0.0255720053835801,0.00592193808882907,2058,0.553970390309556,1657,0.446029609690444
"E02000235",13,281,554,883,405,62,8,2206,0.00589301903898459,0.127379873073436,0.251133272892112,0.400271985494107,0.183590208522212,0.028105167724388,0.00362647325475975,848,0.384406165004533,1358,0.615593834995467
"E02000236",5,556,366,973,454,71,9,2434,0.00205423171733772,0.228430566967954,0.150369761709121,0.399753492193919,0.186524239934265,0.0291700903861956,0.00369761709120789,927,0.380854560394412,1507,0.619145439605587
"E02000237",24,113,497,1094,427,68,9,2232,0.010752688172043,0.0506272401433692,0.222670250896057,0.490143369175627,0.191308243727599,0.0304659498207885,0.00403225806451613,634,0.28405017921147,1598,0.71594982078853
"E02000238",2,1172,1249,1266,340,34,12,4075,0.00049079754601227,0.28760736196319,0.306503067484663,0.310674846625767,0.0834355828220859,0.00834355828220859,0.00294478527607362,2423,0.594601226993865,1652,0.405398773006135
"E02000239",1,212,582,1087,278,41,13,2214,0.0004516711833785,0.0957542908762421,0.262872628726287,0.49096657633243,0.125564588979223,0.0185185185185185,0.00587172538392051,795,0.359078590785908,1419,0.640921409214092
"E02000240",0,421,1521,1110,329,34,13,3428,0,0.122812135355893,0.443698949824971,0.323803967327888,0.0959743290548425,0.00991831971995333,0.00379229871645274,1942,0.566511085180863,1486,0.433488914819137
"E02000241",1,161,545,1031,310,32,10,2090,0.000478468899521531,0.0770334928229665,0.260765550239234,0.493301435406699,0.148325358851675,0.015311004784689,0.00478468899521531,707,0.338277511961722,1383,0.661722488038277
"E02000242",1,166,524,854,180,22,15,1762,0.000567536889897843,0.094211123723042,0.29738933030647,0.484676503972758,0.102156640181612,0.0124858115777526,0.00851305334846765,691,0.39216799091941,1071,0.60783200908059
"E02000243",5,589,876,1257,302,33,10,3072,0.00162760416666667,0.191731770833333,0.28515625,0.4091796875,0.0983072916666667,0.0107421875,0.00325520833333333,1470,0.478515625,1602,0.521484375
"E02000244",0,230,1174,1180,313,35,10,2942,0,0.0781781101291638,0.399048266485384,0.401087695445275,0.106390210740993,0.0118966689326988,0.00339904826648538,1404,0.477226376614548,1538,0.522773623385452
"E02000245",6,722,1415,986,303,43,10,3485,0.00172166427546628,0.207173601147776,0.406025824964132,0.282926829268293,0.0869440459110473,0.012338593974175,0.00286944045911047,2143,0.614921090387374,1342,0.385078909612626
"E02000246",7,58,1307,1082,254,30,11,2749,0.00254638050200073,0.0210985813022917,0.47544561658785,0.393597671880684,0.0923972353583121,0.0109130592942888,0.00400145507457257,1372,0.499090578392143,1377,0.500909421607857
"E02000247",5,538,1464,1202,278,28,10,3525,0.00141843971631206,0.152624113475177,0.41531914893617,0.340992907801418,0.0788652482269504,0.00794326241134752,0.00283687943262411,2007,0.56936170212766,1518,0.43063829787234
"E02000248",0,206,1247,1479,407,56,8,3403,0,0.060534822215692,0.366441375257126,0.434616514839847,0.119600352630032,0.0164560681751396,0.0023508668821628,1453,0.426976197472818,1950,0.573023802527182
"E02000249",3,271,758,1003,289,43,10,2377,0.0012620950778292,0.114009255363904,0.31888935633151,0.421960454354228,0.121581825830879,0.0180900294488851,0.00420698359276399,1032,0.434160706773244,1345,0.565839293226756
"E02000250",0,60,535,928,482,62,13,2080,0,0.0288461538461538,0.257211538461538,0.446153846153846,0.231730769230769,0.0298076923076923,0.00625,595,0.286057692307692,1485,0.713942307692308
"E02000251",0,27,443,975,191,32,8,1676,0,0.016109785202864,0.264319809069212,0.581742243436754,0.113961813842482,0.0190930787589499,0.00477326968973747,470,0.280429594272076,1206,0.719570405727924
"E02000252",0,2452,1629,1340,394,32,18,5865,0,0.418073316283035,0.277749360613811,0.22847399829497,0.0671781756180733,0.00545609548167093,0.0030690537084399,4081,0.695822676896846,1784,0.304177323103154
"E02000253",0,195,1393,1205,232,29,7,3061,0,0.0637046716759229,0.455080039202875,0.393662201894806,0.0757922247631493,0.00947402809539366,0.00228683436785364,1588,0.518784710878798,1473,0.481215289121202
"E02000254",2,66,432,994,201,20,13,1728,0.00115740740740741,0.0381944444444444,0.25,0.575231481481482,0.116319444444444,0.0115740740740741,0.00752314814814815,500,0.289351851851852,1228,0.710648148148148
"E02000255",2,400,1201,1570,418,68,16,3675,0.00054421768707483,0.108843537414966,0.326802721088435,0.427210884353741,0.113741496598639,0.0185034013605442,0.00435374149659864,1603,0.436190476190476,2072,0.563809523809524
"E02000256",3,723,1435,1486,630,114,16,4407,0.00068073519400953,0.164057181756297,0.325618334467892,0.337190832766054,0.142954390742001,0.0258679373723622,0.00363058770138416,2161,0.490356251418198,2246,0.509643748581802
"E02000258",2,128,799,1231,373,46,14,2593,0.000771307365985345,0.0493636714230621,0.308137292711145,0.47473968376398,0.143848823756267,0.0177400694176629,0.00539915156189742,929,0.358272271500193,1664,0.641727728499807
"E02000259",1,80,665,949,287,47,13,2042,0.000489715964740451,0.039177277179236,0.3256611165524,0.464740450538688,0.140548481880509,0.0230166503428012,0.00636630754162586,746,0.365328109696376,1296,0.634671890303624
"E02000260",0,270,721,1112,230,30,6,2369,0,0.11397214014352,0.304347826086957,0.469396369776277,0.0970873786407767,0.0126635711270578,0.00253271422541157,991,0.418319966230477,1378,0.581680033769523
"E02000261",28,1305,2064,1586,433,27,18,5461,0.00512726606848563,0.238967222120491,0.377952755905512,0.29042299945065,0.0792895074162241,0.00494414942318257,0.00329609961545504,3397,0.622047244094488,2064,0.377952755905512
"E02000262",1,589,1697,1629,533,72,16,4537,0.000220409962530306,0.12982146793035,0.37403570641393,0.359047828961869,0.117478510028653,0.0158695173021821,0.0035265594004849,2287,0.504077584306811,2250,0.495922415693189
"E02000263",8,1083,775,1520,331,17,5,3739,0.00213960952126237,0.289649638940893,0.207274672372292,0.40652580903985,0.0885263439422305,0.00454667023268254,0.00133725595078898,1866,0.499063920834448,1873,0.500936079165552
"E02000264",7,373,1328,1358,572,94,27,3759,0.00186219739292365,0.0992285182229316,0.353285448257515,0.361266294227188,0.152168129821761,0.0250066507049747,0.00718276137270551,1708,0.454376163873371,2051,0.545623836126629
"E02000265",40,1252,1798,1718,489,47,17,5361,0.00746129453460175,0.233538518933035,0.335385189330349,0.320462600261145,0.0912143256855064,0.00876702107815706,0.00317105017720575,3090,0.576385002797985,2271,0.423614997202015
"E02000266",10,1263,1427,1170,331,24,15,4240,0.00235849056603774,0.297877358490566,0.336556603773585,0.275943396226415,0.0780660377358491,0.00566037735849057,0.0035377358490566,2700,0.636792452830189,1540,0.363207547169811
"E02000267",2,812,907,1222,359,40,20,3362,0.000594883997620464,0.241522903033908,0.26977989292088,0.363474122546104,0.106781677572873,0.0118976799524093,0.00594883997620464,1721,0.511897679952409,1641,0.488102320047591
"E02000268",1,131,1235,1547,480,60,24,3478,0.000287521564117309,0.0376653248993675,0.355089131684876,0.444795859689477,0.138010350776308,0.0172512938470385,0.00690051753881541,1367,0.393041978148361,2111,0.606958021851639
"E02000269",0,71,777,1533,450,74,18,2923,0,0.0242901128977078,0.265822784810127,0.52446117003079,0.153951419774205,0.0253164556962025,0.00615805679096818,848,0.290112897707834,2075,0.709887102292166
"E02000270",2,2508,1144,1021,292,66,11,5044,0.000396510705789056,0.497224425059477,0.22680412371134,0.202418715305313,0.0578905630452022,0.0130848532910389,0.00218080888183981,3654,0.724425059476606,1390,0.275574940523394
"E02000271",1,119,830,1263,526,68,20,2827,0.000353731871241599,0.0420940926777503,0.293597453130527,0.446763353378139,0.186062964273081,0.0240537672444287,0.00707463742483198,950,0.336045277679519,1877,0.663954722320481
"E02000272",0,34,577,867,309,41,12,1840,0,0.0184782608695652,0.313586956521739,0.471195652173913,0.167934782608696,0.0222826086956522,0.00652173913043478,611,0.332065217391304,1229,0.667934782608696
"E02000275",0,528,625,982,258,32,12,2437,0,0.216659827656955,0.256462864177267,0.402954452195322,0.105867870332376,0.0131308986458761,0.00492408699220353,1153,0.473122691834222,1284,0.526877308165777
"E02000276",1,99,1042,1262,306,39,21,2770,0.00036101083032491,0.0357400722021661,0.376173285198556,0.455595667870036,0.110469314079422,0.0140794223826715,0.0075812274368231,1142,0.412274368231047,1628,0.587725631768953
"E02000277",5,99,602,1194,431,62,7,2400,0.00208333333333333,0.04125,0.250833333333333,0.4975,0.179583333333333,0.0258333333333333,0.00291666666666667,706,0.294166666666667,1694,0.705833333333333
"E02000278",4,183,1320,1272,424,59,17,3279,0.00121988411100945,0.0558096980786825,0.40256175663312,0.387923147301006,0.129307715767002,0.0179932906373894,0.00518450747179018,1507,0.459591338822812,1772,0.540408661177188
"E02000279",6,581,2033,1636,440,70,8,4774,0.00125680770842061,0.121700879765396,0.425848345203184,0.34268956849602,0.0921658986175115,0.0146627565982405,0.00167574361122748,2620,0.548806032677,2154,0.451193967323
"E02000280",22,155,654,1294,587,108,22,2842,0.00774102744546094,0.0545390570021112,0.230119634060521,0.455313159746657,0.206544686840253,0.0380014074595355,0.00774102744546094,831,0.292399718508093,2011,0.707600281491907
"E02000281",0,302,1145,1490,372,44,10,3363,0,0.0898007731192388,0.340469818614332,0.443056794528695,0.110615521855486,0.0130835563484984,0.00297353553374963,1447,0.430270591733571,1916,0.569729408266429
"E02000282",1,146,1422,1566,360,45,22,3562,0.000280741156653565,0.0409882088714206,0.39921392476137,0.439640651319483,0.101066816395284,0.0126333520494104,0.00617630544637844,1569,0.440482874789444,1993,0.559517125210556
"E02000283",2,73,591,1500,342,44,20,2572,0.000777604976671851,0.0283825816485226,0.229782270606532,0.583203732503888,0.132970451010886,0.0171073094867807,0.00777604976671851,666,0.258942457231726,1906,0.741057542768274
"E02000284",4,301,1061,1341,490,83,31,3311,0.00120809423135005,0.0909090909090909,0.3204469948656,0.405013591060103,0.147991543340381,0.0250679553005134,0.00936273029296285,1366,0.41256418000604,1945,0.58743581999396
"E02000285",0,20,326,896,401,62,9,1714,0,0.0116686114352392,0.190198366394399,0.522753792298716,0.233955659276546,0.0361726954492415,0.00525087514585764,346,0.201866977829638,1368,0.798133022170362
"E02000286",52,510,1672,1274,427,89,12,4036,0.0128840436075322,0.126362735381566,0.414271555996036,0.315659068384539,0.105797819623389,0.0220515361744301,0.00297324083250743,2234,0.553518334985134,1802,0.446481665014866
"E02000287",27,837,818,878,342,64,7,2973,0.00908173562058527,0.281533804238143,0.27514295324588,0.295324587958291,0.115035317860747,0.0215270770265725,0.00235452404978137,1682,0.565758493104608,1291,0.434241506895392
"E02000288",0,444,1387,1802,546,45,19,4243,0,0.104642941315107,0.326891350459581,0.424699505067169,0.128682535941551,0.0106057035116663,0.00447796370492576,1831,0.431534291774688,2412,0.568465708225312
"E02000289",4,43,294,854,398,62,10,1665,0.0024024024024024,0.0258258258258258,0.176576576576577,0.512912912912913,0.239039039039039,0.0372372372372372,0.00600600600600601,341,0.204804804804805,1324,0.795195195195195
"E02000290",5,782,1020,855,234,26,12,2934,0.00170415814587594,0.266530334014997,0.347648261758691,0.291411042944785,0.0797546012269939,0.00886162235855487,0.00408997955010225,1807,0.615882753919564,1127,0.384117246080436
"E02000291",9,529,1681,1687,575,96,17,4594,0.00195907705703091,0.115150195907706,0.365912059207662,0.367218110579016,0.125163256421419,0.020896821941663,0.00370047888550283,2219,0.483021332172399,2375,0.516978667827601
"E02000292",4,72,617,1713,496,63,22,2987,0.00133913625711416,0.0241044526280549,0.206561767659859,0.57348510210914,0.166052895882156,0.021091396049548,0.00736524941412789,693,0.232005356545028,2294,0.767994643454971
"E02000293",3,121,498,775,389,67,11,1864,0.00160944206008584,0.0649141630901287,0.267167381974249,0.415772532188841,0.208690987124464,0.0359442060085837,0.00590128755364807,622,0.333690987124464,1242,0.666309012875536
"E02000294",0,80,697,1371,363,42,15,2568,0,0.0311526479750779,0.271417445482866,0.533878504672897,0.141355140186916,0.0163551401869159,0.0058411214953271,777,0.302570093457944,1791,0.697429906542056
"E02000295",0,115,1163,1104,391,58,6,2837,0,0.0405357772294677,0.409940077546704,0.38914346140289,0.13782164258019,0.0204441311244272,0.00211491011632006,1278,0.450475854776172,1559,0.549524145223828
"E02000296",11,593,1610,1613,469,60,12,4368,0.00251831501831502,0.135760073260073,0.368589743589744,0.369276556776557,0.107371794871795,0.0137362637362637,0.00274725274725275,2214,0.506868131868132,2154,0.493131868131868
"E02000297",7,214,612,1135,553,69,12,2602,0.0026902382782475,0.0822444273635665,0.235203689469639,0.436202920830131,0.212528823981553,0.0265180630284397,0.00461183704842429,833,0.320138355111453,1769,0.679861644888547
"E02000298",2,38,423,1141,530,77,19,2230,0.000896860986547085,0.0170403587443946,0.189686098654709,0.511659192825112,0.237668161434978,0.0345291479820628,0.00852017937219731,463,0.20762331838565,1767,0.79237668161435
"E02000299",0,112,879,1835,471,55,29,3381,0,0.0331262939958592,0.259982253771074,0.542738834664301,0.139307897071872,0.0162673765158237,0.00857734398107069,991,0.293108547766933,2390,0.706891452233067
"E02000300",0,61,671,1627,432,45,10,2846,0,0.0214335910049192,0.235769501054111,0.571679550245959,0.151791988756149,0.0158116654954322,0.00351370344342937,732,0.25720309205903,2114,0.74279690794097
"E02000301",1,98,1643,1641,412,30,14,3839,0.00026048450117218,0.0255274811148737,0.427976035425892,0.427455066423548,0.107319614482938,0.00781453503516541,0.00364678301641052,1742,0.453764001041938,2097,0.546235998958062
"E02000302",2,161,695,1099,382,50,10,2399,0.000833680700291788,0.0671112963734889,0.289704043351396,0.458107544810338,0.159233013755732,0.0208420175072947,0.00416840350145894,858,0.357649020425177,1541,0.642350979574823
"E02000303",2,122,914,1404,463,40,14,2959,0.000675904021628929,0.0412301453193646,0.30888813788442,0.474484623183508,0.156471781007097,0.0135180804325786,0.0047313281514025,1038,0.350794187225414,1921,0.649205812774586
"E02000304",0,71,499,882,481,108,14,2055,0,0.0345498783454988,0.242822384428224,0.429197080291971,0.234063260340633,0.0525547445255474,0.00681265206812652,570,0.277372262773723,1485,0.722627737226277
"E02000305",1,203,886,1536,551,81,28,3286,0.000304321363359708,0.0617772367620207,0.269628727936701,0.467437614120511,0.167681071211199,0.0246500304321363,0.00852099817407182,1090,0.331710286062082,2196,0.668289713937918
"E02000306",0,251,1581,1251,277,27,8,3395,0,0.0739322533136966,0.465684830633284,0.368483063328424,0.0815905743740795,0.00795287187039764,0.00235640648011782,1832,0.539617083946981,1563,0.460382916053019
"E02000307",3,16,550,1617,375,51,22,2634,0.00113895216400911,0.00607441154138193,0.208807896735004,0.613895216400911,0.142369020501139,0.0193621867881549,0.00835231586940015,569,0.216021260440395,2065,0.783978739559605
"E02000308",5,573,873,1129,355,63,13,3011,0.00166057788110262,0.190302225174361,0.289936898040518,0.374958485552972,0.117901029558286,0.0209232813018931,0.00431750249086682,1451,0.481899701095981,1560,0.518100298904019
"E02000309",0,594,1087,2018,579,56,26,4360,0,0.136238532110092,0.249311926605505,0.462844036697248,0.132798165137615,0.0128440366972477,0.00596330275229358,1681,0.385550458715596,2679,0.614449541284404
"E02000311",4,175,1033,1453,387,53,11,3116,0.00128369704749679,0.0561617458279846,0.331514762516046,0.466302952503209,0.124197689345314,0.0170089858793325,0.00353016688061617,1212,0.388960205391528,1904,0.611039794608472
"E02000312",1,368,1295,2049,720,56,26,4515,0.000221483942414175,0.0815060908084164,0.286821705426357,0.453820598006645,0.159468438538206,0.0124031007751938,0.00575858250276855,1664,0.368549280177187,2851,0.631450719822813
"E02000313",0,254,1536,788,72,4,0,2654,0,0.0957045968349661,0.578749058025622,0.296910324039186,0.027128862094951,0.00150715900527506,0,1790,0.674453654860588,864,0.325546345139412
"E02000314",1,679,2836,833,152,17,1,4519,0.000221287895552113,0.150254481079885,0.627572471785793,0.18433281699491,0.0336357601239212,0.00376189422438593,0.000221287895552113,3516,0.77804824076123,1003,0.22195175923877
"E02000315",5,431,1438,1041,174,15,8,3112,0.00160668380462725,0.138496143958869,0.462082262210797,0.334511568123393,0.0559125964010283,0.00482005141388175,0.0025706940874036,1874,0.602185089974293,1238,0.397814910025707
"E02000317",29,248,1182,785,155,12,5,2416,0.0120033112582781,0.102649006622517,0.489238410596026,0.324917218543046,0.0641556291390728,0.00496688741721854,0.00206953642384106,1459,0.603890728476821,957,0.396109271523179
"E02000318",0,81,893,1623,396,48,21,3062,0,0.0264532984977139,0.291639451338994,0.53004572175049,0.129327237099935,0.015676028739386,0.00685826257348138,974,0.318092749836708,2088,0.681907250163292
"E02000319",12,769,1483,1374,297,24,15,3974,0.00301962757926522,0.19350780070458,0.373175641670861,0.345747357825868,0.0747357825868143,0.00603925515853045,0.00377453447408153,2264,0.569703069954706,1710,0.430296930045294
"E02000320",0,71,686,994,264,25,7,2047,0,0.0346849047386419,0.335124572545188,0.485588666340987,0.128969223253542,0.0122129946262824,0.00341963849535906,757,0.36980947728383,1290,0.63019052271617
"E02000321",0,196,1151,863,182,17,6,2415,0,0.0811594202898551,0.476604554865424,0.357349896480331,0.0753623188405797,0.00703933747412008,0.00248447204968944,1347,0.557763975155279,1068,0.442236024844721
"E02000323",2,873,2049,1502,299,26,18,4769,0.000419375131054728,0.183057244705389,0.429649821765569,0.314950723422101,0.0626965820926819,0.00545187670371147,0.00377437617949256,2924,0.613126441602013,1845,0.386873558397987
"E02000324",24,490,811,907,277,34,6,2549,0.00941545704197725,0.192232247940369,0.318163985876814,0.355825814044723,0.108670066692821,0.0133385641428011,0.00235386426049431,1325,0.51981169085916,1224,0.48018830914084
"E02000326",0,341,850,1259,331,31,8,2820,0,0.120921985815603,0.301418439716312,0.44645390070922,0.117375886524823,0.0109929078014184,0.00283687943262411,1191,0.422340425531915,1629,0.577659574468085
"E02000327",2,638,1199,804,117,9,2,2771,0.000721761097076868,0.230241789967521,0.432695777697582,0.290147961024901,0.0422230241789968,0.0032479249368459,0.000721761097076868,1839,0.66365932876218,932,0.33634067123782
"E02000328",170,301,816,1125,428,56,7,2903,0.0585601102307957,0.103685842232174,0.28108852910782,0.387530141233207,0.147433689286945,0.0192903892524974,0.00241129865656218,1287,0.443334481570789,1616,0.556665518429211
"E02000329",0,11,443,1020,288,31,9,1802,0,0.00610432852386238,0.245837957824639,0.566037735849057,0.159822419533851,0.0172031076581576,0.00499445061043285,454,0.251942286348502,1348,0.748057713651498
"E02000331",0,258,1280,1023,241,29,5,2836,0,0.0909732016925247,0.451339915373766,0.360719322990127,0.0849788434414669,0.0102256699576869,0.00176304654442877,1538,0.542313117066291,1298,0.457686882933709
"E02000332",7,47,595,1283,418,62,8,2420,0.00289256198347107,0.0194214876033058,0.245867768595041,0.530165289256198,0.172727272727273,0.0256198347107438,0.00330578512396694,649,0.268181818181818,1771,0.731818181818182
"E02000333",6,59,813,1446,471,78,16,2889,0.00207684319833853,0.0204222914503288,0.28141225337487,0.500519210799585,0.163032191069574,0.0269989615784008,0.00553824852890273,878,0.303911388023538,2011,0.696088611976462
"E02000334",20,46,538,995,311,38,4,1952,0.0102459016393443,0.0235655737704918,0.275614754098361,0.509733606557377,0.159323770491803,0.0194672131147541,0.00204918032786885,604,0.309426229508197,1348,0.690573770491803
"E02000335",0,16,286,895,437,50,12,1696,0,0.00943396226415094,0.168632075471698,0.527712264150943,0.257665094339623,0.0294811320754717,0.00707547169811321,302,0.178066037735849,1394,0.821933962264151
"E02000337",4,146,633,1030,263,26,10,2112,0.00189393939393939,0.0691287878787879,0.299715909090909,0.487689393939394,0.124526515151515,0.0123106060606061,0.00473484848484848,783,0.370738636363636,1329,0.629261363636364
"E02000339",5,82,470,833,391,74,19,1874,0.00266808964781217,0.0437566702241195,0.250800426894344,0.444503735325507,0.208644610458911,0.0394877267876201,0.0101387406616862,557,0.297225186766275,1317,0.702774813233724
"E02000340",2,277,833,1026,441,94,7,2680,0.000746268656716418,0.103358208955224,0.310820895522388,0.382835820895522,0.16455223880597,0.0350746268656716,0.00261194029850746,1112,0.414925373134328,1568,0.585074626865672
"E02000341",0,58,1147,840,167,26,4,2242,0,0.0258697591436218,0.511596788581623,0.374665477252453,0.0744870651204282,0.0115967885816235,0.00178412132024978,1205,0.537466547725245,1037,0.462533452274755
"E02000342",57,217,713,760,246,27,6,2026,0.0281342546890424,0.1071076011846,0.351924975320829,0.375123395853899,0.12142152023692,0.0133267522211254,0.00296150049358342,987,0.487166831194472,1039,0.512833168805528
"E02000343",9,71,736,870,268,39,5,1998,0.0045045045045045,0.0355355355355355,0.368368368368368,0.435435435435435,0.134134134134134,0.0195195195195195,0.0025025025025025,816,0.408408408408408,1182,0.591591591591592
"E02000344",0,78,368,872,422,62,9,1811,0,0.0430701270016565,0.203202650469354,0.481501932633904,0.23302043070127,0.0342352291551629,0.00496963003865268,446,0.246272777471011,1365,0.753727222528989
"E02000345",1,308,1051,1014,278,31,11,2694,0.000371195248700817,0.114328136599852,0.390126206384558,0.376391982182628,0.103192279138827,0.0115070527097253,0.00408314773570898,1360,0.504825538233111,1334,0.495174461766889
"E02000346",4,2658,1731,582,119,11,3,5108,0.000783085356303837,0.5203602192639,0.338880187940486,0.113938919342208,0.0232967893500392,0.00215348472983555,0.000587314017227878,4393,0.860023492560689,715,0.139976507439311
"E02000347",3,204,1022,910,327,119,20,2605,0.00115163147792706,0.0783109404990403,0.39232245681382,0.349328214971209,0.12552783109405,0.0456813819577735,0.00767754318618042,1229,0.471785028790787,1376,0.528214971209213
"E02000348",1,500,1134,935,267,24,4,2865,0.000349040139616056,0.174520069808028,0.395811518324607,0.326352530541012,0.0931937172774869,0.00837696335078534,0.00139616055846422,1635,0.570680628272251,1230,0.429319371727749
"E02000350",1,252,1602,1512,396,34,16,3813,0.000262260687123,0.0660896931549961,0.420141620771046,0.396538158929976,0.103855232100708,0.00891686336218201,0.004196170993968,1855,0.486493574613166,1958,0.513506425386834
"E02000351",14,620,1931,1383,332,55,16,4351,0.00321765111468628,0.142495977936107,0.443806021604229,0.317857963686509,0.0763042978625603,0.0126407722362675,0.00367731555964146,2565,0.589519650655022,1786,0.410480349344978
"E02000352",13,133,1237,827,200,36,8,2454,0.00529747351263244,0.0541972290138549,0.504074979625102,0.337000814995925,0.0814995925020375,0.0146699266503667,0.0032599837000815,1383,0.563569682151589,1071,0.436430317848411
"E02000353",0,160,1240,1288,419,34,13,3154,0,0.0507292327203551,0.393151553582752,0.408370323398859,0.13284717818643,0.0107799619530755,0.00412175015852885,1400,0.443880786303107,1754,0.556119213696893
"E02000354",0,410,2025,1242,266,39,69,4051,0,0.101209577882004,0.49987657368551,0.306590965193779,0.0656627993088126,0.00962725253023945,0.0170328313996544,2435,0.601086151567514,1616,0.398913848432486
"E02000355",0,144,1131,1397,381,39,24,3116,0,0.0462130937098845,0.362965340179718,0.448331193838254,0.122272143774069,0.0125160462130937,0.00770218228498074,1275,0.409178433889602,1841,0.590821566110398
"E02000356",2,167,1286,1263,274,24,11,3027,0.000660720185001652,0.0551701354476379,0.424843078956062,0.417244796828543,0.0905186653452263,0.00792864222001982,0.00363396101750909,1455,0.480673934588702,1572,0.519326065411298
"E02000357",0,325,1301,434,80,11,3,2154,0,0.150882079851439,0.603992571959146,0.201485608170845,0.0371402042711235,0.00510677808727948,0.00139275766016713,1626,0.754874651810585,528,0.245125348189415
"E02000358",1,528,2204,1796,433,51,9,5022,0.000199123855037834,0.105137395459976,0.438868976503385,0.357626443647949,0.0862206292313819,0.0101553166069295,0.0017921146953405,2733,0.544205495818399,2289,0.455794504181601
"E02000359",3,109,837,1043,261,18,8,2279,0.00131636682755595,0.0478279947345327,0.367266344888109,0.45765686704695,0.114523913997367,0.00789820096533567,0.00351031154014919,949,0.416410706450197,1330,0.583589293549802
"E02000360",10,684,2350,1349,276,25,9,4703,0.00212630236019562,0.14543908143738,0.499681054645971,0.286838188390389,0.0586859451413991,0.00531575590048905,0.00191367212417606,3044,0.647246438443547,1659,0.352753561556453
"E02000361",62,382,1620,1253,334,94,30,3775,0.0164238410596027,0.101192052980132,0.429139072847682,0.331920529801325,0.088476821192053,0.0249006622516556,0.00794701986754967,2064,0.546754966887417,1711,0.453245033112583
"E02000362",0,842,1376,720,146,14,12,3110,0,0.270739549839228,0.442443729903537,0.231511254019293,0.0469453376205788,0.0045016077170418,0.00385852090032154,2218,0.713183279742765,892,0.286816720257235
"E02000363",0,828,1709,898,193,103,82,3813,0,0.217151848937844,0.448203514293207,0.235510097036454,0.050616312614739,0.027012850773669,0.021505376344086,2537,0.665355363231052,1276,0.334644636768948
"E02000364",2,729,1476,1398,381,59,21,4066,0.000491883915395967,0.17929168716183,0.363010329562223,0.343826856861781,0.0937038858829316,0.014510575504181,0.00516478111165765,2207,0.542793900639449,1859,0.457206099360551
"E02000366",1,115,1296,1045,303,27,10,2797,0.000357525920629246,0.0411154808723632,0.463353593135502,0.373614587057562,0.108330353950661,0.00965319985698963,0.00357525920629246,1412,0.504826599928495,1385,0.495173400071505
"E02000367",23,1142,2096,1262,379,50,20,4972,0.00462590506838294,0.229686242960579,0.421560740144811,0.253821399839099,0.0762268704746581,0.0100563153660499,0.00402252614641995,3261,0.655872888173773,1711,0.344127111826227
"E02000368",1,725,1433,1030,175,52,22,3438,0.00029086678301338,0.2108784176847,0.416812100058173,0.299592786503781,0.0509016870273415,0.0151250727166958,0.00639906922629436,2159,0.627981384525887,1279,0.372018615474113
"E02000369",18,2104,2844,1057,225,15,3,6266,0.002872646026173,0.335780402170444,0.453878072135334,0.168688158314714,0.0359080753271625,0.0023938716884775,0.0004787743376955,4966,0.79253112033195,1300,0.20746887966805
"E02000370",0,1383,1692,810,109,13,4,4011,0,0.344801795063575,0.421839940164548,0.201944652206432,0.0271752680129643,0.00324108701072052,0.00099725754176016,3075,0.766641735228123,936,0.233358264771877
"E02000372",1,3196,1432,1638,422,35,9,6733,0.000148522204069508,0.474676964206149,0.212683796227536,0.243279370265855,0.0626763701173325,0.00519827714243279,0.00133669983662558,4629,0.687509282637754,2104,0.312490717362246
"E02000373",1,244,1338,996,173,7,3,2762,0.000362056480811006,0.0883417813178856,0.484431571325127,0.360608254887762,0.0626357711803041,0.00253439536567705,0.00108616944243302,1583,0.573135409123823,1179,0.426864590876177
"E02000374",1,107,789,1217,356,20,15,2505,0.000399201596806387,0.0427145708582834,0.31497005988024,0.485828343313373,0.142115768463074,0.00798403193612774,0.00598802395209581,897,0.358083832335329,1608,0.641916167664671
"E02000375",0,778,1608,1153,220,42,4,3805,0,0.204467805519054,0.422601839684626,0.303022339027595,0.0578186596583443,0.0110381077529566,0.00105124835742444,2386,0.627069645203679,1419,0.372930354796321
"E02000376",1,208,1548,1383,303,42,17,3502,0.000285551113649343,0.0593946316390634,0.442033123929183,0.394917190177042,0.086521987435751,0.0119931467732724,0.00485436893203883,1757,0.501713306681896,1745,0.498286693318104
"E02000377",0,192,1499,1549,355,41,16,3652,0,0.0525739320920044,0.410460021905805,0.424151150054765,0.0972070098576123,0.0112267250821468,0.00438116100766703,1691,0.463033953997809,1961,0.536966046002191
"E02000378",1,116,1800,1445,313,34,8,3717,0.000269034167339252,0.0312079634113532,0.484261501210654,0.388754371805219,0.0842076943771859,0.00914716168953457,0.00215227333871402,1917,0.515738498789346,1800,0.484261501210654
"E02000379",4,717,1104,1025,320,50,16,3236,0.00123609394313968,0.221569839307787,0.341161928306551,0.316749072929543,0.0988875154511743,0.015451174289246,0.00494437577255871,1825,0.563967861557478,1411,0.436032138442522
"E02000380",0,96,986,1187,284,32,18,2603,0,0.0368805224740684,0.378793699577411,0.456012293507491,0.109104878985786,0.0122935074913561,0.00691509796388782,1082,0.415674222051479,1521,0.584325777948521
"E02000381",1,123,2135,1553,424,70,16,4322,0.0002313743637205,0.0284590467376215,0.493984266543267,0.359324386857936,0.0981027302174919,0.016196205460435,0.003701989819528,2259,0.522674687644609,2063,0.477325312355391
"E02000382",0,456,1246,1027,392,59,16,3196,0,0.142678347934919,0.389862327909887,0.321339173967459,0.122653316645807,0.0184605757196496,0.00500625782227785,1702,0.532540675844806,1494,0.467459324155194
"E02000383",0,386,2091,1735,425,50,12,4699,0,0.0821451372632475,0.444988295381996,0.369227495211747,0.0904447754841456,0.0106405618216642,0.0025537348371994,2477,0.527133432645244,2222,0.472866567354756
"E02000384",16,826,1753,1297,273,29,14,4208,0.00380228136882129,0.196292775665399,0.416587452471483,0.308222433460076,0.0648764258555133,0.00689163498098859,0.00332699619771863,2595,0.616682509505703,1613,0.383317490494297
"E02000385",0,34,1403,1525,342,50,16,3370,0,0.0100890207715134,0.416320474777448,0.452522255192878,0.101483679525223,0.0148367952522255,0.00474777448071217,1437,0.426409495548961,1933,0.573590504451039
"E02000386",0,168,1943,1480,264,24,8,3887,0,0.043220993053769,0.499871366092102,0.380756367378441,0.0679187033702084,0.00617442757910985,0.00205814252636995,2111,0.543092359145871,1776,0.456907640854129
"E02000387",0,98,1102,1080,193,18,12,2503,0,0.0391530163803436,0.440271673991211,0.431482221334399,0.0771074710347583,0.00719137035557331,0.00479424690371554,1200,0.479424690371554,1303,0.520575309628446
"E02000388",1,891,1931,1669,438,63,22,5015,0.000199401794616152,0.177666999002991,0.385044865403789,0.332801595214357,0.0873379860418744,0.0125623130608175,0.00438683948155533,2823,0.562911266201396,2192,0.437088733798604
"E02000389",1,754,1309,1486,386,45,20,4001,0.000249937515621095,0.188452886778305,0.327168207948013,0.371407148212947,0.0964758810297426,0.0112471882029493,0.00499875031242189,2064,0.51587103224194,1937,0.484128967758061
"E02000390",0,82,1157,1488,430,32,10,3199,0,0.0256330103157237,0.361675523601125,0.465145357924351,0.134417005314161,0.0100031259768678,0.00312597686777118,1239,0.387308533916849,1960,0.612691466083151
"E02000391",0,181,1529,1463,454,65,20,3712,0,0.048760775862069,0.411907327586207,0.394127155172414,0.122306034482759,0.017510775862069,0.00538793103448276,1710,0.460668103448276,2002,0.539331896551724
"E02000392",4,232,1757,1903,576,63,34,4569,0.000875465090829503,0.0507769752681112,0.384548041146859,0.416502516962136,0.126066973079448,0.0137885751805647,0.00744145327205078,1993,0.4362004815058,2576,0.5637995184942
"E02000393",0,53,965,1488,386,26,9,2927,0,0.0181072770755039,0.329689101469081,0.508370345063205,0.131875640587632,0.00888281516911514,0.00307482063546293,1018,0.347796378544585,1909,0.652203621455415
"E02000394",3,3244,2314,1172,224,13,14,6984,0.000429553264604811,0.464490263459336,0.331328751431844,0.167812142038946,0.0320733104238259,0.00186139747995418,0.00200458190148912,5561,0.796248568155785,1423,0.203751431844215
"E02000395",0,126,1156,1227,415,49,7,2980,0,0.0422818791946309,0.387919463087248,0.411744966442953,0.139261744966443,0.0164429530201342,0.0023489932885906,1282,0.430201342281879,1698,0.569798657718121
"E02000396",0,263,1268,1050,309,37,12,2939,0,0.089486219802654,0.431439265056142,0.357264375637972,0.10513780197346,0.0125893160939095,0.00408302143586254,1531,0.520925484858796,1408,0.479074515141204
"E02000397",0,187,1267,1625,517,61,17,3674,0,0.0508982035928144,0.344855743059336,0.442297223734349,0.140718562874251,0.0166031573217202,0.00462710941752858,1454,0.39575394665215,2220,0.60424605334785
"E02000398",1,107,1447,1323,329,38,11,3256,0.000307125307125307,0.0328624078624079,0.444410319410319,0.406326781326781,0.101044226044226,0.0116707616707617,0.00337837837837838,1555,0.477579852579853,1701,0.522420147420147
"E02000400",2,315,1039,1075,340,33,10,2814,0.000710732054015636,0.111940298507463,0.369225302061123,0.382018479033404,0.120824449182658,0.011727078891258,0.00355366027007818,1356,0.481876332622601,1458,0.518123667377399
"E02000401",0,176,785,1120,348,32,12,2473,0,0.071168621107966,0.317428224828144,0.452891225232511,0.140719773554387,0.0129397492923575,0.00485240598463405,961,0.38859684593611,1512,0.61140315406389
"E02000402",3,53,816,1239,301,35,4,2451,0.00122399020807834,0.0216238270093839,0.332925336597307,0.505507955936353,0.12280701754386,0.0142798857609139,0.00163198694410445,872,0.355773153814769,1579,0.644226846185231
"E02000403",0,137,982,1512,446,46,20,3143,0,0.0435889277760102,0.312440343620745,0.481069042316258,0.141902640789055,0.0146356983773465,0.00636334712058543,1119,0.356029271396755,2024,0.643970728603245
"E02000404",1,145,906,979,263,24,4,2322,0.000430663221360896,0.0624461670973299,0.390180878552972,0.421619293712317,0.113264427217916,0.0103359173126615,0.00172265288544358,1052,0.453057708871662,1270,0.546942291128338
"E02000405",2,31,509,1004,409,54,17,2026,0.000987166831194472,0.0153010858835143,0.251233958538993,0.495557749259625,0.20187561697927,0.0266535044422507,0.00839091806515301,542,0.267522211253702,1484,0.732477788746298
"E02000406",0,108,586,1471,295,27,10,2497,0,0.0432519022827393,0.23468161794153,0.589106928313977,0.118141770124149,0.0108129755706848,0.0040048057669203,694,0.277933520224269,1803,0.722066479775731
"E02000407",0,116,1069,1517,362,45,16,3125,0,0.03712,0.34208,0.48544,0.11584,0.0144,0.00512,1185,0.3792,1940,0.6208
"E02000408",0,519,1179,1017,279,27,18,3039,0,0.170779861796644,0.387956564659427,0.334649555774926,0.0918065153010859,0.00888450148075025,0.00592300098716683,1698,0.558736426456071,1341,0.441263573543929
"E02000409",0,197,1171,744,156,14,3,2285,0,0.0862144420131291,0.512472647702407,0.325601750547046,0.0682713347921225,0.00612691466083151,0.00131291028446389,1368,0.598687089715536,917,0.401312910284464
"E02000410",0,103,734,1286,505,83,16,2727,0,0.0377704437110378,0.269160249358269,0.471580491382472,0.185185185185185,0.0304363769710304,0.00586725339200587,837,0.306930693069307,1890,0.693069306930693
"E02000411",1,3346,1404,1254,264,20,11,6300,0.000158730158730159,0.531111111111111,0.222857142857143,0.199047619047619,0.0419047619047619,0.00317460317460317,0.00174603174603175,4751,0.754126984126984,1549,0.245873015873016
"E02000412",0,1431,1007,1283,349,17,13,4100,0,0.349024390243902,0.245609756097561,0.312926829268293,0.0851219512195122,0.00414634146341463,0.00317073170731707,2438,0.594634146341463,1662,0.405365853658537
"E02000413",2,303,883,1045,491,77,11,2812,0.000711237553342817,0.107752489331437,0.314011379800853,0.371621621621622,0.174608819345661,0.0273826458036984,0.00391180654338549,1188,0.422475106685633,1624,0.577524893314367
"E02000414",0,30,631,1572,336,27,15,2611,0,0.0114898506319418,0.241669858291842,0.602068173113749,0.128686327077748,0.0103408655687476,0.00574492531597089,661,0.253159708923784,1950,0.746840291076216
"E02000415",1,171,931,1270,331,30,11,2745,0.000364298724954463,0.0622950819672131,0.339162112932605,0.462659380692168,0.120582877959927,0.0109289617486339,0.00400728597449909,1103,0.401821493624772,1642,0.598178506375228
"E02000416",0,845,1571,1212,344,40,12,4024,0,0.209990059642147,0.390407554671968,0.301192842942346,0.0854870775347912,0.0099403578528827,0.00298210735586481,2416,0.600397614314115,1608,0.399602385685885
"E02000417",8,257,819,1097,421,77,18,2697,0.00296625880608083,0.0952910641453467,0.303670745272525,0.406748238783834,0.156099369670004,0.028550241008528,0.00667408231368187,1084,0.401928068223953,1613,0.598071931776047
"E02000418",1,93,452,897,421,62,10,1936,0.000516528925619835,0.0480371900826446,0.233471074380165,0.463326446280992,0.21745867768595,0.0320247933884297,0.00516528925619835,546,0.28202479338843,1390,0.71797520661157
"E02000419",2,422,1306,1975,513,49,17,4284,0.000466853408029879,0.0985060690943044,0.304855275443511,0.461017740429505,0.119747899159664,0.011437908496732,0.00396825396825397,1730,0.403828197945845,2554,0.596171802054155
"E02000420",14,551,1158,1397,391,39,14,3564,0.00392817059483726,0.154601571268238,0.324915824915825,0.391975308641975,0.109708193041526,0.0109427609427609,0.00392817059483726,1723,0.4834455667789,1841,0.5165544332211
"E02000421",5,636,1363,1142,228,28,21,3423,0.00146070698217937,0.185801928133216,0.398188723342098,0.333625474729769,0.0666082383873795,0.0081799591002045,0.00613496932515337,2004,0.585451358457493,1419,0.414548641542507
"E02000422",1,146,1146,1249,279,25,12,2858,0.000349895031490553,0.0510846745976207,0.400979706088174,0.4370188943317,0.0976207137858642,0.00874737578726382,0.00419874037788663,1293,0.452414275717285,1565,0.547585724282715
"E02000423",3,68,806,1308,326,28,10,2549,0.00117693213024716,0.0266771282856022,0.316202432326402,0.51314240878776,0.127893291486858,0.0109846998823068,0.00392310710082385,877,0.344056492742252,1672,0.655943507257748
"E02000424",0,128,1022,1453,422,44,15,3084,0,0.0415045395590143,0.331387808041505,0.471141374837873,0.136835278858625,0.0142671854734112,0.00486381322957198,1150,0.372892347600519,1934,0.627107652399481
"E02000425",0,76,822,888,255,35,12,2088,0,0.0363984674329502,0.39367816091954,0.425287356321839,0.122126436781609,0.0167624521072797,0.00574712643678161,898,0.43007662835249,1190,0.56992337164751
"E02000426",2,216,829,1132,414,78,11,2682,0.000745712155108128,0.0805369127516778,0.309097688292319,0.422073079791201,0.154362416107383,0.029082774049217,0.00410141685309471,1047,0.390380313199105,1635,0.609619686800895
"E02000427",2,55,1090,1469,370,32,9,3027,0.000660720185001652,0.0181698050875454,0.3600925008259,0.485298975883713,0.122233234225306,0.0105715229600264,0.00297324083250743,1147,0.378923026098447,1880,0.621076973901553
"E02000428",28,227,1406,1205,270,22,4,3162,0.00885515496521189,0.0717900063251107,0.444655281467426,0.381087919038583,0.0853889943074004,0.00695762175838077,0.00126502213788741,1661,0.525300442757748,1501,0.474699557242252
"E02000429",0,200,1287,1257,495,72,19,3330,0,0.0600600600600601,0.386486486486486,0.377477477477477,0.148648648648649,0.0216216216216216,0.00570570570570571,1487,0.446546546546547,1843,0.553453453453453
"E02000430",14,342,1153,1574,555,77,27,3742,0.00374131480491716,0.0913949759486905,0.308123997862106,0.4206306787814,0.148316408337787,0.0205772314270444,0.00721539283805452,1509,0.403260288615714,2233,0.596739711384286
"E02000431",0,96,1142,1539,493,72,15,3357,0,0.0285969615728329,0.340184688710158,0.458445040214477,0.146857313077152,0.0214477211796247,0.00446827524575514,1238,0.368781650282991,2119,0.631218349717009
"E02000432",0,51,1135,1290,300,40,9,2825,0,0.0180530973451327,0.401769911504425,0.456637168141593,0.106194690265487,0.0141592920353982,0.0031858407079646,1186,0.419823008849557,1639,0.580176991150443
"E02000433",35,444,1518,1045,372,60,15,3489,0.0100315276583548,0.12725709372313,0.435081685296647,0.29951275437088,0.106620808254514,0.0171969045571797,0.00429922613929493,1997,0.572370306678131,1492,0.427629693321869
"E02000434",2,901,1021,1127,349,62,12,3474,0.000575705238917674,0.259355210132412,0.293897524467473,0.324409902130109,0.100460564191134,0.0178468624064479,0.00345423143350604,1924,0.553828439838802,1550,0.446171560161197
"E02000435",1,218,908,898,274,52,3,2354,0.000424808836023789,0.0926083262531861,0.385726423109601,0.381478334749363,0.116397621070518,0.022090059473237,0.00127442650807137,1127,0.478759558198811,1227,0.521240441801189
"E02000436",0,67,334,621,316,65,14,1417,0,0.0472829922371207,0.235709244883557,0.438249823570925,0.223006351446718,0.0458715596330275,0.00988002822865208,401,0.282992237120678,1016,0.717007762879322
"E02000437",0,76,746,1234,404,56,9,2525,0,0.0300990099009901,0.295445544554455,0.488712871287129,0.16,0.0221782178217822,0.00356435643564356,822,0.325544554455446,1703,0.674455445544554
"E02000438",1,105,927,1050,440,61,7,2591,0.000385951370127364,0.0405248938633732,0.357776920108066,0.405248938633732,0.16981860285604,0.0235430335777692,0.00270165959089155,1033,0.398687765341567,1558,0.601312234658433
"E02000439",23,283,805,1181,340,51,14,2697,0.00852799406748239,0.104931405265109,0.298479792361884,0.437893956247683,0.126065999258435,0.0189098998887653,0.00519095291064145,1111,0.411939191694475,1586,0.588060808305525
"E02000440",0,51,399,1131,438,64,14,2097,0,0.0243204577968526,0.190271816881259,0.53934191702432,0.208869814020029,0.0305197901764425,0.00667620410109681,450,0.214592274678112,1647,0.785407725321888
"E02000441",9,257,806,904,359,77,8,2420,0.00371900826446281,0.106198347107438,0.333057851239669,0.373553719008264,0.148347107438017,0.0318181818181818,0.00330578512396694,1072,0.44297520661157,1348,0.55702479338843
"E02000442",0,40,423,1135,301,36,10,1945,0,0.0205655526992288,0.217480719794344,0.583547557840617,0.154755784061697,0.0185089974293059,0.0051413881748072,463,0.238046272493573,1482,0.761953727506427
"E02000443",0,366,1123,1515,402,50,18,3474,0,0.105354058721934,0.323258491652274,0.436096718480138,0.115716753022453,0.0143926309729419,0.00518134715025907,1489,0.428612550374208,1985,0.571387449625792
"E02000444",2,43,415,1085,314,42,9,1910,0.00104712041884817,0.0225130890052356,0.217277486910995,0.568062827225131,0.164397905759162,0.0219895287958115,0.00471204188481675,460,0.240837696335079,1450,0.759162303664921
"E02000445",4,565,1337,1587,390,58,20,3961,0.00100984599848523,0.142640747286039,0.337541024993688,0.400656399899015,0.09845998485231,0.0146427669780358,0.00504922999242615,1906,0.481191618278213,2055,0.518808381721788
"E02000447",31,333,436,819,382,59,5,2065,0.0150121065375303,0.161259079903148,0.211138014527845,0.396610169491525,0.18498789346247,0.0285714285714286,0.00242130750605327,800,0.387409200968523,1265,0.612590799031477
"E02000448",2,192,622,980,460,107,7,2370,0.000843881856540084,0.0810126582278481,0.262447257383966,0.413502109704641,0.194092827004219,0.0451476793248945,0.0029535864978903,816,0.344303797468354,1554,0.655696202531646
"E02000449",0,41,565,954,222,23,11,1816,0,0.0225770925110132,0.311123348017621,0.525330396475771,0.122246696035242,0.0126651982378855,0.00605726872246696,606,0.333700440528634,1210,0.666299559471366
"E02000451",1,30,318,828,407,63,7,1654,0.00060459492140266,0.0181378476420798,0.192261185006046,0.500604594921403,0.246070133010883,0.0380894800483676,0.00423216444981862,349,0.211003627569528,1305,0.788996372430472
"E02000452",42,1497,1249,1505,418,61,16,4788,0.0087719298245614,0.31265664160401,0.260860484544695,0.314327485380117,0.0873015873015873,0.0127401837928154,0.00334168755221387,2788,0.582289055973267,2000,0.417710944026733
"E02000453",6,431,834,1055,375,65,19,2785,0.00215439856373429,0.15475763016158,0.299461400359066,0.378815080789946,0.134649910233393,0.0233393177737881,0.00682226211849192,1271,0.456373429084381,1514,0.543626570915619
"E02000454",0,31,418,802,417,72,5,1745,0,0.0177650429799427,0.239541547277937,0.459598853868195,0.238968481375358,0.0412607449856734,0.00286532951289398,449,0.25730659025788,1296,0.74269340974212
"E02000455",0,1932,2233,1324,368,53,13,5923,0,0.326186054364342,0.377004896167483,0.223535370589228,0.0621306770217795,0.00894816815802803,0.00219483369913895,4165,0.703190950531825,1758,0.296809049468175
"E02000456",2,52,605,1013,417,50,12,2151,0.000929800092980009,0.0241748024174802,0.281264528126453,0.470943747094375,0.193863319386332,0.0232450023245002,0.00557880055788006,659,0.306369130636913,1492,0.693630869363087
"E02000457",1,298,572,943,399,45,13,2271,0.000440334654337296,0.131219726992514,0.251871422280934,0.41523557904007,0.175693527080581,0.0198150594451783,0.00572435050638485,871,0.383531483927785,1400,0.616468516072215
"E02000459",1,726,1213,1146,314,48,15,3463,0.000288766965059197,0.209644816632977,0.350274328616806,0.33092694195784,0.0906728270285879,0.0138608143228415,0.00433150447588796,1940,0.560207912214843,1523,0.439792087785157
"E02000460",0,683,789,740,236,16,5,2469,0,0.276630214661806,0.319562575941677,0.299716484406642,0.0955852571891454,0.00648035641960308,0.00202511138112596,1472,0.596192790603483,997,0.403807209396517
"E02000461",3,234,989,1004,356,57,9,2652,0.00113122171945701,0.0882352941176471,0.372926093514329,0.378582202111614,0.134238310708899,0.0214932126696833,0.00339366515837104,1226,0.462292609351433,1426,0.537707390648567
"E02000462",0,128,549,981,276,38,15,1987,0,0.0644187216909914,0.276295923502768,0.493709109209864,0.1389028686462,0.0191243080020131,0.00754906894816306,677,0.340714645193759,1310,0.659285354806241
"E02000463",1,47,581,1085,316,53,5,2088,0.000478927203065134,0.0225095785440613,0.278256704980843,0.51963601532567,0.151340996168582,0.0253831417624521,0.00239463601532567,629,0.301245210727969,1459,0.698754789272031
"E02000464",7,398,783,905,172,22,12,2299,0.00304480208786429,0.173118747281427,0.340582862113963,0.393649412788169,0.0748151370160939,0.00956937799043062,0.00521966072205307,1188,0.516746411483254,1111,0.483253588516746
"E02000465",1,326,937,1301,254,25,7,2851,0.000350754121360926,0.114345843563662,0.328656611715188,0.456331111890565,0.0890915468256752,0.00876885303402315,0.00245527884952648,1264,0.443353209400211,1587,0.556646790599789
"E02000466",8,127,846,1053,349,52,18,2453,0.00326131267835304,0.0517733387688545,0.344883815735834,0.429270281288218,0.142274765593151,0.0211985324092947,0.00733795352629433,981,0.399918467183041,1472,0.600081532816959
"E02000467",3,392,1272,1849,351,30,12,3909,0.000767459708365311,0.100281401893067,0.325402916346892,0.47301100025582,0.0897927858787414,0.00767459708365311,0.00306983883346124,1667,0.426451777948324,2242,0.573548222051676
"E02000468",0,106,624,1206,408,70,8,2422,0,0.0437654830718415,0.257638315441784,0.49793559042114,0.168455821635012,0.0289017341040462,0.00330305532617671,730,0.301403798513625,1692,0.698596201486375
"E02000469",1,127,849,939,240,25,11,2192,0.000456204379562044,0.0579379562043796,0.387317518248175,0.428375912408759,0.109489051094891,0.0114051094890511,0.00501824817518248,977,0.445711678832117,1215,0.554288321167883
"E02000470",5,801,821,1356,470,84,13,3550,0.00140845070422535,0.225633802816901,0.231267605633803,0.381971830985915,0.132394366197183,0.0236619718309859,0.00366197183098592,1627,0.45830985915493,1923,0.541690140845071
"E02000471",0,19,257,1141,507,88,10,2022,0,0.00939663699307616,0.127101879327399,0.564292779426311,0.250741839762611,0.0435212660731949,0.00494559841740851,276,0.136498516320475,1746,0.863501483679525
"E02000472",0,58,549,1422,529,58,18,2634,0,0.0220197418375095,0.208428246013667,0.539863325740319,0.20083523158694,0.0220197418375095,0.00683371298405467,607,0.230447987851177,2027,0.769552012148823
"E02000473",12,350,772,1419,564,81,19,3217,0.00373018340068387,0.108797015853279,0.239975132110662,0.441094187130867,0.175318619832142,0.0251787379546161,0.00590612371774946,1134,0.352502331364625,2083,0.647497668635375
"E02000474",1,328,838,1361,527,83,12,3150,0.000317460317460317,0.104126984126984,0.266031746031746,0.432063492063492,0.167301587301587,0.0263492063492063,0.00380952380952381,1167,0.37047619047619,1983,0.629523809523809
"E02000475",9,372,1116,1187,636,138,22,3480,0.00258620689655172,0.106896551724138,0.320689655172414,0.341091954022989,0.182758620689655,0.0396551724137931,0.00632183908045977,1497,0.430172413793103,1983,0.569827586206897
"E02000476",5,1021,2049,1470,536,86,17,5184,0.000964506172839506,0.196952160493827,0.39525462962963,0.283564814814815,0.103395061728395,0.0165895061728395,0.00327932098765432,3075,0.593171296296296,2109,0.406828703703704
"E02000477",1,125,519,1328,633,102,11,2719,0.000367782272894446,0.0459727841118058,0.190878999632218,0.488414858403825,0.232806178742185,0.0375137918352335,0.00404560500183891,645,0.237219566016918,2074,0.762780433983082
"E02000478",3,128,376,621,332,82,8,1550,0.00193548387096774,0.0825806451612903,0.24258064516129,0.400645161290323,0.214193548387097,0.0529032258064516,0.00516129032258065,507,0.327096774193548,1043,0.672903225806452
"E02000479",0,399,1106,1570,622,61,16,3774,0,0.105723370429253,0.293057763645999,0.416004239533651,0.164811870694224,0.016163222045575,0.00423953365129836,1505,0.398781134075252,2269,0.601218865924748
"E02000480",25,1634,981,1587,608,69,18,4922,0.00507923608289313,0.331978870377895,0.199309223892727,0.322429906542056,0.123527021535961,0.014018691588785,0.00365704997968306,2640,0.536367330353515,2282,0.463632669646485
"E02000481",0,67,610,1111,429,68,11,2296,0,0.0291811846689895,0.265679442508711,0.483885017421603,0.18684668989547,0.029616724738676,0.00479094076655052,677,0.2948606271777,1619,0.7051393728223
"E02000482",0,97,315,801,430,68,13,1724,0,0.0562645011600928,0.182714617169374,0.46461716937355,0.249419953596288,0.0394431554524362,0.00754060324825986,412,0.238979118329466,1312,0.761020881670534
"E02000483",3,303,1034,1180,529,91,22,3162,0.00094876660341556,0.0958254269449715,0.327008222643896,0.373181530676787,0.16729917773561,0.0287792536369386,0.00695762175838077,1340,0.423782416192283,1822,0.576217583807717
"E02000484",0,151,666,1078,348,40,9,2292,0,0.0658813263525305,0.290575916230366,0.470331588132635,0.151832460732984,0.0174520069808028,0.00392670157068063,817,0.356457242582897,1475,0.643542757417103
"E02000485",1,164,694,1340,498,70,22,2789,0.000358551452133381,0.0588024381498745,0.248834707780567,0.480458945858731,0.178558623162424,0.0250986016493367,0.00788813194693438,859,0.307995697382574,1930,0.692004302617426
"E02000486",0,34,445,1106,429,63,19,2096,0,0.0162213740458015,0.212309160305344,0.527671755725191,0.204675572519084,0.0300572519083969,0.00906488549618321,479,0.228530534351145,1617,0.771469465648855
"E02000487",0,36,198,881,473,94,10,1692,0,0.0212765957446809,0.117021276595745,0.520685579196217,0.279550827423168,0.0555555555555556,0.00591016548463357,234,0.138297872340426,1458,0.861702127659574
"E02000488",42,341,412,1000,360,39,8,2202,0.0190735694822888,0.154859218891916,0.187102633969119,0.454132606721163,0.163487738419619,0.0177111716621253,0.0036330608537693,795,0.361035422343324,1407,0.638964577656676
"E02000489",7,211,869,1091,288,38,15,2519,0.00277888050813815,0.0837633981738785,0.344978165938865,0.433108376339817,0.114331083763398,0.0150853513298928,0.00595474394601032,1087,0.431520444620881,1432,0.568479555379119
"E02000490",0,75,796,1198,346,37,10,2462,0,0.0304630381803412,0.323314378554021,0.48659626320065,0.140536149471974,0.0150284321689683,0.00406173842404549,871,0.353777416734362,1591,0.646222583265638
"E02000491",1,2139,922,1134,414,54,26,4690,0.000213219616204691,0.456076759061834,0.196588486140725,0.241791044776119,0.088272921108742,0.0115138592750533,0.00554371002132196,3062,0.652878464818763,1628,0.347121535181237
"E02000492",5,196,410,890,344,41,6,1892,0.00264270613107822,0.103594080338266,0.216701902748414,0.470401691331924,0.181818181818182,0.0216701902748414,0.00317124735729387,611,0.322938689217759,1281,0.677061310782241
"E02000493",0,183,631,1073,314,27,10,2238,0,0.081769436997319,0.281948168007149,0.479445933869526,0.140303842716711,0.0120643431635389,0.00446827524575514,814,0.363717605004468,1424,0.636282394995532
"E02000494",2,256,937,1043,440,84,9,2771,0.000721761097076868,0.092385420425839,0.338145073980512,0.376398412125586,0.158787441356911,0.0303139660772284,0.0032479249368459,1195,0.431252255503428,1576,0.568747744496572
"E02000495",3,321,1396,1757,625,99,20,4221,0.000710732054015636,0.0760483297796731,0.330727315801943,0.416252072968491,0.148069177919924,0.023454157782516,0.00473821369343757,1720,0.407486377635631,2501,0.592513622364369
"E02000496",0,72,923,1108,324,51,21,2499,0,0.0288115246098439,0.369347739095638,0.443377350940376,0.129651860744298,0.0204081632653061,0.00840336134453781,995,0.398159263705482,1504,0.601840736294518
"E02000497",0,397,1093,1125,443,48,8,3114,0,0.127488760436737,0.350995504174695,0.361271676300578,0.142260757867694,0.0154142581888247,0.00256904303147078,1490,0.478484264611432,1624,0.521515735388568
"E02000498",1,129,787,826,312,52,6,2113,0.000473260766682442,0.061050638902035,0.372456223379082,0.390913393279697,0.147657359204922,0.024609559867487,0.00283956460009465,917,0.433980123047799,1196,0.566019876952201
"E02000499",0,51,482,1067,494,69,10,2173,0,0.0234698573400828,0.221813161527842,0.491026231017027,0.227335480901979,0.0317533364012885,0.00460193281178095,533,0.245283018867925,1640,0.754716981132075
"E02000500",5,350,731,1059,482,114,12,2753,0.00181620050853614,0.12713403559753,0.265528514347984,0.384671267707955,0.175081729022884,0.041409371594624,0.00435888122048674,1086,0.39447875045405,1667,0.60552124954595
"E02000501",1,119,624,1226,444,44,10,2468,0.000405186385737439,0.0482171799027553,0.252836304700162,0.496758508914101,0.179902755267423,0.0178282009724473,0.00405186385737439,744,0.301458670988655,1724,0.698541329011345
"E02000502",3,495,1040,1352,374,32,9,3305,0.000907715582450832,0.149773071104387,0.314674735249622,0.409077155824508,0.113161875945537,0.00968229954614221,0.0027231467473525,1538,0.46535552193646,1767,0.53464447806354
"E02000503",0,55,568,1254,386,56,12,2331,0,0.0235950235950236,0.243672243672244,0.537966537966538,0.165594165594166,0.024024024024024,0.00514800514800515,623,0.267267267267267,1708,0.732732732732733
"E02000504",2,95,490,1097,424,61,8,2177,0.00091869545245751,0.0436380339917317,0.22508038585209,0.503904455672944,0.194763435920992,0.0280202112999541,0.00367478180983004,587,0.269637115296279,1590,0.730362884703721
"E02000506",4,305,725,860,344,74,12,2324,0.00172117039586919,0.131239242685026,0.311962134251291,0.370051635111876,0.14802065404475,0.03184165232358,0.00516351118760757,1034,0.444922547332186,1290,0.555077452667814
"E02000507",4,49,501,1207,316,47,17,2141,0.0018682858477347,0.0228865016347501,0.234002802428772,0.563755254553947,0.147594581971042,0.0219523587108828,0.00794021485287249,554,0.258757589911256,1587,0.741242410088743
"E02000508",22,1582,1439,1321,340,43,30,4777,0.0046054008792129,0.331170190496127,0.301235084781243,0.276533389156374,0.0711743772241993,0.0090014653548252,0.00628009210801758,3043,0.637010676156584,1734,0.362989323843416
"E02000509",1,449,1577,1236,410,53,14,3740,0.000267379679144385,0.120053475935829,0.421657754010695,0.33048128342246,0.109625668449198,0.0141711229946524,0.00374331550802139,2027,0.541978609625668,1713,0.458021390374332
"E02000510",4,179,869,1215,399,56,13,2735,0.00146252285191956,0.0654478976234004,0.317733089579525,0.444241316270567,0.145886654478976,0.0204753199268739,0.00475319926873857,1052,0.384643510054845,1683,0.615356489945155
"E02000511",2,208,640,1379,433,49,16,2727,0.000733406674000733,0.0762742940960763,0.234690135680235,0.505683901723506,0.158782544921159,0.017968463513018,0.00586725339200587,850,0.311697836450312,1877,0.688302163549688
"E02000512",2,99,1050,1251,337,42,10,2791,0.000716589036187746,0.0354711572912934,0.376209243998567,0.448226442135435,0.120745252597635,0.0150483697599427,0.00358294518093873,1151,0.412396990326048,1640,0.587603009673952
"E02000513",2,166,1305,1206,233,35,11,2958,0.000676132521974307,0.0561189993238675,0.441176470588235,0.407707910750507,0.0787694388100068,0.0118323191345504,0.00371872887085869,1473,0.497971602434077,1485,0.502028397565923
"E02000514",0,34,777,1400,332,32,14,2589,0,0.0131324835843955,0.300115874855156,0.540749324063345,0.12823483970645,0.0123599845500193,0.00540749324063345,811,0.313248358439552,1778,0.686751641560448
"E02000515",33,1362,2026,1813,472,52,15,5774,0.00571527537235885,0.235885001731902,0.350883269830274,0.313993765154139,0.0817457568410114,0.00900588846553516,0.0025978524419813,3421,0.592483546934534,2352,0.407343262902667
"E02000516",8,22,889,1155,231,17,5,2327,0.00343790287924366,0.00945423291792007,0.382036957455952,0.496347228190804,0.0992694456381607,0.00730554361839278,0.00214868929952729,919,0.394929093253116,1408,0.605070906746884
"E02000517",4,470,953,1383,361,32,10,3213,0.00124494242141301,0.146280734516029,0.29660753190165,0.430438842203548,0.112356053532524,0.00995953937130408,0.00311235605353252,1427,0.444133208839091,1786,0.555866791160909
"E02000518",1,114,975,1378,356,36,11,2871,0.000348310693138279,0.0397074190177638,0.339602925809822,0.479972135144549,0.123998606757227,0.0125391849529781,0.00383141762452107,1090,0.379658655520725,1781,0.620341344479275
"E02000519",2,64,895,1112,368,36,5,2482,0.0008058017727639,0.0257856567284448,0.360596293311845,0.448025785656728,0.148267526188558,0.0145044319097502,0.00201450443190975,961,0.387187751813054,1521,0.612812248186946
"E02000520",4,1597,1308,1638,438,39,12,5036,0.00079428117553614,0.317116759332804,0.259729944400318,0.325258141382049,0.0869737887212073,0.00774424146147736,0.00238284352660842,2909,0.577640984908658,2127,0.422359015091342
"E02000521",5,1069,1520,1410,403,38,4,4449,0.00112384805574286,0.240278714317824,0.341649808945831,0.316925151719488,0.0905821532928748,0.00854124522364576,0.000899078444594291,2594,0.583052371319398,1855,0.416947628680602
"E02000522",5,377,1298,1193,349,51,10,3283,0.00152299725860493,0.114833993298812,0.395370088333841,0.363387145903137,0.106305208650624,0.0155345720377703,0.00304599451720987,1680,0.511727078891258,1603,0.488272921108742
"E02000523",5,1598,1346,1351,387,35,12,4734,0.00105618926911703,0.337558090409801,0.284326151246303,0.28538234051542,0.0817490494296578,0.00739332488381918,0.00253485424588086,2949,0.622940430925222,1785,0.377059569074778
"E02000524",1,53,966,1313,471,79,9,2892,0.000345781466113416,0.0183264177040111,0.33402489626556,0.454011065006916,0.162863070539419,0.0273167358229599,0.00311203319502075,1020,0.352697095435685,1872,0.647302904564315
"E02000525",1,97,1235,1418,429,55,15,3250,0.000307692307692308,0.0298461538461538,0.38,0.436307692307692,0.132,0.0169230769230769,0.00461538461538462,1333,0.410153846153846,1917,0.589846153846154
"E02000526",2,270,836,1554,644,107,26,3439,0.000581564408258215,0.078511195114859,0.243093922651934,0.451875545216633,0.187263739459145,0.0311136958418145,0.00756033730735679,1108,0.322186682175051,2331,0.677813317824949
"E02000529",7,349,868,939,232,27,6,2428,0.0028830313014827,0.143739703459638,0.357495881383855,0.38673805601318,0.0955518945634267,0.0111202635914333,0.00247116968698517,1224,0.504118616144975,1204,0.495881383855025
"E02000530",5,166,821,738,117,7,2,1856,0.00269396551724138,0.0894396551724138,0.442349137931034,0.397629310344828,0.0630387931034483,0.00377155172413793,0.00107758620689655,992,0.53448275862069,864,0.46551724137931
"E02000531",22,1453,1439,1530,459,50,15,4968,0.00442834138486312,0.292471819645733,0.289653784219002,0.307971014492754,0.0923913043478261,0.0100644122383253,0.00301932367149758,2914,0.586553945249597,2054,0.413446054750403
"E02000532",6,168,1218,1291,464,60,15,3222,0.00186219739292365,0.0521415270018622,0.378026070763501,0.400682805710739,0.144009931719429,0.0186219739292365,0.00465549348230913,1392,0.432029795158287,1830,0.567970204841713
"E02000533",7,132,1181,1425,524,75,15,3359,0.00208395355760643,0.0392974099434355,0.351592735933313,0.424233402798452,0.155998809169396,0.0223280738314975,0.00446561476629949,1320,0.392974099434355,2039,0.607025900565645
"E02000534",3,345,886,1106,463,58,9,2870,0.00104529616724739,0.120209059233449,0.308710801393728,0.385365853658537,0.161324041811847,0.0202090592334495,0.00313588850174216,1234,0.429965156794425,1636,0.570034843205575
"E02000535",4,116,567,1074,274,31,16,2082,0.00192122958693564,0.0557156580211335,0.272334293948127,0.515850144092219,0.131604226705091,0.0148895292987512,0.00768491834774256,687,0.329971181556196,1395,0.670028818443804
"E02000536",0,646,760,1118,342,41,11,2918,0,0.221384509938314,0.260452364633311,0.383139136394791,0.11720356408499,0.0140507196710075,0.00376970527758739,1406,0.481836874571624,1512,0.518163125428376
"E02000537",0,125,752,1137,340,51,17,2422,0,0.0516102394715111,0.310487200660611,0.469446738232865,0.14037985136251,0.0210569777043765,0.00701899256812552,877,0.362097440132122,1545,0.637902559867878
"E02000538",1,280,959,960,171,21,5,2397,0.000417188151856487,0.116812682519816,0.400083437630371,0.400500625782228,0.0713391739674593,0.00876095118898623,0.00208594075928244,1240,0.517313308302044,1157,0.482686691697956
"E02000539",11,786,1818,1220,496,48,19,4398,0.00250113688040018,0.178717598908595,0.413369713506139,0.277398817644384,0.112778535698045,0.0109140518417462,0.00432014552069122,2615,0.594588449295134,1783,0.405411550704866
"E02000540",10,1421,1390,1304,399,44,19,4587,0.00218007412252017,0.309788532810116,0.303030303030303,0.28428166557663,0.0869849574885546,0.00959232613908873,0.00414214083278831,2821,0.614998909962939,1766,0.385001090037061
"E02000541",4,329,951,1024,207,15,7,2537,0.00157666535277887,0.129680725266062,0.374852187623177,0.403626330311391,0.0815924320063067,0.00591249507292077,0.00275916436736303,1284,0.506109578242018,1253,0.493890421757982
"E02000542",6,834,1348,1239,337,45,14,3823,0.00156944807742611,0.218153282762229,0.352602668061732,0.324091027988491,0.0881506670154329,0.0117708605806958,0.00366204551399425,2188,0.572325398901386,1635,0.427674601098614
"E02000543",15,1344,1828,1585,568,70,36,5446,0.00275431509364671,0.246786632390745,0.335659199412413,0.291039294895336,0.104296731546089,0.012853470437018,0.00661035622475211,3187,0.585200146896805,2259,0.414799853103195
"E02000544",2,32,575,1042,312,39,11,2013,0.000993541977148535,0.0158966716343766,0.285643318430204,0.517635370094387,0.154992548435171,0.0193740685543964,0.00546448087431694,609,0.302533532041729,1404,0.697466467958271
"E02000545",3,385,1389,1011,318,30,8,3144,0.000954198473282443,0.122455470737913,0.441793893129771,0.321564885496183,0.101145038167939,0.00954198473282443,0.00254452926208651,1777,0.565203562340967,1367,0.434796437659033
"E02000546",1,176,950,1129,293,33,2,2584,0.000386996904024768,0.0681114551083591,0.367647058823529,0.436919504643963,0.113390092879257,0.0127708978328173,0.000773993808049536,1127,0.436145510835913,1457,0.563854489164087
"E02000547",11,429,919,1361,393,54,18,3185,0.00345368916797488,0.13469387755102,0.288540031397174,0.427315541601256,0.123390894819466,0.0169544740973312,0.00565149136577708,1359,0.42668759811617,1826,0.57331240188383
"E02000548",2,588,1239,1089,268,35,9,3230,0.000619195046439629,0.182043343653251,0.38359133126935,0.337151702786378,0.0829721362229102,0.0108359133126935,0.00278637770897833,1829,0.56625386996904,1401,0.43374613003096
"E02000549",17,647,923,1537,429,63,20,3636,0.00467546754675468,0.177942794279428,0.253850385038504,0.422717271727173,0.117986798679868,0.0173267326732673,0.0055005500550055,1587,0.436468646864686,2049,0.563531353135314
"E02000550",4,566,1572,967,287,23,5,3424,0.00116822429906542,0.165303738317757,0.45911214953271,0.282418224299065,0.0838200934579439,0.00671728971962617,0.00146028037383178,2142,0.625584112149533,1282,0.374415887850467
"E02000551",7,317,1220,1225,230,38,17,3054,0.0022920759659463,0.103798297314997,0.399476096922069,0.401113294040602,0.0753110674525213,0.0124426981008513,0.00556647020301244,1544,0.505566470203012,1510,0.494433529796988
"E02000552",23,262,1326,1129,304,42,5,3091,0.00744095761889356,0.0847622128760919,0.428987382724038,0.365253963118732,0.0983500485279845,0.0135878356518926,0.00161759948236817,1611,0.521190553219023,1480,0.478809446780977
"E02000553",8,104,646,966,282,30,10,2046,0.00391006842619746,0.050830889540567,0.315738025415445,0.472140762463343,0.13782991202346,0.0146627565982405,0.00488758553274682,758,0.370478983382209,1288,0.629521016617791
"E02000554",1,218,1863,1473,326,28,8,3917,0.000255297421496043,0.0556548378861373,0.475619096247128,0.376053101863671,0.08322695940771,0.0071483278018892,0.00204237937196834,2082,0.531529231554761,1835,0.468470768445239
"E02000555",3,415,1304,1455,403,56,7,3643,0.000823497117760088,0.113917101290145,0.357946747186385,0.399396102113643,0.110623112819105,0.0153719461981883,0.00192149327477354,1722,0.47268734559429,1921,0.52731265440571
"E02000556",6,543,2135,2072,438,46,12,5252,0.00114242193450114,0.103389185072353,0.406511805026657,0.394516374714394,0.0833968012185834,0.00875856816450876,0.00228484386900229,2684,0.511043412033511,2568,0.488956587966489
"E02000557",8,404,2210,1382,301,45,9,4359,0.00183528332186281,0.092681807754072,0.506997017664602,0.317045193851801,0.0690525349850883,0.0103234686854783,0.00206469373709566,2622,0.601514108740537,1737,0.398485891259463
"E02000558",11,454,1886,1106,283,32,3,3775,0.00291390728476821,0.120264900662252,0.499602649006622,0.292980132450331,0.0749668874172185,0.00847682119205298,0.000794701986754967,2351,0.622781456953642,1424,0.377218543046358
"E02000559",0,1080,1500,1252,359,31,4,4226,0,0.255560814008519,0.354945575011831,0.296261239943209,0.0849503076194983,0.00733554188357785,0.000946521533364884,2580,0.61050638902035,1646,0.38949361097965
"E02000560",1,415,1747,1391,387,52,15,4008,0.000249500998003992,0.103542914171657,0.435878243512974,0.347055888223553,0.0965568862275449,0.0129740518962076,0.00374251497005988,2163,0.539670658682635,1845,0.460329341317365
"E02000561",0,174,1180,1314,317,52,13,3050,0,0.0570491803278689,0.386885245901639,0.430819672131148,0.103934426229508,0.0170491803278689,0.00426229508196721,1354,0.443934426229508,1696,0.556065573770492
"E02000562",3,263,1391,1410,295,42,10,3414,0.000878734622144112,0.0770357352079672,0.407439953134153,0.413005272407733,0.0864089045108377,0.0123022847100176,0.00292911540714704,1657,0.485354422964265,1757,0.514645577035735
"E02000563",6,426,1755,1386,316,40,9,3938,0.00152361604875571,0.108176739461656,0.445657694261046,0.35195530726257,0.0802437785678009,0.0101574403250381,0.00228542407313357,2187,0.555358049771458,1751,0.444641950228542
"E02000564",20,2196,2336,1529,358,48,18,6505,0.00307455803228286,0.337586471944658,0.359108378170638,0.235049961568025,0.0550345887778632,0.00737893927747886,0.00276710222905457,4552,0.699769408147579,1953,0.300230591852421
"E02000565",0,148,1484,1277,238,19,9,3175,0,0.0466141732283465,0.46740157480315,0.402204724409449,0.0749606299212598,0.00598425196850394,0.00283464566929134,1632,0.514015748031496,1543,0.485984251968504
"E02000566",0,348,1533,1421,394,59,23,3778,0,0.0921122286924299,0.405770248808894,0.376124933827422,0.10428798305982,0.0156167284277395,0.00608787718369508,1881,0.497882477501323,1897,0.502117522498676
"E02000567",1,375,2242,1846,339,42,19,4864,0.000205592105263158,0.0770970394736842,0.4609375,0.379523026315789,0.0696957236842105,0.00863486842105263,0.00390625,2618,0.538240131578947,2246,0.461759868421053
"E02000568",3,1611,1970,1028,193,26,8,4839,0.000619962802231866,0.332920024798512,0.407108906798925,0.212440586898119,0.03988427361025,0.00537301095267617,0.00165323413928498,3584,0.740648894399669,1255,0.259351105600331
"E02000569",0,297,2046,1603,382,63,13,4404,0,0.0674386920980926,0.464577656675749,0.363987284287012,0.0867393278837421,0.0143051771117166,0.00295186194368756,2343,0.532016348773842,2061,0.467983651226158
"E02000570",0,258,1694,1720,515,62,13,4262,0,0.0605349601126232,0.39746597841389,0.403566400750821,0.120835288596903,0.014547160957297,0.00305021116846551,1952,0.458000938526513,2310,0.541999061473487
"E02000571",0,681,1739,1220,261,32,13,3946,0,0.172579827673594,0.440699442473391,0.309173846933604,0.0661429295489103,0.00810947795235682,0.00329447541814496,2420,0.613279270146984,1526,0.386720729853016
"E02000572",4,342,1868,828,153,4,0,3200,0.00125,0.106875,0.58375,0.25875,0.0478125,0.00125,0,2214,0.691875,985,0.3078125
"E02000573",0,1176,2085,1857,477,55,37,5687,0,0.206787409882187,0.366625637418674,0.326534200808862,0.0838755055389485,0.00967117988394584,0.00650606646738175,3261,0.573413047300862,2426,0.426586952699138
"E02000574",4,326,1894,1286,367,64,16,3957,0.00101086681829669,0.0823856456911802,0.478645438463482,0.324993682082386,0.0927470305787213,0.016173869092747,0.00404346727318676,2224,0.562041950972959,1733,0.437958049027041
"E02000575",9,1492,3189,1767,412,58,10,6937,0.00129739080294075,0.215078564220845,0.459708807842007,0.254721060977368,0.0593916678679544,0.00836096295228485,0.00144154533660084,4690,0.676084762865792,2247,0.323915237134208
"E02000576",45,2393,2517,1383,376,31,6,6751,0.00666567915864316,0.354466005036291,0.372833654273441,0.204858539475633,0.0556954525255518,0.00459191230928751,0.000888757221152422,4955,0.733965338468375,1796,0.266034661531625
"E02000577",0,1027,1346,750,240,31,3,3397,0,0.302325581395349,0.396231969384751,0.220783043862231,0.070650574035914,0.00912569914630556,0.000883132175448925,2373,0.6985575507801,1024,0.3014424492199
"E02000578",0,245,776,656,164,12,1,1854,0,0.132146709816613,0.418554476806904,0.353829557713053,0.0884573894282632,0.00647249190938511,0.000539374325782093,1021,0.550701186623517,833,0.449298813376483
"E02000579",4,237,1213,1437,417,49,16,3373,0.00118588793359028,0.0702638600652238,0.359620515861251,0.426030240142307,0.123628817076786,0.0145271271864809,0.0047435517343611,1454,0.431070263860065,1919,0.568929736139935
"E02000580",0,72,1773,1598,496,66,12,4017,0,0.0179238237490665,0.441374159820762,0.39780931043067,0.123475230271347,0.0164301717699776,0.00298730395817774,1845,0.459297983569828,2172,0.540702016430172
"E02000581",0,148,1211,1199,237,23,10,2828,0,0.0523338048090523,0.428217821782178,0.423974540311174,0.0838048090523338,0.00813295615275813,0.00353606789250354,1359,0.480551626591231,1469,0.519448373408769
"E02000582",7,75,1605,1832,701,109,29,4358,0.00160624139513538,0.0172097292335934,0.368288205598899,0.420376319412575,0.160853602569986,0.0250114731528224,0.00665442863698945,1687,0.387104176227627,2671,0.612895823772373
"E02000583",2,44,1279,1542,613,89,28,3597,0.000556018904642758,0.0122324159021407,0.355574089519044,0.428690575479566,0.170419794273005,0.0247428412566027,0.00778426466499861,1325,0.368362524325827,2272,0.631637475674173
"E02000584",0,230,1620,1785,694,100,35,4464,0,0.0515232974910394,0.362903225806452,0.399865591397849,0.155465949820789,0.0224014336917563,0.00784050179211469,1850,0.414426523297491,2614,0.585573476702509
"E02000585",0,195,1676,1591,486,66,15,4029,0,0.0483991064780342,0.415984115165053,0.394887068751551,0.120625465376024,0.0163812360387193,0.00372300819061802,1871,0.464383221643088,2158,0.535616778356912
"E02000586",2,327,1745,1763,679,109,37,4662,0.000429000429000429,0.0701415701415701,0.374302874302874,0.378163878163878,0.145645645645646,0.0233805233805234,0.00793650793650794,2074,0.444873444873445,2588,0.555126555126555
"E02000587",0,229,1663,1554,616,117,28,4207,0,0.0544330877109579,0.395293558355122,0.369384359400998,0.146422628951747,0.027810791537913,0.00665557404326123,1892,0.44972664606608,2315,0.55027335393392
"E02000588",1,266,2399,2443,884,144,37,6174,0.000161969549724652,0.0430839002267574,0.38856494978944,0.395691609977324,0.143181081956592,0.0233236151603499,0.00599287333981212,2666,0.431810819565922,3508,0.568189180434078
"E02000589",1,294,2644,1957,558,74,25,5553,0.000180082838105529,0.0529443544030254,0.476139023951017,0.352422114172519,0.100486223662885,0.0133261300198091,0.00450207095263821,2939,0.529263461192148,2614,0.470736538807852
"E02000590",0,151,2517,1401,492,76,19,4656,0,0.0324312714776632,0.540592783505155,0.30090206185567,0.105670103092784,0.0163230240549828,0.0040807560137457,2668,0.573024054982818,1988,0.426975945017182
"E02000591",0,1260,2016,1386,319,78,17,5076,0,0.24822695035461,0.397163120567376,0.273049645390071,0.0628447596532703,0.0153664302600473,0.00334909377462569,3276,0.645390070921986,1800,0.354609929078014
"E02000592",1,82,1813,1994,592,100,29,4611,0.000216872695727608,0.0177835610496638,0.393190197354153,0.43244415528085,0.128388635870744,0.0216872695727608,0.00628930817610063,1896,0.411190631099545,2715,0.588809368900455
"E02000593",0,128,2340,1935,497,69,20,4989,0,0.0256564441771898,0.469031870114251,0.387853277209862,0.0996191621567448,0.0138304269392664,0.00400881940268591,2468,0.494688314291441,2521,0.505311685708559
"E02000594",0,175,1516,1794,600,87,14,4186,0,0.0418060200668896,0.362159579550884,0.428571428571429,0.143334925943622,0.0207835642618251,0.00334448160535117,1691,0.403965599617774,2495,0.596034400382226
"E02000595",0,181,1529,1730,713,101,34,4288,0,0.0422108208955224,0.356576492537313,0.403451492537313,0.166277985074627,0.0235541044776119,0.00792910447761194,1710,0.398787313432836,2578,0.601212686567164
"E02000596",3,159,1554,1694,569,88,16,4083,0.000734753857457752,0.0389419544452608,0.380602498163115,0.414891011511144,0.139358314964487,0.0215527798187607,0.00391868723977468,1716,0.420279206465834,2367,0.579720793534166
"E02000597",2,606,1419,1122,332,44,8,3533,0.000566091140673648,0.171525615624115,0.401641664307954,0.317577129917917,0.0939711293518256,0.0124540050948203,0.00226436456269459,2027,0.573733371072743,1506,0.426266628927257
"E02000598",9,89,683,972,404,71,12,2240,0.00401785714285714,0.0397321428571429,0.304910714285714,0.433928571428571,0.180357142857143,0.0316964285714286,0.00535714285714286,781,0.348660714285714,1459,0.651339285714286
"E02000599",15,254,552,824,386,81,9,2121,0.00707213578500707,0.11975483262612,0.26025459688826,0.388495992456388,0.181989627534182,0.0381895332390382,0.00424328147100424,821,0.387081565299387,1300,0.612918434700613
"E02000600",7,201,1473,1388,522,113,26,3730,0.00187667560321716,0.053887399463807,0.394906166219839,0.372117962466488,0.139946380697051,0.0302949061662198,0.00697050938337802,1681,0.450670241286863,2049,0.549329758713137
"E02000601",1,1338,1727,1472,649,124,26,5337,0.00018737118231216,0.250702641933671,0.323590031853101,0.2758103803635,0.121603897320592,0.0232340266067079,0.00487165074011617,3066,0.574480044969084,2271,0.425519955030916
"E02000602",7,277,2080,1670,619,92,24,4769,0.00146781295869155,0.0580834556510799,0.436150136296918,0.350178234430698,0.129796603061438,0.0192912560285175,0.00503250157265674,2364,0.495701404906689,2405,0.504298595093311
"E02000603",4,492,1096,1286,398,58,18,3352,0.00119331742243437,0.146778042959427,0.326968973747017,0.383651551312649,0.11873508353222,0.0173031026252983,0.00536992840095465,1592,0.474940334128878,1760,0.525059665871122
"E02000604",2,419,978,1362,595,98,24,3478,0.000575043128234618,0.120471535365152,0.281196089706728,0.391604370327775,0.171075330649799,0.0281771132834963,0.00690051753881541,1399,0.402242668200115,2079,0.597757331799885
"E02000605",0,129,705,1232,516,86,10,2678,0,0.0481702763256161,0.263256161314414,0.460044809559373,0.192681105302465,0.0321135175504108,0.00373412994772218,834,0.31142643764003,1844,0.68857356235997
"E02000606",4,829,2381,1918,719,113,45,6009,0.000665668164420037,0.137959727076053,0.396238974871027,0.319187884839408,0.119653852554502,0.018805125644866,0.00748876684972541,3214,0.534864370111499,2795,0.465135629888501
"E02000607",7,120,620,1027,509,77,15,2375,0.00294736842105263,0.0505263157894737,0.261052631578947,0.432421052631579,0.214315789473684,0.0324210526315789,0.00631578947368421,747,0.314526315789474,1628,0.685473684210526
"E02000608",6,411,1465,1488,496,80,17,3963,0.00151400454201363,0.103709311127933,0.36966944234166,0.375473126419379,0.12515770880646,0.0201867272268483,0.00428967953570527,1882,0.474892758011607,2081,0.525107241988393
"E02000609",2,104,628,1020,466,84,15,2319,0.00086244070720138,0.0448469167744718,0.270806382061233,0.439844760672704,0.200948684777922,0.036222509702458,0.00646830530401035,734,0.316515739542906,1585,0.683484260457094
"E02000610",5,377,1995,1586,593,83,20,4659,0.00107319167203263,0.0809186520712599,0.428203477141017,0.340416398368749,0.127280532303069,0.0178149817557416,0.0042927666881305,2377,0.51019532088431,2282,0.48980467911569
"E02000611",1,33,266,828,492,90,11,1721,0.000581057524694945,0.0191748983149332,0.154561301568855,0.481115630447414,0.285880302149913,0.052295177222545,0.00639163277164439,300,0.174317257408483,1421,0.825682742591517
"E02000612",1,34,539,1078,488,75,16,2231,0.000448229493500672,0.0152398027790229,0.241595696996862,0.483191393993725,0.218735992828328,0.0336172120125504,0.00717167189601076,574,0.257283729269386,1657,0.742716270730614
"E02000613",4,160,963,1383,568,103,21,3202,0.00124921923797626,0.0499687695190506,0.300749531542786,0.431917551530294,0.17738913179263,0.0321673953778888,0.00655840099937539,1127,0.351967520299813,2075,0.648032479700187
"E02000614",2,449,985,1293,472,64,21,3286,0.000608642726719416,0.136640292148509,0.299756542909312,0.393487522824102,0.143639683505782,0.0194765672550213,0.00639074863055387,1436,0.43700547778454,1850,0.56299452221546
"E02000615",3,48,632,1074,430,75,25,2287,0.00131176213379974,0.0209881941407958,0.276344556187145,0.469610843900306,0.188019239177962,0.0327940533449934,0.0109313511149978,683,0.29864451246174,1604,0.70135548753826
"E02000616",0,41,523,883,245,36,6,1734,0,0.0236447520184544,0.30161476355248,0.509227220299885,0.141291810841984,0.0207612456747405,0.00346020761245675,564,0.325259515570934,1170,0.674740484429066
"E02000617",6,125,1218,1213,318,51,13,2944,0.00203804347826087,0.0424592391304348,0.413722826086957,0.412024456521739,0.108016304347826,0.0173233695652174,0.00441576086956522,1349,0.458220108695652,1595,0.541779891304348
"E02000619",2,645,2231,1290,208,32,15,4423,0.000452181777074384,0.145828623106489,0.504408772326475,0.291657246212978,0.0470269048157359,0.00723490843319014,0.00339136332805788,2878,0.650689577210039,1545,0.349310422789962
"E02000620",0,1875,2288,1499,348,63,17,6090,0,0.307881773399015,0.375697865353038,0.246141215106732,0.0571428571428571,0.0103448275862069,0.00279146141215107,4163,0.683579638752053,1927,0.316420361247947
"E02000621",6,2848,2943,1814,425,55,21,8112,0.000739644970414201,0.351084812623274,0.362795857988166,0.22361932938856,0.0523915187376726,0.00678007889546351,0.0025887573964497,5797,0.714620315581854,2315,0.285379684418146
"E02000622",8,252,1712,1465,370,51,13,3871,0.00206664944458796,0.0650994575045208,0.442262981141824,0.37845517954017,0.0955825368121932,0.0131748902092483,0.00335830534745544,1972,0.509429088090933,1899,0.490570911909067
"E02000623",2,77,1860,1190,229,26,8,3392,0.000589622641509434,0.0227004716981132,0.548349056603774,0.350825471698113,0.0675117924528302,0.00766509433962264,0.00235849056603774,1939,0.571639150943396,1453,0.428360849056604
"E02000624",0,1267,1866,1343,308,51,15,4850,0,0.261237113402062,0.384742268041237,0.276907216494845,0.0635051546391753,0.0105154639175258,0.00309278350515464,3133,0.645979381443299,1717,0.354020618556701
"E02000625",13,408,2198,1432,328,16,11,4406,0.0029505220154335,0.0926009986382206,0.498865183840218,0.325011348161598,0.0744439400817068,0.00363141171130277,0.00249659555152065,2619,0.594416704493872,1787,0.405583295506128
"E02000626",2,118,1948,1327,253,27,13,3688,0.000542299349240781,0.0319956616052061,0.528199566160521,0.359815618221258,0.0686008676789588,0.00732104121475054,0.00352494577006508,2068,0.560737527114967,1620,0.439262472885033
"E02000627",3,497,1638,1664,390,28,14,4235,0.000708382526564345,0.117355371900826,0.386776859504132,0.392916174734357,0.0920897284533648,0.00661157024793388,0.00330578512396694,2138,0.504840613931523,2096,0.494923258559622
"E02000628",0,1045,2256,1292,303,29,15,4940,0,0.211538461538462,0.45668016194332,0.261538461538462,0.061336032388664,0.00587044534412955,0.00303643724696356,3301,0.668218623481781,1639,0.331781376518219
"E02000629",0,647,1801,1884,493,59,38,4922,0,0.131450629825274,0.365908167411621,0.382771231206826,0.100162535554653,0.0119869971556278,0.00772043884599756,2448,0.497358797236896,2474,0.502641202763104
"E02000630",0,307,1739,1539,619,67,22,4293,0,0.0715117633356627,0.405078034008852,0.358490566037736,0.144188213370603,0.0156068017703238,0.00512462147682273,2046,0.476589797344514,2247,0.523410202655486
"E02000631",0,366,1314,1770,540,75,27,4092,0,0.0894428152492669,0.321114369501466,0.432551319648094,0.131964809384164,0.0183284457478006,0.00659824046920821,1680,0.410557184750733,2412,0.589442815249267
"E02000632",2,409,1914,2135,507,30,7,5004,0.000399680255795364,0.0817346123101519,0.382494004796163,0.426658673061551,0.101318944844125,0.00599520383693046,0.00139888089528377,2325,0.46462829736211,2679,0.53537170263789
"E02000633",0,475,2087,1531,321,30,8,4452,0,0.106693620844564,0.468778077268643,0.343890386343217,0.0721024258760108,0.00673854447439353,0.00179694519317161,2562,0.575471698113208,1890,0.424528301886792
"E02000634",0,180,1701,1361,353,23,10,3628,0,0.0496141124586549,0.468853362734289,0.375137816979052,0.0972987872105843,0.00633958103638368,0.00275633958103638,1881,0.518467475192944,1747,0.481532524807056
"E02000635",10,1061,1612,1618,456,49,19,4825,0.00207253886010363,0.219896373056995,0.334093264248705,0.335336787564767,0.0945077720207254,0.0101554404145078,0.00393782383419689,2683,0.556062176165803,2142,0.443937823834197
"E02000636",4,239,1168,1624,518,63,17,3633,0.0011010184420589,0.0657858519130195,0.3214973850812,0.447013487475915,0.142581888246628,0.0173410404624277,0.00467932837875034,1411,0.388384255436279,2222,0.611615744563721
"E02000637",6,83,1306,1947,501,62,23,3928,0.00152749490835031,0.0211303462321792,0.332484725050916,0.495672097759674,0.127545824847251,0.0157841140529532,0.00585539714867617,1395,0.355142566191446,2533,0.644857433808554
"E02000638",1,249,1958,1875,389,34,8,4514,0.000221533008418254,0.0551617190961453,0.433761630482942,0.415374390784227,0.0861763402747009,0.00753212228622065,0.00177226406734603,2208,0.489144882587506,2306,0.510855117412494
"E02000639",9,986,1530,1090,302,41,13,3971,0.00226643162931252,0.248300176278016,0.385293376983128,0.274490052883405,0.0760513724502644,0.0103248552002015,0.00327373457567363,2525,0.635859984890456,1446,0.364140015109544
"E02000640",9,134,1485,1902,519,58,13,4120,0.00218446601941748,0.0325242718446602,0.360436893203884,0.461650485436893,0.125970873786408,0.0140776699029126,0.00315533980582524,1628,0.395145631067961,2492,0.604854368932039
"E02000641",1,149,1919,1115,234,20,1,3439,0.000290782204129107,0.043326548415237,0.558011049723757,0.324222157603955,0.0680430357662111,0.00581564408258215,0.000290782204129107,2069,0.601628380343123,1370,0.398371619656877
"E02000642",0,177,1492,1735,577,76,23,4080,0,0.0433823529411765,0.365686274509804,0.425245098039216,0.141421568627451,0.0186274509803922,0.00563725490196078,1669,0.40906862745098,2411,0.59093137254902
"E02000643",5,438,1264,1746,682,114,32,4281,0.00116795141322121,0.102312543798178,0.295258117262322,0.407848633496847,0.159308572763373,0.0266292922214436,0.00747488904461574,1707,0.398738612473721,2574,0.601261387526279
"E02000644",18,144,1206,1675,630,68,20,3761,0.00478596118053709,0.0382876894442967,0.320659399095985,0.445360276522202,0.167508641318798,0.0180802977931401,0.00531773464504121,1368,0.363733049720819,2393,0.636266950279181
"E02000645",1,287,1514,1957,666,105,22,4552,0.000219683655536028,0.0630492091388401,0.332601054481547,0.429920913884007,0.146309314586995,0.023066783831283,0.00483304042179262,1802,0.395869947275923,2750,0.604130052724077
"E02000646",0,242,1565,1687,531,81,32,4138,0,0.0584823586273562,0.378202029966167,0.407684871918801,0.128322861285645,0.0195746737554374,0.00773320444659256,1807,0.436684388593523,2331,0.563315611406477
"E02000647",9,258,1045,1417,508,79,15,3331,0.00270189132392675,0.0774542179525668,0.313719603722606,0.425397778444911,0.15250675472831,0.0237166016211348,0.00450315220654458,1312,0.393875712999099,2019,0.606124287000901
"E02000648",12,248,1522,1534,363,41,17,3737,0.00321113192400321,0.0663633930960664,0.407278565694407,0.41048969761841,0.0971367407010971,0.010971367407011,0.00454910355900455,1782,0.476853090714477,1955,0.523146909285523
"E02000649",4,589,2160,2471,811,106,28,6169,0.000648403306856865,0.0954773869346734,0.350137785702707,0.400551142810828,0.131463770465229,0.0171826876317069,0.00453882314799805,2753,0.446263575944237,3416,0.553736424055763
"E02000650",2,176,1500,1486,438,58,20,3680,0.000543478260869565,0.0478260869565217,0.407608695652174,0.403804347826087,0.119021739130435,0.0157608695652174,0.00543478260869565,1678,0.455978260869565,2002,0.544021739130435
"E02000651",6,178,1078,1531,597,79,22,3491,0.00171870524205099,0.0509882555141793,0.308794041821828,0.438556287596677,0.171011171584073,0.022629619020338,0.00630191922085362,1262,0.361501002578058,2229,0.638498997421942
"E02000652",5,23,1015,1118,250,30,11,2452,0.00203915171288744,0.00938009787928222,0.41394779771615,0.455954323001631,0.101957585644372,0.0122349102773246,0.00448613376835237,1043,0.42536704730832,1409,0.57463295269168
"E02000653",15,2480,2108,788,189,20,4,5604,0.00267665952890792,0.442541042112777,0.37615988579586,0.140613847251963,0.0337259100642398,0.00356887937187723,0.000713775874375446,4603,0.821377587437545,1001,0.178622412562455
"E02000654",1,1351,1463,903,188,12,6,3924,0.000254841997961264,0.344291539245668,0.372833843017329,0.230122324159021,0.0479102956167176,0.00305810397553517,0.00152905198776758,2815,0.717380224260958,1109,0.282619775739042
"E02000655",0,760,1511,1368,270,23,13,3945,0,0.192648922686946,0.383016476552598,0.346768060836502,0.0684410646387833,0.00583016476552598,0.00329531051964512,2271,0.575665399239544,1674,0.424334600760456
"E02000657",0,487,1787,1637,341,55,16,4323,0,0.11265325005783,0.413370344668055,0.378672218366875,0.0788804071246819,0.0127226463104326,0.00370113347212584,2274,0.526023594725885,2049,0.473976405274115
"E02000658",0,326,1178,1248,371,42,19,3184,0,0.102386934673367,0.369974874371859,0.391959798994975,0.116520100502513,0.0131909547738693,0.00596733668341709,1504,0.472361809045226,1680,0.527638190954774
"E02000659",4,1219,1199,1230,386,74,21,4133,0.0009678199854827,0.294943140575853,0.290104040648439,0.29760464553593,0.0933946285990806,0.01790466973143,0.00508105492378418,2422,0.586015001209775,1711,0.413984998790225
"E02000660",1,405,1631,1479,403,41,13,3973,0.000251698968034231,0.101938082053864,0.410521016863831,0.372262773722628,0.101434684117795,0.0103196576894035,0.003272086584445,2037,0.512710797885729,1936,0.487289202114271
"E02000661",0,125,1216,1402,396,40,16,3195,0,0.0391236306729265,0.380594679186228,0.438810641627543,0.123943661971831,0.0125195618153365,0.00500782472613458,1341,0.419718309859155,1854,0.580281690140845
"E02000662",0,292,1110,1293,271,30,7,3003,0,0.0972360972360972,0.36963036963037,0.430569430569431,0.0902430902430902,0.00999000999000999,0.00233100233100233,1402,0.466866466866467,1601,0.533133533133533
"E02000663",1,131,740,1274,395,47,21,2609,0.000383288616328095,0.0502108087389804,0.28363357608279,0.488309697201993,0.151399003449598,0.0180145649674205,0.00804906094289,872,0.334227673438099,1737,0.665772326561901
"E02000665",6,248,1169,1417,470,50,16,3376,0.00177725118483412,0.0734597156398104,0.346267772511848,0.419727488151659,0.139218009478673,0.0148104265402844,0.004739336492891,1423,0.421504739336493,1953,0.578495260663507
"E02000666",4,81,1001,1137,360,27,15,2625,0.00152380952380952,0.0308571428571429,0.381333333333333,0.433142857142857,0.137142857142857,0.0102857142857143,0.00571428571428571,1086,0.413714285714286,1539,0.586285714285714
"E02000667",2,65,550,1197,358,37,10,2219,0.000901306894997747,0.0292924740874268,0.24785939612438,0.539432176656151,0.161333934204597,0.0166741775574583,0.00450653447498873,617,0.278053177106805,1602,0.721946822893195
"E02000668",0,111,931,1009,404,62,10,2527,0,0.0439256034823902,0.368421052631579,0.399287692916502,0.1598733676296,0.0245350217649387,0.00395726157499011,1042,0.412346656113969,1485,0.587653343886031
"E02000669",1,290,1305,1628,421,44,19,3708,0.000269687162891046,0.0782092772384035,0.351941747572816,0.439050701186624,0.113538295577131,0.011866235167206,0.00512405609492988,1596,0.43042071197411,2112,0.56957928802589
"E02000670",1,191,951,1455,429,35,17,3079,0.00032478077297824,0.0620331276388438,0.308866515102306,0.472556024683339,0.139330951607665,0.0113673270542384,0.00552127314063007,1143,0.371224423514128,1936,0.628775576485872
"E02000671",2,92,1254,1747,485,76,15,3671,0.000544810678289294,0.0250612912013075,0.341596295287388,0.475892127485699,0.132116589485154,0.0207028057749932,0.00408608008716971,1348,0.367202397166984,2323,0.632797602833015
"E02000672",1,795,1183,1817,578,63,32,4469,0.000223763705526964,0.177892145893936,0.264712463638398,0.406578652942493,0.129335421794585,0.0140971134481987,0.00716043857686283,1979,0.442828373237861,2490,0.557171626762139
"E02000673",12,214,1147,1500,548,87,24,3532,0.00339750849377123,0.0605889014722537,0.324745186862967,0.424688561721404,0.15515288788222,0.0246319365798414,0.00679501698754247,1373,0.388731596828992,2159,0.611268403171008
"E02000674",0,21,684,1498,479,58,33,2773,0,0.00757302560403895,0.246664262531554,0.540209159754778,0.17273710782546,0.0209159754778219,0.0119004688063469,705,0.254237288135593,2068,0.745762711864407
"E02000675",6,131,1073,1291,508,68,6,3083,0.00194615634122608,0.0424910801167694,0.348037625689264,0.418747972753811,0.164774570223808,0.0220564385338956,0.00194615634122608,1210,0.392474862147259,1873,0.607525137852741
"E02000676",0,130,933,1589,534,49,17,3252,0,0.0399753997539975,0.28690036900369,0.488622386223862,0.164206642066421,0.0150676506765068,0.00522755227552276,1063,0.326875768757688,2189,0.673124231242312
"E02000677",1,139,640,1248,512,63,17,2620,0.000381679389312977,0.0530534351145038,0.244274809160305,0.476335877862595,0.195419847328244,0.0240458015267176,0.00648854961832061,780,0.297709923664122,1840,0.702290076335878
"E02000678",0,71,913,1051,217,26,5,2283,0,0.0310994305738064,0.399912395970215,0.46035917652212,0.0950503723171266,0.0113885238720981,0.00219010074463425,984,0.431011826544021,1299,0.568988173455979
"E02000679",1,301,1248,1305,373,67,25,3320,0.000301204819277108,0.0906626506024096,0.375903614457831,0.393072289156627,0.112349397590361,0.0201807228915663,0.00753012048192771,1550,0.466867469879518,1770,0.533132530120482
"E02000680",1,199,1226,1221,313,33,12,3005,0.000332778702163062,0.0662229617304493,0.407986688851913,0.406322795341098,0.104159733777038,0.010981697171381,0.00399334442595674,1426,0.474542429284526,1579,0.525457570715474
"E02000681",3,129,1258,1272,367,39,11,3079,0.000974342318934719,0.0418967197141929,0.408574212406626,0.413121143228321,0.119194543683014,0.0126664501461513,0.00357258850276064,1390,0.451445274439753,1689,0.548554725560247
"E02000682",2,388,963,1188,371,44,13,2969,0.000673627484001347,0.130683731896261,0.324351633546649,0.4001347254968,0.12495789828225,0.0148198046480296,0.00437857864600876,1353,0.455708992926911,1616,0.544291007073089
"E02000683",1,89,1233,1235,265,28,9,2860,0.00034965034965035,0.0311188811188811,0.431118881118881,0.431818181818182,0.0926573426573427,0.00979020979020979,0.00314685314685315,1323,0.462587412587413,1537,0.537412587412587
"E02000685",0,264,1522,1399,306,26,7,3524,0,0.0749148694665153,0.431895573212259,0.396992054483541,0.08683314415437,0.00737797956867196,0.00198637911464245,1786,0.506810442678774,1738,0.493189557321226
"E02000686",0,296,1395,1077,195,28,13,3004,0,0.0985352862849534,0.464380825565912,0.358521970705726,0.06491344873502,0.00932090545938748,0.00432756324900133,1691,0.562916111850865,1313,0.437083888149135
"E02000687",21,146,1082,1529,435,56,17,3286,0.00639074863055387,0.0444309190505173,0.329275715155204,0.465307364576993,0.132379793061473,0.0170419963481436,0.00517346317711503,1249,0.380097382836275,2037,0.619902617163725
"E02000689",8,1099,1427,1375,427,82,19,4437,0.00180302005859815,0.247689880549921,0.321613702952445,0.309894072571557,0.0962361956276764,0.0184809556006311,0.00428217263917061,2534,0.571106603560965,1903,0.428893396439035
"E02000690",15,146,753,754,359,85,10,2122,0.00706880301602262,0.0688030160226202,0.354853911404336,0.355325164938737,0.169180018850141,0.0400565504241282,0.00471253534401508,914,0.430725730442978,1208,0.569274269557022
"E02000691",2,194,1019,1306,505,70,21,3117,0.000641642605068977,0.0622393326916907,0.326916907282644,0.418992621110042,0.162014757779917,0.0224574911774142,0.00673724735322425,1215,0.389797882579403,1902,0.610202117420597
"E02000692",11,436,1637,1564,625,97,20,4390,0.00250569476082005,0.0993166287015945,0.372892938496583,0.35626423690205,0.142369020501139,0.0220956719817768,0.00455580865603645,2084,0.474715261958998,2306,0.525284738041002
"E02000693",9,497,1868,1773,460,43,11,4661,0.00193091611242223,0.10662947865265,0.400772366444969,0.380390474147179,0.0986912679682472,0.00922548809268397,0.00236000858184939,2374,0.509332761210041,2287,0.490667238789959
"E02000694",2,242,1614,1757,565,61,20,4261,0.000469373386528984,0.056794179770007,0.37878432292889,0.412344520065712,0.132597981694438,0.014315888289134,0.00469373386528984,1858,0.436047876085426,2403,0.563952123914574
"E02000695",1,114,777,1228,303,44,25,2492,0.000401284109149278,0.0457463884430177,0.311797752808989,0.492776886035313,0.121589085072231,0.0176565008025682,0.0100321027287319,892,0.357945425361156,1600,0.642054574638844
"E02000696",9,147,1386,1493,333,33,20,3421,0.00263080970476469,0.0429698918444899,0.405144694533762,0.43642209880152,0.0973399590762935,0.00964630225080386,0.00584624378836598,1542,0.450745396083017,1879,0.549254603916983
"E02000697",4,389,1506,1616,543,82,27,4167,0.000959923206143509,0.0933525317974562,0.361411087113031,0.387808975281977,0.130309575233981,0.0196784257259419,0.00647948164146868,1899,0.455723542116631,2268,0.544276457883369
"E02000698",16,304,810,1224,621,124,11,3110,0.00514469453376206,0.0977491961414791,0.260450160771704,0.393569131832797,0.19967845659164,0.0398713826366559,0.00353697749196141,1130,0.363344051446945,1980,0.636655948553055
"E02000699",41,251,1048,1481,432,59,16,3328,0.0123197115384615,0.0754206730769231,0.314903846153846,0.445012019230769,0.129807692307692,0.0177283653846154,0.00480769230769231,1340,0.402644230769231,1988,0.597355769230769
"E02000700",1,345,1870,1212,254,30,9,3721,0.000268744961031981,0.0927170115560333,0.502553077129804,0.325718892770761,0.0682612201021231,0.00806234883095942,0.00241870464928783,2216,0.595538833646869,1505,0.404461166353131
"E02000701",6,199,1066,1049,353,44,12,2729,0.00219860754855258,0.0729204836936607,0.390619274459509,0.384389886405277,0.129351410773177,0.0161231220227189,0.00439721509710517,1271,0.465738365701722,1458,0.534261634298278
"E02000702",11,394,1187,1376,325,37,9,3339,0.00329439952081462,0.117999401018269,0.35549565738245,0.412099430967356,0.0973345312967955,0.0110811620245583,0.00269541778975741,1592,0.476789457921533,1747,0.523210542078467
"E02000703",3,86,642,1012,457,65,19,2284,0.00131348511383538,0.0376532399299475,0.281085814360771,0.4430823117338,0.200087565674256,0.0284588441330998,0.00831873905429072,731,0.320052539404553,1553,0.679947460595447
"E02000704",18,359,1420,1563,459,56,34,3909,0.00460475825019187,0.0918393451010489,0.36326426195958,0.399846508058327,0.117421335379893,0.0143259145561525,0.00869787669480686,1797,0.459708365310821,2112,0.540291634689179
"E02000705",0,326,733,1155,316,41,7,2578,0,0.126454615981381,0.28432893716059,0.448021722265322,0.122575640031032,0.0159038013964313,0.00271528316524438,1059,0.410783553141971,1519,0.589216446858029
"E02000706",0,373,1479,1465,389,45,18,3769,0,0.0989652427699655,0.39241178031308,0.388697267179623,0.103210400636774,0.011939506500398,0.00477580260015919,1852,0.491377023083046,1917,0.508622976916954
"E02000707",0,42,864,1144,203,19,9,2281,0,0.0184129767645769,0.378781236299868,0.501534414730381,0.0889960543621219,0.00832967996492766,0.00394563787812363,906,0.397194213064445,1375,0.602805786935555
"E02000708",5,364,668,1182,416,45,11,2691,0.00185804533630621,0.135265700483092,0.248234856930509,0.439241917502787,0.154589371980676,0.0167224080267559,0.00408769973987365,1037,0.385358602749907,1654,0.614641397250093
"E02000709",0,20,409,991,368,51,11,1850,0,0.0108108108108108,0.221081081081081,0.535675675675676,0.198918918918919,0.0275675675675676,0.00594594594594595,429,0.231891891891892,1421,0.768108108108108
"E02000710",3,215,1224,1322,388,70,19,3241,0.000925640234495526,0.066337550138846,0.377661215674175,0.407898796667695,0.119716136994755,0.0215982721382289,0.005862388151805,1442,0.444924406047516,1799,0.555075593952484
"E02000711",2,232,1576,1484,314,40,23,3671,0.000544810678289294,0.0631980386815582,0.429310814491964,0.404249523290656,0.0855352764914192,0.0108962135657859,0.00626532280032689,1810,0.493053663851811,1861,0.506946336148189
"E02000712",0,186,1289,1415,317,53,17,3277,0,0.056759231003967,0.39334757400061,0.431797375648459,0.0967348184314922,0.0161733292645713,0.00518767165090021,1475,0.450106805004577,1802,0.549893194995423
"E02000713",0,33,452,1005,340,43,11,1884,0,0.017515923566879,0.239915074309979,0.53343949044586,0.180467091295117,0.0228237791932059,0.00583864118895966,485,0.257430997876858,1399,0.742569002123142
"E02000714",1,249,908,1228,331,35,11,2763,0.000361925443358668,0.0901194353963084,0.328628302569671,0.444444444444444,0.119797321751719,0.0126673905175534,0.00398117987694535,1158,0.419109663409338,1605,0.580890336590662
"E02000715",2,67,850,1163,235,30,5,2352,0.000850340136054422,0.0284863945578231,0.361394557823129,0.494472789115646,0.0999149659863946,0.0127551020408163,0.00212585034013605,919,0.390731292517007,1433,0.609268707482993
"E02000716",4,44,713,1201,286,20,6,2274,0.00175901495162709,0.019349164467898,0.313544415127529,0.528144239226033,0.125769569041337,0.00879507475813544,0.00263852242744063,761,0.334652594547054,1513,0.665347405452946
"E02000717",0,80,891,1197,313,22,18,2521,0,0.0317334391114637,0.353431178103927,0.474811582705276,0.124157080523602,0.00872669575565252,0.00714002380007933,971,0.385164617215391,1550,0.614835382784609
"E02000718",0,182,1127,828,178,16,6,2337,0,0.077877620881472,0.482242190842961,0.354300385109114,0.0761660248181429,0.00684638425331622,0.00256739409499358,1309,0.560119811724433,1028,0.439880188275567
"E02000719",1,291,1150,1296,285,42,17,3082,0.000324464633354964,0.0944192083062946,0.373134328358209,0.420506164828034,0.0924724205061648,0.0136275146009085,0.00551589876703439,1442,0.467878001297859,1640,0.532121998702141
"E02000720",1,37,399,1188,324,23,10,1982,0.000504540867810293,0.0186680121089808,0.201311806256307,0.599394550958628,0.163471241170535,0.0116044399596367,0.00504540867810293,437,0.220484359233098,1545,0.779515640766902
"E02000721",3,361,803,1436,402,40,17,3062,0.000979751796211626,0.117896799477466,0.262246897452645,0.468974526453299,0.131286740692358,0.0130633572828217,0.00555192684519922,1167,0.381123448726323,1895,0.618876551273677
"E02000722",0,333,1184,1300,307,34,9,3167,0,0.105146826649826,0.373855383643827,0.410483107041364,0.0969371645089991,0.0107357120303126,0.00284180612567098,1517,0.479002210293653,1650,0.520997789706347
"E02000723",5,36,528,1465,428,41,11,2514,0.00198886237072395,0.0143198090692124,0.210023866348449,0.582736674622116,0.17024661893397,0.0163086714399364,0.00437549721559268,569,0.226332537788385,1945,0.773667462211615
"E02000724",1,48,506,1401,332,31,10,2329,0.0004293688278231,0.0206097037355088,0.217260626878489,0.601545727780163,0.142550450837269,0.0133104336625161,0.004293688278231,555,0.238299699441821,1774,0.761700300558179
"E02000725",6,1030,2115,1333,229,19,15,4747,0.00126395618285233,0.216979144722983,0.445544554455446,0.280808931957025,0.0482409943121972,0.0040025279123657,0.00315989045713082,3151,0.663787655361281,1596,0.336212344638719
"E02000727",0,91,648,1186,311,26,7,2269,0,0.0401057734684883,0.285588364918466,0.522697223446452,0.137064786249449,0.0114587924195681,0.00308505949757602,739,0.325694138386955,1530,0.674305861613045
"E02000728",0,3,571,1335,285,17,11,2222,0,0.00135013501350135,0.256975697569757,0.600810081008101,0.128262826282628,0.00765076507650765,0.00495049504950495,574,0.258325832583258,1648,0.741674167416742
"E02000729",0,112,571,1089,266,36,5,2079,0,0.0538720538720539,0.274651274651275,0.523809523809524,0.127946127946128,0.0173160173160173,0.00240500240500241,683,0.328523328523328,1396,0.671476671476671
"E02000730",0,56,604,1270,329,41,15,2315,0,0.0241900647948164,0.260907127429806,0.548596112311015,0.142116630669546,0.0177105831533477,0.00647948164146868,660,0.285097192224622,1655,0.714902807775378
"E02000731",1,540,701,1613,424,36,27,3342,0.000299222022740874,0.161579892280072,0.209754637941352,0.482645122681029,0.12687013764213,0.0107719928186715,0.00807899461400359,1242,0.371633752244165,2100,0.628366247755835
"E02000732",1,762,898,967,223,17,6,2874,0.00034794711203897,0.265135699373695,0.312456506610995,0.336464857341684,0.0775922059846903,0.00591510090466249,0.00208768267223382,1661,0.577940153096729,1213,0.422059846903271
"E02000733",1,210,1595,1226,245,14,10,3301,0.000302938503483793,0.0636170857315965,0.48318691305665,0.37140260527113,0.0742199333535292,0.0042411390487731,0.00302938503483793,1806,0.54710693729173,1495,0.45289306270827
"E02000734",0,293,1087,902,178,18,4,2482,0,0.118049959709911,0.43795326349718,0.363416599516519,0.0717163577759871,0.0072522159548751,0.0016116035455278,1380,0.556003223207091,1102,0.443996776792909
"E02000735",8,222,736,1267,295,24,9,2561,0.00312377977352597,0.0866848887153456,0.287387739164389,0.494728621632175,0.11518937914877,0.0093713393205779,0.00351425224521671,966,0.37719640765326,1595,0.62280359234674
"E02000736",1,34,764,1472,258,31,9,2569,0.000389256520046711,0.0132347216815882,0.297391981315687,0.572985597508758,0.100428182172051,0.012066952121448,0.0035033086804204,799,0.311015959517322,1770,0.688984040482678
"E02000737",5,287,866,1527,349,42,21,3097,0.00161446561188247,0.0926703261220536,0.279625443978043,0.493057797868905,0.112689699709396,0.0135615111398127,0.00678075556990636,1158,0.373910235711979,1939,0.626089764288021
"E02000738",0,419,460,1451,384,41,16,2771,0,0.151208949837604,0.16600505232768,0.523637675929267,0.138578130638759,0.0147961024900758,0.00577408877661494,879,0.317214002165283,1892,0.682785997834717
"E02000739",2,277,942,1086,263,24,6,2600,0.000769230769230769,0.106538461538462,0.362307692307692,0.417692307692308,0.101153846153846,0.00923076923076923,0.00230769230769231,1221,0.469615384615385,1379,0.530384615384615
"E02000740",1,406,1030,1032,232,30,13,2744,0.000364431486880466,0.147959183673469,0.37536443148688,0.376093294460641,0.0845481049562682,0.010932944606414,0.00473760932944606,1437,0.52368804664723,1307,0.47631195335277
"E02000741",0,40,757,1546,301,22,17,2683,0,0.0149086843086098,0.28214685054044,0.576220648527767,0.112187849422288,0.00819977636973537,0.00633619083115915,797,0.29705553484905,1886,0.70294446515095
"E02000742",1,30,733,1336,310,37,10,2457,0.000407000407000407,0.0122100122100122,0.298331298331298,0.543752543752544,0.126170126170126,0.0150590150590151,0.00407000407000407,764,0.310948310948311,1693,0.689051689051689
"E02000743",15,1293,1473,1141,191,20,8,4141,0.00362231345085728,0.312243419463898,0.355711180874185,0.275537309828544,0.0461241246075827,0.00482975126780971,0.00193190050712388,2781,0.67157691378894,1360,0.32842308621106
"E02000744",0,566,1207,1508,286,37,20,3624,0,0.156181015452539,0.333057395143488,0.416114790286976,0.0789183222958057,0.0102097130242826,0.00551876379690949,1773,0.489238410596026,1851,0.510761589403974
"E02000745",6,428,1290,1015,236,22,5,3002,0.00199866755496336,0.14257161892072,0.429713524317122,0.338107928047968,0.0786142571618921,0.00732844770153231,0.0016655562958028,1724,0.574283810792805,1278,0.425716189207195
"E02000746",0,1840,1505,602,174,13,4,4138,0,0.444659255679072,0.363702271628806,0.145480908651522,0.042049299178347,0.00314161430642823,0.00096665055582407,3345,0.808361527307878,793,0.191638472692122
"E02000747",1,5270,2192,931,132,20,12,8558,0.000116849731245618,0.615798083664408,0.256134610890395,0.10878709978967,0.0154241645244216,0.00233699462491236,0.00140219677494742,7463,0.872049544286048,1095,0.127950455713952
"E02000748",0,15,1188,867,157,25,0,2252,0,0.0066607460035524,0.52753108348135,0.384991119005329,0.0697158081705151,0.011101243339254,0,1203,0.534191829484902,1049,0.465808170515098
"E02000749",5,532,1607,1020,141,4,4,3313,0.00150920615756112,0.160579535164503,0.485058859040145,0.307878056142469,0.0425596136432237,0.0012073649260489,0.0012073649260489,2144,0.647147600362209,1169,0.35285239963779
"E02000751",3,172,971,1379,668,166,20,3379,0.000887836638058597,0.0509026339153596,0.287363125184966,0.408108907960935,0.197691624741048,0.0491269606392424,0.00591891092039065,1146,0.339153595738384,2233,0.660846404261616
"E02000752",18,766,707,1169,262,48,17,2987,0.00602611315701373,0.256444593237362,0.236692333444928,0.391362571141614,0.0877134248409776,0.0160696350853699,0.00569132909273519,1491,0.499163039839304,1496,0.500836960160696
"E02000753",1,36,509,1020,284,49,5,1904,0.000525210084033613,0.0189075630252101,0.267331932773109,0.535714285714286,0.149159663865546,0.0257352941176471,0.00262605042016807,546,0.286764705882353,1358,0.713235294117647
"E02000754",2,63,535,1088,327,35,6,2056,0.000972762645914397,0.0306420233463035,0.260214007782101,0.529182879377432,0.159046692607004,0.0170233463035019,0.00291828793774319,600,0.291828793774319,1456,0.708171206225681
"E02000755",1,27,453,871,301,40,9,1702,0.000587544065804935,0.0158636897767333,0.266157461809636,0.511750881316099,0.176850763807286,0.0235017626321974,0.00528789659224442,481,0.282608695652174,1221,0.717391304347826
"E02000756",0,332,1521,2049,565,45,20,4532,0,0.0732568402471315,0.335613415710503,0.452118270079435,0.124669020300088,0.00992939099735216,0.00441306266548985,1853,0.408870255957635,2679,0.591129744042365
"E02000757",8,624,1673,1647,746,116,21,4835,0.00165460186142709,0.129058945191313,0.346018614270941,0.340641158221303,0.154291623578077,0.0239917269906929,0.00434332988624612,2305,0.476732161323681,2530,0.523267838676318
"E02000758",0,248,431,765,288,32,5,1769,0,0.140192198982476,0.243640474844545,0.432447710570944,0.16280384397965,0.0180893159977388,0.00282645562464669,679,0.383832673827021,1090,0.616167326172979
"E02000759",13,247,1068,1961,728,108,11,4136,0.0031431334622824,0.0597195357833656,0.258220502901354,0.474129593810445,0.176015473887814,0.0261121856866538,0.00265957446808511,1328,0.321083172147002,2808,0.678916827852998
"E02000760",0,59,717,1039,319,41,12,2187,0,0.0269775948788294,0.327846364883402,0.475080018289895,0.14586191129401,0.0187471422039323,0.00548696844993141,776,0.354823959762231,1411,0.645176040237769
"E02000762",0,65,398,789,275,48,7,1582,0,0.0410872313527181,0.251580278128951,0.498735777496839,0.173830594184576,0.0303413400758533,0.00442477876106195,463,0.292667509481669,1119,0.707332490518331
"E02000763",16,200,653,937,261,34,11,2112,0.00757575757575758,0.0946969696969697,0.309185606060606,0.443655303030303,0.123579545454545,0.0160984848484848,0.00520833333333333,869,0.411458333333333,1243,0.588541666666667
"E02000764",3,235,1783,2098,780,123,29,5051,0.000593941793704217,0.0465254405068303,0.352999406058206,0.415363294397149,0.154424866363096,0.0243516135418729,0.00574143733914076,2021,0.400118788358741,3030,0.599881211641259
"E02000765",41,283,571,809,231,38,8,1981,0.0206966178697627,0.142857142857143,0.288238263503281,0.408379606259465,0.11660777385159,0.0191822311963655,0.00403836446239273,895,0.451792024230187,1086,0.548207975769813
"E02000767",0,158,754,1083,276,31,3,2305,0,0.0685466377440347,0.327114967462039,0.469848156182213,0.119739696312364,0.0134490238611714,0.00130151843817787,912,0.395661605206074,1393,0.604338394793926
"E02000768",2,81,406,678,360,64,12,1603,0.00124766063630692,0.0505302557704304,0.253275109170306,0.422956955708047,0.224578914535246,0.0399251403618216,0.00748596381784155,489,0.305053025577043,1114,0.694946974422957
"E02000770",2,29,589,1072,286,41,12,2031,0.000984736582964057,0.0142786804529788,0.290004923682915,0.527818808468735,0.14081733136386,0.0201870999507632,0.00590841949778434,620,0.305268340718858,1411,0.694731659281142
"E02000772",2,127,820,1070,278,30,11,2338,0.000855431993156544,0.0543199315654406,0.350727117194183,0.457656116338751,0.11890504704876,0.0128314798973482,0.00470487596236099,949,0.40590248075278,1389,0.59409751924722
"E02000773",2,294,918,883,248,29,15,2389,0.000837170364169108,0.123064043532859,0.384261197153621,0.369610715780661,0.103809125156969,0.0121389702804521,0.00627877773126831,1214,0.508162411050649,1175,0.491837588949351
"E02000774",0,223,532,1148,301,35,9,2248,0,0.0991992882562278,0.236654804270463,0.51067615658363,0.133896797153025,0.0155693950177936,0.00400355871886121,755,0.33585409252669,1493,0.66414590747331
"E02000776",0,47,469,990,305,38,15,1864,0,0.0252145922746781,0.251609442060086,0.531115879828326,0.16362660944206,0.0203862660944206,0.00804721030042918,516,0.276824034334764,1348,0.723175965665236
"E02000777",0,20,464,735,385,75,14,1693,0,0.0118133490844654,0.274069698759598,0.434140578854105,0.22740696987596,0.0443000590667454,0.00826934435912581,484,0.285883047844064,1209,0.714116952155936
"E02000779",1,183,949,1667,387,69,16,3272,0.000305623471882641,0.0559290953545232,0.290036674816626,0.509474327628362,0.118276283618582,0.0210880195599022,0.00488997555012225,1133,0.346271393643032,2139,0.653728606356968
"E02000781",2,86,864,1777,597,66,15,3407,0.000587026709715292,0.0252421485177576,0.253595538597006,0.521573231582037,0.175227472850015,0.0193718814206046,0.00440270032286469,952,0.279424713824479,2455,0.720575286175521
"E02000782",0,922,1239,1444,283,26,11,3925,0,0.234904458598726,0.315668789808917,0.367898089171975,0.0721019108280255,0.00662420382165605,0.00280254777070064,2161,0.550573248407643,1764,0.449426751592357
"E02000783",0,147,948,831,152,10,4,2092,0,0.0702676864244742,0.453154875717017,0.397227533460803,0.0726577437858509,0.00478011472275335,0.00191204588910134,1095,0.523422562141491,997,0.476577437858509
"E02000784",5,168,1390,1547,651,107,15,3883,0.00128766417718259,0.0432655163533351,0.35797064125676,0.398403296420294,0.167653875869173,0.0275560133917074,0.00386299253154777,1563,0.402523821787278,2320,0.597476178212722
"E02000785",4,96,1071,1592,923,170,37,3893,0.00102748522989982,0.0246596455175957,0.275109170305677,0.408939121500128,0.237092216799383,0.0436681222707424,0.00950423837657334,1171,0.300796301053172,2722,0.699203698946828
"E02000786",11,245,1625,2096,679,91,21,4768,0.00230704697986577,0.0513842281879195,0.340813758389262,0.439597315436242,0.142407718120805,0.0190855704697987,0.00440436241610738,1881,0.394505033557047,2887,0.605494966442953
"E02000787",44,707,1879,1727,591,73,20,5041,0.00872842689942472,0.140249950406665,0.37274350327316,0.34259075580242,0.117238643126364,0.0144812537195001,0.00396746677246578,2630,0.52172188057925,2411,0.47827811942075
"E02000788",6,57,953,1544,636,104,26,3326,0.00180396873120866,0.0171377029464823,0.286530366806975,0.464221286831028,0.191220685508118,0.0312687913409501,0.00781719783523752,1016,0.305472038484666,2310,0.694527961515334
"E02000789",3,55,1185,1154,468,87,11,2963,0.0010124873439082,0.0185622679716504,0.399932500843739,0.389470131623355,0.157948025649679,0.0293621329733378,0.00371245359433007,1243,0.419507256159298,1720,0.580492743840702
"E02000790",0,170,691,1104,492,59,22,2538,0,0.0669818754925138,0.272261623325453,0.434988179669031,0.193853427895981,0.0232466509062254,0.0086682427107959,861,0.339243498817967,1677,0.660756501182033
"E02000791",4,169,1087,1510,650,81,23,3524,0.00113507377979569,0.0479568671963678,0.308456299659478,0.428490351872872,0.184449489216799,0.0229852440408627,0.0065266742338252,1260,0.357548240635641,2264,0.642451759364359
"E02000792",6,87,923,1319,521,88,20,2964,0.00202429149797571,0.0293522267206478,0.31140350877193,0.445006747638327,0.175775978407557,0.0296896086369771,0.0067476383265857,1016,0.342780026990553,1948,0.657219973009447
"E02000793",12,99,593,1074,438,56,21,2293,0.00523331879633668,0.0431748800697776,0.258613170518971,0.468382032272133,0.191016136066289,0.0244221543829045,0.00915830789358918,704,0.307021369385085,1589,0.692978630614915
"E02000794",4,269,592,1021,438,71,22,2417,0.00165494414563508,0.111294993793959,0.244931733553993,0.422424493173355,0.181216383947042,0.0293752585850228,0.00910219280099297,865,0.357881671493587,1552,0.642118328506413
"E02000795",4,112,485,864,432,81,10,1988,0.00201207243460765,0.0563380281690141,0.243963782696177,0.434607645875252,0.217303822937626,0.0407444668008048,0.00503018108651911,601,0.302313883299799,1387,0.697686116700201
"E02000796",5,158,961,1392,487,64,17,3084,0.00162127107652399,0.0512321660181582,0.311608300907912,0.45136186770428,0.157911802853437,0.0207522697795071,0.00551232166018158,1124,0.364461738002594,1960,0.635538261997406
"E02000797",7,243,1168,1508,550,56,15,3547,0.00197349873132224,0.0685085988159008,0.329292359740626,0.425148012404849,0.155060614603891,0.015787989850578,0.00422892585283338,1418,0.399774457287849,2129,0.600225542712151
"E02000798",11,121,1007,1765,568,65,11,3548,0.00310033821871477,0.0341037204058625,0.283821871476888,0.497463359639233,0.160090191657272,0.0183201803833145,0.00310033821871477,1139,0.321025930101466,2409,0.678974069898534
"E02000799",7,78,714,794,341,63,5,2002,0.0034965034965035,0.038961038961039,0.356643356643357,0.396603396603397,0.17032967032967,0.0314685314685315,0.0024975024975025,799,0.399100899100899,1203,0.600899100899101
"E02000800",4,40,531,834,186,21,3,1619,0.00247066090179123,0.0247066090179123,0.327980234712786,0.515132798023471,0.114885731933292,0.012970969734404,0.00185299567634342,575,0.355157504632489,1044,0.644842495367511
"E02000801",6,478,843,1061,428,63,16,2895,0.00207253886010363,0.165112262521589,0.29119170984456,0.366493955094991,0.147841105354059,0.0217616580310881,0.00552677029360967,1327,0.458376511226252,1568,0.541623488773748
"E02000802",7,148,893,1041,482,74,19,2664,0.00262762762762763,0.0555555555555556,0.33521021021021,0.390765765765766,0.180930930930931,0.0277777777777778,0.00713213213213213,1048,0.393393393393393,1616,0.606606606606607
"E02000803",0,163,1444,1221,457,78,17,3380,0,0.0482248520710059,0.427218934911243,0.361242603550296,0.135207100591716,0.0230769230769231,0.00502958579881657,1607,0.475443786982248,1773,0.524556213017751
"E02000804",7,150,992,1213,437,75,13,2887,0.00242466227918254,0.0519570488396259,0.343609282992726,0.420159334949775,0.15136820228611,0.025978524419813,0.00450294423276758,1149,0.397990994111534,1738,0.602009005888466
"E02000805",5,633,1695,1478,616,105,26,4558,0.00109697235629662,0.138876700307152,0.371873628784555,0.324265028521281,0.135146994295744,0.023036419482229,0.00570425625274243,2333,0.511847301448004,2225,0.488152698551997
"E02000806",10,156,1161,1372,660,110,17,3486,0.00286861732644865,0.044750430292599,0.333046471600688,0.393574297188755,0.189328743545611,0.0315547905909352,0.00487664945496271,1327,0.380665519219736,2159,0.619334480780264
"E02000807",33,604,2384,934,289,31,5,4280,0.00771028037383178,0.141121495327103,0.557009345794393,0.218224299065421,0.0675233644859813,0.00724299065420561,0.00116822429906542,3021,0.705841121495327,1259,0.294158878504673
"E02000808",2,2642,2778,1031,255,30,8,6746,0.000296471983397569,0.391639490068189,0.411799584939223,0.152831307441447,0.03780017788319,0.00444707975096353,0.00118588793359028,5422,0.803735546990809,1324,0.196264453009191
"E02000810",1,2210,1919,899,148,11,5,5193,0.000192566917003659,0.425572886578086,0.369535913730021,0.173117658386289,0.0284999037165415,0.00211823608704025,0.000962834585018294,4130,0.795301367225111,1063,0.204698632774889
"E02000812",0,1394,2046,1183,229,26,16,4894,0,0.284838577850429,0.418062934205149,0.241724560686555,0.0467919901920719,0.00531262770739681,0.00326930935839804,3440,0.702901512055578,1454,0.297098487944422
"E02000813",5,874,2210,1056,245,23,8,4421,0.00113096584483149,0.197692829676544,0.499886903415517,0.23885998642841,0.0554173263967428,0.00520244288622484,0.00180954535173038,3089,0.698710698936892,1332,0.301289301063108
"E02000814",4,1416,2522,1005,185,32,2,5166,0.000774293457220286,0.274099883855981,0.488192024777391,0.194541231126597,0.0358110723964382,0.00619434765776229,0.000387146728610143,3942,0.763066202090592,1224,0.236933797909408
"E02000815",20,2243,1508,808,235,32,2,4848,0.00412541254125413,0.46266501650165,0.311056105610561,0.166666666666667,0.048473597359736,0.0066006600660066,0.000412541254125413,3771,0.777846534653465,1077,0.222153465346535
"E02000816",2,855,2059,1141,170,27,8,4262,0.000469263256687001,0.200610042233693,0.483106522759268,0.267714687939934,0.0398873768183951,0.00633505396527452,0.00187705302674801,2916,0.684185828249648,1346,0.315814171750352
"E02000817",4,597,1456,420,105,2,1,2585,0.00154738878143133,0.230947775628627,0.563249516441006,0.16247582205029,0.0406189555125725,0.000773694390715667,0.000386847195357834,2057,0.795744680851064,528,0.204255319148936
"E02000818",1,1922,1384,1141,260,32,12,4752,0.00021043771043771,0.404461279461279,0.291245791245791,0.240109427609428,0.0547138047138047,0.00673400673400673,0.00252525252525253,3307,0.695917508417508,1445,0.304082491582492
"E02000819",0,273,1676,875,214,39,12,3089,0,0.0883781158951117,0.54257041113629,0.283263191971512,0.0692780835221755,0.0126254451278731,0.00388475234703788,1949,0.630948527031402,1140,0.369051472968598
"E02000820",0,1371,1504,1134,231,28,7,4275,0,0.320701754385965,0.351812865497076,0.265263157894737,0.0540350877192982,0.00654970760233918,0.0016374269005848,2875,0.672514619883041,1400,0.327485380116959
"E02000821",5,513,896,884,231,20,10,2559,0.00195388823759281,0.200468933177022,0.350136772176631,0.345447440406409,0.0902696365767878,0.00781555295037124,0.00390777647518562,1414,0.552559593591247,1145,0.447440406408753
"E02000822",0,635,1249,986,316,34,12,3232,0,0.196472772277228,0.38644801980198,0.305074257425743,0.0977722772277228,0.010519801980198,0.00371287128712871,1884,0.582920792079208,1348,0.417079207920792
"E02000823",11,457,1219,1054,291,35,11,3078,0.00357374918778428,0.148473034437947,0.396036387264457,0.342430149447693,0.094541910331384,0.01137102014295,0.00357374918778428,1687,0.548083170890188,1391,0.451916829109812
"E02000824",2,823,1374,905,188,16,12,3320,0.000602409638554217,0.24789156626506,0.413855421686747,0.272590361445783,0.0566265060240964,0.00481927710843374,0.0036144578313253,2199,0.662349397590361,1121,0.337650602409639
"E02000825",0,965,1824,492,159,13,4,3457,0,0.279143766271334,0.527625108475557,0.142319930575644,0.0459936361006653,0.00376048597049465,0.00115707260630605,2789,0.80676887474689,668,0.19323112525311
"E02000826",0,679,1324,1124,288,28,17,3460,0,0.196242774566474,0.382658959537572,0.32485549132948,0.0832369942196532,0.00809248554913295,0.00491329479768786,2003,0.578901734104046,1457,0.421098265895954
"E02000827",3,856,1601,1318,326,42,15,4161,0.000720980533525595,0.205719778899303,0.384763278058159,0.316750781062245,0.0783465513097813,0.0100937274693583,0.00360490266762797,2460,0.591204037490988,1701,0.408795962509012
"E02000828",1,705,1259,1011,288,30,14,3308,0.00030229746070133,0.213119709794438,0.380592503022975,0.305622732769045,0.0870616686819831,0.0090689238210399,0.00423216444981862,1965,0.594014510278114,1343,0.405985489721886
"E02000829",6,624,1807,1530,354,35,15,4371,0.00137268359643102,0.142759094028826,0.413406543125143,0.350034317089911,0.0809883321894303,0.00800732097918097,0.00343170899107756,2437,0.5575383207504,1934,0.4424616792496
"E02000830",5,171,1470,1586,524,86,20,3862,0.00129466597617815,0.0442775763852926,0.380631796996375,0.410668047643708,0.13568099430347,0.0222682547902641,0.00517866390471258,1646,0.426204039357846,2216,0.573795960642154
"E02000831",4,490,1416,1658,525,66,21,4180,0.000956937799043062,0.117224880382775,0.338755980861244,0.396650717703349,0.125598086124402,0.0157894736842105,0.00502392344497608,1910,0.456937799043062,2270,0.543062200956938
"E02000832",13,361,1569,1458,364,40,19,3824,0.00339958158995816,0.0944037656903766,0.410303347280335,0.381276150627615,0.0951882845188285,0.0104602510460251,0.00496861924686192,1943,0.508106694560669,1881,0.491893305439331
"E02000833",8,133,1134,885,231,39,4,2434,0.00328677074774034,0.0546425636811832,0.465899753492194,0.363599013968776,0.0949055053410025,0.0160230073952342,0.00164338537387017,1275,0.523829087921117,1159,0.476170912078882
"E02000834",0,314,1429,1963,638,83,19,4446,0,0.0706252811515969,0.321412505623032,0.441520467836257,0.143499775078722,0.0186684660368871,0.00427350427350427,1743,0.392037786774629,2703,0.607962213225371
"E02000835",21,115,783,1242,402,56,17,2636,0.00796661608497724,0.0436267071320182,0.297040971168437,0.471168437025797,0.152503793626707,0.0212443095599393,0.00644916540212443,919,0.348634294385432,1717,0.651365705614568
"E02000836",8,63,759,1690,621,84,18,3243,0.00246685168054271,0.0194264569842738,0.234042553191489,0.521122417514647,0.191489361702128,0.0259019426456984,0.00555041628122109,830,0.255935861856306,2413,0.744064138143694
"E02000837",16,66,440,1206,794,163,16,2701,0.00592373195112921,0.024435394298408,0.162902628656053,0.446501295816364,0.293965198074787,0.0603480192521288,0.00592373195112921,522,0.193261754905591,2179,0.806738245094409
"E02000838",0,113,1292,1727,567,78,16,3793,0,0.0297917215924071,0.340627471658318,0.455312417611389,0.149485895069866,0.0205641972053783,0.00421829686264171,1405,0.370419193250725,2388,0.629580806749275
"E02000839",2,129,1149,1384,571,73,12,3320,0.000602409638554217,0.038855421686747,0.346084337349398,0.416867469879518,0.171987951807229,0.0219879518072289,0.0036144578313253,1280,0.385542168674699,2040,0.614457831325301
"E02000840",7,252,1179,1081,191,26,4,2740,0.00255474452554745,0.091970802919708,0.43029197080292,0.394525547445255,0.0697080291970803,0.00948905109489051,0.00145985401459854,1438,0.524817518248175,1302,0.475182481751825
"E02000841",0,103,1134,1141,197,32,15,2622,0,0.0392829900839054,0.432494279176201,0.435163996948894,0.0751334858886346,0.0122044241037376,0.005720823798627,1237,0.471777269260107,1385,0.528222730739893
"E02000842",8,70,436,983,459,50,17,2023,0.00395452298566485,0.0346020761245675,0.215521502718735,0.485912011863569,0.226890756302521,0.0247157686604053,0.00840336134453781,514,0.254078101828967,1509,0.745921898171033
"E02000843",8,1377,1192,1256,344,39,11,4227,0.00189259522119707,0.325762952448545,0.281996687958363,0.297137449727939,0.0813815945114739,0.0092264017033357,0.00260231842914597,2577,0.609652235628105,1650,0.390347764371895
"E02000844",6,198,912,1112,317,41,20,2606,0.00230237912509593,0.0759785111281658,0.349961627014582,0.426707597851113,0.121642363775902,0.0157329240214889,0.00767459708365311,1116,0.428242517267843,1490,0.571757482732157
"E02000845",55,331,970,1211,441,65,16,3089,0.0178051149239236,0.107154418905795,0.314017481385562,0.392036257688572,0.142764648753642,0.0210424085464552,0.0051796697960505,1356,0.43897701521528,1733,0.56102298478472
"E02000846",2,127,560,941,387,75,13,2105,0.000950118764845606,0.060332541567696,0.26603325415677,0.447030878859857,0.183847980997625,0.0356294536817102,0.00617577197149644,689,0.327315914489311,1416,0.672684085510689
"E02000847",5,154,827,1232,543,78,16,2855,0.00175131348511384,0.0539404553415061,0.289667250437828,0.431523642732049,0.190192644483363,0.0273204903677758,0.00560420315236427,986,0.345359019264448,1869,0.654640980735552
"E02000848",2,38,461,993,440,61,18,2013,0.000993541977148535,0.0188772975658222,0.229011425732737,0.493293591654247,0.218579234972678,0.0303030303030303,0.00894187779433681,501,0.248882265275708,1512,0.751117734724292
"E02000849",4,143,740,1044,463,74,9,2477,0.00161485668146952,0.0577311263625353,0.298748486071861,0.421477593863545,0.186919660880097,0.0298748486071861,0.00363342753330642,887,0.358094469115866,1590,0.641905530884134
"E02000850",24,100,835,1393,564,67,15,2998,0.00800533689126084,0.0333555703802535,0.278519012675117,0.464643095396931,0.18812541694463,0.0223482321547698,0.00500333555703803,959,0.319879919946631,2039,0.680120080053369
"E02000851",1,1442,2144,1546,525,75,18,5751,0.000173882802990784,0.250739001912711,0.372804729612241,0.268822813423752,0.0912884715701617,0.0130412102243088,0.00312989045383412,3587,0.623717614327943,2164,0.376282385672057
"E02000852",5,101,788,1248,521,70,28,2761,0.00181093806591815,0.0365809489315465,0.2854038391887,0.452010141253169,0.188699746468671,0.025353132922854,0.0101412531691416,894,0.323795726186164,1867,0.676204273813836
"E02000853",4,124,784,1233,475,63,13,2696,0.00148367952522255,0.0459940652818991,0.29080118694362,0.457344213649852,0.176186943620178,0.0233679525222552,0.00482195845697329,912,0.338278931750742,1784,0.661721068249258
"E02000854",22,138,740,1051,528,90,21,2590,0.00849420849420849,0.0532818532818533,0.285714285714286,0.405791505791506,0.203861003861004,0.0347490347490347,0.00810810810810811,900,0.347490347490347,1690,0.652509652509653
"E02000855",7,228,555,996,540,92,17,2435,0.00287474332648871,0.0936344969199179,0.227926078028747,0.409034907597536,0.2217659137577,0.037782340862423,0.00698151950718686,790,0.324435318275154,1645,0.675564681724846
"E02000856",6,360,920,1277,714,114,24,3415,0.00175695461200586,0.105417276720351,0.269399707174231,0.37393850658858,0.209077598828697,0.0333821376281113,0.00702781844802343,1286,0.376573938506589,2129,0.623426061493411
"E02000857",0,288,1915,1515,527,96,23,4364,0,0.0659945004582951,0.438817598533456,0.347158570119157,0.120760769935839,0.0219981668194317,0.00527039413382218,2203,0.504812098991751,2161,0.495187901008249
"E02000858",3,273,1907,662,201,33,2,3081,0.000973709834469328,0.0886075949367089,0.61895488477767,0.214865303472898,0.065238558909445,0.0107108081791626,0.000649139889646219,2183,0.708536189548848,898,0.291463810451152
"E02000859",18,314,1036,959,555,118,17,3017,0.00596619158104077,0.104076897580378,0.34338747099768,0.317865429234339,0.183957573748757,0.0391117003646006,0.00563473649320517,1368,0.453430560159098,1649,0.546569439840901
"E02000860",0,490,2436,1235,400,63,6,4630,0,0.105831533477322,0.526133909287257,0.266738660907127,0.0863930885529158,0.0136069114470842,0.00129589632829374,2926,0.631965442764579,1704,0.368034557235421
"E02000861",41,95,415,819,461,106,7,1944,0.0210905349794239,0.0488683127572016,0.213477366255144,0.421296296296296,0.237139917695473,0.0545267489711934,0.00360082304526749,551,0.28343621399177,1393,0.716563786008231
"E02000863",15,128,408,687,304,62,10,1614,0.00929368029739777,0.0793060718711276,0.252788104089219,0.425650557620818,0.188351920693928,0.0384138785625774,0.00619578686493185,551,0.341387856257745,1063,0.658612143742255
"E02000864",22,1759,2078,676,216,39,4,4794,0.00458906967042136,0.366916979557781,0.43345848977889,0.141009595327493,0.0450563204005006,0.0081351689612015,0.000834376303712975,3859,0.804964539007092,935,0.195035460992908
"E02000865",1,493,1319,787,132,14,9,2755,0.000362976406533575,0.178947368421053,0.478765880217786,0.285662431941924,0.0479128856624319,0.00508166969147005,0.00326678765880218,1813,0.658076225045372,942,0.341923774954628
"E02000866",3,424,1598,1468,384,31,12,3920,0.00076530612244898,0.108163265306122,0.40765306122449,0.374489795918367,0.0979591836734694,0.00790816326530612,0.00306122448979592,2025,0.516581632653061,1895,0.483418367346939
"E02000867",6,1901,2683,1122,325,23,5,6065,0.000989282769991756,0.313437757625721,0.44237427864798,0.184995877988458,0.0535861500412201,0.00379225061830173,0.000824402308326463,4590,0.756801319043693,1475,0.243198680956307
"E02000868",1,470,1277,850,217,42,15,2872,0.000348189415041783,0.163649025069638,0.444637883008357,0.295961002785515,0.0755571030640668,0.0146239554317549,0.00522284122562674,1748,0.608635097493036,1124,0.391364902506964
"E02000869",0,356,1138,764,195,13,8,2474,0,0.143896523848019,0.459983831851253,0.308811641067098,0.0788197251414713,0.00525464834276475,0.00323362974939369,1494,0.603880355699272,980,0.396119644300727
"E02000870",1,75,987,904,227,24,10,2228,0.000448833034111311,0.0336624775583483,0.442998204667864,0.405745062836625,0.101885098743268,0.0107719928186715,0.00448833034111311,1063,0.477109515260323,1165,0.522890484739677
"E02000871",44,2573,2005,594,91,6,1,5314,0.00828001505457283,0.484192698532179,0.377305231464057,0.111780203236733,0.0171245765901393,0.0011290929619872,0.000188182160331201,4622,0.869777945050809,692,0.130222054949191
"E02000872",3,972,1691,1022,241,34,13,3976,0.000754527162977867,0.244466800804829,0.425301810865191,0.257042253521127,0.0606136820925553,0.0085513078470825,0.00326961770623742,2666,0.670523138832998,1310,0.329476861167002
"E02000873",0,738,1439,760,117,10,3,3067,0,0.240626018910988,0.469188131724812,0.247799152266058,0.0381480273883274,0.0032605151613955,0.00097815454841865,2177,0.7098141506358,890,0.2901858493642
"E02000874",2,479,1094,698,136,8,4,2421,0.000826104915324246,0.197852127220157,0.451879388682363,0.288310615448162,0.0561751342420487,0.00330441966129698,0.00165220983064849,1575,0.650557620817844,846,0.349442379182156
"E02000875",0,2157,2708,917,186,9,4,5981,0,0.360642033104832,0.452767095803377,0.153318843002842,0.0310984785152984,0.00150476508944992,0.000668784484199967,4865,0.813409128908209,1116,0.186590871091791
"E02000876",0,407,1356,996,434,51,24,3268,0,0.124541003671971,0.414932680538556,0.304773561811506,0.132802937576499,0.0156058751529988,0.00734394124847001,1763,0.539473684210526,1505,0.460526315789474
"E02000877",0,2026,2409,1075,134,9,1,5654,0,0.35833038556774,0.426070038910506,0.190130880792359,0.0237000353731871,0.00159179342058719,0.000176865935620799,4435,0.784400424478245,1219,0.215599575521755
"E02000878",0,1308,2489,1253,345,48,22,5465,0,0.239341262580055,0.45544373284538,0.229277218664227,0.0631290027447392,0.00878316559926807,0.0040256175663312,3797,0.694784995425435,1668,0.305215004574565
"E02000879",0,442,1550,848,184,19,8,3051,0,0.144870534251065,0.508030154047853,0.277941658472632,0.0603080957063258,0.00622746640445756,0.00262209111766634,1992,0.652900688298918,1059,0.347099311701082
"E02000880",0,969,1064,846,160,21,5,3065,0,0.316150081566068,0.347145187601958,0.276019575856444,0.0522022838499184,0.00685154975530179,0.00163132137030995,2033,0.663295269168026,1032,0.336704730831974
"E02000881",12,2954,1274,784,146,14,3,5187,0.00231347599768652,0.569500674763833,0.245614035087719,0.15114709851552,0.028147291305186,0.00269905533063428,0.000578368999421631,4240,0.817428185849238,947,0.182571814150762
"E02000882",3,1077,1778,573,193,12,2,3638,0.000824628916987356,0.296041781198461,0.488730071467839,0.157504123144585,0.0530511269928532,0.00329851566794942,0.000549752611324904,2858,0.785596481583288,780,0.214403518416712
"E02000883",0,1260,1402,666,107,11,1,3447,0,0.365535248041775,0.406730490281404,0.193211488250653,0.0310414853495793,0.00319118073687264,0.000290107339715695,2662,0.77226573832318,785,0.22773426167682
"E02000884",8,2983,3210,1116,345,25,9,7696,0.00103950103950104,0.38760395010395,0.417099792099792,0.145010395010395,0.0448284823284823,0.00324844074844075,0.00116943866943867,6201,0.805743243243243,1495,0.194256756756757
"E02000885",0,308,1270,636,108,8,1,2331,0,0.132132132132132,0.544830544830545,0.272844272844273,0.0463320463320463,0.00343200343200343,0.000429000429000429,1578,0.676962676962677,753,0.323037323037323
"E02000886",0,1415,2012,778,198,22,5,4430,0,0.31941309255079,0.454176072234763,0.175620767494357,0.0446952595936795,0.00496613995485327,0.00112866817155756,3427,0.773589164785553,1003,0.226410835214447
"E02000887",9,1193,1842,1272,142,17,7,4482,0.00200803212851406,0.266175814368585,0.410977242302544,0.28380187416332,0.0316822846943329,0.00379294957608211,0.00156180276662204,3044,0.679161088799643,1438,0.320838911200357
"E02000888",0,926,2037,849,140,7,5,3964,0,0.233602421796165,0.513874873864783,0.214177598385469,0.0353178607467205,0.00176589303733602,0.00126135216952573,2963,0.747477295660949,1001,0.252522704339051
"E02000889",2,2124,2584,973,212,16,2,5913,0.000338237781160156,0.359208523592085,0.437003213258921,0.164552680534416,0.0358532048029765,0.00270590224928124,0.000338237781160156,4710,0.796549974632166,1203,0.203450025367834
"E02000890",0,368,1736,924,331,55,11,3425,0,0.107445255474453,0.506861313868613,0.26978102189781,0.0966423357664234,0.0160583941605839,0.00321167883211679,2104,0.614306569343066,1321,0.385693430656934
"E02000893",1,889,1805,755,103,18,1,3572,0.000279955207166853,0.248880179171333,0.50531914893617,0.211366181410974,0.0288353863381859,0.00503919372900336,0.000279955207166853,2695,0.75447928331467,877,0.24552071668533
"E02000894",105,815,2981,1346,210,14,3,5474,0.0191815856777494,0.148885641213007,0.544574351479722,0.245889660211911,0.0383631713554987,0.00255754475703325,0.000548045305078553,3901,0.712641578370479,1573,0.287358421629521
"E02000895",3,167,995,1129,443,69,18,2824,0.00106232294617564,0.0591359773371105,0.352337110481586,0.399787535410765,0.156869688385269,0.0244334277620397,0.00637393767705382,1165,0.412535410764872,1659,0.587464589235127
"E02000896",8,240,1017,1384,545,99,23,3316,0.00241254523522316,0.0723763570566948,0.306694813027744,0.417370325693607,0.164354644149578,0.0298552472858866,0.00693606755126659,1265,0.381483715319662,2051,0.618516284680338
"E02000897",2,175,1065,1280,367,44,9,2942,0.000679809653297077,0.0594833446634942,0.361998640380693,0.435078178110129,0.124745071380014,0.0149558123725357,0.00305914343983685,1242,0.422161794697485,1700,0.577838205302515
"E02000898",0,294,1011,962,348,60,9,2684,0,0.109538002980626,0.376676602086438,0.358420268256334,0.129657228017884,0.022354694485842,0.0033532041728763,1305,0.486214605067064,1379,0.513785394932936
"E02000899",0,143,646,1210,506,85,28,2618,0,0.0546218487394958,0.246753246753247,0.46218487394958,0.19327731092437,0.0324675324675325,0.0106951871657754,789,0.301375095492743,1829,0.698624904507257
"E02000900",4,137,690,1166,369,58,19,2443,0.00163733115022513,0.0560785918952108,0.282439623413835,0.477282030290626,0.151043798608269,0.0237413016782644,0.00777732296356938,831,0.340155546459271,1612,0.659844453540729
"E02000901",2,283,902,1338,524,73,22,3144,0.000636132315521629,0.0900127226463104,0.286895674300254,0.425572519083969,0.166666666666667,0.0232188295165394,0.00699745547073791,1187,0.377544529262087,1957,0.622455470737914
"E02000902",0,421,1058,1255,371,56,9,3170,0,0.132807570977918,0.333753943217666,0.39589905362776,0.117034700315457,0.0176656151419558,0.0028391167192429,1479,0.466561514195584,1691,0.533438485804416
"E02000903",2,521,1213,1264,307,51,13,3371,0.000593295757935331,0.154553544942154,0.359833877187778,0.374962919015129,0.0910708988430733,0.0151290418273509,0.00385642242657965,1736,0.514980717887867,1635,0.485019282112133
"E02000904",1,323,673,1320,392,43,19,2771,0.000360880548538434,0.116564417177914,0.242872609166366,0.476362324070733,0.141465175027066,0.0155178635871527,0.00685673042223024,997,0.359797906892818,1774,0.640202093107182
"E02000905",8,397,921,1647,415,49,28,3465,0.00230880230880231,0.114574314574315,0.265800865800866,0.475324675324675,0.11976911976912,0.0141414141414141,0.00808080808080808,1326,0.382683982683983,2139,0.617316017316017
"E02000906",11,85,1254,1683,358,45,13,3449,0.00318933024064946,0.0246448245868368,0.363583647434039,0.487967526819368,0.103798202377501,0.0130472600753842,0.00376920846622209,1350,0.391417802261525,2099,0.608582197738475
"E02000907",24,876,1899,1653,390,69,19,4930,0.00486815415821501,0.177687626774848,0.385192697768763,0.335294117647059,0.0791075050709939,0.0139959432048682,0.00385395537525355,2799,0.567748478701826,2131,0.432251521298174
"E02000908",0,2523,1668,1818,454,46,22,6531,0,0.386311437758383,0.255397335783188,0.278364722094626,0.069514622569285,0.00704333180217425,0.0033685499923442,4191,0.641708773541571,2340,0.358291226458429
"E02000909",0,292,1090,1631,506,70,26,3615,0,0.0807745504840941,0.301521438450899,0.451175656984786,0.139972337482711,0.0193637621023513,0.00719225449515906,1382,0.382295988934993,2233,0.617704011065007
"E02000910",15,482,1539,2051,493,60,23,4663,0.00321681321037958,0.103366931160197,0.330045035384945,0.439845592965902,0.105725927514476,0.0128672528415183,0.00493244692258203,2036,0.436628779755522,2627,0.563371220244478
"E02000911",3,1277,1782,2100,492,73,34,5761,0.000520742926575247,0.22166290574553,0.309321298385697,0.364520048602673,0.0854018399583406,0.012671411213331,0.0059017531678528,3062,0.531504947057802,2699,0.468495052942198
"E02000912",11,163,956,1361,318,40,16,2865,0.00383944153577661,0.0568935427574171,0.333682373472949,0.475043630017452,0.110994764397906,0.0139616055846422,0.00558464223385689,1130,0.394415357766143,1735,0.605584642233857
"E02000913",10,154,691,1358,418,47,20,2698,0.00370644922164566,0.0570793180133432,0.256115641215715,0.503335804299481,0.154929577464789,0.0174203113417346,0.00741289844329133,855,0.316901408450704,1843,0.683098591549296
"E02000914",22,401,1587,1648,412,57,23,4150,0.00530120481927711,0.0966265060240964,0.382409638554217,0.39710843373494,0.0992771084337349,0.0137349397590361,0.0055421686746988,2010,0.48433734939759,2140,0.51566265060241
"E02000915",1,47,871,1619,504,70,17,3129,0.000319590923617769,0.0150207734100352,0.278363694471077,0.517417705337168,0.161073825503356,0.0223713646532438,0.00543304570150208,919,0.29370405880473,2210,0.70629594119527
"E02000916",1,593,1198,1861,430,56,18,4157,0.000240558094779889,0.142650950204474,0.288188597546307,0.447678614385374,0.103439980755352,0.0134712533076738,0.00433004570603801,1792,0.431080105845562,2365,0.568919894154438
"E02000917",12,307,1232,1873,455,46,13,3938,0.00304723209751143,0.0779583544946673,0.312849162011173,0.475622143219909,0.115540883697308,0.0116810563737938,0.00330116810563738,1551,0.393854748603352,2387,0.606145251396648
"E02000918",2,273,1597,1450,371,47,11,3751,0.000533191149026926,0.0727805918421754,0.425753132498001,0.386563583044521,0.0989069581444948,0.0125299920021328,0.00293255131964809,1872,0.499066915489203,1879,0.500933084510797
"E02000919",1,83,932,1799,401,48,19,3283,0.000304599451720987,0.0252817544928419,0.28388668900396,0.547974413646055,0.122144380140116,0.0146207736826074,0.00578738958269875,1016,0.309473042948523,2267,0.690526957051477
"E02000920",6,987,1314,1553,340,37,13,4250,0.00141176470588235,0.232235294117647,0.309176470588235,0.365411764705882,0.08,0.00870588235294118,0.00305882352941176,2307,0.542823529411765,1943,0.457176470588235
"E02000921",2,236,1682,1655,388,36,24,4023,0.000497141436738752,0.0586626895351728,0.418095948297291,0.411384538901317,0.0964454387273179,0.00894854586129754,0.00596569724086503,1920,0.477255779269202,2103,0.522744220730798
"E02000922",0,68,1161,2083,458,51,20,3841,0,0.017703722988805,0.302265035147097,0.542306690965894,0.119239781306951,0.0132777922416037,0.00520697734964853,1229,0.319968758135902,2612,0.680031241864098
"E02000923",1,406,1795,1195,379,54,13,3843,0.000260213374967473,0.105646630236794,0.467083008066615,0.310954983086131,0.0986208691126724,0.0140515222482436,0.00338277387457715,2202,0.572989851678376,1641,0.427010148321624
"E02000925",18,303,1518,1066,267,31,7,3210,0.00560747663551402,0.094392523364486,0.472897196261682,0.33208722741433,0.0831775700934579,0.00965732087227414,0.00218068535825545,1839,0.572897196261682,1371,0.427102803738318
"E02000926",4,3314,2396,1247,394,55,14,7424,0.000538793103448276,0.446390086206897,0.322737068965517,0.16796875,0.0530711206896552,0.00740840517241379,0.00188577586206897,5714,0.769665948275862,1710,0.230334051724138
"E02000927",6,132,1124,1419,374,37,30,3122,0.00192184497117233,0.0422805893657912,0.360025624599616,0.454516335682255,0.119795003203075,0.0118513773222293,0.00960922485586163,1262,0.404228058936579,1860,0.595771941063421
"E02000928",1,173,1157,1605,585,92,16,3629,0.000275558004960044,0.0476715348580876,0.318820611738771,0.442270597960871,0.161201432901626,0.0253513364563241,0.00440892807936071,1331,0.366767704601819,2298,0.633232295398181
"E02000929",0,751,1950,764,87,4,3,3559,0,0.21101432986794,0.547906715369486,0.214667041303737,0.0244450688395617,0.00112391121101433,0.000842933408260747,2701,0.758921045237426,858,0.241078954762574
"E02000930",2,190,1897,2151,630,73,28,4971,0.000402333534500101,0.0382216857775096,0.381613357473345,0.432709716354858,0.126735063367532,0.0146851740092537,0.00563266948300141,2089,0.420237376785355,2882,0.579762623214645
"E02000931",1,66,970,1875,713,58,14,3697,0.000270489586150933,0.0178523126859616,0.262374898566405,0.507167974033,0.192859074925615,0.0156883959967541,0.00378685420611306,1037,0.280497700838518,2660,0.719502299161482
"E02000932",14,3454,2800,1927,585,77,26,8883,0.00157604412923562,0.388832601598559,0.315208825847124,0.216931216931217,0.0658561296859169,0.0086682427107959,0.00292693909715186,6268,0.705617471574918,2615,0.294382528425082
"E02000933",5,463,1505,1330,510,104,23,3940,0.00126903553299492,0.11751269035533,0.381979695431472,0.33756345177665,0.129441624365482,0.0263959390862944,0.00583756345177665,1973,0.500761421319797,1967,0.499238578680203
"E02000934",0,745,1913,1967,517,57,14,5213,0,0.142911950892001,0.366967197391138,0.377325915979283,0.0991751390753885,0.0109342029541531,0.0026855937080376,2658,0.509879148283138,2555,0.490120851716862
"E02000935",5,147,1421,535,112,12,2,2234,0.00223813786929275,0.0658012533572068,0.636078782452999,0.239480752014324,0.0501342882721576,0.0053715308863026,0.000895255147717099,1573,0.704118173679499,661,0.295881826320501
"E02000936",0,762,2273,1553,470,78,23,5159,0,0.147703043225431,0.440589261484784,0.301027330878077,0.0911029269238224,0.0151192091490599,0.00445822833882535,3035,0.588292304710215,2124,0.411707695289785
"E02000937",2,95,1044,1406,536,73,12,3168,0.000631313131313131,0.0299873737373737,0.329545454545455,0.443813131313131,0.169191919191919,0.0230429292929293,0.00378787878787879,1141,0.360164141414141,2027,0.639835858585859
"E02000938",0,834,1700,1335,364,38,10,4281,0,0.194814295725298,0.397103480495211,0.311843027330063,0.0850268628825041,0.0088764307404812,0.00233590282644242,2534,0.591917776220509,1747,0.408082223779491
"E02000939",0,80,628,1321,508,66,15,2618,0,0.0305576776165011,0.239877769289534,0.504583651642475,0.194041252864782,0.0252100840336134,0.00572956455309397,708,0.270435446906035,1910,0.729564553093965
"E02000940",6,1590,1699,1225,241,34,9,4804,0.00124895920066611,0.33097418817652,0.353663613655287,0.254995836802664,0.0501665278934222,0.0070774354704413,0.00187343880099917,3295,0.685886761032473,1509,0.314113238967527
"E02000941",15,203,1467,2076,565,72,19,4417,0.00339597011546298,0.045958795562599,0.33212587729228,0.470002263980077,0.127914874349106,0.0163006565542223,0.00430156214625311,1685,0.381480642970342,2732,0.618519357029658
"E02000942",2,151,1300,1654,536,87,22,3752,0.000533049040511727,0.0402452025586354,0.346481876332623,0.440831556503198,0.142857142857143,0.0231876332622601,0.005863539445629,1453,0.38726012793177,2299,0.61273987206823
"E02000943",13,482,1636,1767,451,41,17,4407,0.00294985250737463,0.109371454504198,0.371227592466531,0.400953029271613,0.102337190832766,0.00930338098479691,0.00385749943272067,2131,0.483548899478103,2276,0.516451100521897
"E02000944",1,402,1304,895,207,36,15,2860,0.00034965034965035,0.140559440559441,0.455944055944056,0.312937062937063,0.0723776223776224,0.0125874125874126,0.00524475524475524,1707,0.596853146853147,1153,0.403146853146853
"E02000945",0,256,1357,928,228,34,12,2815,0,0.0909413854351687,0.482060390763766,0.329662522202487,0.0809946714031972,0.0120781527531083,0.00426287744227353,1613,0.573001776198934,1202,0.426998223801066
"E02000946",2,118,1366,1338,328,35,15,3202,0.000624609618988132,0.0368519675202998,0.426608369768894,0.417863835103061,0.102435977514054,0.0109306683322923,0.00468457214241099,1486,0.464084946908182,1716,0.535915053091818
"E02000947",0,312,1477,1906,435,35,16,4181,0,0.0746232958622339,0.353264769193973,0.455871801004544,0.104042095192538,0.00837120306146855,0.00382683568524277,1789,0.427888065056207,2392,0.572111934943793
"E02000948",1,304,2109,1997,527,69,19,5026,0.000198965380023876,0.0604854755272583,0.419617986470354,0.39733386390768,0.104854755272583,0.0137286112216474,0.00378034222045364,2414,0.480302427377636,2612,0.519697572622364
"E02000949",0,600,1887,1742,605,90,16,4940,0,0.121457489878543,0.381983805668016,0.352631578947368,0.12246963562753,0.0182186234817814,0.00323886639676113,2487,0.503441295546559,2453,0.496558704453441
"E02000950",0,110,1600,1065,295,37,7,3114,0,0.0353243416827232,0.513808606294155,0.342003853564547,0.0947334617854849,0.0118818240205523,0.00224791265253693,1710,0.549132947976879,1404,0.450867052023121
"E02000951",0,231,1166,1176,367,49,17,3006,0,0.0768463073852295,0.387890884896873,0.391217564870259,0.122089155023287,0.0163007318695941,0.00565535595475715,1397,0.464737192282102,1609,0.535262807717898
"E02000952",1,128,950,1119,371,46,11,2626,0.000380807311500381,0.0487433358720487,0.361766945925362,0.426123381568926,0.141279512566641,0.0175171363290175,0.00418888042650419,1079,0.410891089108911,1547,0.589108910891089
"E02000953",0,498,1306,1177,263,31,17,3292,0,0.151275820170109,0.396719319562576,0.357533414337789,0.0798906439854192,0.00941676792223572,0.0051640340218712,1804,0.547995139732685,1488,0.452004860267315
"E02000954",1,83,591,1133,301,28,10,2147,0.000465766185374942,0.0386585933861202,0.275267815556591,0.527713088029809,0.140195621797857,0.0130414531904984,0.00465766185374942,675,0.314392175128086,1472,0.685607824871914
"E02000955",1,157,677,1322,291,26,7,2481,0.000403063280935107,0.0632809351068118,0.272873841193067,0.532849657396211,0.117291414752116,0.0104796453043128,0.00282144296654575,835,0.336557839580814,1646,0.663442160419186
"E02000956",0,232,1357,1471,316,34,15,3425,0,0.0677372262773723,0.396204379562044,0.42948905109489,0.0922627737226277,0.00992700729927007,0.00437956204379562,1589,0.463941605839416,1836,0.536058394160584
"E02000957",1,497,1866,1992,504,52,16,4928,0.000202922077922078,0.100852272727273,0.378652597402597,0.404220779220779,0.102272727272727,0.0105519480519481,0.00324675324675325,2364,0.479707792207792,2564,0.520292207792208
"E02000958",0,32,846,1153,393,46,12,2482,0,0.0128928283642224,0.34085414987913,0.464544721998388,0.158340048348106,0.0185334407735697,0.0048348106365834,878,0.353746978243352,1604,0.646253021756648
"E02000959",5,112,1259,1361,322,32,13,3104,0.00161082474226804,0.0360824742268041,0.405605670103093,0.438466494845361,0.103737113402062,0.0103092783505155,0.00418814432989691,1376,0.443298969072165,1728,0.556701030927835
"E02000960",4,101,1483,1411,414,54,14,3481,0.0011490950876185,0.0290146509623671,0.426027003734559,0.405343292157426,0.118931341568515,0.0155127836828498,0.00402183280666475,1588,0.456190749784545,1893,0.543809250215455
"E02000961",0,383,1905,1631,527,82,13,4541,0,0.0843426558026866,0.419511120898481,0.359171988548778,0.116053732658005,0.0180576965426118,0.00286280554943845,2288,0.503853776701167,2253,0.496146223298833
"E02000962",2,768,2449,1583,479,54,15,5350,0.000373831775700935,0.143551401869159,0.457757009345794,0.29588785046729,0.0895327102803738,0.0100934579439252,0.00280373831775701,3219,0.601682242990654,2131,0.398317757009346
"E02000963",8,215,1587,1701,317,34,16,3878,0.00206291903042806,0.055440948942754,0.409231562661166,0.438628158844765,0.0817431665807117,0.00876740587931924,0.00412583806085611,1810,0.466735430634348,2068,0.533264569365652
"E02000964",5,342,2566,2134,319,35,11,5412,0.000923872875092387,0.0631929046563193,0.474131559497413,0.394308943089431,0.0589430894308943,0.00646711012564671,0.00203252032520325,2913,0.538248337028825,2499,0.461751662971175
"E02000965",0,119,1899,1753,430,35,9,4245,0,0.0280329799764429,0.447349823321555,0.412956419316843,0.101295641931684,0.00824499411071849,0.00212014134275618,2018,0.475382803297998,2227,0.524617196702002
"E02000966",9,123,1825,2008,565,94,21,4645,0.00193756727664155,0.0264800861141012,0.392895586652314,0.432292787944026,0.121636167922497,0.0202368137782562,0.00452099031216362,1957,0.421313240043057,2688,0.578686759956943
"E02000967",4,393,2152,1548,500,40,16,4653,0.000859660434128519,0.084461637653127,0.462497313561143,0.332688588007737,0.107457554266065,0.00859660434128519,0.00343864173651408,2549,0.547818611648399,2104,0.452181388351601
"E02000968",0,1428,2938,1362,313,42,24,6107,0,0.233830031111839,0.481087276895366,0.223022760766334,0.0512526608809563,0.00687735385623056,0.0039299164892746,4366,0.714917308007205,1741,0.285082691992795
"E02000969",0,525,1894,745,168,22,6,3360,0,0.15625,0.563690476190476,0.22172619047619,0.05,0.00654761904761905,0.00178571428571429,2419,0.719940476190476,941,0.280059523809524
"E02000970",6,828,3383,2105,921,139,46,7428,0.000807754442649435,0.111470113085622,0.45543887991384,0.28338718362951,0.123990306946688,0.0187129779213786,0.00619278406031233,4217,0.567716747442111,3211,0.432283252557889
"E02000971",0,418,2788,1957,580,95,38,5876,0,0.0711368277739959,0.474472430224643,0.333049693669163,0.0987066031313819,0.0161674608577263,0.00646698434309054,3206,0.545609257998639,2670,0.454390742001362
"E02000972",6,1571,3005,1707,609,94,49,7041,0.000852151682999574,0.223121715665388,0.426785967902287,0.242437153813379,0.0864933958244568,0.0133503763669933,0.00695923874449652,4582,0.650759835250675,2459,0.349240164749325
"E02000973",0,241,2594,2097,611,87,20,5650,0,0.0426548672566372,0.459115044247788,0.371150442477876,0.108141592920354,0.0153982300884956,0.00353982300884956,2835,0.501769911504425,2815,0.498230088495575
"E02000974",1,1699,2669,1775,617,67,11,6839,0.000146220207632695,0.248428132767949,0.390261734171663,0.259540868548033,0.0902178681093727,0.00979675391139055,0.00160842228395964,4369,0.638836087147244,2470,0.361163912852756
"E02000975",1,275,2413,1773,654,122,32,5270,0.000189753320683112,0.0521821631878558,0.457874762808349,0.336432637571157,0.124098671726755,0.0231499051233397,0.00607210626185958,2689,0.510246679316888,2581,0.489753320683112
"E02000976",0,503,2909,2063,646,95,28,6244,0,0.08055733504164,0.465887251761691,0.330397181294042,0.10345932094811,0.0152146060217809,0.00448430493273543,3412,0.546444586803331,2832,0.453555413196669
"E02000977",1,1425,3355,1969,877,157,66,7850,0.000127388535031847,0.181528662420382,0.427388535031847,0.250828025477707,0.11171974522293,0.02,0.00840764331210191,4781,0.609044585987261,3069,0.390955414012739
"E02000978",3,356,1906,2190,842,127,43,5467,0.000548747027620267,0.0651179806109384,0.348637278214743,0.400585330162795,0.154014999085422,0.0232302908359246,0.00786537406255716,2265,0.414304005853302,3202,0.585695994146698
"E02000979",0,2007,2373,1297,370,61,20,6128,0,0.327513054830287,0.387238903394256,0.211651436031332,0.060378590078329,0.00995430809399478,0.00326370757180157,4380,0.714751958224543,1748,0.285248041775457
"E02000980",0,923,2524,1377,305,56,9,5194,0,0.177705044281864,0.485945321524836,0.265113592606854,0.0587216018482865,0.0107816711590297,0.00173276857912977,3447,0.6636503658067,1747,0.3363496341933
"E02000981",0,335,2009,2075,578,87,18,5102,0,0.0656605252842023,0.393767150137201,0.406703253626029,0.11328890631125,0.0170521364170913,0.00352802822422579,2344,0.459427675421403,2758,0.540572324578597
"E02000982",58,1598,2148,1102,306,36,8,5256,0.0110350076103501,0.304033485540335,0.408675799086758,0.209665144596651,0.0582191780821918,0.00684931506849315,0.0015220700152207,3804,0.723744292237443,1452,0.276255707762557
"E02000983",0,319,3112,1620,358,18,4,5431,0,0.0587368808690849,0.573006812741668,0.29828760817529,0.0659178788436752,0.00331430675750322,0.000736512612778494,3431,0.631743693610753,2000,0.368256306389247
"E02000984",1,104,716,1157,259,44,12,2293,0.000436109899694723,0.0453554295682512,0.312254688181422,0.504579153946795,0.112952464020933,0.0191888355865678,0.00523331879633668,821,0.358046227649368,1472,0.641953772350632
"E02000985",2,123,641,1151,303,49,10,2279,0.000877577885037297,0.0539710399297938,0.281263712154454,0.505046072838964,0.132953049583151,0.0215006581834138,0.00438788942518649,766,0.336112329969285,1513,0.663887670030715
"E02000986",2,235,926,1426,430,64,11,3094,0.000646412411118293,0.0759534583063995,0.29928894634777,0.460892049127343,0.138978668390433,0.0206851971557854,0.00355526826115061,1163,0.375888817065288,1931,0.624111182934712
"E02000987",35,283,1107,1254,419,56,18,3172,0.0110340479192938,0.08921815889029,0.348991172761665,0.395334174022699,0.132093316519546,0.0176544766708701,0.00567465321563682,1425,0.449243379571248,1747,0.550756620428752
"E02000988",1,161,1261,1325,424,79,12,3263,0.000306466441924609,0.0493410971498621,0.386454183266932,0.406068035550107,0.129941771376034,0.0242108489120441,0.00367759730309531,1423,0.436101746858719,1840,0.563898253141281
"E02000989",4,225,583,1318,392,61,12,2595,0.00154142581888247,0.0867052023121387,0.224662813102119,0.507899807321773,0.151059730250482,0.0235067437379576,0.0046242774566474,812,0.312909441233141,1783,0.687090558766859
"E02000990",37,473,1137,1152,346,35,17,3197,0.0115733500156397,0.147951204253988,0.35564591804817,0.360337816703159,0.108226462308414,0.0109477635283078,0.00531748514232093,1647,0.515170472317798,1550,0.484829527682202
"E02000991",1,54,698,1322,435,91,12,2613,0.000382701875239189,0.0206659012629162,0.267125908916954,0.505931879066207,0.166475315729047,0.0348258706467662,0.00459242250287026,753,0.288174512055109,1860,0.711825487944891
"E02000992",2,329,622,819,248,38,9,2067,0.000967585873246251,0.159167876149008,0.300919206579584,0.39622641509434,0.119980648282535,0.0183841315916788,0.00435413642960813,953,0.461054668601838,1114,0.538945331398162
"E02000993",0,485,1530,955,185,33,8,3196,0,0.151752190237797,0.478723404255319,0.298811013767209,0.0578848560700876,0.0103254067584481,0.00250312891113892,2015,0.630475594493116,1181,0.369524405506884
"E02000994",10,187,1457,1227,323,65,22,3291,0.00303859009419629,0.0568216347614707,0.4427225767244,0.372835004557885,0.0981464600425403,0.0197508356122759,0.00668489820723184,1654,0.502582801580067,1637,0.497417198419933
"E02000995",1,74,1005,1203,396,70,12,2761,0.000362187613183629,0.0268018833755886,0.363998551249547,0.435711698659906,0.143426294820717,0.025353132922854,0.00434625135820355,1080,0.391162622238319,1681,0.608837377761681
"E02000996",4,260,1385,1017,197,42,4,2909,0.00137504297009282,0.089377793056033,0.476108628394637,0.349604675146098,0.0677208662770712,0.0144379511859746,0.00137504297009282,1649,0.566861464420763,1260,0.433138535579237
"E02000997",7,501,934,735,359,48,10,2594,0.00269853508095605,0.19313801079414,0.36006168080185,0.283346183500385,0.138396299151889,0.0185042405551272,0.0038550501156515,1442,0.555898226676947,1152,0.444101773323053
"E02000998",1,178,1332,1634,678,130,46,3999,0.000250062515628907,0.0445111277819455,0.333083270817704,0.408602150537634,0.169542385596399,0.0325081270317579,0.0115028757189297,1511,0.377844461115279,2488,0.622155538884721
"E02000999",11,816,2290,946,296,47,13,4419,0.00248925096175605,0.184657162253904,0.518216791129215,0.214075582711021,0.0669834804254356,0.0106358904729577,0.0029418420457117,3117,0.705363204344874,1302,0.294636795655126
"E02001000",1,165,1379,1635,573,115,36,3904,0.000256147540983607,0.0422643442622951,0.353227459016393,0.418801229508197,0.146772540983607,0.0294569672131148,0.00922131147540984,1545,0.395747950819672,2359,0.604252049180328
"E02001001",0,183,938,1271,462,84,19,2957,0,0.061887047683463,0.317213391951302,0.429827527899899,0.156239431856611,0.0284071694284748,0.00642543118025025,1121,0.379100439634765,1836,0.620899560365235
"E02001002",3,164,1193,1199,299,56,10,2924,0.00102599179206566,0.0560875512995896,0.408002735978112,0.410054719562243,0.102257181942544,0.0191518467852257,0.00341997264021888,1360,0.465116279069767,1564,0.534883720930233
"E02001003",1,79,577,1115,298,55,9,2134,0.000468603561387067,0.0370196813495783,0.270384254920337,0.522492970946579,0.139643861293346,0.0257731958762887,0.0042174320524836,657,0.307872539831303,1477,0.692127460168697
"E02001004",1,46,1039,1069,324,69,13,2561,0.000390472471690746,0.0179617336977743,0.405700898086685,0.417415072237407,0.126513080827802,0.0269426005466615,0.0050761421319797,1086,0.42405310425615,1475,0.57594689574385
"E02001005",7,336,1405,1394,397,78,19,3636,0.00192519251925193,0.0924092409240924,0.386413641364136,0.383388338833883,0.109185918591859,0.0214521452145215,0.00522552255225523,1748,0.480748074807481,1888,0.519251925192519
"E02001006",3,18,700,1111,331,61,23,2247,0.00133511348464619,0.00801068090787717,0.311526479750779,0.494437027147308,0.147307521139297,0.0271473075211393,0.0102358700489542,721,0.320872274143302,1526,0.679127725856698
"E02001007",13,128,1132,1260,365,45,14,2957,0.00439634764964491,0.0432871153195807,0.382820426107541,0.426107541427122,0.123435914778492,0.0152181264795401,0.00473452823807913,1273,0.430503889076767,1684,0.569496110923233
"E02001008",0,66,1131,939,248,38,9,2431,0,0.0271493212669683,0.46524064171123,0.386260798025504,0.102015631427396,0.0156314273961333,0.00370218017276841,1197,0.492389962978198,1234,0.507610037021802
"E02001009",1,359,1114,1079,301,58,20,2932,0.00034106412005457,0.122442019099591,0.379945429740791,0.368008185538881,0.102660300136426,0.0197817189631651,0.00682128240109141,1474,0.502728512960437,1458,0.497271487039563
"E02001010",0,166,913,970,321,59,21,2450,0,0.0677551020408163,0.37265306122449,0.395918367346939,0.131020408163265,0.0240816326530612,0.00857142857142857,1079,0.440408163265306,1371,0.559591836734694
"E02001011",15,496,1353,1301,294,43,10,3512,0.00427107061503417,0.14123006833713,0.385250569476082,0.370444191343964,0.0837129840546697,0.0122437357630979,0.00284738041002278,1864,0.530751708428246,1648,0.469248291571754
"E02001012",1,46,682,1130,316,65,9,2249,0.000444642063139173,0.020453534904402,0.303245887060916,0.502445531347265,0.140506891951979,0.0289017341040462,0.00400177856825256,729,0.324144064028457,1520,0.675855935971543
"E02001013",17,133,539,875,289,53,3,1909,0.00890518596123625,0.0696699842849659,0.28234677841802,0.458355159769513,0.151388161341016,0.0277632268203248,0.00157150340492404,689,0.360921948664222,1220,0.639078051335778
"E02001014",16,550,1330,1240,297,54,10,3497,0.00457535030025736,0.157277666571347,0.380325993708893,0.354589648269946,0.0849299399485273,0.0154418072633686,0.00285959393766085,1896,0.542179010580498,1601,0.457820989419502
"E02001015",10,452,1627,1255,343,53,26,3766,0.00265533722782793,0.120021242697823,0.432023366967605,0.333244822092406,0.0910780669144981,0.0140732873074881,0.00690387679235263,2089,0.554699946893255,1677,0.445300053106745
"E02001016",4,217,1336,979,187,43,6,2772,0.00144300144300144,0.0782828282828283,0.481962481962482,0.353174603174603,0.0674603174603175,0.0155122655122655,0.00216450216450216,1557,0.561688311688312,1215,0.438311688311688
"E02001017",5,175,1374,1433,339,68,16,3410,0.00146627565982405,0.0513196480938416,0.402932551319648,0.420234604105572,0.0994134897360704,0.019941348973607,0.00469208211143695,1554,0.455718475073314,1856,0.544281524926686
"E02001018",4,88,846,1047,227,31,11,2254,0.00177462289263532,0.0390417036379769,0.375332741792369,0.464507542147294,0.100709849157054,0.0137533274179237,0.00488021295474712,938,0.416149068322981,1316,0.583850931677019
"E02001019",2,254,1165,1429,578,88,21,3537,0.000565450947130336,0.0718122702855527,0.329375176703421,0.404014701724625,0.163415323720667,0.0248798416737348,0.00593723494486853,1421,0.401752897936104,2116,0.598247102063896
"E02001020",1,97,419,859,284,65,17,1742,0.000574052812858783,0.055683122847302,0.24052812858783,0.493111366245695,0.163030998851894,0.0373134328358209,0.00975889781859931,517,0.296785304247991,1225,0.703214695752009
"E02001021",6,101,653,1054,359,77,23,2273,0.00263968323801144,0.0444346678398592,0.287285525736912,0.463704355477343,0.157941047074351,0.0338759348878135,0.0101187857457105,760,0.334359876814782,1513,0.665640123185218
"E02001022",1,193,815,1340,391,50,10,2800,0.000357142857142857,0.0689285714285714,0.291071428571429,0.478571428571429,0.139642857142857,0.0178571428571429,0.00357142857142857,1009,0.360357142857143,1791,0.639642857142857
"E02001023",0,51,648,935,230,29,4,1897,0,0.0268845545598313,0.341591987348445,0.492883500263574,0.121244069583553,0.0152872957301002,0.00210859251449657,699,0.368476541908276,1198,0.631523458091724
"E02001024",9,154,628,1205,360,57,6,2419,0.00372054568003307,0.0636626705250103,0.259611409673419,0.498139727159983,0.148821827201323,0.0235634559735428,0.00248036378668871,791,0.326994625878462,1628,0.673005374121538
"E02001025",70,305,1251,1637,273,48,8,3592,0.0194877505567929,0.0849109131403118,0.348273942093541,0.455734966592428,0.0760022271714922,0.0133630289532294,0.0022271714922049,1626,0.452672605790646,1966,0.547327394209354
"E02001026",2,340,1675,1951,609,102,49,4728,0.000423011844331641,0.071912013536379,0.35427241962775,0.412648054145516,0.128807106598985,0.0215736040609137,0.0103637901861252,2017,0.42660744500846,2711,0.57339255499154
"E02001027",0,121,1185,1345,420,65,24,3160,0,0.0382911392405063,0.375,0.425632911392405,0.132911392405063,0.0205696202531646,0.00759493670886076,1306,0.413291139240506,1854,0.586708860759494
"E02001028",0,43,515,1043,300,33,7,1941,0,0.0221535291087069,0.265327150953117,0.537351880473983,0.154559505409583,0.0170015455950541,0.00360638845955693,558,0.287480680061824,1383,0.712519319938176
"E02001029",0,121,1065,1118,368,66,20,2758,0,0.0438723712835388,0.386149383611313,0.405366207396664,0.133430021754895,0.0239303843364757,0.00725163161711385,1186,0.430021754894851,1572,0.569978245105149
"E02001030",0,228,495,773,220,46,5,1767,0,0.129032258064516,0.280135823429542,0.437464629315224,0.12450481041313,0.0260328239954726,0.00282965478211658,723,0.409168081494058,1044,0.590831918505942
"E02001031",0,180,1074,1040,249,44,9,2596,0,0.0693374422187981,0.413713405238829,0.400616332819723,0.0959167950693374,0.0169491525423729,0.00346687211093991,1254,0.483050847457627,1342,0.516949152542373
"E02001032",3,128,754,1253,288,30,15,2471,0.00121408336705787,0.0518008903278025,0.305139619587212,0.507082152974504,0.116552003237556,0.0121408336705787,0.00607041683528936,885,0.358154593282072,1586,0.641845406717928
"E02001033",26,352,881,976,242,28,8,2513,0.0103461997612415,0.140071627536809,0.350576999602069,0.388380421806606,0.0962992439315559,0.011142061281337,0.00318344608038201,1259,0.500994826900119,1254,0.499005173099881
"E02001034",1,246,1928,1762,382,52,23,4394,0.000227583067819754,0.0559854346836595,0.438780154756486,0.401001365498407,0.0869367319071461,0.0118343195266272,0.00523441055985435,2175,0.494993172507965,2219,0.505006827492035
"E02001035",0,52,461,1079,294,40,12,1938,0,0.0268317853457172,0.237874097007224,0.556759545923633,0.151702786377709,0.0206398348813209,0.00619195046439629,513,0.264705882352941,1425,0.735294117647059
"E02001036",1,150,1084,1240,340,37,10,2862,0.000349406009783368,0.0524109014675052,0.378756114605171,0.433263452131377,0.118798043326345,0.0129280223619846,0.00349406009783368,1235,0.43151642208246,1627,0.56848357791754
"E02001037",2,52,581,1123,461,84,13,2316,0.000863557858376511,0.0224525043177893,0.250863557858376,0.484887737478411,0.199050086355786,0.0362694300518135,0.00561312607944732,635,0.274179620034542,1681,0.725820379965458
"E02001038",17,71,1052,1019,318,49,5,2531,0.00671671276175425,0.0280521532990913,0.41564598972738,0.402607664954563,0.125642038719874,0.0193599367838799,0.00197550375345713,1140,0.450414855788226,1391,0.549585144211774
"E02001039",24,116,1440,1305,204,22,9,3120,0.00769230769230769,0.0371794871794872,0.461538461538462,0.418269230769231,0.0653846153846154,0.00705128205128205,0.00288461538461538,1580,0.506410256410256,1540,0.493589743589744
"E02001040",0,133,366,939,413,107,29,1987,0,0.0669350780070458,0.184197282335179,0.472571716155008,0.20785103170609,0.0538500251635632,0.0145948666331152,499,0.251132360342224,1488,0.748867639657776
"E02001041",1,133,991,1483,452,44,16,3120,0.000320512820512821,0.0426282051282051,0.317628205128205,0.475320512820513,0.144871794871795,0.0141025641025641,0.00512820512820513,1125,0.360576923076923,1995,0.639423076923077
"E02001042",1,238,906,1080,418,76,11,2730,0.000366300366300366,0.0871794871794872,0.331868131868132,0.395604395604396,0.153113553113553,0.0278388278388278,0.00402930402930403,1145,0.419413919413919,1585,0.580586080586081
"E02001043",0,213,707,841,243,37,8,2049,0,0.103953147877013,0.345046364080039,0.410444119082479,0.118594436310395,0.018057589067838,0.00390434358223524,920,0.448999511957052,1129,0.551000488042948
"E02001044",0,21,509,1156,484,57,11,2238,0,0.00938337801608579,0.227435210008937,0.516532618409294,0.216264521894549,0.0254691689008043,0.00491510277033065,530,0.236818588025022,1708,0.763181411974978
"E02001045",15,271,1306,1279,276,40,16,3203,0.00468310958476428,0.0846081798314081,0.407742741180144,0.399313143927568,0.0861692163596628,0.0124882922260381,0.00499531689041524,1592,0.497034030596316,1611,0.502965969403684
"E02001046",28,502,1645,1429,391,66,13,4074,0.00687285223367698,0.123220422189494,0.403780068728522,0.350760922925871,0.0959744722631321,0.01620029455081,0.00319096710849288,2175,0.533873343151694,1899,0.466126656848306
"E02001047",2,518,1798,1227,295,65,10,3915,0.000510855683269476,0.132311621966794,0.459259259259259,0.313409961685824,0.0753512132822478,0.016602809706258,0.00255427841634738,2318,0.592081736909323,1597,0.407918263090677
"E02001048",2,169,1229,1202,451,59,13,3125,0.00064,0.05408,0.39328,0.38464,0.14432,0.01888,0.00416,1400,0.448,1725,0.552
"E02001049",5,224,1406,1207,320,51,23,3236,0.0015451174289246,0.069221260815822,0.434487021013597,0.372991347342398,0.0988875154511743,0.0157601977750309,0.00710754017305315,1635,0.505253399258344,1601,0.494746600741656
"E02001050",2,285,1331,1425,435,58,19,3555,0.000562587904360056,0.080168776371308,0.374402250351617,0.40084388185654,0.122362869198312,0.0163150492264416,0.00534458509142053,1618,0.455133614627286,1937,0.544866385372715
"E02001051",21,296,923,1707,553,83,23,3606,0.00582362728785358,0.0820854132002218,0.255962285080422,0.473377703826955,0.153355518580144,0.0230171935662784,0.00637825845812535,1240,0.343871325568497,2366,0.656128674431503
"E02001052",3,356,1475,1875,809,127,38,4683,0.000640614990390775,0.076019645526372,0.314969036942131,0.400384368994234,0.172752509075379,0.0271193679265428,0.00811445654494982,1834,0.391629297458894,2849,0.608370702541106
"E02001053",5,455,2635,1412,290,45,12,4854,0.00103007828594973,0.0937371240214256,0.542851256695509,0.290894107952204,0.0597445405850845,0.00927070457354759,0.00247218788627936,3095,0.637618459002884,1759,0.362381540997116
"E02001055",23,476,1649,1328,355,68,17,3916,0.00587334014300306,0.121552604698672,0.421092951991828,0.339121552604699,0.0906537282941777,0.017364657814096,0.004341164453524,2148,0.548518896833504,1768,0.451481103166496
"E02001056",0,105,1232,1437,537,62,14,3387,0,0.0310008857395926,0.363743726011219,0.424269264836138,0.158547387068202,0.0183052849129023,0.00413345143194567,1337,0.394744611750812,2050,0.605255388249188
"E02001059",4,927,2926,1338,299,44,23,5561,0.000719295090811005,0.16669663729545,0.52616435892825,0.240604207876281,0.0537673080381226,0.00791224599892106,0.00413594677216328,3857,0.693580291314512,1704,0.306419708685488
"E02001061",4,805,2031,1826,476,61,33,5236,0.000763941940412529,0.153743315508021,0.387891520244461,0.348739495798319,0.0909090909090909,0.0116501145912911,0.00630252100840336,2840,0.542398777692895,2396,0.457601222307105
"E02001062",15,942,2415,613,103,17,6,4111,0.00364874726343955,0.229141328144004,0.587448309413768,0.149112138165896,0.0250547312089516,0.00413524689856483,0.00145949890537582,3372,0.820238384821211,739,0.179761615178789
"E02001063",1,610,2576,689,141,1,0,4018,0.000248880039820806,0.151816824290692,0.641114982578397,0.171478347436536,0.0350920856147337,0.000248880039820806,0,3187,0.79318068690891,831,0.20681931309109
"E02001064",1,907,2112,1319,303,47,12,4701,0.000212720697723889,0.192937672835567,0.449266113592853,0.280578600297809,0.0644543714103382,0.00999787279302276,0.00255264837268666,3020,0.642416507126143,1681,0.357583492873857
"E02001065",1,278,1131,2057,663,92,40,4262,0.000234631628343501,0.0652275926794932,0.265368371656499,0.482637259502581,0.155560769591741,0.0215861098076021,0.00938526513374003,1410,0.330830595964336,2852,0.669169404035664
"E02001066",1,324,1774,1873,627,87,32,4718,0.000211954217888936,0.0686731665960153,0.376006782534972,0.396990250105977,0.132895294616363,0.0184400169563374,0.00678253497244595,2099,0.444891903348877,2619,0.555108096651123
"E02001067",4,541,1862,1754,625,49,17,4852,0.000824402308326463,0.111500412201154,0.383759274525969,0.361500412201154,0.12881286067601,0.0100989282769992,0.00350370981038747,2407,0.496084089035449,2445,0.503915910964551
"E02001068",2,588,2417,1315,344,48,16,4730,0.000422832980972516,0.12431289640592,0.510993657505285,0.278012684989429,0.0727272727272727,0.0101479915433404,0.00338266384778013,3007,0.635729386892178,1723,0.364270613107822
"E02001069",32,392,1828,2216,553,59,30,5110,0.00626223091976517,0.0767123287671233,0.357729941291585,0.433659491193738,0.108219178082192,0.011545988258317,0.00587084148727984,2252,0.440704500978474,2858,0.559295499021526
"E02001070",2,132,1510,1613,626,72,32,3987,0.000501630298470028,0.0331075996990218,0.378730875344871,0.404564835716077,0.157010283421119,0.018058690744921,0.00802608477552044,1644,0.412340105342363,2343,0.587659894657637
"E02001072",5,304,1579,1608,727,120,24,4367,0.00114495076711701,0.0696130066407144,0.361575452255553,0.368216166704832,0.166475841538814,0.0274788184108083,0.00549576368216167,1888,0.432333409663384,2479,0.567666590336615
"E02001073",1,195,975,1686,817,114,26,3814,0.000262191924488726,0.0511274252753015,0.255637126376508,0.442055584687992,0.214210802307289,0.0298898793917147,0.00681699003670687,1171,0.307026743576298,2643,0.692973256423702
"E02001074",1,160,1544,1782,475,63,23,4048,0.00024703557312253,0.0395256916996047,0.381422924901186,0.440217391304348,0.117341897233202,0.0155632411067194,0.00568181818181818,1705,0.421195652173913,2343,0.578804347826087
"E02001075",1,114,880,1714,763,116,39,3627,0.000275709953129308,0.0314309346567411,0.242624758753791,0.472566859663634,0.210366694237662,0.0319823545629997,0.010752688172043,995,0.274331403363661,2632,0.725668596636339
"E02001076",4,170,1366,1541,522,49,11,3663,0.00109200109200109,0.0464100464100464,0.372918372918373,0.420693420693421,0.142506142506143,0.0133770133770134,0.003003003003003,1540,0.42042042042042,2123,0.57957957957958
"E02001077",2,79,806,1212,530,106,28,2763,0.000723850886717336,0.0285921100253348,0.291711907347087,0.438653637350706,0.191820484980094,0.0383640969960188,0.0101339124140427,887,0.321027868259139,1876,0.678972131740861
"E02001078",0,202,920,1570,686,107,23,3508,0,0.0575826681870011,0.262257696693273,0.447548460661346,0.195553021664766,0.0305017103762828,0.00655644241733181,1122,0.319840364880274,2386,0.680159635119726
"E02001079",7,148,1437,1342,300,29,5,3268,0.00214198286413709,0.0452876376988984,0.439718482252142,0.410648714810282,0.0917992656058751,0.00887392900856793,0.00152998776009792,1592,0.487148102815178,1676,0.512851897184823
"E02001080",1,214,1465,1728,454,52,11,3925,0.000254777070063694,0.0545222929936306,0.373248407643312,0.440254777070064,0.115668789808917,0.0132484076433121,0.00280254777070064,1680,0.428025477707006,2245,0.571974522292994
"E02001081",0,193,714,1134,416,57,7,2521,0,0.0765569218564062,0.283220944069814,0.449821499404998,0.165013883379611,0.0226100753669179,0.00277667592225307,907,0.35977786592622,1614,0.64022213407378
"E02001082",2,103,1161,1308,440,60,15,3089,0.000647458724506313,0.0333441243120751,0.375849789575915,0.423438005827129,0.142440919391389,0.0194237617351894,0.00485594043379735,1266,0.409841372612496,1823,0.590158627387504
"E02001083",14,507,2219,1484,558,62,7,4851,0.00288600288600289,0.104514533085962,0.457431457431457,0.305916305916306,0.115027829313544,0.0127808699237271,0.00144300144300144,2740,0.564831993403422,2111,0.435168006596578
"E02001084",3,143,1123,1361,414,65,13,3122,0.000960922485586163,0.0458039718129404,0.35970531710442,0.435938500960922,0.13260730301089,0.0208199871877002,0.00416399743754004,1269,0.406470211402947,1853,0.593529788597053
"E02001085",1,160,1183,1017,223,20,6,2610,0.000383141762452107,0.0613026819923372,0.453256704980843,0.389655172413793,0.0854406130268199,0.00766283524904215,0.00229885057471264,1344,0.514942528735632,1266,0.485057471264368
"E02001086",2,219,1339,930,262,46,9,2807,0.000712504453152832,0.0780192376202351,0.477021731385821,0.331314570716067,0.093338083363021,0.0163876024225151,0.00320627003918774,1560,0.555753473459209,1247,0.444246526540791
"E02001087",1,333,1589,1704,560,74,15,4276,0.000233863423760524,0.0778765201122544,0.371608980355472,0.398503274087933,0.130963517305893,0.0173058933582788,0.00350795135640786,1923,0.449719363891487,2353,0.550280636108513
"E02001088",71,323,2175,1757,247,38,4,4615,0.0153846153846154,0.0699891657638137,0.471289274106175,0.380715059588299,0.0535211267605634,0.00823401950162514,0.000866738894907909,2569,0.556663055254605,2046,0.443336944745395
"E02001089",4,273,860,1202,389,65,15,2808,0.00142450142450142,0.0972222222222222,0.306267806267806,0.428062678062678,0.138532763532764,0.0231481481481481,0.00534188034188034,1137,0.40491452991453,1671,0.59508547008547
"E02001090",22,129,1286,1153,373,65,13,3041,0.00723446234791187,0.0424202564945742,0.422887208155212,0.379151594870109,0.122657020716869,0.0213745478461033,0.00427490956922065,1437,0.472541926997698,1604,0.527458073002302
"E02001091",1,174,2182,1372,298,58,6,4091,0.00024443901246639,0.0425323881691518,0.533365925201662,0.335370325103887,0.0728428257149841,0.0141774627230506,0.00146663407479834,2357,0.57614275238328,1734,0.42385724761672
"E02001092",4,222,2041,1843,281,29,11,4431,0.000902730760550666,0.0501015572105619,0.460618370570977,0.415933197923719,0.0634168359286843,0.00654479801399233,0.00248250959151433,2267,0.51162265854209,2164,0.48837734145791
"E02001093",8,366,2226,1843,349,42,14,4848,0.00165016501650165,0.0754950495049505,0.459158415841584,0.380156765676568,0.0719884488448845,0.00866336633663366,0.00288778877887789,2600,0.536303630363036,2248,0.463696369636964
"E02001094",14,442,2523,1961,286,30,10,5266,0.00265856437523737,0.0839346752753513,0.479111279908849,0.372388909988606,0.054310672236992,0.00569692366122294,0.00189897455374098,2979,0.565704519559438,2287,0.434295480440562
"E02001095",6,428,2119,1645,264,28,6,4496,0.00133451957295374,0.0951957295373665,0.471307829181495,0.365880782918149,0.0587188612099644,0.00622775800711744,0.00133451957295374,2553,0.567838078291815,1943,0.432161921708185
"E02001096",6,371,1809,1184,231,42,5,3648,0.00164473684210526,0.101699561403509,0.495888157894737,0.324561403508772,0.0633223684210526,0.0115131578947368,0.00137061403508772,2186,0.599232456140351,1462,0.400767543859649
"E02001097",9,238,2318,1185,196,36,6,3988,0.0022567703109328,0.059679037111334,0.581243731193581,0.297141424272818,0.0491474423269809,0.00902708124373119,0.00150451354062187,2565,0.643179538615848,1423,0.356820461384152
"E02001098",3,74,686,857,264,45,5,1934,0.0015511892450879,0.0382626680455016,0.354705274043433,0.443123061013444,0.136504653567735,0.0232678386763185,0.00258531540847983,763,0.394519131334023,1171,0.605480868665977
"E02001099",11,100,730,1075,268,38,9,2231,0.0049305244285074,0.0448229493500672,0.327207530255491,0.481846705513223,0.12012550425818,0.0170327207530255,0.00403406544150605,841,0.376961004034065,1390,0.623038995965935
"E02001100",4,132,559,918,266,38,11,1928,0.0020746887966805,0.0684647302904564,0.2899377593361,0.476141078838174,0.137966804979253,0.0197095435684647,0.00570539419087137,695,0.360477178423237,1233,0.639522821576764
"E02001101",1,32,446,853,258,40,5,1635,0.000611620795107034,0.0195718654434251,0.272782874617737,0.5217125382263,0.157798165137615,0.0244648318042813,0.00305810397553517,479,0.292966360856269,1156,0.707033639143731
"E02001102",17,290,504,880,243,41,5,1980,0.00858585858585859,0.146464646464646,0.254545454545455,0.444444444444444,0.122727272727273,0.0207070707070707,0.00252525252525253,811,0.40959595959596,1169,0.59040404040404
"E02001103",4,124,494,682,304,59,20,1687,0.002371072910492,0.0735032602252519,0.292827504445762,0.404267931238886,0.180201541197392,0.034973325429757,0.01185536455246,622,0.368701837581506,1065,0.631298162418494
"E02001104",1,282,803,824,172,24,7,2113,0.000473260766682442,0.133459536204449,0.380028395646001,0.389966871746332,0.08140085186938,0.0113582584003786,0.00331282536677709,1086,0.513961192617132,1027,0.486038807382868
"E02001105",6,206,712,827,182,27,8,1968,0.00304878048780488,0.104674796747967,0.361788617886179,0.420223577235772,0.092479674796748,0.013719512195122,0.0040650406504065,924,0.469512195121951,1044,0.530487804878049
"E02001106",2,241,861,957,420,44,5,2530,0.000790513833992095,0.0952569169960474,0.340316205533597,0.378260869565217,0.16600790513834,0.0173913043478261,0.00197628458498024,1104,0.436363636363636,1426,0.563636363636364
"E02001107",2,109,624,971,284,61,7,2058,0.000971817298347911,0.0529640427599611,0.303206997084548,0.471817298347911,0.137998056365403,0.0296404275996113,0.00340136054421769,735,0.357142857142857,1323,0.642857142857143
"E02001108",0,279,684,946,222,38,10,2179,0,0.128040385497935,0.313905461220743,0.434144102799449,0.101881597062873,0.0174391922900413,0.00458926112895824,963,0.441945846718678,1216,0.558054153281322
"E02001109",0,156,1249,1259,339,57,21,3081,0,0.0506329113924051,0.405387861084064,0.408633560532295,0.110029211295034,0.0185004868549172,0.0068159688412853,1405,0.456020772476469,1676,0.543979227523531
"E02001110",3,174,584,862,390,95,12,2120,0.00141509433962264,0.0820754716981132,0.275471698113208,0.406603773584906,0.183962264150943,0.044811320754717,0.00566037735849057,761,0.358962264150943,1359,0.641037735849057
"E02001111",13,418,2000,1037,174,28,9,3679,0.00353356890459364,0.113617830932319,0.543625985322098,0.281870073389508,0.0472954607230226,0.00761076379450938,0.00244631693394944,2431,0.660777385159011,1248,0.339222614840989
"E02001112",9,286,436,747,200,37,8,1723,0.00522344747533372,0.165989553105049,0.253047011027278,0.433546140452699,0.116076610562972,0.0214741729541497,0.00464306442251886,731,0.424260011607661,992,0.575739988392339
"E02001113",37,168,872,1004,294,34,16,2425,0.0152577319587629,0.0692783505154639,0.359587628865979,0.414020618556701,0.121237113402062,0.014020618556701,0.0065979381443299,1077,0.444123711340206,1348,0.555876288659794
"E02001114",1,360,1314,1240,259,31,6,3211,0.000311429461227032,0.112114606041732,0.40921831205232,0.38617253192152,0.0806602304578013,0.00965431329803799,0.00186857676736219,1675,0.521644347555279,1536,0.478355652444721
"E02001115",2,64,643,1039,229,44,14,2035,0.000982800982800983,0.0314496314496314,0.315970515970516,0.510565110565111,0.112530712530713,0.0216216216216216,0.00687960687960688,709,0.348402948402948,1326,0.651597051597052
"E02001116",0,61,558,1216,486,84,27,2432,0,0.0250822368421053,0.229440789473684,0.5,0.199835526315789,0.0345394736842105,0.0111019736842105,619,0.254523026315789,1813,0.745476973684211
"E02001117",1,197,667,747,309,43,18,1982,0.000504540867810293,0.0993945509586276,0.336528758829465,0.376892028254289,0.15590312815338,0.0216952573158426,0.00908173562058527,865,0.436427850655903,1117,0.563572149344097
"E02001118",3,67,619,882,321,38,8,1938,0.00154798761609907,0.0345717234262126,0.319401444788442,0.455108359133127,0.165634674922601,0.0196078431372549,0.00412796697626419,689,0.355521155830753,1249,0.644478844169247
"E02001119",1,32,646,1215,505,67,21,2487,0.000402090872537193,0.0128669079211902,0.259750703659027,0.48854041013269,0.203055890631283,0.026940088459992,0.00844390832328106,679,0.273019702452754,1808,0.726980297547246
"E02001121",22,223,844,983,345,81,33,2531,0.00869221651521138,0.0881074674041881,0.333465033583564,0.388384037929672,0.136309758988542,0.0320031608060055,0.0130383247728171,1089,0.430264717502963,1442,0.569735282497037
"E02001123",1,118,1027,1159,251,43,7,2606,0.000383729854182655,0.0452801227935533,0.394090560245587,0.444742900997698,0.0963161933998465,0.0165003837298542,0.00268610897927859,1146,0.439754412893323,1460,0.560245587106677
"E02001124",0,359,987,870,216,37,10,2479,0,0.144816458249294,0.398144413069786,0.350947962888261,0.0871319080274304,0.0149253731343284,0.00403388463089956,1346,0.54296087131908,1133,0.45703912868092
"E02001125",1,118,746,1178,394,51,9,2497,0.00040048057669203,0.0472567080496596,0.298758510212255,0.471766119343212,0.15778934721666,0.0204245094112936,0.00360432519022827,865,0.346415698838606,1632,0.653584301161394
"E02001126",54,419,1919,1245,355,49,21,4062,0.0132939438700148,0.103151157065485,0.472427375677006,0.306499261447563,0.0873953717380601,0.0120630231413097,0.0051698670605613,2392,0.588872476612506,1670,0.411127523387494
"E02001127",1,214,866,1147,235,50,10,2523,0.000396353547364249,0.0848196591359493,0.34324217201744,0.454617518826794,0.0931430836305985,0.0198176773682124,0.00396353547364249,1081,0.428458184700753,1442,0.571541815299247
"E02001128",0,83,832,1352,463,68,23,2821,0,0.0294221907125133,0.294930875576037,0.47926267281106,0.164126196384261,0.0241049273307338,0.00815313718539525,915,0.32435306628855,1906,0.67564693371145
"E02001129",18,399,956,1205,353,53,14,2998,0.00600400266844563,0.133088725817211,0.318879252835224,0.401934623082055,0.117745163442295,0.0176784523015344,0.00466977985323549,1373,0.457971981320881,1625,0.542028018679119
"E02001130",1,93,739,767,169,24,7,1800,0.000555555555555556,0.0516666666666667,0.410555555555556,0.426111111111111,0.0938888888888889,0.0133333333333333,0.00388888888888889,833,0.462777777777778,967,0.537222222222222
"E02001131",1,70,400,870,227,27,5,1600,0.000625,0.04375,0.25,0.54375,0.141875,0.016875,0.003125,471,0.294375,1129,0.705625
"E02001132",0,360,864,1063,347,71,25,2730,0,0.131868131868132,0.316483516483516,0.389377289377289,0.127106227106227,0.026007326007326,0.00915750915750916,1224,0.448351648351648,1506,0.551648351648352
"E02001133",0,116,727,787,245,50,9,1934,0,0.0599793174767322,0.375904860392968,0.406928645294726,0.126680455015512,0.0258531540847983,0.0046535677352637,843,0.4358841778697,1091,0.5641158221303
"E02001134",3,130,622,887,224,40,13,1919,0.00156331422615946,0.0677436164669099,0.324127149557061,0.462219906201146,0.116727462219906,0.0208441896821261,0.00677436164669099,755,0.39343408025013,1164,0.60656591974987
"E02001135",1,301,1942,1044,175,29,13,3505,0.000285306704707561,0.0858773181169757,0.554065620542083,0.297860199714693,0.0499286733238231,0.00827389443651926,0.00370898716119829,2244,0.640228245363766,1261,0.359771754636234
"E02001136",4,144,1204,1350,320,43,12,3077,0.00129996750081248,0.0467988300292493,0.391290217744556,0.438739031524212,0.103997400064998,0.0139746506337342,0.00389990250243744,1352,0.439389015274618,1725,0.560610984725382
"E02001137",2,88,505,871,285,64,24,1839,0.00108754758020663,0.0478520935290919,0.274605764002175,0.473626971179989,0.154975530179445,0.0348015225666123,0.0130505709624796,595,0.323545405111474,1244,0.676454594888526
"E02001138",3,84,964,1286,277,37,3,2654,0.00113036925395629,0.0316503391107762,0.363225320271289,0.484551620195931,0.104370761115298,0.0139412207987943,0.00113036925395629,1051,0.396006028636021,1603,0.603993971363979
"E02001139",2,356,1065,1234,376,55,20,3108,0.000643500643500643,0.114543114543115,0.342664092664093,0.397039897039897,0.120978120978121,0.0176962676962677,0.00643500643500643,1423,0.457850707850708,1685,0.542149292149292
"E02001140",10,122,1111,1256,328,54,11,2892,0.00345781466113416,0.0421853388658368,0.384163208852006,0.434301521438451,0.113416320885201,0.0186721991701245,0.00380359612724758,1243,0.429806362378977,1649,0.570193637621024
"E02001141",19,543,2547,1923,658,121,40,5851,0.00324730815245257,0.0928046487779867,0.435310203384037,0.328661767219279,0.112459408648094,0.0206802256024611,0.00683643821568963,3109,0.531362160314476,2742,0.468637839685524
"E02001142",1,95,466,864,311,55,9,1801,0.000555247084952804,0.0527484730705164,0.258745141588007,0.479733481399223,0.172681843420322,0.0305385896724042,0.00499722376457524,562,0.312048861743476,1239,0.687951138256524
"E02001143",2,337,1478,1477,356,61,24,3735,0.000535475234270415,0.0902275769745649,0.395716198125837,0.395448460508701,0.0953145917001339,0.0163319946452477,0.00642570281124498,1817,0.486479250334672,1918,0.513520749665328
"E02001144",5,245,896,809,306,40,15,2316,0.00215889464594128,0.105785837651123,0.386873920552677,0.349309153713299,0.132124352331606,0.0172711571675302,0.00647668393782383,1146,0.494818652849741,1170,0.505181347150259
"E02001145",9,92,720,1030,288,40,12,2191,0.00410771337288909,0.0419899589228663,0.328617069831127,0.470104974897307,0.131446827932451,0.0182565038795071,0.00547695116385212,821,0.374714742126883,1370,0.625285257873117
"E02001146",1,279,1005,1204,402,73,25,2989,0.000334560053529609,0.0933422549347608,0.336232853797257,0.402810304449649,0.134493141518903,0.0244228839076614,0.00836400133824021,1285,0.429909668785547,1704,0.570090331214453
"E02001147",4,954,1792,1510,239,47,9,4555,0.000878155872667398,0.209440175631175,0.393413830954994,0.331503841931943,0.0524698133918771,0.0103183315038419,0.00197585071350165,2750,0.603732162458836,1805,0.396267837541164
"E02001148",39,414,1507,1562,450,75,23,4070,0.00958230958230958,0.101719901719902,0.37027027027027,0.383783783783784,0.110565110565111,0.0184275184275184,0.00565110565110565,1960,0.481572481572482,2110,0.518427518427518
"E02001149",8,589,2330,1477,425,67,13,4909,0.00162965980851497,0.119983703401915,0.474638419229986,0.300875942147077,0.0865756773273579,0.0136484008963129,0.00264819718883683,2927,0.596251782440416,1982,0.403748217559585
"E02001150",2,286,1261,1508,290,33,18,3398,0.000588581518540318,0.0841671571512655,0.37110064743967,0.4437904649794,0.0853443201883461,0.00971159505591524,0.00529723366686286,1549,0.455856386109476,1849,0.544143613890524
"E02001151",2,239,1198,1407,380,79,24,3329,0.000600781015319916,0.0717933313307299,0.35986782817663,0.422649444277561,0.114148392910784,0.0237308501051367,0.00720937218383899,1439,0.432261940522679,1890,0.56773805947732
"E02001152",1,596,1626,1361,350,59,12,4005,0.000249687890137328,0.148813982521848,0.405992509363296,0.339825218476904,0.0873907615480649,0.0147315855181024,0.00299625468164794,2223,0.555056179775281,1782,0.444943820224719
"E02001153",11,1523,2226,1013,222,31,8,5034,0.00218514104092173,0.302542709574891,0.442193087008343,0.201231624950338,0.0441001191895113,0.00615812475168852,0.00158919348430671,3760,0.746920937624156,1274,0.253079062375844
"E02001154",1,470,1479,1552,362,47,10,3921,0.000255036980362153,0.119867380770212,0.377199693955624,0.395817393522061,0.0923233868910992,0.0119867380770212,0.00255036980362153,1950,0.497322111706197,1971,0.502677888293803
"E02001155",2,167,1534,1034,313,50,20,3120,0.000641025641025641,0.053525641025641,0.491666666666667,0.331410256410256,0.100320512820513,0.016025641025641,0.00641025641025641,1703,0.545833333333333,1417,0.454166666666667
"E02001156",2,48,1054,1302,407,72,14,2899,0.000689893066574681,0.0165574335977923,0.363573646084857,0.449120386340117,0.140393239047948,0.0248361503966885,0.00482925146602277,1104,0.380820972749224,1795,0.619179027250776
"E02001157",38,669,2243,943,284,21,6,4204,0.00903901046622265,0.159134157944814,0.533539486203616,0.224310180780209,0.0675547098001903,0.00499524262607041,0.00142721217887726,2950,0.701712654614653,1254,0.298287345385347
"E02001158",77,319,1374,879,310,26,11,2996,0.0257009345794393,0.106475300400534,0.458611481975968,0.293391188251001,0.10347129506008,0.00867823765020027,0.00367156208277704,1770,0.590787716955941,1226,0.409212283044059
"E02001159",18,1002,1401,729,170,17,5,3342,0.00538599640933573,0.299820466786355,0.419210053859964,0.218132854578097,0.0508677438659485,0.00508677438659485,0.00149611011370437,2421,0.724416517055655,921,0.275583482944345
"E02001160",9,614,1545,806,230,17,4,3225,0.0027906976744186,0.190387596899225,0.47906976744186,0.249922480620155,0.0713178294573643,0.00527131782945736,0.00124031007751938,2168,0.672248062015504,1057,0.327751937984496
"E02001161",1,136,1038,893,228,38,13,2347,0.000426075841499787,0.057946314443971,0.442266723476779,0.38048572645931,0.0971452918619514,0.0161908819769919,0.00553898593949723,1175,0.50063911376225,1172,0.49936088623775
"E02001162",8,91,1165,941,264,39,12,2520,0.00317460317460317,0.0361111111111111,0.462301587301587,0.373412698412698,0.104761904761905,0.0154761904761905,0.00476190476190476,1264,0.501587301587302,1256,0.498412698412698
"E02001163",1,486,1363,1521,442,62,16,3891,0.000257003341043434,0.124903623747109,0.3502955538422,0.390902081727062,0.113595476741198,0.0159342071446929,0.00411205345669494,1850,0.475456180930352,2041,0.524543819069648
"E02001164",2,360,1497,846,238,28,5,2976,0.000672043010752688,0.120967741935484,0.503024193548387,0.284274193548387,0.0799731182795699,0.00940860215053763,0.00168010752688172,1859,0.624663978494624,1117,0.375336021505376
"E02001165",0,223,827,1020,287,34,10,2401,0,0.092877967513536,0.344439816743024,0.424822990420658,0.119533527696793,0.0141607663473553,0.0041649312786339,1050,0.43731778425656,1351,0.56268221574344
"E02001166",1,119,1010,747,378,84,14,2353,0.000424989375265618,0.0505737356566086,0.429239269018275,0.317467063323417,0.160645983850404,0.0356991075223119,0.00594985125371866,1130,0.480237994050149,1223,0.519762005949851
"E02001167",0,183,1217,1149,326,62,12,2949,0,0.0620549338758901,0.412682265174635,0.389623601220753,0.110545947778908,0.0210240759579518,0.00406917599186165,1400,0.474737199050526,1549,0.525262800949474
"E02001168",1,400,1729,1458,432,61,18,4099,0.000243961941937058,0.0975847767748231,0.421810197609173,0.35569651134423,0.105391558916809,0.0148816784581605,0.00439131495486704,2130,0.519638936325933,1969,0.480361063674067
"E02001169",2,323,1055,1396,312,49,13,3150,0.000634920634920635,0.102539682539683,0.334920634920635,0.443174603174603,0.0990476190476191,0.0155555555555556,0.00412698412698413,1380,0.438095238095238,1770,0.561904761904762
"E02001170",0,150,1015,1406,474,75,16,3136,0,0.0478316326530612,0.323660714285714,0.448341836734694,0.151147959183673,0.0239158163265306,0.00510204081632653,1165,0.371492346938776,1971,0.628507653061224
"E02001171",0,167,521,789,247,43,12,1779,0,0.0938729623383924,0.292861157953907,0.443507588532884,0.138842046093311,0.0241708825182687,0.00674536256323777,688,0.386734120292299,1091,0.613265879707701
"E02001173",107,896,1825,1167,303,46,16,4360,0.0245412844036697,0.205504587155963,0.418577981651376,0.267660550458716,0.0694954128440367,0.0105504587155963,0.0036697247706422,2828,0.648623853211009,1532,0.351376146788991
"E02001174",0,25,473,1016,404,59,10,1987,0,0.0125817815802718,0.238047307498742,0.511323603422245,0.203321590337192,0.0296930045294414,0.00503271263210871,498,0.250629089079014,1489,0.749370910920986
"E02001175",2,237,1243,1103,446,47,5,3083,0.000648718780408693,0.0768731754784301,0.403178722024003,0.357768407395394,0.144664288031139,0.0152448913396043,0.00162179695102173,1482,0.480700616282841,1601,0.519299383717159
"E02001176",6,614,2075,1824,702,106,26,5353,0.0011208668036615,0.11470203624136,0.387633102932935,0.340743508313095,0.131141416028395,0.0198019801980198,0.00485708948253316,2695,0.503456005977956,2658,0.496543994022044
"E02001177",1,858,2542,2112,630,86,19,6248,0.000160051216389245,0.137323943661972,0.40685019206146,0.338028169014085,0.100832266325224,0.013764404609475,0.00304097311139565,3401,0.544334186939821,2847,0.455665813060179
"E02001179",4,709,1235,1313,336,48,21,3666,0.0010911074740862,0.193398799781779,0.336879432624113,0.358156028368794,0.0916530278232406,0.0130932896890344,0.00572831423895254,1948,0.531369339879978,1718,0.468630660120022
"E02001180",124,1126,1473,419,69,11,11,3233,0.0383544695329415,0.348283328178163,0.455613980822765,0.129600989792762,0.021342406433653,0.00340241261985772,0.00340241261985772,2723,0.842251778533869,510,0.157748221466131
"E02001181",1,176,1540,691,177,35,12,2632,0.000379939209726444,0.0668693009118541,0.585106382978723,0.262537993920973,0.0672492401215806,0.0132978723404255,0.00455927051671732,1717,0.652355623100304,915,0.347644376899696
"E02001182",0,564,1365,1216,310,53,9,3517,0,0.160363946545351,0.388114870628376,0.345749218083594,0.088143303952232,0.0150696616434461,0.00255899914700028,1929,0.548478817173728,1588,0.451521182826272
"E02001183",9,422,1099,1247,388,56,18,3239,0.00277863538129052,0.130287125656067,0.339302253782031,0.384995368941031,0.11979005866008,0.0172892868169188,0.00555727076258104,1530,0.472368014819389,1709,0.527631985180611
"E02001185",1,130,1526,1377,372,36,8,3450,0.000289855072463768,0.0376811594202899,0.44231884057971,0.399130434782609,0.107826086956522,0.0104347826086957,0.00231884057971014,1657,0.480289855072464,1793,0.519710144927536
"E02001186",11,323,1876,1459,514,78,31,4292,0.00256290773532153,0.0752562907735322,0.437092264678472,0.339934762348555,0.119757688723206,0.0181733457595527,0.00722273998136067,2210,0.514911463187325,2082,0.485088536812675
"E02001187",0,33,662,1204,319,45,17,2280,0,0.0144736842105263,0.290350877192982,0.528070175438596,0.139912280701754,0.0197368421052632,0.00745614035087719,695,0.304824561403509,1585,0.695175438596491
"E02001188",7,223,1224,1437,365,46,20,3322,0.00210716435881999,0.0671282360024082,0.368452739313666,0.43257074051776,0.109873570138471,0.0138470800722456,0.00602046959662854,1454,0.437688139674895,1868,0.562311860325105
"E02001189",3,83,713,1349,379,46,15,2588,0.00115919629057187,0.0320710973724884,0.275502318392581,0.521251931993818,0.14644513137558,0.017774343122102,0.00579598145285935,799,0.308732612055641,1789,0.691267387944358
"E02001190",7,510,1206,1140,163,22,11,3059,0.0022883295194508,0.166721150702844,0.394246485779667,0.372670807453416,0.0532853873814972,0.0071918927754168,0.0035959463877084,1723,0.563255966001961,1336,0.436744033998039
"E02001191",17,111,567,843,241,41,4,1824,0.00932017543859649,0.0608552631578947,0.310855263157895,0.462171052631579,0.132127192982456,0.0224780701754386,0.00219298245614035,695,0.381030701754386,1129,0.618969298245614
"E02001192",5,173,670,1052,620,105,19,2644,0.0018910741301059,0.0654311649016641,0.253403933434191,0.397881996974281,0.234493192133132,0.0397125567322239,0.00718608169440242,848,0.320726172465961,1796,0.679273827534039
"E02001193",6,128,808,1352,380,60,16,2750,0.00218181818181818,0.0465454545454545,0.293818181818182,0.491636363636364,0.138181818181818,0.0218181818181818,0.00581818181818182,942,0.342545454545455,1808,0.657454545454546
"E02001194",5,183,589,918,412,93,12,2212,0.00226039783001808,0.0827305605786618,0.26627486437613,0.41500904159132,0.18625678119349,0.0420433996383363,0.0054249547920434,777,0.35126582278481,1435,0.64873417721519
"E02001195",1,128,609,1277,360,64,20,2459,0.000406669377795852,0.0520536803578691,0.247661651077674,0.519316795445303,0.146400976006507,0.0260268401789345,0.00813338755591704,738,0.300122000813339,1721,0.699877999186661
"E02001196",4,146,726,1154,427,92,16,2565,0.00155945419103314,0.0569200779727096,0.283040935672515,0.44990253411306,0.166471734892788,0.0358674463937622,0.00623781676413255,876,0.341520467836257,1689,0.658479532163743
"E02001197",2,34,526,933,322,55,8,1880,0.00106382978723404,0.0180851063829787,0.279787234042553,0.496276595744681,0.171276595744681,0.0292553191489362,0.00425531914893617,562,0.298936170212766,1318,0.701063829787234
"E02001198",1,167,1467,1043,237,42,2,2959,0.000337952010814464,0.0564379858060155,0.495775599864819,0.352483947279486,0.0800946265630281,0.0141939844542075,0.000675904021628929,1635,0.552551537681649,1324,0.447448462318351
"E02001199",0,195,742,1277,518,72,11,2815,0,0.0692717584369449,0.263587921847247,0.453641207815275,0.184014209591474,0.0255772646536412,0.00390763765541741,937,0.332859680284192,1878,0.667140319715808
"E02001200",1,688,1831,1299,468,62,14,4363,0.000229200091680037,0.157689663075865,0.419665367866147,0.297730919092368,0.107265642906257,0.0142104056841623,0.00320880128352051,2520,0.577584231033692,1843,0.422415768966308
"E02001201",0,140,414,1032,274,42,9,1911,0,0.0732600732600733,0.216640502354788,0.540031397174254,0.143380429094715,0.021978021978022,0.00470957613814757,554,0.289900575614861,1357,0.710099424385139
"E02001202",0,220,818,1499,548,85,21,3191,0,0.0689439047320589,0.256345973049201,0.469758696333438,0.171732999059856,0.0266374177373864,0.00658100908806017,1038,0.32528987778126,2153,0.67471012221874
"E02001203",4,87,355,774,378,85,24,1707,0.00234329232571763,0.0509666080843585,0.20796719390744,0.453427065026362,0.221441124780316,0.0497949619214997,0.0140597539543058,446,0.261277094317516,1261,0.738722905682484
"E02001204",0,44,663,1422,611,83,14,2837,0,0.0155093408530137,0.233697567853366,0.501233697567853,0.215368346845259,0.0292562566090941,0.00493479027141347,707,0.24920690870638,2130,0.75079309129362
"E02001205",0,313,1099,1388,448,73,13,3334,0,0.0938812237552489,0.329634073185363,0.416316736652669,0.134373125374925,0.0218956208758248,0.00389922015596881,1412,0.423515296940612,1922,0.576484703059388
"E02001206",5,261,874,997,345,73,9,2564,0.00195007800312012,0.101794071762871,0.340873634945398,0.388845553822153,0.134555382215289,0.0284711388455538,0.00351014040561622,1140,0.444617784711388,1424,0.555382215288612
"E02001207",1,51,655,1067,257,30,5,2066,0.000484027105517909,0.0246853823814134,0.31703775411423,0.516456921587609,0.124394966118103,0.0145208131655373,0.00242013552758954,707,0.342207163601162,1359,0.657792836398838
"E02001208",2,122,903,1427,484,53,16,3007,0.00066511473229132,0.0405719986697705,0.300299301629531,0.474559361489857,0.1609577652145,0.01762554040572,0.00532091785833056,1027,0.341536415031593,1980,0.658463584968407
"E02001209",2,157,786,1367,570,71,20,2973,0.00067272115708039,0.0528086108308106,0.264379414732593,0.459804910864447,0.191725529767911,0.0238816010763539,0.0067272115708039,945,0.317860746720484,2028,0.682139253279516
"E02001210",39,299,862,923,199,28,8,2358,0.0165394402035623,0.126802374893978,0.365564037319763,0.391433418150975,0.0843935538592027,0.0118744698897371,0.00339270568278202,1200,0.508905852417303,1158,0.491094147582697
"E02001211",1,247,475,836,355,65,15,1994,0.000501504513540622,0.123871614844534,0.238214643931795,0.41925777331996,0.178034102306921,0.0325977933801404,0.00752256770310933,723,0.36258776328987,1271,0.63741223671013
"E02001212",3,210,970,799,186,28,11,2207,0.00135931128228364,0.095151789759855,0.439510647938378,0.36202990484821,0.0842772995015859,0.012686905301314,0.00498414136837336,1183,0.536021748980517,1024,0.463978251019483
"E02001213",0,379,786,1551,730,120,23,3589,0,0.105600445806631,0.219002507662301,0.432153803287824,0.203399275564224,0.0334354973530231,0.0064084703259961,1165,0.324602953468933,2424,0.675397046531067
"E02001214",1,127,776,1064,353,82,9,2412,0.000414593698175788,0.052653399668325,0.321724709784411,0.441127694859038,0.146351575456053,0.0339966832504146,0.00373134328358209,904,0.374792703150912,1508,0.625207296849088
"E02001215",5,100,573,826,327,54,14,1899,0.00263296471827278,0.0526592943654555,0.30173775671406,0.434965771458662,0.17219589257504,0.028436018957346,0.00737230121116377,678,0.357030015797788,1221,0.642969984202212
"E02001216",3,202,623,1017,358,70,7,2280,0.00131578947368421,0.0885964912280702,0.273245614035088,0.446052631578947,0.157017543859649,0.0307017543859649,0.00307017543859649,828,0.363157894736842,1452,0.636842105263158
"E02001217",1,266,786,1221,486,56,24,2840,0.000352112676056338,0.0936619718309859,0.276760563380282,0.429929577464789,0.17112676056338,0.0197183098591549,0.00845070422535211,1053,0.370774647887324,1787,0.629225352112676
"E02001218",2,61,705,774,254,54,8,1858,0.00107642626480086,0.0328310010764263,0.379440258342304,0.416576964477933,0.136706135629709,0.0290635091496232,0.00430570505920344,768,0.413347685683531,1090,0.586652314316469
"E02001219",0,12,343,811,238,32,4,1440,0,0.00833333333333333,0.238194444444444,0.563194444444444,0.165277777777778,0.0222222222222222,0.00277777777777778,355,0.246527777777778,1085,0.753472222222222
"E02001220",3,123,518,709,233,45,5,1636,0.00183374083129584,0.0751833740831296,0.316625916870416,0.433374083129584,0.142420537897311,0.0275061124694377,0.00305623471882641,644,0.393643031784841,992,0.606356968215159
"E02001221",9,68,360,813,243,28,0,1521,0.00591715976331361,0.0447074293228139,0.236686390532544,0.534516765285996,0.159763313609467,0.0184089414858646,0,437,0.287310979618672,1084,0.712689020381328
"E02001222",1,84,403,933,278,38,6,1743,0.00057372346528973,0.0481927710843374,0.231210556511761,0.535283993115318,0.159495123350545,0.0218014916810098,0.00344234079173838,488,0.279977051061388,1255,0.720022948938612
"E02001223",1,29,476,1034,337,64,11,1952,0.000512295081967213,0.0148565573770492,0.243852459016393,0.529713114754098,0.172643442622951,0.0327868852459016,0.00563524590163934,506,0.25922131147541,1446,0.74077868852459
"E02001224",7,28,296,939,340,63,13,1686,0.00415183867141162,0.0166073546856465,0.175563463819692,0.556939501779359,0.201660735468565,0.0373665480427046,0.00771055753262159,331,0.19632265717675,1355,0.80367734282325
"E02001225",2,146,602,1040,331,61,5,2187,0.000914494741655235,0.0667581161408322,0.275262917238226,0.475537265660722,0.151348879743941,0.0278920896204847,0.00228623685413809,750,0.342935528120713,1437,0.657064471879287
"E02001226",7,284,792,979,273,31,4,2370,0.0029535864978903,0.119831223628692,0.334177215189873,0.413080168776371,0.115189873417722,0.0130801687763713,0.00168776371308017,1083,0.456962025316456,1287,0.543037974683544
"E02001227",1,44,335,816,253,58,4,1511,0.000661813368630046,0.029119788219722,0.221707478491066,0.540039708802118,0.167438782263402,0.0383851753805427,0.00264725347452019,380,0.251489080079418,1131,0.748510919920582
"E02001228",49,817,361,765,304,56,9,2361,0.0207539178314274,0.346039813638289,0.152901313002965,0.324015247776366,0.128759000423549,0.023718763235917,0.00381194409148666,1227,0.519695044472681,1134,0.480304955527319
"E02001229",5,318,1280,1694,466,86,30,3879,0.00128899200824955,0.0819798917246713,0.329981954111885,0.436710492394947,0.120134055168858,0.0221706625418922,0.00773395204949729,1603,0.413250837844805,2276,0.586749162155195
"E02001230",3,167,554,799,147,27,4,1701,0.0017636684303351,0.0981775426219871,0.325690770135215,0.469723691945914,0.0864197530864197,0.0158730158730159,0.00235155790711346,724,0.425631981187537,977,0.574368018812463
"E02001231",2,61,1019,971,167,14,8,2242,0.000892060660124889,0.0272078501338091,0.454504906333631,0.433095450490633,0.0744870651204282,0.00624442462087422,0.00356824264049955,1082,0.482604817127565,1160,0.517395182872435
"E02001232",8,131,1486,1297,258,42,10,3232,0.00247524752475248,0.0405321782178218,0.459777227722772,0.401299504950495,0.0798267326732673,0.0129950495049505,0.00309405940594059,1625,0.502784653465347,1607,0.497215346534653
"E02001233",4,177,1214,1085,275,47,9,2811,0.00142298114549982,0.0629669156883671,0.431874777659196,0.385983635716827,0.0978299537531128,0.0167200284596229,0.0032017075773746,1395,0.496264674493063,1416,0.503735325506937
"E02001234",1,98,1336,1329,352,51,7,3174,0.000315059861373661,0.0308758664146188,0.420919974795211,0.418714555765595,0.110901071203529,0.0160680529300567,0.00220541902961563,1435,0.452110901071204,1739,0.547889098928796
"E02001235",5,283,835,1143,330,51,7,2654,0.00188394875659382,0.10663149962321,0.314619442351168,0.430670685757347,0.124340617935192,0.019216277317257,0.00263752825923135,1123,0.423134890730972,1531,0.576865109269028
"E02001236",3,196,1190,968,212,39,15,2623,0.00114372855508959,0.07472359893252,0.453678993518872,0.369043080442242,0.0808234845596645,0.0148684712161647,0.00571864277544796,1389,0.529546321006481,1234,0.470453678993519
"E02001237",0,148,1262,1159,254,44,14,2881,0,0.0513710517181534,0.438042346407497,0.402290871225269,0.0881638320027768,0.0152724748351267,0.00485942381117668,1410,0.489413398125651,1471,0.510586601874349
"E02001238",1,136,1071,1109,288,47,10,2662,0.000375657400450789,0.0510894064613073,0.402329075882795,0.416604057099925,0.108189331329827,0.0176558978211871,0.00375657400450789,1208,0.453794139744553,1454,0.546205860255447
"E02001239",0,154,1309,1571,401,36,17,3488,0,0.044151376146789,0.375286697247706,0.450401376146789,0.114965596330275,0.0103211009174312,0.00487385321100917,1463,0.419438073394495,2025,0.580561926605505
"E02001240",0,171,483,1099,347,40,11,2151,0,0.0794979079497908,0.224546722454672,0.510925151092515,0.161320316132032,0.0185960018596002,0.00511390051139005,654,0.304044630404463,1497,0.695955369595537
"E02001241",3,476,2007,1365,480,80,37,4448,0.000674460431654676,0.107014388489209,0.451214028776978,0.306879496402878,0.107913669064748,0.0179856115107914,0.00831834532374101,2486,0.558902877697842,1962,0.441097122302158
"E02001242",3,750,602,826,268,38,13,2500,0.0012,0.3,0.2408,0.3304,0.1072,0.0152,0.0052,1355,0.542,1145,0.458
"E02001243",3,285,1127,1288,435,63,12,3213,0.000933706816059757,0.0887021475256769,0.350762527233115,0.400871459694989,0.135387488328665,0.0196078431372549,0.00373482726423903,1415,0.440398381574852,1798,0.559601618425148
"E02001244",2,34,417,784,202,35,12,1486,0.00134589502018843,0.0228802153432032,0.280619111709287,0.527590847913863,0.135935397039031,0.0235531628532974,0.00807537012113055,453,0.304845222072678,1033,0.695154777927322
"E02001245",1,100,1464,1328,314,110,39,3356,0.000297973778307509,0.0297973778307509,0.436233611442193,0.395709177592372,0.0935637663885578,0.032777115613826,0.0116209773539928,1565,0.466328963051251,1791,0.533671036948749
"E02001246",9,173,1248,1047,201,17,9,2704,0.00332840236686391,0.0639792899408284,0.461538461538462,0.387204142011834,0.0743343195266272,0.00628698224852071,0.00332840236686391,1430,0.528846153846154,1274,0.471153846153846
"E02001247",1,319,1096,1202,263,54,7,2942,0.000339904826648538,0.108429639700884,0.372535690006798,0.408565601631543,0.0893949694085656,0.0183548606390211,0.00237933378653977,1416,0.48130523453433,1526,0.51869476546567
"E02001248",6,792,2144,1516,348,42,15,4863,0.00123380629241209,0.162862430598396,0.440880115155254,0.311741723216122,0.0715607649599013,0.00863664404688464,0.00308451573103023,2942,0.604976352046062,1921,0.395023647953938
"E02001249",13,252,776,1234,371,54,22,2722,0.00477590007347539,0.0925789860396767,0.285084496693608,0.453343130051433,0.136296840558413,0.0198383541513593,0.00808229243203527,1041,0.38243938280676,1681,0.61756061719324
"E02001250",15,154,661,845,245,31,10,1961,0.00764915859255482,0.0785313615502295,0.337072921978582,0.430902600713921,0.124936257011729,0.01580826109128,0.00509943906170321,830,0.423253442121367,1131,0.576746557878633
"E02001251",2,124,711,1059,343,66,17,2322,0.000861326442721792,0.0534022394487511,0.306201550387597,0.456072351421189,0.147717484926787,0.0284237726098191,0.00732127476313523,837,0.36046511627907,1485,0.63953488372093
"E02001252",0,31,550,1172,398,61,12,2224,0,0.0139388489208633,0.247302158273381,0.526978417266187,0.178956834532374,0.0274280575539568,0.00539568345323741,581,0.261241007194245,1643,0.738758992805755
"E02001253",1,62,530,856,221,46,8,1724,0.000580046403712297,0.0359628770301624,0.307424593967517,0.496519721577726,0.128190255220418,0.0266821345707657,0.00464037122969838,593,0.343967517401392,1131,0.656032482598608
"E02001254",0,56,806,755,154,21,4,1796,0,0.0311804008908686,0.448775055679287,0.420378619153675,0.0857461024498886,0.0116926503340757,0.0022271714922049,862,0.479955456570156,934,0.520044543429844
"E02001255",29,778,2012,573,77,18,4,3491,0.00830707533657978,0.222858779719278,0.576339157834431,0.164136350615869,0.0220567172729877,0.00515611572615297,0.00114580349470066,2819,0.807505012890289,672,0.192494987109711
"E02001256",1,195,1454,1615,514,71,27,3877,0.000257931390250193,0.0502966210987877,0.375032241423781,0.416559195254062,0.132576734588599,0.0183131287077637,0.00696414753675522,1650,0.425586793912819,2227,0.574413206087181
"E02001257",6,179,1522,1370,329,52,5,3463,0.00173260179035518,0.0516892867455963,0.439503320820098,0.3956107421311,0.0950043315044759,0.0150158821830783,0.00144383482529599,1707,0.49292520935605,1756,0.50707479064395
"E02001258",1,123,614,1144,450,81,14,2427,0.000412031314379893,0.0506798516687268,0.252987227029254,0.471363823650597,0.185414091470952,0.0333745364647713,0.0057684384013185,738,0.304079110012361,1689,0.695920889987639
"E02001259",7,1356,2418,1567,557,76,28,6009,0.00116491928773506,0.225661507738392,0.402396405391912,0.260775503411549,0.0926942918954901,0.0126476951239807,0.00465967715094026,3781,0.62922283241804,2228,0.37077716758196
"E02001260",0,50,462,1061,313,42,2,1930,0,0.0259067357512953,0.239378238341969,0.549740932642487,0.162176165803109,0.0217616580310881,0.00103626943005181,512,0.265284974093264,1418,0.734715025906736
"E02001261",6,509,1080,1484,430,56,15,3580,0.00167597765363128,0.142178770949721,0.301675977653631,0.414525139664804,0.120111731843575,0.0156424581005587,0.00418994413407821,1595,0.445530726256983,1985,0.554469273743017
"E02001262",0,107,750,1139,436,57,18,2507,0,0.0426804946150778,0.299162345432788,0.454327881930594,0.173913043478261,0.0227363382528919,0.00717989629038692,857,0.341842840047866,1650,0.658157159952134
"E02001263",4,115,491,1160,471,65,11,2317,0.00172637030643073,0.0496331463098835,0.211911955114372,0.500647388864912,0.203280103582218,0.0280535174794994,0.00474751834268451,610,0.263271471730686,1707,0.736728528269314
"E02001264",0,459,489,1250,393,49,12,2652,0,0.173076923076923,0.184389140271493,0.471342383107089,0.148190045248869,0.0184766214177979,0.00452488687782805,948,0.357466063348416,1704,0.642533936651584
"E02001265",0,102,713,1260,290,44,8,2417,0,0.0422010757136947,0.294993793959454,0.521307405875052,0.119983450558544,0.0182043856019859,0.00330988829127017,815,0.337194869673148,1602,0.662805130326852
"E02001266",1,110,968,1117,328,56,7,2587,0.000386548125241593,0.0425202937765752,0.374178585233862,0.431774255894859,0.126787785079242,0.0216466950135292,0.00270583687669115,1079,0.417085427135678,1508,0.582914572864322
"E02001267",1,189,950,1229,512,84,23,2988,0.000334672021419009,0.0632530120481928,0.317938420348059,0.411311914323963,0.171352074966533,0.0281124497991968,0.00769745649263722,1140,0.381526104417671,1848,0.618473895582329
"E02001268",2,25,368,1006,464,52,18,1935,0.00103359173126615,0.0129198966408269,0.190180878552972,0.519896640826873,0.239793281653747,0.0268733850129199,0.00930232558139535,395,0.204134366925065,1540,0.795865633074935
"E02001269",2,149,1016,1384,500,89,21,3161,0.000632711167352104,0.0471369819677317,0.321417273014869,0.437836127807656,0.158177791838026,0.0281556469471686,0.00664346725719709,1167,0.369186966149953,1994,0.630813033850047
"E02001270",0,256,845,1505,687,108,21,3422,0,0.0748100526008182,0.246931618936295,0.439801285797779,0.200759789596727,0.0315604909409702,0.00613676212741087,1101,0.321741671537113,2321,0.678258328462887
"E02001271",2,30,857,1013,237,33,11,2183,0.000916170407695831,0.0137425561154375,0.392579019697664,0.464040311497939,0.108566193311956,0.0151168117269812,0.00503893724232707,889,0.407237746220797,1294,0.592762253779203
"E02001272",4,87,667,1260,514,89,26,2647,0.00151114469210427,0.0328673970532678,0.251983377408387,0.476010578012845,0.194182092935399,0.03362296939932,0.00982244049867775,758,0.286361919153759,1889,0.713638080846241
"E02001273",11,329,1554,1559,704,134,31,4322,0.0025451180009255,0.0761221656640444,0.359555761221657,0.360712633040259,0.162887552059232,0.031004164738547,0.00717260527533549,1894,0.438223044886627,2428,0.561776955113373
"E02001274",6,45,516,1045,412,82,11,2117,0.00283419933868682,0.0212564950401512,0.243741143127067,0.493623051487955,0.194615021256495,0.0387340576287199,0.00519603212092584,567,0.267831837505905,1550,0.732168162494095
"E02001275",2,714,1081,1534,197,34,18,3580,0.000558659217877095,0.199441340782123,0.30195530726257,0.428491620111732,0.0550279329608939,0.00949720670391061,0.00502793296089385,1797,0.50195530726257,1783,0.49804469273743
"E02001276",0,79,858,1364,218,42,10,2571,0,0.0307273434461299,0.333722287047841,0.530532866588876,0.0847919097627382,0.0163360560093349,0.00388953714507974,937,0.364449630493971,1634,0.635550369506029
"E02001277",4,366,1760,1004,122,14,2,3272,0.00122249388753056,0.111858190709046,0.537897310513447,0.306845965770171,0.0372860635696821,0.00427872860635697,0.000611246943765281,2130,0.650977995110025,1142,0.349022004889976
"E02001278",2,157,723,1199,383,54,8,2526,0.000791765637371338,0.06215360253365,0.286223277909739,0.474663499604117,0.151623119556611,0.0213776722090261,0.00316706254948535,882,0.34916864608076,1644,0.65083135391924
"E02001279",0,51,470,1092,330,66,13,2022,0,0.0252225519287834,0.2324431256182,0.540059347181009,0.163204747774481,0.0326409495548961,0.00642927794263106,521,0.257665677546983,1501,0.742334322453017
"E02001280",0,199,1089,1200,251,45,11,2795,0,0.0711985688729875,0.389624329159213,0.429338103756708,0.0898032200357782,0.0161001788908766,0.00393559928443649,1288,0.4608228980322,1507,0.5391771019678
"E02001281",0,155,500,1040,356,55,11,2117,0,0.0732168162494095,0.236183278223902,0.491261218705716,0.168162494095418,0.0259801606046292,0.00519603212092584,655,0.309400094473311,1462,0.690599905526689
"E02001282",7,439,1033,1606,633,98,22,3838,0.00182386659718603,0.114382490880667,0.269150599270453,0.418447107868682,0.164929650859823,0.0255341323606045,0.00573215216258468,1479,0.385356956748306,2359,0.614643043251694
"E02001283",1,663,1383,1324,488,120,26,4005,0.000249687890137328,0.165543071161049,0.345318352059925,0.330586766541823,0.121847690387016,0.0299625468164794,0.00649188514357054,2047,0.511111111111111,1958,0.488888888888889
"E02001284",1,100,529,1098,679,142,10,2559,0.000390777647518562,0.0390777647518562,0.206721375537319,0.429073856975381,0.265338022665104,0.0554904259476358,0.00390777647518562,630,0.246189917936694,1929,0.753810082063306
"E02001285",1,193,866,1079,593,133,20,2885,0.000346620450606586,0.0668977469670711,0.300173310225303,0.374003466204506,0.205545927209705,0.0461005199306759,0.00693240901213172,1060,0.367417677642981,1825,0.632582322357019
"E02001286",4,175,659,1043,440,103,11,2435,0.00164271047227926,0.0718685831622177,0.270636550308008,0.428336755646817,0.180698151950719,0.042299794661191,0.00451745379876797,838,0.344147843942505,1597,0.655852156057495
"E02001287",7,847,548,774,204,37,7,2424,0.00288778877887789,0.349422442244224,0.226072607260726,0.319306930693069,0.0841584158415842,0.0152640264026403,0.00288778877887789,1402,0.578382838283828,1022,0.421617161716172
"E02001288",9,878,745,1033,275,36,9,2985,0.00301507537688442,0.294137353433836,0.249581239530988,0.34606365159129,0.0921273031825796,0.0120603015075377,0.00301507537688442,1632,0.546733668341709,1353,0.453266331658291
"E02001289",4,279,838,1286,426,61,5,2899,0.00137978613314936,0.096240082787168,0.289065194894791,0.44360124180752,0.146947223180407,0.0210417385305278,0.0017247326664367,1121,0.386685063815109,1778,0.613314936184891
"E02001290",2,123,792,718,226,62,13,1936,0.00103305785123967,0.0635330578512397,0.409090909090909,0.370867768595041,0.116735537190083,0.0320247933884297,0.00671487603305785,917,0.473657024793388,1019,0.526342975206612
"E02001291",0,182,771,1219,302,53,10,2537,0,0.0717382735514387,0.303902246748128,0.480488766259361,0.119038234134805,0.0208908159243201,0.00394166338194718,953,0.375640520299566,1584,0.624359479700434
"E02001292",1,169,739,1385,549,118,24,2985,0.00033500837520938,0.0566164154103853,0.247571189279732,0.463986599664992,0.18391959798995,0.0395309882747069,0.00804020100502513,909,0.304522613065327,2076,0.695477386934673
"E02001293",4,254,679,726,182,29,10,1884,0.00212314225053079,0.134819532908705,0.360403397027601,0.385350318471338,0.0966029723991507,0.0153927813163482,0.00530785562632696,937,0.497346072186836,947,0.502653927813164
"E02001294",4,220,892,1633,677,125,41,3592,0.00111358574610245,0.0612472160356347,0.248329621380846,0.454621380846325,0.18847438752784,0.0347995545657016,0.0114142538975501,1116,0.310690423162584,2476,0.689309576837417
"E02001295",0,268,1389,1197,324,46,8,3232,0,0.0829207920792079,0.429764851485149,0.370358910891089,0.100247524752475,0.0142326732673267,0.00247524752475248,1657,0.512685643564356,1575,0.487314356435644
"E02001296",3,111,1303,1512,189,35,3,3156,0.000950570342205323,0.035171102661597,0.412864385297845,0.479087452471483,0.0598859315589354,0.0110899873257288,0.000950570342205323,1417,0.448986058301648,1739,0.551013941698352
"E02001297",19,113,893,1040,240,36,5,2346,0.00809889173060529,0.0481670929241262,0.380647911338448,0.443307757885763,0.10230179028133,0.0153452685421995,0.00213128729752771,1025,0.43691389599318,1321,0.56308610400682
"E02001298",8,146,1113,1218,288,52,18,2843,0.00281392894829406,0.0513542033063665,0.39148786493141,0.42842068237777,0.101301442138586,0.0182905381639114,0.00633134013366162,1267,0.445655997186071,1576,0.554344002813929
"E02001299",8,540,987,1378,377,62,21,3373,0.00237177586718055,0.160094871034687,0.292617847613401,0.40853839312185,0.111769937740883,0.0183812629706493,0.00622591165134895,1535,0.455084494515268,1838,0.544915505484732
"E02001300",3,208,949,1244,426,64,13,2907,0.00103199174406605,0.0715514275885793,0.326453388372893,0.427932576539388,0.146542827657379,0.022015823873409,0.00447196422428621,1160,0.399036807705538,1747,0.600963192294462
"E02001301",15,667,1506,1365,367,81,16,4017,0.00373412994772218,0.16604431167538,0.374906646751307,0.339805825242718,0.091361712720936,0.0201643017176998,0.00398307194423699,2188,0.544685088374409,1829,0.455314911625591
"E02001302",14,256,872,1082,243,32,5,2504,0.00559105431309904,0.10223642172524,0.348242811501597,0.432108626198083,0.0970447284345048,0.012779552715655,0.00199680511182109,1142,0.456070287539936,1362,0.543929712460064
"E02001303",3,391,1569,1068,183,18,5,3237,0.00092678405931418,0.120790855730615,0.484708063021316,0.329935125115848,0.056533827618165,0.00556070435588508,0.00154464009885697,1963,0.606425702811245,1274,0.393574297188755
"E02001304",3,394,1169,1704,577,96,24,3967,0.000756238971514999,0.0993193849256365,0.294681119233678,0.429543735820519,0.145449962188051,0.02419964708848,0.00604991177211999,1566,0.394756743130829,2401,0.605243256869171
"E02001305",4,222,640,1129,375,53,8,2432,0.00164473684210526,0.0912828947368421,0.263157894736842,0.464226973684211,0.154194078947368,0.0217927631578947,0.00328947368421053,866,0.356085526315789,1565,0.643503289473684
"E02001306",6,114,478,898,241,30,7,1774,0.00338218714768884,0.0642615558060879,0.269447576099211,0.506200676437429,0.135851183765502,0.0169109357384442,0.00394588500563698,598,0.337091319052988,1176,0.662908680947012
"E02001307",76,273,969,1248,289,42,6,2903,0.0261798139855322,0.0940406476059249,0.333792628315536,0.429900103341371,0.0995521873923527,0.0144677919393731,0.00206682741991044,1318,0.454013089906993,1585,0.545986910093007
"E02001308",5,73,637,987,297,46,13,2058,0.00242954324586978,0.0354713313896987,0.30952380952381,0.479591836734694,0.144314868804665,0.0223517978620019,0.00631681243926142,715,0.347424684159378,1343,0.652575315840622
"E02001309",7,428,1141,1278,348,55,14,3271,0.00214001834301437,0.130846835830021,0.348822989911342,0.390706206053195,0.106389483338429,0.01681442983797,0.00428003668602874,1576,0.481809844084378,1695,0.518190155915622
"E02001310",1,408,1605,1287,353,51,19,3724,0.000268528464017186,0.109559613319012,0.430988184747583,0.345596133190118,0.0947905477980666,0.0136949516648765,0.00510204081632653,2014,0.540816326530612,1710,0.459183673469388
"E02001311",11,145,921,1386,354,71,24,2912,0.00377747252747253,0.049793956043956,0.316277472527473,0.475961538461538,0.121565934065934,0.0243818681318681,0.00824175824175824,1077,0.369848901098901,1835,0.630151098901099
"E02001312",0,338,971,1099,332,72,17,2829,0,0.119476846942382,0.343230823612584,0.388476493460587,0.117355956168257,0.0254506892895016,0.00600919052668788,1309,0.462707670554966,1520,0.537292329445034
"E02001313",2,477,1158,1086,269,39,9,3040,0.000657894736842105,0.156907894736842,0.380921052631579,0.357236842105263,0.0884868421052632,0.0128289473684211,0.00296052631578947,1637,0.538486842105263,1403,0.461513157894737
"E02001314",2,56,787,1004,217,25,2,2093,0.000955566172957477,0.0267558528428094,0.376015289058767,0.479694218824654,0.103678929765886,0.0119445771619685,0.000955566172957477,845,0.403726708074534,1248,0.596273291925466
"E02001315",13,1304,633,1147,308,52,11,3468,0.00374855824682814,0.3760092272203,0.182525951557093,0.330738177623991,0.0888119953863899,0.0149942329873126,0.00317185697808535,1950,0.562283737024221,1518,0.437716262975779
"E02001316",0,299,1088,1518,562,84,30,3581,0,0.0834962301033231,0.303825746998045,0.42390393744764,0.156939402401564,0.0234571348785256,0.00837754817090198,1387,0.387321977101368,2194,0.612678022898632
"E02001317",1,625,1175,1130,259,53,15,3258,0.000306936771025169,0.191835481890731,0.360650705954573,0.346838551258441,0.0794966236955187,0.0162676488643339,0.00460405156537753,1801,0.552793124616329,1457,0.447206875383671
"E02001318",37,373,715,1021,268,37,17,2468,0.0149918962722853,0.151134521880065,0.289708265802269,0.413695299837925,0.108589951377634,0.0149918962722853,0.00688816855753647,1125,0.455834683954619,1343,0.544165316045381
"E02001319",16,644,1059,1284,334,65,18,3420,0.00467836257309942,0.188304093567251,0.309649122807018,0.375438596491228,0.0976608187134503,0.0190058479532164,0.00526315789473684,1719,0.502631578947368,1701,0.497368421052632
"E02001320",2,147,889,1232,304,65,14,2653,0.000753863550697324,0.0554089709762533,0.33509234828496,0.464379947229551,0.114587259705993,0.024500565397663,0.00527704485488127,1038,0.391255182811911,1615,0.608744817188089
"E02001321",7,76,671,1102,307,40,10,2213,0.00316312697695436,0.0343425214640759,0.303208314505197,0.497966561229101,0.13872571170357,0.0180750112968821,0.00451875282422051,754,0.340713962946227,1459,0.659286037053773
"E02001322",13,47,553,1133,356,57,10,2169,0.00599354541263255,0.0216689718764408,0.254956201014292,0.522360534808668,0.164130935915168,0.0262793914246196,0.00461041954817888,613,0.282618718303366,1556,0.717381281696634
"E02001323",12,498,1034,1090,283,56,10,2983,0.00402279584311096,0.166946027489105,0.346630908481395,0.365403955749246,0.0948709353000335,0.0187730472678512,0.00335232986925913,1544,0.51759973181361,1439,0.48240026818639
"E02001324",4,155,968,1312,381,65,25,2910,0.0013745704467354,0.0532646048109966,0.332646048109966,0.45085910652921,0.130927835051546,0.0223367697594502,0.00859106529209622,1127,0.387285223367698,1783,0.612714776632302
"E02001325",2,1172,615,1065,269,37,6,3166,0.000631711939355654,0.370183196462413,0.194251421351864,0.336386607706886,0.0849652558433354,0.0116866708780796,0.00189513581806696,1789,0.565066329753632,1377,0.434933670246368
"E02001326",11,609,808,1116,263,48,9,2864,0.00384078212290503,0.212639664804469,0.282122905027933,0.389664804469274,0.0918296089385475,0.0167597765363128,0.00314245810055866,1428,0.498603351955307,1436,0.501396648044693
"E02001327",4,889,2174,833,141,35,14,4090,0.00097799511002445,0.217359413202934,0.531540342298289,0.203667481662592,0.0344743276283619,0.00855745721271394,0.00342298288508557,3067,0.749877750611247,1023,0.250122249388753
"E02001328",9,363,1626,1205,229,35,10,3477,0.00258843830888697,0.104400345125108,0.467644521138913,0.346563129134311,0.0658613747483463,0.0100661489790049,0.00287604256542997,1998,0.574633304572908,1479,0.425366695427092
"E02001329",4,424,2259,853,240,35,13,3828,0.00104493207941484,0.110762800417973,0.59012539184953,0.222831765935214,0.0626959247648903,0.00914315569487983,0.00339602925809822,2687,0.701933124346917,1141,0.298066875653083
"E02001330",6,597,2283,1039,245,51,10,4231,0.00141810446702907,0.141101394469393,0.539588749704562,0.245568423540534,0.0579059324036871,0.0120538879697471,0.00236350744504845,2886,0.682108248640983,1345,0.317891751359017
"E02001331",10,466,2416,1209,343,85,29,4558,0.00219394471259324,0.102237823606845,0.530057042562527,0.265247915752523,0.0752523036419482,0.0186485300570426,0.0063624396665204,2892,0.634488810881966,1666,0.365511189118034
"E02001332",2,513,2144,870,316,14,3,3862,0.000517866390471258,0.132832729155878,0.555152770585189,0.225271879854997,0.0818228896944588,0.00362506473329881,0.000776799585706888,2659,0.688503366131538,1203,0.311496633868462
"E02001333",9,1442,2437,1318,354,59,34,5653,0.00159207500442243,0.255085795153016,0.431098531753051,0.233150539536529,0.0626216168406156,0.0104369361401026,0.00601450557226252,3888,0.68777640191049,1765,0.31222359808951
"E02001334",18,922,1845,971,108,16,5,3885,0.00463320463320463,0.237323037323037,0.474903474903475,0.24993564993565,0.0277992277992278,0.00411840411840412,0.00128700128700129,2785,0.716859716859717,1100,0.283140283140283
"E02001335",1,399,977,1045,275,50,19,2766,0.000361532899493854,0.144251626898048,0.353217642805495,0.377801879971077,0.0994215473608098,0.0180766449746927,0.00686912509038322,1377,0.497830802603037,1389,0.502169197396963
"E02001336",2,447,2182,1113,174,32,10,3960,0.000505050505050505,0.112878787878788,0.551010101010101,0.281060606060606,0.0439393939393939,0.00808080808080808,0.00252525252525253,2631,0.664393939393939,1329,0.335606060606061
"E02001337",1,148,935,798,184,33,16,2115,0.000472813238770686,0.0699763593380615,0.442080378250591,0.377304964539007,0.0869976359338061,0.0156028368794326,0.00756501182033097,1084,0.512529550827423,1031,0.487470449172577
"E02001338",0,359,889,845,271,42,19,2425,0,0.148041237113402,0.36659793814433,0.348453608247423,0.111752577319588,0.017319587628866,0.00783505154639175,1248,0.514639175257732,1177,0.485360824742268
"E02001339",8,330,1463,772,169,37,13,2792,0.00286532951289398,0.118194842406877,0.523997134670487,0.276504297994269,0.0605300859598854,0.0132521489971347,0.00465616045845272,1801,0.645057306590258,991,0.354942693409742
"E02001340",4,441,427,1164,539,88,29,2692,0.00148588410104012,0.163818722139673,0.158618127786033,0.432392273402675,0.200222882615156,0.0326894502228826,0.0107726597325409,872,0.323922734026746,1820,0.676077265973254
"E02001341",14,438,1782,943,202,45,17,3441,0.004068584713746,0.127288578901482,0.517872711421098,0.274048241790177,0.0587038651554781,0.013077593722755,0.004940424295263,2234,0.649229875036327,1207,0.350770124963673
"E02001342",0,475,638,779,279,45,13,2229,0,0.213100044863167,0.286227007626738,0.349484073575594,0.125168236877524,0.0201884253028264,0.00583221175414984,1113,0.499327052489906,1116,0.500672947510094
"E02001343",41,911,574,817,314,83,42,2782,0.0147375988497484,0.327462257368799,0.206326383896477,0.293673616103523,0.112868439971244,0.0298346513299784,0.01509705248023,1526,0.548526240115025,1256,0.451473759884975
"E02001344",22,346,1053,626,114,16,7,2184,0.0100732600732601,0.158424908424908,0.482142857142857,0.286630036630037,0.0521978021978022,0.00732600732600733,0.00320512820512821,1421,0.650641025641026,763,0.349358974358974
"E02001345",1,94,524,606,150,23,7,1405,0.000711743772241993,0.0669039145907473,0.372953736654804,0.431316725978648,0.106761565836299,0.0163701067615658,0.00498220640569395,619,0.440569395017794,786,0.559430604982206
"E02001346",4,261,1924,985,230,44,11,3459,0.00115640358485111,0.0754553339115351,0.556230124313385,0.284764382769587,0.066493206128939,0.0127204394333622,0.00318010985834056,2189,0.632841861809772,1270,0.367158138190228
"E02001347",0,231,1010,1031,200,47,8,2527,0,0.0914127423822715,0.399683419074001,0.40799366838148,0.0791452314998021,0.0185991294024535,0.00316580925999209,1241,0.491096161456272,1286,0.508903838543728
"E02001348",1,34,501,1317,516,96,53,2518,0.00039714058776807,0.0135027799841144,0.198967434471803,0.523034154090548,0.204924543288324,0.0381254964257347,0.0210484511517077,536,0.212867355043685,1982,0.787132644956315
"E02001349",0,27,638,1234,571,110,52,2632,0,0.010258358662614,0.242401215805471,0.468844984802432,0.216945288753799,0.0417933130699088,0.0197568389057751,665,0.252659574468085,1967,0.747340425531915
"E02001350",73,275,1537,913,238,62,11,3109,0.0234802187198456,0.0884528787391444,0.494371180443873,0.293663557413959,0.0765519459633323,0.0199421035702798,0.00353811514956578,1885,0.606304277902863,1224,0.393695722097137
"E02001351",1,163,1251,1247,254,54,18,2988,0.000334672021419009,0.0545515394912985,0.418674698795181,0.417336010709505,0.0850066934404284,0.0180722891566265,0.00602409638554217,1415,0.473560910307898,1573,0.526439089692102
"E02001352",0,310,1256,1211,439,93,37,3346,0,0.0926479378362224,0.375373580394501,0.361924686192469,0.131201434548715,0.0277943813508667,0.0110579796772265,1566,0.468021518230723,1780,0.531978481769277
"E02001353",1,37,770,907,146,18,3,1882,0.00053134962805526,0.0196599362380446,0.40913921360255,0.481934112646121,0.077577045696068,0.00956429330499469,0.00159404888416578,808,0.42933049946865,1074,0.57066950053135
"E02001354",0,268,1862,867,200,56,22,3275,0,0.0818320610687023,0.568549618320611,0.264732824427481,0.0610687022900763,0.0170992366412214,0.0067175572519084,2130,0.650381679389313,1145,0.349618320610687
"E02001355",0,153,1006,1444,567,82,53,3305,0,0.0462934947049924,0.304387291981846,0.436913767019667,0.171558245083207,0.0248108925869894,0.016036308623298,1159,0.350680786686838,2146,0.649319213313162
"E02001356",1,1208,1233,639,111,22,15,3229,0.000309693403530505,0.37410963146485,0.381851966553112,0.197894084855993,0.034375967791886,0.00681325487767111,0.00464540105295757,2442,0.756271291421493,787,0.243728708578507
"E02001357",1,17,1461,895,164,35,22,2595,0.000385356454720617,0.00655105973025048,0.563005780346821,0.344894026974952,0.0631984585741811,0.0134874759152216,0.00847784200385356,1479,0.569942196531792,1116,0.430057803468208
"E02001358",0,53,927,1863,679,106,75,3703,0,0.0143127194166892,0.250337564137186,0.503105590062112,0.183364839319471,0.0286254388333783,0.0202538482311639,980,0.264650283553875,2723,0.735349716446125
"E02001359",3,70,719,611,161,28,16,1608,0.00186567164179104,0.0435323383084577,0.447139303482587,0.379975124378109,0.100124378109453,0.0174129353233831,0.00995024875621891,792,0.492537313432836,816,0.507462686567164
"E02001360",3,330,2582,1614,439,97,55,5120,0.0005859375,0.064453125,0.504296875,0.315234375,0.0857421875,0.0189453125,0.0107421875,2915,0.5693359375,2205,0.4306640625
"E02001361",0,271,1297,1340,392,68,28,3396,0,0.0797997644287397,0.381919905771496,0.394581861012956,0.115429917550059,0.0200235571260306,0.00824499411071849,1568,0.461719670200236,1828,0.538280329799764
"E02001362",1,71,1023,1180,300,64,32,2671,0.000374391613627855,0.0265818045675777,0.383002620741295,0.441782104080869,0.112317484088356,0.0239610632721827,0.0119805316360914,1095,0.409958816922501,1576,0.590041183077499
"E02001363",1,395,1556,1014,222,47,26,3261,0.000306654400490647,0.121128488193806,0.477154247163447,0.310947562097516,0.0680772769089236,0.0144127568230604,0.00797301441275682,1952,0.598589389757743,1309,0.401410610242257
"E02001364",0,396,952,1147,396,69,67,3027,0,0.130822596630327,0.314502808060786,0.378923026098447,0.130822596630327,0.022794846382557,0.0221341261975553,1348,0.445325404691113,1679,0.554674595308887
"E02001365",0,52,1182,2264,947,217,92,4754,0,0.0109381573411864,0.248632730332352,0.476230542700883,0.199200673117375,0.0456457719814893,0.0193521245267143,1234,0.259570887673538,3520,0.740429112326462
"E02001366",1,113,1275,1903,700,143,105,4240,0.000235849056603774,0.0266509433962264,0.300707547169811,0.448820754716981,0.165094339622642,0.0337264150943396,0.0247641509433962,1389,0.327594339622642,2851,0.672405660377358
"E02001367",1,213,882,1146,523,99,31,2895,0.000345423143350604,0.0735751295336788,0.304663212435233,0.395854922279793,0.180656303972366,0.0341968911917098,0.0107081174438687,1096,0.378583765112262,1799,0.621416234887738
"E02001368",0,1184,2218,908,159,15,6,4490,0,0.26369710467706,0.493986636971047,0.202227171492205,0.0354120267260579,0.00334075723830735,0.00133630289532294,3402,0.757683741648107,1088,0.242316258351893
"E02001369",5,682,2779,1148,165,40,3,4822,0.00103691414350892,0.141435089174616,0.576316880962256,0.238075487349647,0.0342181667357943,0.00829531314807134,0.000622148486105351,3466,0.718788884280382,1356,0.281211115719618
"E02001370",1,425,2266,1082,315,52,42,4183,0.00023906287353574,0.101601721252689,0.541716471431987,0.258666029165671,0.0753048051637581,0.0124312694238585,0.0100406406885011,2692,0.643557255558212,1491,0.356442744441788
"E02001371",7,317,981,917,173,39,13,2447,0.00286064568859828,0.129546383326522,0.400899060073559,0.374744585206375,0.0706988148753576,0.0159378831221904,0.00531262770739681,1305,0.53330608908868,1142,0.46669391091132
"E02001372",0,59,1002,761,275,66,19,2182,0,0.0270394133822181,0.459211732355637,0.348762603116407,0.126031164069661,0.0302474793767186,0.00870760769935839,1061,0.486251145737855,1121,0.513748854262145
"E02001373",5,119,1204,1816,610,137,54,3945,0.00126742712294043,0.0301647655259823,0.305196451204056,0.460329531051965,0.154626108998733,0.0347275031685678,0.0136882129277567,1328,0.336628643852978,2617,0.663371356147021
"E02001374",1,457,1659,1957,843,156,100,5173,0.0001933114247052,0.0883433210902764,0.320703653585927,0.378310458148077,0.162961531026484,0.0301565822540112,0.01933114247052,2117,0.409240286100909,3056,0.590759713899091
"E02001375",0,46,916,1456,410,71,22,2921,0,0.015748031496063,0.313591235878124,0.498459431701472,0.140362889421431,0.0243067442656624,0.00753166723724752,962,0.329339267374187,1959,0.670660732625813
"E02001376",4,700,1628,2183,597,92,65,5269,0.000759157335357753,0.132852533687607,0.308977035490605,0.414310115771494,0.113304232302145,0.0174606187132283,0.0123363066995635,2332,0.44258872651357,2937,0.55741127348643
"E02001377",8,807,2398,1630,439,86,28,5396,0.00148257968865827,0.149555226093403,0.444403261675315,0.302075611564122,0.0813565604151223,0.0159377316530764,0.00518902891030393,3213,0.595441067457376,2183,0.404558932542624
"E02001378",1,203,1479,1166,358,73,24,3304,0.000302663438256659,0.0614406779661017,0.447639225181598,0.352905569007264,0.108353510895884,0.0220944309927361,0.00726392251815981,1683,0.509382566585956,1621,0.490617433414044
"E02001380",0,122,480,934,477,115,33,2161,0,0.0564553447478019,0.22211938917168,0.432207311429894,0.220731142989357,0.0532161036557149,0.015270708005553,602,0.278574733919482,1559,0.721425266080518
"E02001381",2,288,1787,2245,658,114,67,5161,0.000387521798101143,0.0558031389265646,0.346250726603371,0.434993218368533,0.127494671575276,0.0220887424917652,0.0129819802363883,2077,0.402441387328037,3084,0.597558612671963
"E02001382",0,5,311,860,381,56,20,1633,0,0.00306184935701163,0.190447030006124,0.526638089406001,0.233312921004287,0.0342927127985303,0.0122473974280465,316,0.193508879363135,1317,0.806491120636865
"E02001383",25,1667,2491,1250,503,72,27,6035,0.00414250207125104,0.276222038111019,0.412758906379453,0.207125103562552,0.0833471416735708,0.011930405965203,0.00447390223695112,4183,0.693123446561723,1852,0.306876553438277
"E02001384",4,148,1569,2069,673,101,36,4600,0.000869565217391304,0.0321739130434783,0.341086956521739,0.449782608695652,0.146304347826087,0.0219565217391304,0.00782608695652174,1721,0.374130434782609,2879,0.625869565217391
"E02001385",70,318,2028,1486,431,58,28,4419,0.0158406879384476,0.0719619823489477,0.458927359131025,0.336275175379045,0.0975333785924417,0.0131251414347137,0.00633627517537905,2416,0.54673002941842,2003,0.45326997058158
"E02001386",7,692,1841,844,144,17,8,3553,0.00197016605685336,0.194764987334647,0.518153672952435,0.237545735997748,0.040529130312412,0.00478468899521531,0.00225161835068956,2540,0.714888826343935,1013,0.285111173656065
"E02001387",0,82,385,984,589,128,27,2195,0,0.0373576309794989,0.175398633257403,0.448291571753986,0.268337129840547,0.0583143507972665,0.0123006833712984,467,0.212756264236902,1728,0.787243735763098
"E02001388",0,43,658,1503,635,96,39,2974,0,0.0144586415601883,0.221250840618695,0.505379959650303,0.213517148621385,0.0322797579018157,0.0131136516476126,701,0.235709482178884,2273,0.764290517821116
"E02001389",41,408,2174,1710,556,134,48,5071,0.00808519029777164,0.0804575034509959,0.428712285545257,0.337211595346086,0.109643068428318,0.0264247682902781,0.00946558864129363,2623,0.517254979294025,2448,0.482745020705975
"E02001390",3,641,2288,1515,413,53,23,4936,0.000607779578606159,0.129862236628849,0.46353322528363,0.30692868719611,0.0836709886547812,0.0107374392220421,0.00465964343598055,2932,0.594003241491086,2004,0.405996758508914
"E02001391",5,292,840,548,127,36,12,1860,0.00268817204301075,0.156989247311828,0.451612903225806,0.294623655913978,0.0682795698924731,0.0193548387096774,0.00645161290322581,1137,0.611290322580645,723,0.388709677419355
"E02001392",1,307,485,788,373,85,20,2059,0.000485672656629432,0.149101505585236,0.235551238465274,0.382710053423992,0.181155900922778,0.0412821758135017,0.00971345313258863,793,0.385138416707139,1266,0.614861583292861
"E02001393",1,127,433,766,445,111,22,1905,0.0005249343832021,0.0666666666666667,0.227296587926509,0.402099737532808,0.233595800524934,0.0582677165354331,0.0115485564304462,561,0.294488188976378,1344,0.705511811023622
"E02001394",1,383,1645,1492,621,109,28,4279,0.000233699462491236,0.0895068941341435,0.384435615798084,0.348679598036924,0.145127366207058,0.0254732414115448,0.00654358494975462,2029,0.474176209394718,2250,0.525823790605282
"E02001395",0,19,412,924,351,80,23,1809,0,0.0105030403537866,0.227750138197899,0.51077943615257,0.194029850746269,0.0442233278054174,0.0127142067440575,431,0.238253178551686,1378,0.761746821448314
"E02001396",0,326,1680,1469,419,63,25,3982,0,0.0818684078352587,0.421898543445505,0.368910095429432,0.105223505775992,0.0158211953792064,0.00627825213460573,2006,0.503766951280763,1976,0.496233048719237
"E02001397",3,258,1565,1152,467,79,27,3551,0.000844832441565756,0.072655589974655,0.440720923683469,0.32441565756125,0.131512250070403,0.0222472542945649,0.00760349197409181,1826,0.51422134609969,1725,0.48577865390031
"E02001398",2,204,1314,1194,444,81,29,3268,0.000611995104039168,0.0624235006119951,0.402080783353733,0.365361077111383,0.135862913096695,0.0247858017135863,0.00887392900856793,1520,0.465116279069767,1748,0.534883720930233
"E02001399",0,34,428,763,477,90,27,1819,0,0.0186915887850467,0.235294117647059,0.419461242440902,0.262231995601979,0.0494777350192413,0.0148433205057724,462,0.253985706432106,1357,0.746014293567895
"E02001400",1,319,1099,991,322,64,22,2818,0.00035486160397445,0.11320085166785,0.389992902767921,0.35166784953868,0.114265436479773,0.0227111426543648,0.0078069552874379,1419,0.503548616039745,1399,0.496451383960256
"E02001401",1,165,1170,942,341,56,20,2695,0.000371057513914657,0.0612244897959184,0.434137291280148,0.349536178107607,0.126530612244898,0.0207792207792208,0.00742115027829314,1336,0.495732838589981,1359,0.504267161410019
"E02001402",3,423,1289,934,559,131,36,3375,0.000888888888888889,0.125333333333333,0.381925925925926,0.276740740740741,0.16562962962963,0.0388148148148148,0.0106666666666667,1715,0.508148148148148,1660,0.491851851851852
"E02001403",1,235,1208,1168,386,91,34,3123,0.00032020493115594,0.0752481588216459,0.386807556836375,0.373999359590138,0.123599103426193,0.0291386487351905,0.010886967659302,1444,0.462375920589177,1679,0.537624079410823
"E02001404",0,474,1547,1142,170,40,15,3388,0,0.139905548996458,0.456611570247934,0.337072018890201,0.0501770956316411,0.0118063754427391,0.00442739079102716,2021,0.596517119244392,1367,0.403482880755608
"E02001405",4,534,2304,1670,166,39,22,4739,0.000844059928254906,0.11268200042203,0.486178518674826,0.352395020046423,0.0350284870225786,0.00822958430048533,0.00464232960540198,2842,0.599704579025111,1897,0.400295420974889
"E02001406",3,157,578,1166,419,90,21,2434,0.00123253903040263,0.0645028759244043,0.23746918652424,0.479046836483155,0.172144617912901,0.0369761709120789,0.00862777321281841,738,0.303204601479047,1696,0.696795398520953
"E02001407",2,24,562,800,251,41,13,1693,0.00118133490844654,0.0141760189013585,0.331955109273479,0.472533963378618,0.148257531010041,0.0242173656231542,0.00767867690490254,588,0.347312463083284,1105,0.652687536916716
"E02001408",1,26,301,843,237,48,10,1466,0.000682128240109141,0.0177353342428377,0.205320600272851,0.575034106412005,0.161664392905866,0.0327421555252387,0.00682128240109141,328,0.223738062755798,1138,0.776261937244202
"E02001409",1,274,1322,1883,404,52,23,3959,0.000252589037635767,0.0692093963122,0.333922707754483,0.475625157868149,0.10204597120485,0.0131346299570599,0.00580954786562263,1597,0.403384693104319,2362,0.596615306895681
"E02001410",3,56,818,976,246,39,10,2148,0.00139664804469274,0.0260707635009311,0.380819366852886,0.454376163873371,0.114525139664804,0.0181564245810056,0.00465549348230913,877,0.40828677839851,1271,0.59171322160149
"E02001411",0,182,724,839,242,36,12,2035,0,0.0894348894348894,0.355773955773956,0.412285012285012,0.118918918918919,0.0176904176904177,0.0058968058968059,906,0.445208845208845,1129,0.554791154791155
"E02001412",0,182,876,1568,457,74,15,3172,0,0.0573770491803279,0.276166456494325,0.494325346784363,0.144073139974779,0.0233291298865069,0.00472887767969735,1058,0.333543505674653,2114,0.666456494325347
"E02001413",2,49,1101,1482,349,50,15,3048,0.000656167979002625,0.0160761154855643,0.361220472440945,0.486220472440945,0.114501312335958,0.0164041994750656,0.00492125984251968,1152,0.377952755905512,1896,0.622047244094488
"E02001414",3,142,386,661,261,41,9,1503,0.00199600798403194,0.0944777112441783,0.256819693945442,0.439787092481703,0.173652694610778,0.0272787757817698,0.00598802395209581,531,0.353293413173653,972,0.646706586826347
"E02001415",1,145,1118,1206,200,26,8,2704,0.000369822485207101,0.0536242603550296,0.413461538461538,0.446005917159763,0.0739644970414201,0.00961538461538462,0.0029585798816568,1264,0.467455621301775,1440,0.532544378698225
"E02001416",1,210,1273,1270,175,22,6,2957,0.000338180588434224,0.071017923571187,0.430503889076767,0.429489347311464,0.0591816029759892,0.00743997294555293,0.00202908353060534,1484,0.501859993236388,1473,0.498140006763612
"E02001417",2,227,1694,1665,420,67,29,4104,0.000487329434697856,0.0553118908382066,0.412768031189084,0.405701754385965,0.10233918128655,0.0163255360623782,0.00706627680311891,1923,0.468567251461988,2181,0.531432748538012
"E02001418",0,623,1197,1044,251,46,23,3184,0,0.195665829145729,0.375942211055276,0.327889447236181,0.0788316582914573,0.0144472361809045,0.00722361809045226,1820,0.571608040201005,1364,0.428391959798995
"E02001419",2,1032,1599,1667,352,69,17,4738,0.000422119037568594,0.217813423385395,0.337484170536091,0.351836217813423,0.0742929506120726,0.0145631067961165,0.00358801181933305,2633,0.555719712959055,2105,0.444280287040946
"E02001420",3,653,1969,1696,411,53,19,4804,0.000624479600333056,0.135928393005828,0.409866777685262,0.353039134054954,0.0855537052456286,0.0110324729392173,0.00395503746877602,2625,0.546419650291424,2179,0.453580349708576
"E02001421",1,208,1187,2249,578,102,35,4360,0.000229357798165138,0.0477064220183486,0.272247706422018,0.515825688073394,0.13256880733945,0.023394495412844,0.00802752293577982,1396,0.320183486238532,2964,0.679816513761468
"E02001422",2,266,1278,1382,214,45,12,3199,0.000625195373554236,0.0831509846827133,0.399499843701157,0.432010003125977,0.0668959049703032,0.0140668959049703,0.00375117224132541,1546,0.483276023757424,1653,0.516723976242576
"E02001423",3,288,689,839,302,42,8,2171,0.00138185168125288,0.132657761400276,0.317365269461078,0.386457853523722,0.139106402579456,0.0193459235375403,0.00368493781667434,980,0.451404882542607,1191,0.548595117457393
"E02001425",7,237,1496,1627,417,77,29,3890,0.00179948586118252,0.0609254498714653,0.384575835475578,0.418251928020566,0.10719794344473,0.0197943444730077,0.00745501285347044,1740,0.447300771208226,2150,0.552699228791774
"E02001426",1,190,509,798,254,32,29,1813,0.000551571980143409,0.104798676227248,0.280750137892995,0.44015444015444,0.140099282956426,0.0176503033645891,0.0159955874241589,700,0.386100386100386,1113,0.613899613899614
"E02001427",3,537,1986,1488,323,54,27,4418,0.000679040289723857,0.12154821186057,0.449524671797193,0.336803983703033,0.0731100045269353,0.0122227252150294,0.00611136260751471,2526,0.571751923947488,1892,0.428248076052512
"E02001428",0,127,356,697,236,36,8,1460,0,0.086986301369863,0.243835616438356,0.477397260273973,0.161643835616438,0.0246575342465753,0.00547945205479452,483,0.330821917808219,977,0.669178082191781
"E02001429",5,116,643,1186,310,46,10,2316,0.00215889464594128,0.0500863557858377,0.277633851468048,0.512089810017271,0.133851468048359,0.0198618307426598,0.00431778929188256,764,0.329879101899827,1552,0.670120898100173
"E02001430",0,176,439,1082,487,94,17,2295,0,0.0766884531590414,0.191285403050109,0.471459694989107,0.212200435729847,0.040958605664488,0.00740740740740741,615,0.26797385620915,1680,0.73202614379085
"E02001431",0,495,1514,1204,490,106,17,3826,0,0.129377940407737,0.395713538944067,0.314688970203868,0.12807109252483,0.0277051751176163,0.00444328280188186,2009,0.525091479351803,1817,0.474908520648197
"E02001432",1,406,2168,2036,1045,242,109,6007,0.000166472448809722,0.0675878142167471,0.360912269019477,0.338937905776594,0.173963709006159,0.0402863326119527,0.0181454969202597,2575,0.428666555685034,3432,0.571333444314966
"E02001433",3,25,541,1116,620,100,36,2441,0.00122900450634986,0.0102417042195821,0.221630479311757,0.457189676362147,0.253994264645637,0.0409668168783286,0.0147480540761983,569,0.233101188037689,1872,0.76689881196231
"E02001434",2,103,462,962,707,150,31,2417,0.000827472072817542,0.0426148117501034,0.191146048820852,0.398014067025238,0.292511377741001,0.0620604054613157,0.0128258171286719,567,0.234588332643773,1850,0.765411667356227
"E02001435",1,216,860,1337,903,256,70,3643,0.000274499039253363,0.0592917924787263,0.236069173757892,0.367005215481746,0.247872632445786,0.0702717540488608,0.0192149327477354,1077,0.295635465275872,2566,0.704364534724129
"E02001436",2,1016,947,1152,709,148,26,4000,5e-04,0.254,0.23675,0.288,0.17725,0.037,0.0065,1965,0.49125,2035,0.50875
"E02001437",8,288,1467,1333,741,224,31,4092,0.00195503421309873,0.0703812316715543,0.358504398826979,0.325757575757576,0.18108504398827,0.0547409579667644,0.00757575757575758,1763,0.430840664711632,2329,0.569159335288367
"E02001438",0,32,515,1081,434,70,23,2155,0,0.0148491879350348,0.238979118329466,0.501624129930394,0.20139211136891,0.0324825986078886,0.0106728538283063,547,0.253828306264501,1608,0.746171693735499
"E02001439",0,222,891,979,298,50,22,2462,0,0.0901705930138099,0.361900893582453,0.397644191714054,0.121039805036556,0.0203086921202275,0.00893582453290008,1113,0.452071486596263,1349,0.547928513403737
"E02001440",4,48,397,827,293,50,11,1630,0.00245398773006135,0.0294478527607362,0.243558282208589,0.507361963190184,0.179754601226994,0.0306748466257669,0.00674846625766871,449,0.275460122699387,1181,0.724539877300613
"E02001441",4,115,453,810,276,46,7,1711,0.00233781414377557,0.0672121566335476,0.264757451782583,0.473407364114553,0.161309175920514,0.0268848626534191,0.00409117475160725,572,0.334307422559907,1139,0.665692577440094
"E02001442",3,199,642,830,276,54,13,2017,0.0014873574615766,0.0986613782845811,0.318294496777392,0.411502231036192,0.136836886465047,0.0267724343083788,0.00644521566683193,844,0.41844323252355,1173,0.58155676747645
"E02001443",3,131,373,725,261,36,9,1538,0.00195058517555267,0.0851755526657997,0.242522756827048,0.471391417425228,0.169700910273082,0.023407022106632,0.005851755526658,507,0.329648894668401,1031,0.670351105331599
"E02001444",15,436,471,761,247,72,23,2025,0.00740740740740741,0.215308641975309,0.232592592592593,0.375802469135802,0.121975308641975,0.0355555555555556,0.011358024691358,922,0.455308641975309,1103,0.544691358024691
"E02001445",1,92,575,942,231,49,19,1909,0.000523834468308015,0.0481927710843374,0.301204819277108,0.49345206914615,0.121005762179151,0.0256678889470927,0.00995285489785228,668,0.349921424829754,1241,0.650078575170246
"E02001446",17,342,475,904,243,40,12,2033,0.00836202656173143,0.168224299065421,0.233644859813084,0.444663059517954,0.11952779144122,0.0196753566158387,0.0059026069847516,834,0.410231185440236,1199,0.589768814559764
"E02001447",2,457,657,801,226,49,11,2203,0.000907852927825692,0.207444394008171,0.29822968679074,0.36359509759419,0.102587380844303,0.0222423967317295,0.00499319110304131,1116,0.506581933726736,1087,0.493418066273264
"E02001448",1,130,507,928,376,59,23,2024,0.000494071146245059,0.0642292490118577,0.250494071146245,0.458498023715415,0.185770750988142,0.0291501976284585,0.0113636363636364,638,0.315217391304348,1386,0.684782608695652
"E02001449",73,319,845,1292,441,101,36,3107,0.0234953331187641,0.102671387190216,0.271966527196653,0.41583521081429,0.141937560347602,0.0325072417122626,0.0115867396202124,1237,0.398133247505632,1870,0.601866752494367
"E02001450",7,238,831,1135,547,129,29,2916,0.00240054869684499,0.0816186556927298,0.284979423868313,0.38923182441701,0.18758573388203,0.044238683127572,0.00994513031550069,1076,0.368998628257888,1840,0.631001371742113
"E02001451",0,118,1043,889,149,49,8,2256,0,0.0523049645390071,0.462322695035461,0.394060283687943,0.0660460992907801,0.0217198581560284,0.00354609929078014,1161,0.514627659574468,1095,0.485372340425532
"E02001452",1,141,1444,1036,118,30,13,2783,0.000359324469996407,0.0506647502694934,0.518864534674811,0.372260150916277,0.042400287459576,0.0107797340998922,0.00467121810995329,1586,0.569888609414301,1197,0.430111390585699
"E02001453",1,150,510,1130,531,90,20,2432,0.000411184210526316,0.0616776315789474,0.209703947368421,0.464638157894737,0.218338815789474,0.0370065789473684,0.00822368421052632,661,0.271792763157895,1771,0.728207236842105
"E02001454",21,218,620,864,248,74,32,2077,0.0101107366393837,0.104959075589793,0.298507462686567,0.415984593163216,0.119402985074627,0.0356283100625903,0.0154068367838228,859,0.413577274915744,1218,0.586422725084256
"E02001455",1,115,635,878,258,44,15,1946,0.000513874614594039,0.0590955806783145,0.326310380267215,0.451181911613566,0.132579650565262,0.0226104830421377,0.00770811921891059,751,0.385919835560123,1195,0.614080164439877
"E02001456",0,66,686,1114,553,98,39,2556,0,0.0258215962441315,0.268388106416275,0.435837245696401,0.216353677621283,0.0383411580594679,0.0152582159624413,752,0.294209702660407,1804,0.705790297339593
"E02001457",1,256,1431,925,170,42,11,2836,0.000352609308885755,0.0902679830747532,0.504583921015515,0.326163610719323,0.0599435825105783,0.0148095909732017,0.0038787023977433,1688,0.595204513399154,1148,0.404795486600846
"E02001458",1,61,711,1349,566,105,46,2839,0.000352236703064459,0.021486438886932,0.250440295878831,0.475167312433956,0.199365973934484,0.0369848538217682,0.0162028883409651,773,0.272278971468827,2066,0.727721028531173
"E02001459",2,70,884,1014,273,47,21,2311,0.000865426222414539,0.0302899177845089,0.382518390307226,0.438771094764171,0.118130679359585,0.0203375162267417,0.00908697533535266,956,0.41367373431415,1355,0.58632626568585
"E02001460",2,321,1713,1202,401,71,45,3755,0.000532623169107856,0.0854860186418109,0.456191744340879,0.320106524633822,0.106790945406125,0.0189081225033289,0.0119840213049268,2036,0.542210386151798,1719,0.457789613848202
"E02001461",1,420,723,887,331,57,22,2441,0.000409668168783286,0.17206063088898,0.296190086030315,0.363375665710774,0.135600163867268,0.0233510856206473,0.00901269971323228,1144,0.468660385088079,1297,0.531339614911921
"E02001462",1,377,1486,1296,402,68,50,3680,0.000271739130434783,0.102445652173913,0.403804347826087,0.352173913043478,0.109239130434783,0.0184782608695652,0.0135869565217391,1864,0.506521739130435,1816,0.493478260869565
"E02001463",3,275,1240,896,255,61,21,2751,0.00109051254089422,0.0999636495819702,0.450745183569611,0.325699745547074,0.0926935659760087,0.0221737549981825,0.00763358778625954,1518,0.551799345692475,1233,0.448200654307525
"E02001464",0,98,1216,1574,521,89,55,3553,0,0.0275823247959471,0.342245989304813,0.443005910498171,0.146636645088657,0.0250492541514213,0.0154798761609907,1314,0.36982831410076,2239,0.63017168589924
"E02001465",21,724,1711,1191,407,88,48,4190,0.00501193317422434,0.172792362768496,0.408353221957041,0.284248210023866,0.0971360381861575,0.0210023866348449,0.0114558472553699,2456,0.586157517899761,1734,0.413842482100239
"E02001466",1,163,1165,1562,601,118,56,3666,0.000272776868521549,0.0444626295690125,0.317785051827605,0.42607746863066,0.163938897981451,0.0321876704855428,0.0152755046372068,1329,0.362520458265139,2337,0.637479541734861
"E02001467",9,306,1048,1292,683,116,41,3495,0.00257510729613734,0.0875536480686695,0.299856938483548,0.36967095851216,0.195422031473534,0.0331902718168813,0.0117310443490701,1363,0.389985693848355,2132,0.610014306151645
"E02001468",1,66,633,1189,681,142,53,2765,0.000361663652802893,0.023869801084991,0.228933092224231,0.43001808318264,0.24629294755877,0.0513562386980108,0.0191681735985533,700,0.253164556962025,2065,0.746835443037975
"E02001469",3,63,639,1029,608,146,29,2517,0.00119189511323004,0.0250297973778308,0.253873659117998,0.408820023837902,0.241557409614621,0.0580055621771951,0.0115216527612237,705,0.280095351609058,1812,0.719904648390942
"E02001470",0,32,235,1037,841,167,29,2341,0,0.0136693720632208,0.100384451089278,0.442973088423751,0.359248184536523,0.0713370354549338,0.0123878684322939,267,0.114053823152499,2074,0.885946176847501
"E02001471",1,193,1004,1365,588,80,59,3290,0.000303951367781155,0.0586626139817629,0.30516717325228,0.414893617021277,0.178723404255319,0.0243161094224924,0.0179331306990881,1198,0.364133738601824,2092,0.635866261398176
"E02001472",14,219,724,1101,255,55,19,2387,0.00586510263929619,0.0917469627147046,0.303309593632174,0.461248428990365,0.106828655215752,0.0230414746543779,0.00795978215333054,957,0.400921658986175,1430,0.599078341013825
"E02001473",2,192,460,1332,607,116,35,2744,0.000728862973760933,0.0699708454810496,0.167638483965015,0.485422740524781,0.221209912536443,0.0422740524781341,0.0127551020408163,654,0.238338192419825,2090,0.761661807580175
"E02001474",8,167,1507,1452,448,86,30,3698,0.00216333153055706,0.0451595457003786,0.407517577068686,0.392644672796106,0.121146565711195,0.0232558139534884,0.00811249323958897,1682,0.454840454299621,2016,0.545159545700379
"E02001475",1,307,1373,1058,193,32,10,2974,0.000336247478143914,0.103227975790182,0.461667787491594,0.355749831876261,0.0648957632817754,0.0107599193006052,0.00336247478143914,1681,0.565232010759919,1293,0.434767989240081
"E02001476",0,761,1159,1636,519,74,43,4192,0,0.181536259541985,0.276479007633588,0.390267175572519,0.123807251908397,0.0176526717557252,0.0102576335877863,1920,0.458015267175573,2272,0.541984732824427
"E02001477",1,327,1781,1215,244,31,29,3628,0.000275633958103638,0.0901323042998897,0.49090407938258,0.334895259095921,0.0672546857772878,0.00854465270121279,0.00799338478500551,2109,0.581312017640573,1519,0.418687982359427
"E02001478",11,274,1032,1277,413,74,23,3104,0.00354381443298969,0.0882731958762887,0.332474226804124,0.411404639175258,0.13305412371134,0.023840206185567,0.00740979381443299,1317,0.424291237113402,1787,0.575708762886598
"E02001479",1,102,402,882,260,42,13,1702,0.000587544065804935,0.0599294947121034,0.236192714453584,0.518213866039953,0.152761457109283,0.0246768507638073,0.00763807285546416,505,0.296709753231492,1197,0.703290246768508
"E02001480",0,218,667,1232,643,131,26,2917,0,0.0747343160781625,0.228659581762084,0.422351731230717,0.220431950634213,0.0449091532396298,0.00891326705519369,885,0.303393897840247,2032,0.696606102159753
"E02001481",2,184,797,1289,506,92,36,2906,0.000688231245698555,0.063317274604267,0.274260151410874,0.443565037852719,0.174122505161734,0.0316586373021335,0.012388162422574,983,0.33826565726084,1923,0.66173434273916
"E02001482",35,425,2426,1756,632,91,57,5422,0.00645518258945039,0.0783843600147547,0.447436370343047,0.323865732202139,0.116562154186647,0.016783474732571,0.0105127259313906,2886,0.532275912947252,2536,0.467724087052748
"E02001483",3,157,524,1064,381,61,8,2198,0.00136487716105551,0.0714285714285714,0.238398544131028,0.484076433121019,0.173339399454049,0.0277525022747953,0.00363967242948135,684,0.311191992720655,1514,0.688808007279345
"E02001484",10,422,1017,1100,320,55,14,2938,0.00340367597004765,0.143635125936011,0.346153846153846,0.374404356705242,0.108917631041525,0.0187202178352621,0.00476514635806671,1449,0.493192648059905,1489,0.506807351940095
"E02001485",11,317,1228,820,176,40,9,2601,0.00422914263744714,0.121876201460977,0.472126105344098,0.315263360246059,0.0676662821991542,0.0153787004998078,0.00346020761245675,1556,0.598231449442522,1045,0.401768550557478
"E02001486",0,233,1534,1481,559,121,27,3955,0,0.0589127686472819,0.387863463969659,0.374462705436157,0.14134007585335,0.0305941845764855,0.006826801517067,1767,0.446776232616941,2188,0.553223767383059
"E02001487",3,310,1301,2151,817,119,50,4751,0.000631446011366028,0.0652494211744896,0.273837086929068,0.452746790149442,0.171963797095348,0.0250473584508525,0.0105241001894338,1614,0.339717954114923,3137,0.660282045885077
"E02001488",1,111,886,1557,681,110,33,3379,0.000295945546019532,0.0328499556081681,0.262207753773306,0.460787215152412,0.201538916839302,0.0325540100621486,0.00976620301864457,998,0.295353654927493,2381,0.704646345072507
"E02001489",2,66,669,1179,374,50,8,2348,0.000851788756388416,0.0281090289608177,0.284923339011925,0.502129471890971,0.159284497444634,0.0212947189097104,0.00340715502555366,737,0.313884156729131,1611,0.686115843270869
"E02001490",2,48,748,977,283,45,11,2114,0.000946073793755913,0.0227057710501419,0.353831598864711,0.462157048249764,0.133869441816462,0.021286660359508,0.00520340586565752,798,0.377483443708609,1316,0.622516556291391
"E02001491",4,159,1341,1453,238,36,9,3240,0.00123456790123457,0.0490740740740741,0.413888888888889,0.448456790123457,0.0734567901234568,0.0111111111111111,0.00277777777777778,1504,0.464197530864198,1736,0.535802469135802
"E02001492",5,217,918,1372,566,91,30,3199,0.00156298843388559,0.0678336980306346,0.286964676461394,0.428884026258206,0.176930290715849,0.0284463894967177,0.00937793060331354,1140,0.356361362925914,2059,0.643638637074086
"E02001493",34,595,1666,1638,508,56,26,4523,0.00751713464514703,0.131549856290073,0.368339597612204,0.36214901613973,0.112314835286314,0.012381162944948,0.00574839708158302,2295,0.507406588547424,2228,0.492593411452576
"E02001494",3,99,575,929,396,59,18,2079,0.00144300144300144,0.0476190476190476,0.276575276575277,0.446849446849447,0.19047619047619,0.0283790283790284,0.00865800865800866,677,0.325637325637326,1402,0.674362674362674
"E02001495",0,291,815,1306,515,90,26,3043,0,0.0956293131777851,0.267827801511666,0.429181728557345,0.169240880709826,0.0295760762405521,0.00854419980282616,1106,0.363457114689451,1937,0.636542885310549
"E02001496",0,124,544,773,309,61,11,1822,0,0.0680570801317234,0.298572996706915,0.424259055982437,0.169593852908891,0.0334796926454446,0.00603732162458836,668,0.366630076838639,1154,0.633369923161361
"E02001497",5,124,1025,1444,581,63,29,3271,0.00152858453072455,0.0379088963619688,0.313359828798533,0.44145521247325,0.177621522470193,0.0192601650871293,0.00886579027820238,1154,0.352797309691226,2117,0.647202690308774
"E02001498",0,30,379,1149,502,81,22,2163,0,0.013869625520111,0.175219602404068,0.53120665742025,0.232085067036523,0.0374479889042996,0.010171058714748,409,0.189089227924179,1754,0.810910772075821
"E02001499",3,34,450,955,382,85,24,1933,0.00155199172271081,0.0175892395240559,0.232798758406622,0.494050698396275,0.19762027935851,0.0439730988101397,0.0124159337816865,487,0.251939989653389,1446,0.748060010346612
"E02001500",5,81,483,1158,471,72,21,2291,0.00218245307725884,0.0353557398515932,0.210824967263204,0.505456132693147,0.205587079877783,0.0314273243125273,0.00916630292448712,569,0.248363160192056,1722,0.751636839807944
"E02001501",2,70,419,1204,484,83,17,2279,0.000877577885037297,0.0307152259763054,0.183852566915314,0.528301886792453,0.212373848179026,0.0364194822290478,0.00745941202281702,491,0.215445370776656,1788,0.784554629223344
"E02001502",1,666,961,1394,511,62,18,3613,0.000276778300581234,0.184334348187102,0.265983946858566,0.385828951010241,0.141433711597011,0.0171602546360365,0.00498200941046222,1628,0.45059507334625,1985,0.54940492665375
"E02001503",8,270,861,1279,447,76,12,2953,0.00270910938029123,0.091432441584829,0.291567897053844,0.43311886217406,0.151371486623772,0.0257365391127667,0.00406366407043684,1139,0.385709448018964,1814,0.614290551981036
"E02001504",0,55,484,935,297,65,14,1850,0,0.0297297297297297,0.261621621621622,0.505405405405405,0.160540540540541,0.0351351351351351,0.00756756756756757,539,0.291351351351351,1311,0.708648648648649
"E02001505",13,384,583,1006,453,59,13,2511,0.00517722023098367,0.152927120669056,0.232178414974114,0.400637196336121,0.180406212664277,0.0234966148944644,0.00517722023098367,980,0.390282755874154,1531,0.609717244125846
"E02001506",11,116,547,1183,551,148,29,2585,0.00425531914893617,0.0448742746615087,0.211605415860735,0.457640232108317,0.213152804642166,0.0572533849129594,0.0112185686653772,674,0.26073500967118,1911,0.73926499032882
"E02001507",1,62,526,877,245,34,3,1748,0.0005720823798627,0.0354691075514874,0.30091533180778,0.501716247139588,0.140160183066362,0.0194508009153318,0.0017162471395881,589,0.33695652173913,1159,0.66304347826087
"E02001508",2,241,900,1297,384,55,19,2898,0.000690131124913734,0.0831608005521049,0.31055900621118,0.447550034506556,0.132505175983437,0.0189786059351277,0.00655624568668047,1143,0.394409937888199,1755,0.605590062111801
"E02001509",5,530,859,1059,214,30,10,2707,0.0018470631695604,0.195788695973402,0.317325452530477,0.391207979312892,0.0790543036571851,0.0110823790173624,0.0036941263391208,1394,0.514961211673439,1313,0.485038788326561
"E02001510",22,133,698,1009,289,39,13,2203,0.00998638220608261,0.0603722197004085,0.316840671811167,0.458011802088062,0.131184748070813,0.017703132092601,0.005901044030867,853,0.387199273717658,1350,0.612800726282342
"E02001511",12,136,796,988,249,44,6,2231,0.00537875392200807,0.0609592111160914,0.356790676826535,0.442850739578664,0.111609143881667,0.0197220977140296,0.00268937696100403,944,0.423128641864635,1287,0.576871358135365
"E02001512",4,467,912,1342,282,44,6,3057,0.00130847235852143,0.152764147857377,0.298331697742885,0.438992476283939,0.0922473012757605,0.0143931959437357,0.00196270853778214,1383,0.452404317958783,1674,0.547595682041217
"E02001513",3,248,658,1254,286,53,14,2516,0.00119236883942766,0.0985691573926868,0.261526232114467,0.498410174880763,0.113672496025437,0.0210651828298887,0.00556438791732909,909,0.361287758346582,1607,0.638712241653418
"E02001514",6,401,1376,1118,255,33,6,3195,0.00187793427230047,0.125508607198748,0.430672926447574,0.349921752738654,0.07981220657277,0.0103286384976526,0.00187793427230047,1783,0.558059467918623,1412,0.441940532081377
"E02001515",3,458,1295,2094,274,26,4,4154,0.000722195474241695,0.110255175734232,0.311747713047665,0.504092441020703,0.0659605199807415,0.00625902744342802,0.000962927298988926,1756,0.422725084256139,2398,0.577274915743861
"E02001516",1,349,665,1039,289,35,7,2385,0.000419287211740042,0.146331236897275,0.278825995807128,0.435639412997904,0.121174004192872,0.0146750524109015,0.00293501048218029,1015,0.425576519916143,1370,0.574423480083857
"E02001517",3,299,939,1322,213,26,2,2804,0.00106990014265335,0.106633380884451,0.334878744650499,0.471469329529244,0.075962910128388,0.00927246790299572,0.000713266761768902,1241,0.442582025677603,1563,0.557417974322396
"E02001518",4,459,1471,1571,480,79,19,4083,0.000979671809943669,0.112417340191036,0.360274308106784,0.384766103355376,0.11756061719324,0.0193485182463875,0.00465344109723243,1934,0.473671320107764,2149,0.526328679892236
"E02001519",5,503,992,1319,288,48,2,3157,0.00158378207158695,0.159328476401647,0.314222363002851,0.417801710484637,0.0912258473234083,0.0152043078872347,0.00063351282863478,1500,0.475134621476085,1657,0.524865378523915
"E02001520",2,627,1171,1852,393,44,16,4105,0.00048721071863581,0.152740560292326,0.285261875761267,0.45115712545676,0.0957369062119367,0.0107186358099878,0.00389768574908648,1800,0.438489646772229,2305,0.561510353227771
"E02001521",1,306,1668,2578,1134,157,29,5873,0.000170270730461434,0.0521028435211987,0.284011578409671,0.438957943129576,0.193087008343266,0.0267325046824451,0.00493785118338158,1975,0.336284692661332,3898,0.663715307338668
"E02001522",52,675,1401,1494,323,48,13,4006,0.0129805292061907,0.168497254118822,0.349725411882177,0.372940589116325,0.0806290564153769,0.0119820269595607,0.00324513230154768,2128,0.531203195207189,1878,0.468796804792811
"E02001523",1,311,875,1043,411,54,6,2701,0.000370233246945576,0.115142539800074,0.323954091077379,0.386153276564235,0.152165864494632,0.0199925953350611,0.00222139948167345,1187,0.439466864124398,1514,0.560533135875602
"E02001524",19,379,495,899,290,70,31,2183,0.0087036188731104,0.17361429225836,0.226752175904718,0.411818598259276,0.132844709115896,0.0320659642693541,0.0142006413192854,893,0.409070087036189,1290,0.590929912963811
"E02001525",7,218,1460,1470,395,54,14,3618,0.00193477059148701,0.0602542841348812,0.403537866224433,0.406301824212272,0.109176340519624,0.0149253731343284,0.00386954118297402,1685,0.465726920950802,1933,0.534273079049198
"E02001526",4,358,1160,1055,192,11,2,2782,0.00143781452192667,0.128684399712437,0.416966211358735,0.37922358015816,0.0690150970524802,0.00395398993529835,0.000718907260963336,1522,0.547088425593099,1260,0.452911574406901
"E02001527",25,225,717,1014,165,26,6,2178,0.0114784205693297,0.103305785123967,0.329201101928375,0.465564738292011,0.0757575757575758,0.0119375573921028,0.00275482093663912,967,0.443985307621671,1211,0.556014692378329
"E02001528",8,306,1189,1999,544,75,17,4138,0.00193330111164814,0.0739487675205413,0.287336877718705,0.483083615273079,0.131464475592073,0.0181246979217013,0.0041082648622523,1503,0.363218946350894,2635,0.636781053649106
"E02001529",8,235,1108,2098,447,56,13,3965,0.00201765447667087,0.0592686002522068,0.279445145018915,0.529129886506936,0.112736443883985,0.0141235813366961,0.00327868852459016,1351,0.340731399747793,2614,0.659268600252207
"E02001530",36,525,1168,1311,428,63,24,3555,0.010126582278481,0.147679324894515,0.328551336146273,0.368776371308017,0.120393811533052,0.0177215189873418,0.00675105485232068,1729,0.486357243319269,1826,0.513642756680731
"E02001531",13,669,967,1413,361,43,11,3477,0.00373885533505896,0.192407247627265,0.278113316077078,0.406384814495255,0.103825136612022,0.0123669830313489,0.00316364682197297,1649,0.474259419039402,1828,0.525740580960598
"E02001532",11,499,1446,1406,422,68,22,3874,0.00283944243675787,0.128807434176562,0.373257614868353,0.362932369643779,0.108931337119257,0.0175529168817759,0.00567888487351575,1956,0.504904491481673,1918,0.495095508518327
"E02001533",17,248,1172,1204,307,55,10,3013,0.00564221705940923,0.0823099900431464,0.388981081978095,0.39960172585463,0.101891802190508,0.0182542316627946,0.00331895121141719,1437,0.476933289080651,1576,0.52306671091935
"E02001534",31,647,1421,1419,395,34,10,3957,0.00783421784179934,0.16350770785949,0.359110437199899,0.358605003790751,0.0998230983067981,0.00859236795552186,0.00252716704574172,2099,0.530452362901188,1858,0.469547637098812
"E02001535",39,345,650,750,398,146,45,2373,0.0164348925410872,0.145385587863464,0.273914875684787,0.316055625790139,0.1677201854193,0.0615254951538137,0.0189633375474083,1034,0.435735356089338,1339,0.564264643910662
"E02001536",19,362,833,1509,553,84,18,3378,0.00562462995855536,0.107164002368265,0.246595618709295,0.446714031971581,0.163706335109532,0.024866785079929,0.00532859680284192,1214,0.359384251036116,2164,0.640615748963884
"E02001537",3,264,1164,1354,391,58,7,3241,0.000925640234495526,0.0814563406356063,0.359148410984264,0.417772292502314,0.12064177722925,0.0178957112002468,0.00215982721382289,1431,0.441530391854366,1810,0.558469608145634
"E02001538",13,137,991,1573,316,49,8,3087,0.00421120829284095,0.0443796566245546,0.32102364755426,0.509556203433754,0.10236475542598,0.0158730158730159,0.00259151279559443,1141,0.369614512471655,1946,0.630385487528345
"E02001539",2,319,599,932,285,54,21,2212,0.000904159132007233,0.144213381555154,0.270795660036166,0.421338155515371,0.128842676311031,0.0244122965641953,0.00949367088607595,920,0.415913200723327,1292,0.584086799276673
"E02001540",3,734,1101,1876,600,135,62,4511,0.000665041010862337,0.162713367324318,0.244070050986477,0.415872312125914,0.133008202172467,0.0299268454888051,0.013744180891155,1838,0.407448459321658,2673,0.592551540678342
"E02001541",12,439,1233,1657,485,76,19,3921,0.00306044376434583,0.111961234378985,0.314460596786534,0.422596276460087,0.123692935475644,0.0193828105075236,0.0048457026268809,1684,0.429482274929865,2237,0.570517725070135
"E02001542",5,353,744,968,376,125,55,2626,0.0019040365575019,0.134424980959634,0.283320639756283,0.368621477532369,0.143183549124143,0.0476009139375476,0.0209444021325209,1102,0.41964965727342,1524,0.58035034272658
"E02001543",2,93,950,1628,493,78,11,3255,0.000614439324116743,0.0285714285714286,0.291858678955453,0.500153609831029,0.151459293394777,0.023963133640553,0.00337941628264209,1045,0.321044546850998,2210,0.678955453149002
"E02001544",4,233,924,1369,276,47,16,2869,0.00139421401185082,0.0812129661903102,0.322063436737539,0.477169745555943,0.0962007668177065,0.0163820146392471,0.00557685604740328,1161,0.4046706169397,1708,0.5953293830603
"E02001545",5,234,908,1285,241,22,1,2696,0.00185459940652819,0.0867952522255193,0.336795252225519,0.476632047477745,0.0893916913946588,0.00816023738872404,0.000370919881305638,1147,0.425445103857567,1549,0.574554896142433
"E02001546",26,647,535,916,282,58,28,2492,0.0104333868378812,0.259630818619583,0.214686998394864,0.367576243980738,0.113162118780096,0.0232744783306581,0.0112359550561798,1208,0.484751203852327,1284,0.515248796147673
"E02001547",6,569,1158,1714,558,97,23,4125,0.00145454545454545,0.137939393939394,0.280727272727273,0.415515151515152,0.135272727272727,0.0235151515151515,0.00557575757575758,1733,0.420121212121212,2392,0.579878787878788
"E02001548",5,348,1026,1600,652,107,13,3751,0.00133297787256732,0.0927752599306852,0.273527059450813,0.426552919221541,0.173820314582778,0.0285257264729405,0.00346574246867502,1379,0.367635297254066,2372,0.632364702745934
"E02001549",7,263,481,983,203,26,7,1970,0.00355329949238579,0.133502538071066,0.244162436548223,0.498984771573604,0.103045685279188,0.0131979695431472,0.00355329949238579,751,0.381218274111675,1219,0.618781725888325
"E02001550",16,392,791,1301,331,40,8,2879,0.00555748523792984,0.136158388329281,0.274748176450156,0.45189301840917,0.114970475859674,0.0138937130948246,0.00277874261896492,1199,0.416464050017367,1680,0.583535949982633
"E02001551",4,38,438,1214,514,79,19,2306,0.00173460537727667,0.0164787510841284,0.189939288811795,0.526452732003469,0.222896790980052,0.0342584562012142,0.00823937554206418,480,0.2081526452732,1826,0.7918473547268
"E02001552",54,471,1272,1161,220,31,6,3215,0.016796267496112,0.146500777604977,0.395645412130638,0.361119751166407,0.0684292379471229,0.00964230171073095,0.00186625194401244,1797,0.558942457231726,1418,0.441057542768274
"E02001553",5,698,1104,1540,530,81,13,3971,0.0012591286829514,0.175774364140015,0.278015613195669,0.38781163434903,0.133467640392848,0.0203978846638126,0.00327373457567363,1807,0.455049106018635,2164,0.544950893981365
"E02001554",2,60,480,928,224,30,8,1732,0.00115473441108545,0.0346420323325635,0.277136258660508,0.535796766743649,0.12933025404157,0.0173210161662818,0.0046189376443418,542,0.312933025404157,1190,0.687066974595843
"E02001555",7,56,510,972,139,18,7,1709,0.00409596255119953,0.0327677004095963,0.298420128730252,0.568753657109421,0.0813341135166764,0.0105324751316559,0.00409596255119953,573,0.335283791691047,1136,0.664716208308953
"E02001556",5,65,1157,1389,381,52,15,3064,0.00163185378590078,0.0212140992167102,0.377610966057441,0.453328981723238,0.12434725848564,0.0169712793733681,0.00489556135770235,1227,0.400456919060052,1837,0.599543080939948
"E02001557",0,271,681,1742,1047,199,51,3991,0,0.0679027812578301,0.170633926334252,0.436482084690554,0.262340265597595,0.0498621899273365,0.012778752192433,952,0.238536707592082,3039,0.761463292407918
"E02001558",3,164,428,787,354,138,42,1916,0.00156576200417537,0.0855949895615866,0.223382045929019,0.410751565762004,0.184759916492693,0.0720250521920668,0.0219206680584551,595,0.310542797494781,1321,0.689457202505219
"E02001559",38,126,545,1130,342,42,6,2229,0.0170480035890534,0.0565275908479139,0.244504262000897,0.50695379093764,0.15343203230148,0.018842530282638,0.00269179004037685,709,0.318079856437865,1520,0.681920143562135
"E02001560",2,744,1546,2673,1279,156,70,6470,0.000309119010819165,0.11499227202473,0.238948995363215,0.413137557959815,0.197681607418856,0.0241112828438949,0.0108191653786708,2292,0.354250386398763,4178,0.645749613601236
"E02001561",0,104,1165,1297,455,62,15,3098,0,0.0335700451904455,0.376049063912201,0.418657198192382,0.146868947708199,0.0200129115558425,0.00484183344092963,1269,0.409619109102647,1829,0.590380890897353
"E02001562",1,44,823,1024,185,24,4,2105,0.000475059382422803,0.0209026128266033,0.390973871733967,0.48646080760095,0.0878859857482185,0.0114014251781473,0.00190023752969121,868,0.412351543942993,1237,0.587648456057007
"E02001563",2,256,860,1115,341,49,7,2630,0.000760456273764259,0.0973384030418251,0.326996197718631,0.423954372623574,0.129657794676806,0.0186311787072243,0.0026615969581749,1118,0.425095057034221,1512,0.574904942965779
"E02001564",17,463,687,1033,246,45,7,2498,0.00680544435548439,0.185348278622898,0.27502001601281,0.413530824659728,0.0984787830264211,0.0180144115292234,0.00280224179343475,1167,0.467173738991193,1331,0.532826261008807
"E02001565",8,1077,1050,947,155,19,2,3258,0.00245549416820135,0.330570902394107,0.322283609576427,0.290669122160835,0.0475751995089012,0.00583179864947821,0.000613873542050338,2135,0.655310006138735,1123,0.344689993861265
"E02001566",3,911,1398,1505,517,65,20,4419,0.000678886625933469,0.206155238741797,0.316361167684997,0.340574790676624,0.116994795202535,0.0147092102285585,0.00452591083955646,2312,0.523195293052727,2107,0.476804706947273
"E02001567",4,85,1305,1645,431,62,11,3543,0.00112898673440587,0.0239909681061248,0.368331922099915,0.464295794524414,0.121648320632233,0.017499294383291,0.00310471351961614,1394,0.393451876940446,2149,0.606548123059554
"E02001568",0,374,1058,1402,375,43,12,3264,0,0.114583333333333,0.324142156862745,0.42953431372549,0.114889705882353,0.0131740196078431,0.00367647058823529,1432,0.438725490196078,1832,0.561274509803922
"E02001569",6,187,964,1924,685,104,28,3898,0.00153925089789636,0.0479733196511031,0.247306310928681,0.493586454592098,0.175731144176501,0.0266803488968702,0.00718317085684967,1157,0.296818881477681,2741,0.703181118522319
"E02001570",0,393,1228,1268,304,58,19,3270,0,0.120183486238532,0.375535168195719,0.387767584097859,0.0929663608562691,0.017737003058104,0.00581039755351682,1621,0.495718654434251,1649,0.504281345565749
"E02001571",2,66,500,970,348,90,18,1994,0.00100300902708124,0.033099297893681,0.250752256770311,0.486459378134403,0.174523570712136,0.045135406218656,0.00902708124373119,568,0.284854563691073,1426,0.715145436308927
"E02001572",1,569,774,1383,362,55,22,3166,0.000315855969677827,0.179722046746684,0.244472520530638,0.436828806064435,0.114339861023373,0.0173720783322805,0.00694883133291219,1344,0.424510423246999,1822,0.575489576753001
"E02001573",3,105,758,1211,325,43,8,2453,0.00122299225438239,0.0428047289033836,0.30900937627395,0.493681206685691,0.132490827558092,0.0175295556461476,0.00326131267835304,866,0.353037097431716,1587,0.646962902568284
"E02001574",2,89,666,957,156,15,7,1892,0.00105708245243129,0.0470401691331924,0.352008456659619,0.505813953488372,0.0824524312896406,0.00792811839323467,0.00369978858350951,757,0.400105708245243,1135,0.599894291754757
"E02001575",2,655,837,1472,406,58,19,3449,0.00057987822557263,0.189910118875036,0.242679037402146,0.426790374021455,0.117715279791244,0.0168164685416063,0.00550884314293998,1494,0.433169034502754,1955,0.566830965497246
"E02001576",5,486,1186,913,191,39,9,2829,0.00176740897843761,0.171792152704136,0.419229409685401,0.322728879462708,0.0675150229763167,0.0137857900318134,0.0031813361611877,1677,0.592788971367974,1152,0.407211028632025
"E02001577",2,82,628,1097,324,76,15,2224,0.000899280575539568,0.0368705035971223,0.282374100719424,0.493255395683453,0.14568345323741,0.0341726618705036,0.00674460431654676,712,0.320143884892086,1512,0.679856115107914
"E02001578",26,548,1713,1309,328,53,11,3988,0.00651955867602808,0.13741223671013,0.429538615847543,0.328234704112337,0.082246740220662,0.0132898696088265,0.00275827482447342,2287,0.573470411233701,1701,0.426529588766299
"E02001579",37,311,1252,1515,430,74,6,3625,0.0102068965517241,0.0857931034482759,0.345379310344828,0.417931034482759,0.118620689655172,0.0204137931034483,0.0016551724137931,1600,0.441379310344828,2025,0.558620689655172
"E02001580",1,337,776,1275,389,49,12,2839,0.000352236703064459,0.118703768932723,0.27333568157802,0.449101796407186,0.137020077492075,0.0172595984501585,0.00422684043677351,1114,0.392391687213808,1725,0.607608312786192
"E02001581",1,289,592,909,228,18,3,2040,0.000490196078431373,0.141666666666667,0.290196078431373,0.445588235294118,0.111764705882353,0.00882352941176471,0.00147058823529412,882,0.432352941176471,1158,0.567647058823529
"E02001582",2,78,1147,951,255,36,6,2475,0.000808080808080808,0.0315151515151515,0.463434343434343,0.384242424242424,0.103030303030303,0.0145454545454545,0.00242424242424242,1227,0.495757575757576,1248,0.504242424242424
"E02001583",1,130,574,956,342,50,9,2062,0.000484966052376334,0.0630455868089234,0.278370514064016,0.463627546071775,0.165858389912706,0.0242483026188167,0.004364694471387,705,0.341901066925315,1357,0.658098933074685
"E02001584",3,263,490,946,382,76,30,2190,0.00136986301369863,0.120091324200913,0.223744292237443,0.431963470319635,0.174429223744292,0.034703196347032,0.0136986301369863,756,0.345205479452055,1434,0.654794520547945
"E02001585",14,220,1010,1209,289,51,15,2808,0.00498575498575499,0.0783475783475783,0.35968660968661,0.430555555555556,0.102920227920228,0.0181623931623932,0.00534188034188034,1244,0.443019943019943,1564,0.556980056980057
"E02001586",11,121,1851,1076,258,36,16,3369,0.00326506381715643,0.0359157019887207,0.549421193232413,0.319382606114574,0.0765805877114871,0.0106856634016028,0.00474918373404571,1983,0.58860195903829,1386,0.41139804096171
"E02001587",86,407,765,819,185,30,15,2307,0.0372778500216732,0.17641959254443,0.331599479843953,0.355006501950585,0.0801907238838318,0.0130039011703511,0.00650195058517555,1258,0.545296922410056,1049,0.454703077589944
"E02001588",2,105,921,937,160,21,2,2148,0.000931098696461825,0.0488826815642458,0.42877094972067,0.436219739292365,0.074487895716946,0.00977653631284916,0.000931098696461825,1028,0.478584729981378,1120,0.521415270018622
"E02001589",8,195,1012,1082,220,45,11,2573,0.00310921103769918,0.0757870190439176,0.393315196268947,0.420520792848815,0.0855033035367276,0.0174893120870579,0.00427516517683638,1215,0.472211426350564,1358,0.527788573649436
"E02001590",10,160,1017,1027,200,26,9,2449,0.00408329930583912,0.0653327888934259,0.415271539403838,0.419354838709677,0.0816659861167824,0.0106165781951817,0.00367496937525521,1187,0.484687627603103,1262,0.515312372396897
"E02001591",0,56,896,1205,527,90,27,2801,0,0.0199928596929668,0.319885755087469,0.430203498750446,0.188147090324884,0.0321313816494109,0.00963941449482328,952,0.339878614780436,1849,0.660121385219564
"E02001592",1,140,827,1227,345,60,9,2609,0.000383288616328095,0.0536604062859333,0.316979685703335,0.470295132234573,0.132234572633193,0.0229973169796857,0.00344959754695286,968,0.371023380605596,1641,0.628976619394404
"E02001593",14,155,1131,1247,520,68,15,3156,0.00443599493029151,0.0491128010139417,0.358365019011407,0.395120405576679,0.164765525982256,0.0215462610899873,0.00475285171102662,1300,0.41191381495564,1850,0.586185044359949
"E02001594",0,488,1368,1241,576,76,35,3784,0,0.128964059196617,0.361522198731501,0.327959830866808,0.152219873150106,0.0200845665961945,0.00924947145877379,1856,0.490486257928118,1928,0.509513742071882
"E02001595",3,105,780,1434,282,35,6,2645,0.00113421550094518,0.0396975425330813,0.294896030245747,0.542155009451796,0.106616257088847,0.0132325141776938,0.00226843100189036,888,0.335727788279773,1757,0.664272211720227
"E02001596",11,143,1059,1180,251,32,8,2684,0.00409836065573771,0.0532786885245902,0.394560357675112,0.439642324888227,0.0935171385991058,0.0119225037257824,0.0029806259314456,1213,0.45193740685544,1471,0.54806259314456
"E02001597",16,264,1194,1617,534,86,21,3732,0.00428724544480171,0.0707395498392283,0.319935691318328,0.433279742765273,0.143086816720257,0.0230439442658092,0.00562700964630225,1474,0.394962486602358,2258,0.605037513397642
"E02001598",13,150,844,1353,384,56,7,2807,0.00463127894549341,0.0534378339864624,0.300676879230495,0.482009262557891,0.136800855005344,0.0199501246882793,0.00249376558603491,1007,0.358745992162451,1800,0.641254007837549
"E02001600",6,240,933,1459,510,117,11,3276,0.00183150183150183,0.0732600732600733,0.284798534798535,0.445360195360195,0.155677655677656,0.0357142857142857,0.00335775335775336,1179,0.35989010989011,2097,0.64010989010989
"E02001602",1,142,931,1238,315,53,7,2687,0.000372162262746558,0.0528470413100112,0.346483066617045,0.460736881280238,0.117231112765166,0.0197245999255675,0.0026051358392259,1074,0.399702270189803,1613,0.600297729810197
"E02001603",4,458,708,1010,262,51,16,2509,0.00159426066161817,0.182542845755281,0.282184137106417,0.402550817058589,0.10442407333599,0.0203268234356317,0.0063770426464727,1170,0.466321243523316,1339,0.533678756476684
"E02001604",22,2227,1138,1083,294,52,10,4826,0.00455864069622876,0.461458765022793,0.23580605055947,0.224409448818898,0.0609200165768753,0.0107749689183589,0.00207210940737671,3387,0.701823456278492,1439,0.298176543721508
"E02001605",6,279,1179,1079,317,83,15,2958,0.00202839756592292,0.0943204868154158,0.398580121703854,0.364773495605139,0.107167004732928,0.0280594996619337,0.0050709939148073,1464,0.494929006085193,1494,0.505070993914807
"E02001606",25,441,735,1302,364,56,17,2940,0.00850340136054422,0.15,0.25,0.442857142857143,0.123809523809524,0.019047619047619,0.00578231292517007,1201,0.408503401360544,1739,0.591496598639456
"E02001607",7,116,868,1291,316,54,8,2660,0.00263157894736842,0.043609022556391,0.326315789473684,0.485338345864662,0.118796992481203,0.0203007518796992,0.00300751879699248,991,0.372556390977444,1669,0.627443609022556
"E02001608",2,321,643,1027,328,56,4,2381,0.000839983200335993,0.134817303653927,0.270054598908022,0.431331373372533,0.137757244855103,0.0235195296094078,0.00167996640067199,966,0.405711885762285,1415,0.594288114237715
"E02001609",8,171,577,1217,383,73,14,2443,0.00327466230045027,0.0699959066721244,0.236185018419975,0.498158002455997,0.156774457634056,0.0298812934916087,0.00573065902578797,756,0.30945558739255,1687,0.69054441260745
"E02001610",16,315,998,1128,365,104,18,2944,0.00543478260869565,0.106997282608696,0.338994565217391,0.383152173913043,0.12398097826087,0.0353260869565217,0.00611413043478261,1329,0.451426630434783,1615,0.548573369565217
"E02001611",1,363,867,1054,312,60,18,2675,0.000373831775700935,0.135700934579439,0.32411214953271,0.394018691588785,0.116635514018692,0.0224299065420561,0.00672897196261682,1231,0.46018691588785,1444,0.53981308411215
"E02001612",54,79,573,883,236,33,11,1869,0.028892455858748,0.0422685928303906,0.306581059390048,0.472445157838416,0.126270733012306,0.0176565008025682,0.00588550026752274,706,0.377742108079187,1163,0.622257891920813
"E02001613",5,184,1062,1600,342,51,4,3248,0.00153940886699507,0.0566502463054187,0.326970443349754,0.492610837438424,0.105295566502463,0.0157019704433498,0.00123152709359606,1251,0.385160098522167,1997,0.614839901477833
"E02001614",7,130,920,1648,410,60,14,3189,0.002195045468799,0.0407651301348385,0.288491690185011,0.516776418940107,0.128566948886798,0.0188146754468485,0.00439009093759799,1057,0.331451865788648,2132,0.668548134211352
"E02001615",1,118,508,1093,318,69,23,2130,0.000469483568075117,0.0553990610328638,0.23849765258216,0.513145539906103,0.149295774647887,0.0323943661971831,0.0107981220657277,627,0.294366197183099,1503,0.705633802816901
"E02001616",3,217,861,985,196,28,9,2299,0.00130491518051327,0.094388864723793,0.374510656807308,0.428447150935189,0.0852544584602001,0.0121792083514572,0.0039147455415398,1081,0.470204436711614,1218,0.529795563288386
"E02001617",2,149,868,916,118,16,7,2076,0.000963391136801541,0.0717726396917148,0.418111753371869,0.441233140655106,0.0568400770712909,0.00770712909441233,0.00337186897880539,1019,0.490847784200385,1057,0.509152215799615
"E02001618",2,248,1332,1121,320,89,27,3139,0.000637145587766805,0.0790060528830838,0.424338961452692,0.357120101943294,0.101943294042689,0.0283529786556228,0.00860146543485186,1582,0.503982159923543,1557,0.496017840076457
"E02001619",16,517,1192,1366,207,24,7,3329,0.00480624812255933,0.155301892460198,0.35806548513067,0.410333433463503,0.0621808350856113,0.00720937218383899,0.00210273355361971,1725,0.518173625713428,1604,0.481826374286573
"E02001620",1,293,1023,1046,173,38,13,2587,0.000386548125241593,0.113258600695787,0.395438732122149,0.404329339002706,0.0668728256667955,0.0146888287591805,0.0050251256281407,1317,0.509083880943177,1270,0.490916119056823
"E02001621",10,455,872,812,148,30,5,2332,0.00428816466552316,0.195111492281304,0.373927958833619,0.34819897084048,0.0634648370497427,0.0128644939965695,0.00214408233276158,1337,0.573327615780446,995,0.426672384219554
"E02001622",23,194,1134,1512,361,55,11,3290,0.00699088145896657,0.0589665653495441,0.34468085106383,0.459574468085106,0.109726443768997,0.0167173252279635,0.00334346504559271,1351,0.41063829787234,1939,0.58936170212766
"E02001623",1,68,1620,950,199,33,8,2879,0.000347342827370615,0.0236193122612018,0.562695380340396,0.329975686002084,0.0691212226467523,0.0114623133032303,0.00277874261896492,1689,0.586662035428968,1190,0.413337964571032
"E02001624",1,221,1234,1250,515,91,22,3334,0.0002999400119976,0.0662867426514697,0.370125974805039,0.374925014997001,0.154469106178764,0.0272945410917816,0.00659868026394721,1456,0.436712657468506,1878,0.563287342531494
"E02001625",0,120,1129,1114,166,28,9,2566,0,0.0467653936087295,0.439984411535464,0.434138737334373,0.0646921278254092,0.0109119251753702,0.00350740452065472,1249,0.486749805144193,1317,0.513250194855807
"E02001626",0,75,378,779,454,65,14,1765,0,0.0424929178470255,0.214164305949009,0.441359773371105,0.257223796033994,0.0368271954674221,0.00793201133144476,453,0.256657223796034,1312,0.743342776203966
"E02001627",0,150,650,1112,565,67,14,2558,0,0.0586395621579359,0.254104769351056,0.434714620797498,0.220875684128225,0.026192337763878,0.00547302580140735,800,0.312744331508991,1758,0.687255668491009
"E02001628",3,157,542,734,426,65,35,1962,0.00152905198776758,0.0800203873598369,0.27624872579001,0.374108053007136,0.217125382262997,0.0331294597349643,0.0178389398572885,702,0.357798165137615,1260,0.642201834862385
"E02001629",28,155,1036,907,257,43,21,2447,0.0114425827543931,0.063342868818962,0.423375561912546,0.370657948508378,0.105026563138537,0.0175725378013895,0.00858193706579485,1219,0.498161013485901,1228,0.501838986514099
"E02001630",7,100,701,965,894,154,30,2851,0.00245527884952648,0.0350754121360926,0.245878639074009,0.338477727113294,0.313574184496668,0.0540161346895826,0.0105226236408278,808,0.283409330059628,2043,0.716590669940372
"E02001631",18,133,707,1203,511,80,11,2663,0.00675929402929027,0.0499436725497559,0.265490048817124,0.451746150957567,0.191888847164852,0.0300413067968457,0.00413067968456628,858,0.32219301539617,1805,0.67780698460383
"E02001632",34,478,1954,1442,923,108,44,4983,0.00682319887617901,0.0959261489062814,0.392133253060405,0.289383905277945,0.185229781256271,0.0216736905478627,0.00883002207505519,2466,0.494882600842866,2517,0.505117399157134
"E02001633",74,229,707,977,238,59,18,2302,0.0321459600347524,0.0994787141615986,0.307124239791486,0.424413553431798,0.103388357949609,0.025629887054735,0.00781928757602085,1010,0.438748913987837,1292,0.561251086012163
"E02001634",1,130,1033,1738,851,114,23,3890,0.00025706940874036,0.0334190231362468,0.265552699228792,0.446786632390746,0.218766066838046,0.029305912596401,0.00591259640102828,1164,0.299228791773779,2726,0.700771208226221
"E02001635",1,99,977,975,244,35,6,2337,0.000427899015832264,0.0423620025673941,0.418057338468122,0.417201540436457,0.104407359863072,0.0149764655541292,0.00256739409499358,1077,0.460847240051348,1260,0.539152759948652
"E02001636",11,504,2341,1025,334,47,13,4275,0.00257309941520468,0.117894736842105,0.547602339181287,0.239766081871345,0.0781286549707602,0.0109941520467836,0.00304093567251462,2856,0.668070175438596,1419,0.331929824561403
"E02001637",29,279,1122,764,418,61,26,2699,0.0107447202667655,0.103371619118192,0.415709522045202,0.283067802889959,0.154872174879585,0.0226009633197481,0.00963319748054835,1430,0.529825861430159,1269,0.470174138569841
"E02001638",2,25,422,1145,693,49,8,2344,0.000853242320819113,0.0106655290102389,0.180034129692833,0.488481228668942,0.295648464163823,0.0209044368600683,0.00341296928327645,449,0.191552901023891,1895,0.808447098976109
"E02001639",1,86,630,1217,552,60,12,2558,0.000390930414386239,0.0336200156372166,0.246286161063331,0.475762314308053,0.215793588741204,0.0234558248631744,0.00469116497263487,717,0.280297107114934,1841,0.719702892885067
"E02001640",0,199,1177,1208,613,60,17,3274,0,0.0607819181429444,0.359499083689676,0.368967623701894,0.187232742822236,0.0183262064752596,0.00519242516799023,1376,0.420281001832621,1898,0.579718998167379
"E02001642",0,192,976,1459,586,96,27,3336,0,0.0575539568345324,0.292565947242206,0.437350119904077,0.175659472422062,0.0287769784172662,0.00809352517985612,1168,0.350119904076739,2168,0.649880095923261
"E02001643",1,63,566,846,300,51,11,1838,0.000544069640914037,0.0342763873775843,0.307943416757345,0.460282916213275,0.163220892274211,0.0277475516866159,0.00598476605005441,630,0.342763873775843,1208,0.657236126224157
"E02001646",1,154,813,1211,653,115,10,2957,0.000338180588434224,0.0520798106188705,0.274940818397024,0.409536692593845,0.220831924247548,0.0388907676699357,0.00338180588434224,968,0.327358809604329,1989,0.672641190395671
"E02001647",2,102,789,792,181,24,6,1896,0.00105485232067511,0.0537974683544304,0.416139240506329,0.417721518987342,0.095464135021097,0.0126582278481013,0.00316455696202532,893,0.470991561181435,1003,0.529008438818565
"E02001648",6,240,677,856,481,100,14,2374,0.0025273799494524,0.101095197978096,0.285172704296546,0.360572872788543,0.202611625947767,0.04212299915754,0.0058972198820556,923,0.388795282224094,1451,0.611204717775906
"E02001649",119,830,2402,1450,324,24,5,5154,0.0230888630190144,0.161039968956151,0.46604578967792,0.281334885525805,0.0628637951105937,0.00465657741559953,0.00097012029491657,3351,0.650174621653085,1803,0.349825378346915
"E02001650",0,672,1835,1038,560,68,7,4180,0,0.160765550239234,0.438995215311005,0.248325358851675,0.133971291866029,0.0162679425837321,0.00167464114832536,2507,0.599760765550239,1673,0.400239234449761
"E02001651",17,99,572,1046,349,59,15,2157,0.00788131664348632,0.0458970792767733,0.265183124710246,0.4849327770051,0.16179879462216,0.0273528048215114,0.00695410292072323,688,0.318961520630505,1469,0.681038479369495
"E02001652",0,1706,1483,1518,1045,136,37,5925,0,0.287932489451477,0.250295358649789,0.25620253164557,0.176371308016878,0.0229535864978903,0.00624472573839662,3189,0.538227848101266,2736,0.461772151898734
"E02001653",35,702,1478,848,198,23,7,3291,0.010635065329687,0.21330902461258,0.449103615922212,0.257672439987846,0.0601640838650866,0.00698875721665147,0.0021270130659374,2215,0.673047705864479,1076,0.326952294135521
"E02001654",1,327,413,854,262,33,12,1902,0.000525762355415352,0.17192429022082,0.21713985278654,0.449001051524711,0.137749737118822,0.0173501577287066,0.00630914826498423,741,0.389589905362776,1161,0.610410094637224
"E02001655",1,31,1154,1375,213,28,2,2804,0.000356633380884451,0.011055634807418,0.411554921540656,0.49037089871612,0.075962910128388,0.00998573466476462,0.000713266761768902,1186,0.422967189728959,1618,0.577032810271041
"E02001656",6,168,573,1277,829,107,25,2985,0.00201005025125628,0.0562814070351759,0.191959798994975,0.427805695142379,0.277721943048576,0.0358458961474037,0.00837520938023451,747,0.250251256281407,2238,0.749748743718593
"E02001657",0,59,525,1408,721,96,5,2814,0,0.0209665955934613,0.186567164179104,0.500355366027008,0.256218905472637,0.0341151385927505,0.00177683013503909,584,0.207533759772566,2230,0.792466240227434
"E02001658",1,248,658,862,81,32,12,1894,0.000527983104540655,0.130939809926082,0.347412882787751,0.455121436114044,0.042766631467793,0.0168954593453009,0.00633579725448786,907,0.478880675818374,987,0.521119324181626
"E02001659",1,101,1457,810,237,44,5,2655,0.000376647834274953,0.0380414312617702,0.548775894538606,0.305084745762712,0.0892655367231638,0.0165725047080979,0.00188323917137476,1559,0.587193973634652,1096,0.412806026365348
"E02001660",2,194,899,1410,1128,202,36,3871,0.00051666236114699,0.0501162490312581,0.232239731335572,0.364246964608628,0.291397571686903,0.052182898475846,0.00929992250064583,1095,0.282872642727977,2776,0.717127357272023
"E02001661",0,132,1438,1239,423,52,4,3288,0,0.0401459854014599,0.437347931873479,0.376824817518248,0.128649635036496,0.0158150851581509,0.00121654501216545,1570,0.477493917274939,1718,0.522506082725061
"E02001662",1,82,768,1290,364,56,9,2570,0.000389105058365759,0.0319066147859922,0.298832684824903,0.501945525291829,0.141634241245136,0.0217898832684825,0.00350194552529183,851,0.331128404669261,1719,0.668871595330739
"E02001663",10,110,424,1309,808,144,18,2823,0.00354233085370174,0.0389656393907191,0.150194828196954,0.463691108749557,0.2862203329791,0.051009564293305,0.00637619553666312,544,0.192702798441374,2279,0.807297201558625
"E02001664",1,102,785,917,218,28,6,2057,0.000486144871171609,0.0495867768595041,0.381623723869713,0.445794846864366,0.105979581915411,0.0136120563928051,0.00291686922702965,888,0.431696645600389,1169,0.568303354399611
"E02001665",6,332,630,1148,544,120,15,2795,0.00214669051878354,0.118783542039356,0.225402504472272,0.410733452593918,0.194633273703041,0.0429338103756708,0.00536672629695885,968,0.346332737030411,1827,0.653667262969589
"E02001666",2,71,665,791,191,37,2,1759,0.00113700966458215,0.0403638430926663,0.378055713473565,0.44968732234224,0.108584422967595,0.0210346787947698,0.00113700966458215,738,0.419556566230813,1021,0.580443433769187
"E02001669",0,223,678,1407,665,116,18,3107,0,0.0717734148696492,0.218216929514001,0.452848406823302,0.214032829095591,0.0373350498873511,0.00579336981010621,901,0.28999034438365,2206,0.71000965561635
"E02001670",3,84,1043,983,137,30,6,2286,0.00131233595800525,0.036745406824147,0.456255468066492,0.430008748906387,0.0599300087489064,0.0131233595800525,0.0026246719160105,1130,0.494313210848644,1156,0.505686789151356
"E02001671",16,117,690,874,120,16,2,1835,0.00871934604904632,0.0637602179836512,0.376021798365123,0.476294277929155,0.0653950953678474,0.00871934604904632,0.00108991825613079,823,0.44850136239782,1012,0.55149863760218
"E02001672",1,66,682,903,181,36,8,1877,0.00053276505061268,0.0351624933404369,0.363345764517848,0.48108684070325,0.096430474160895,0.0191795418220565,0.00426212040490144,749,0.399041022908897,1128,0.600958977091103
"E02001673",1,44,393,834,149,16,5,1442,0.000693481276005548,0.0305131761442441,0.27253814147018,0.578363384188627,0.103328710124827,0.0110957004160888,0.00346740638002774,438,0.30374479889043,1004,0.69625520110957
"E02001674",5,283,829,1218,404,52,15,2806,0.00178189593727726,0.100855310049893,0.29543834640057,0.434069850320741,0.143977191732003,0.0185317177476835,0.00534568781183179,1117,0.398075552387741,1689,0.601924447612259
"E02001675",5,75,1499,1281,155,16,3,3034,0.0016479894528675,0.0247198417930125,0.494067237969677,0.422214897824654,0.0510876730388925,0.005273566249176,0.000988793671720501,1579,0.520435069215557,1455,0.479564930784443
"E02001676",2,34,444,877,260,47,8,1672,0.00119617224880383,0.0203349282296651,0.26555023923445,0.524521531100478,0.155502392344498,0.02811004784689,0.00478468899521531,480,0.287081339712919,1192,0.712918660287081
"E02001678",11,274,1075,1420,474,101,19,3374,0.0032602252519265,0.0812092471843509,0.318612922347362,0.42086544161233,0.140486069946651,0.0299347954949615,0.00563129816241849,1360,0.40308239478364,2014,0.59691760521636
"E02001679",2,101,1290,914,182,19,4,2512,0.000796178343949045,0.0402070063694267,0.513535031847134,0.363853503184713,0.0724522292993631,0.00756369426751592,0.00159235668789809,1393,0.55453821656051,1119,0.44546178343949
"E02001680",3,213,1694,727,127,17,3,2784,0.00107758620689655,0.0765086206896552,0.608477011494253,0.261135057471264,0.045617816091954,0.00610632183908046,0.00107758620689655,1910,0.686063218390805,874,0.313936781609195
"E02001681",2,69,832,1147,285,56,4,2395,0.000835073068893528,0.0288100208768267,0.347390396659708,0.478914405010438,0.118997912317328,0.0233820459290188,0.00167014613778706,903,0.377035490605428,1492,0.622964509394572
"E02001682",36,577,1145,1315,254,36,8,3371,0.010679323642836,0.171165826164343,0.339661821417977,0.39009196084248,0.075348561257787,0.010679323642836,0.00237318303174132,1758,0.521506971225156,1613,0.478493028774844
"E02001683",17,403,870,1422,382,46,14,3154,0.00538998097653773,0.127774254914394,0.275840202916931,0.450856055802156,0.121116043119848,0.0145846544071021,0.00443880786303107,1290,0.409004438807863,1864,0.590995561192137
"E02001684",10,323,1083,1352,292,55,4,3119,0.00320615581917281,0.103558832959282,0.347226675216416,0.433472266752164,0.0936197499198461,0.0176338570054505,0.00128246232766912,1416,0.45399166399487,1703,0.54600833600513
"E02001685",7,300,1247,1203,320,37,9,3123,0.00224143451809158,0.0960614793467819,0.399295549151457,0.385206532180596,0.102465577969901,0.0118475824527698,0.00288184438040346,1554,0.49759846301633,1569,0.50240153698367
"E02001686",1,166,635,1083,250,34,6,2175,0.000459770114942529,0.0763218390804598,0.291954022988506,0.497931034482759,0.114942528735632,0.015632183908046,0.00275862068965517,802,0.368735632183908,1373,0.631264367816092
"E02001688",2,560,1863,1106,141,23,4,3699,0.000540686672073533,0.151392268180589,0.503649635036496,0.298999729656664,0.0381184103811841,0.00621789672884563,0.00108137334414707,2425,0.655582589889159,1274,0.344417410110841
"E02001689",0,46,1347,1363,492,61,17,3326,0,0.0138304269392664,0.404990980156344,0.409801563439567,0.14792543595911,0.018340348767288,0.00511124473842453,1393,0.41882140709561,1933,0.58117859290439
"E02001690",1,84,975,1183,261,31,3,2538,0.000394011032308905,0.033096926713948,0.384160756501182,0.466115051221434,0.102836879432624,0.012214342001576,0.00118203309692671,1060,0.417651694247439,1478,0.582348305752561
"E02001691",1,372,1201,1942,688,82,14,4300,0.000232558139534884,0.0865116279069767,0.279302325581395,0.451627906976744,0.16,0.0190697674418605,0.00325581395348837,1574,0.366046511627907,2726,0.633953488372093
"E02001692",0,111,975,1017,153,15,0,2271,0,0.0488771466314399,0.429326287978864,0.44782034346103,0.0673712021136063,0.00660501981505945,0,1086,0.478203434610304,1185,0.521796565389696
"E02001693",0,47,793,1018,176,19,5,2058,0,0.0228377065111759,0.385325558794947,0.494655004859086,0.0855199222546161,0.00923226433430515,0.00242954324586978,840,0.408163265306122,1218,0.591836734693878
"E02001694",9,107,610,968,247,22,9,1972,0.00456389452332657,0.0542596348884381,0.309330628803245,0.490872210953347,0.12525354969574,0.0111561866125761,0.00456389452332657,726,0.36815415821501,1246,0.63184584178499
"E02001695",7,124,690,772,136,16,0,1745,0.00401146131805158,0.0710601719197708,0.39541547277937,0.442406876790831,0.0779369627507163,0.00916905444126074,0,821,0.470487106017192,924,0.529512893982808
"E02001696",3,121,1045,1624,292,33,3,3121,0.000961230374879846,0.0387696251201538,0.334828580583146,0.520346042934957,0.093559756488305,0.0105735341236783,0.000961230374879846,1169,0.37455943607818,1952,0.62544056392182
"E02001697",0,37,788,1275,376,71,10,2557,0,0.0144700821274932,0.30817364098553,0.498631208447399,0.14704732107939,0.0277669143527571,0.00391083300743058,825,0.322643723113023,1732,0.677356276886977
"E02001698",2,68,690,981,168,10,2,1921,0.00104112441436752,0.0353982300884956,0.359187922956793,0.510671525247267,0.0874544508068714,0.00520562207183758,0.00104112441436752,760,0.395627277459656,1161,0.604372722540344
"E02001699",1,106,921,1031,139,10,3,2211,0.000452284034373587,0.0479421076436002,0.416553595658073,0.466304839439168,0.0628674807779285,0.00452284034373587,0.00135685210312076,1028,0.464947987336047,1183,0.535052012663953
"E02001700",0,290,1054,1430,300,50,5,3129,0,0.0926813678491531,0.336848833493129,0.45701502077341,0.0958772770853308,0.0159795461808885,0.00159795461808885,1344,0.429530201342282,1785,0.570469798657718
"E02001701",1,75,529,911,313,43,6,1878,0.00053248136315229,0.0399361022364217,0.281682641107561,0.485090521831736,0.166666666666667,0.0228966986155485,0.00319488817891374,605,0.322151224707135,1273,0.677848775292865
"E02001702",0,113,1261,1127,318,26,2,2847,0,0.0396909027046013,0.442922374429224,0.395855286266245,0.111696522655427,0.0091324200913242,0.000702493853178785,1374,0.482613277133825,1473,0.517386722866175
"E02001703",0,80,454,783,196,32,10,1555,0,0.0514469453376206,0.291961414790997,0.503536977491961,0.12604501607717,0.0205787781350482,0.00643086816720257,534,0.343408360128617,1021,0.656591639871383
"E02001704",0,75,1459,902,174,15,4,2629,0,0.0285279573982503,0.554963864587296,0.343096234309623,0.0661848611639407,0.00570559147965006,0.00152149106124002,1534,0.583491821985546,1095,0.416508178014454
"E02001706",2,423,1179,864,162,31,11,2672,0.000748502994011976,0.158308383233533,0.44124251497006,0.323353293413174,0.0606287425149701,0.0116017964071856,0.00411676646706587,1604,0.600299401197605,1068,0.399700598802395
"E02001707",0,177,1090,1148,232,29,10,2686,0,0.0658972449739389,0.405807892777364,0.427401340282949,0.0863737900223381,0.0107967237527923,0.00372300819061802,1267,0.471705137751303,1419,0.528294862248697
"E02001709",3,184,1931,1432,285,50,11,3896,0.000770020533880904,0.0472279260780287,0.495636550308008,0.367556468172485,0.0731519507186858,0.0128336755646817,0.00282340862422998,2118,0.543634496919918,1778,0.456365503080082
"E02001710",0,393,1504,1451,395,53,2,3798,0,0.10347551342812,0.395997893628225,0.38204318062138,0.104002106371775,0.0139547130068457,0.000526592943654555,1897,0.499473407056345,1901,0.500526592943655
"E02001711",162,1127,1241,1472,336,32,8,4378,0.0370031978072179,0.257423481041571,0.283462768387391,0.336226587482869,0.0767473732297853,0.00730927364093193,0.00182731841023298,2530,0.577889447236181,1848,0.422110552763819
"E02001712",1,156,1192,1668,493,75,13,3598,0.000277932184546971,0.0433574207893274,0.331295163979989,0.463590883824347,0.137020566981656,0.0208449138410228,0.00361311839911062,1349,0.374930516953863,2249,0.625069483046137
"E02001713",4,148,1351,1671,534,78,11,3797,0.00105346326046879,0.0389781406373453,0.355807216223334,0.440084277060838,0.140637345272584,0.0205425335791414,0.00289702396628918,1503,0.395838820121148,2294,0.604161179878852
"E02001714",4,220,1081,1331,261,30,7,2934,0.00136332651670075,0.0749829584185412,0.368438991138378,0.453646898432174,0.0889570552147239,0.0102249488752556,0.00238582140422631,1305,0.44478527607362,1629,0.55521472392638
"E02001715",2,263,1499,1891,464,37,7,4163,0.000480422772039395,0.0631755945231804,0.360076867643526,0.454239730963248,0.11145808311314,0.0088878212827288,0.00168147970213788,1764,0.423732884938746,2399,0.576267115061254
"E02001718",4,734,888,690,122,12,2,2452,0.00163132137030995,0.299347471451876,0.362153344208809,0.281402936378467,0.0497553017944535,0.00489396411092985,0.000815660685154976,1626,0.663132137030995,826,0.336867862969005
"E02001719",0,36,871,1390,368,55,6,2726,0,0.0132061628760088,0.31951577402788,0.509904622157007,0.134996331621423,0.0201760821716801,0.00220102714600147,907,0.332721936903888,1819,0.667278063096111
"E02001720",0,109,1058,1794,619,55,9,3644,0,0.0299121844127333,0.290340285400659,0.49231613611416,0.1698682766191,0.0150933040614709,0.00246981339187706,1167,0.320252469813392,2477,0.679747530186608
"E02001721",12,991,1468,1482,300,41,7,4301,0.00279004882585445,0.230411532201814,0.341315973029528,0.344571029993025,0.0697512206463613,0.00953266682166938,0.00162752848174843,2471,0.574517554057196,1830,0.425482445942804
"E02001722",44,276,1448,1272,320,41,2,3403,0.0129297678518954,0.0811049074346165,0.425506905671466,0.373787834263885,0.0940346752865119,0.0120481927710843,0.000587716720540699,1768,0.519541580957978,1635,0.480458419042022
"E02001723",0,307,742,1069,249,32,4,2403,0,0.1277569704536,0.308780690803163,0.444860590928007,0.103620474406991,0.0133166874739908,0.00166458593424886,1049,0.436537661256762,1354,0.563462338743238
"E02001724",1,180,1626,1773,608,66,4,4258,0.000234852043212776,0.0422733677782997,0.381869422263974,0.416392672616252,0.142790042273368,0.0155002348520432,0.000939408172851104,1807,0.424377642085486,2451,0.575622357914514
"E02001725",46,134,1837,2422,636,36,6,5117,0.00898964236857534,0.026187219073676,0.358999413718976,0.473324213406293,0.124291577095955,0.00703537228845026,0.00117256204807504,2017,0.394176275161227,3100,0.605823724838773
"E02001726",16,366,1356,1666,367,40,8,3819,0.00418957842367112,0.0958366064414768,0.355066771406127,0.436239853364755,0.0960984550929563,0.0104739460591778,0.00209478921183556,1738,0.455092956271275,2081,0.544907043728725
"E02001727",12,275,1025,1488,388,50,11,3249,0.00369344413665743,0.0846414281317328,0.315481686672822,0.457987072945522,0.11942136041859,0.015389350569406,0.00338565712526931,1312,0.403816558941213,1937,0.596183441058787
"E02001728",11,161,1197,1510,308,44,6,3237,0.00339820821748533,0.0497374111831943,0.369786839666358,0.466481309854804,0.0951498300895891,0.0135928328699413,0.00185356811862836,1369,0.422922459067037,1868,0.577077540932963
"E02001729",2,45,1682,2580,631,98,11,5049,0.000396118043176867,0.0089126559714795,0.333135274311745,0.510992275698158,0.124975242622301,0.0194097841156665,0.00217864923747277,1729,0.342444048326401,3320,0.657555951673599
"E02001732",37,621,637,833,166,15,4,2313,0.0159965412883701,0.268482490272374,0.275399913532209,0.360138348465197,0.0717682663207955,0.00648508430609598,0.00172935581495893,1295,0.559878945092953,1018,0.440121054907047
"E02001734",2,503,1339,1180,378,32,9,3443,0.000580888759802498,0.146093523090328,0.388905024687772,0.342724368283474,0.109787975602672,0.00929422015683997,0.00261399941911124,1844,0.535579436537903,1599,0.464420563462097
"E02001735",1,107,1112,1077,222,18,3,2540,0.000393700787401575,0.0421259842519685,0.437795275590551,0.424015748031496,0.0874015748031496,0.00708661417322835,0.00118110236220472,1220,0.480314960629921,1320,0.519685039370079
"E02001737",25,472,1081,803,221,18,3,2623,0.00953107129241327,0.179946626000762,0.41212352268395,0.306138009912314,0.0842546702249333,0.00686237133053755,0.00114372855508959,1578,0.601601219977125,1045,0.398398780022875
"E02001738",1,236,418,815,189,41,6,1706,0.000586166471277843,0.138335287221571,0.245017584994138,0.477725674091442,0.110785463071512,0.0240328253223916,0.00351699882766706,655,0.383939038686987,1051,0.616060961313013
"E02001739",7,257,1097,1169,239,44,1,2814,0.00248756218905473,0.0913290689410092,0.389836531627576,0.415422885572139,0.0849324804548685,0.015636105188344,0.000355366027007818,1361,0.48365316275764,1453,0.51634683724236
"E02001740",0,45,399,830,253,56,6,1589,0,0.0283196979232222,0.251101321585903,0.52234109502832,0.15921963499056,0.0352422907488987,0.00377595972309629,444,0.279421019509125,1145,0.720578980490875
"E02001741",9,720,876,1203,258,31,6,3103,0.0029004189494038,0.232033515952304,0.282307444408637,0.387689332903642,0.0831453432162423,0.00999033193683532,0.00193361263293587,1605,0.517241379310345,1498,0.482758620689655
"E02001742",2,23,672,911,232,26,2,1868,0.00107066381156317,0.0123126338329764,0.359743040685225,0.487687366167024,0.124197002141328,0.0139186295503212,0.00107066381156317,697,0.373126338329764,1171,0.626873661670236
"E02001743",1,112,824,1346,543,71,15,2912,0.000343406593406593,0.0384615384615385,0.282967032967033,0.462225274725275,0.18646978021978,0.0243818681318681,0.0051510989010989,937,0.321771978021978,1975,0.678228021978022
"E02001744",2,669,1403,928,195,23,4,3224,0.000620347394540943,0.207506203473945,0.435173697270471,0.287841191066998,0.0604838709677419,0.00713399503722084,0.00124069478908189,2074,0.643300248138958,1150,0.356699751861042
"E02001745",18,335,900,979,149,16,5,2402,0.00749375520399667,0.139467110741049,0.374687760199833,0.407577019150708,0.0620316402997502,0.00666111573688593,0.00208159866777685,1253,0.521648626144879,1149,0.478351373855121
"E02001746",1,181,1016,1265,320,44,7,2834,0.000352858151023289,0.0638673253352152,0.358503881439661,0.44636556104446,0.112914608327452,0.0155257586450247,0.00247000705716302,1198,0.4227240649259,1636,0.5772759350741
"E02001747",2,81,524,1054,285,41,6,1993,0.00100351229302559,0.0406422478675364,0.262920220772704,0.528850978424486,0.143000501756147,0.0205720020070246,0.00301053687907677,607,0.304565980933266,1386,0.695434019066734
"E02001748",3,674,1498,897,132,14,2,3220,0.00093167701863354,0.209316770186335,0.465217391304348,0.278571428571429,0.0409937888198758,0.00434782608695652,0.00062111801242236,2175,0.675465838509317,1045,0.324534161490683
"E02001749",3,367,875,862,357,38,5,2507,0.00119664938173115,0.146390107698444,0.349022736338253,0.343837255684085,0.142401276426007,0.0151575588352613,0.00199441563621859,1245,0.496609493418428,1262,0.503390506581572
"E02001750",63,305,816,917,244,11,2,2358,0.0267175572519084,0.129346904156064,0.346055979643766,0.388888888888889,0.103477523324852,0.00466497031382528,0.000848176420695505,1184,0.502120441051739,1174,0.497879558948261
"E02001751",0,458,846,1014,193,30,8,2549,0,0.179678305217732,0.331894860729698,0.397803060023539,0.0757159670459003,0.0117693213024716,0.00313848568065908,1304,0.51157316594743,1245,0.48842683405257
"E02001752",27,279,1152,748,110,10,1,2327,0.0116029222174474,0.119896862913623,0.495058014611087,0.321443919209282,0.0472711645896003,0.00429737859905458,0.000429737859905458,1458,0.626557799742157,869,0.373442200257843
"E02001753",4,231,1173,1133,380,65,7,2993,0.00133645172068159,0.0771800868693618,0.391914467089876,0.37854994988306,0.126962913464751,0.0217173404610758,0.00233879051119278,1408,0.47043100567992,1585,0.52956899432008
"E02001754",3,157,608,1162,360,51,5,2346,0.00127877237851662,0.06692242114237,0.259164535379369,0.495311167945439,0.153452685421995,0.0217391304347826,0.00213128729752771,768,0.327365728900256,1578,0.672634271099744
"E02001755",4,849,1095,1202,303,42,4,3499,0.00114318376679051,0.242640754501286,0.312946556158903,0.343526721920549,0.0865961703343812,0.0120034295513004,0.00114318376679051,1948,0.556730494426979,1551,0.443269505573021
"E02001756",9,284,2195,1245,204,8,2,3947,0.00228021281986319,0.0719533823156828,0.556118571066633,0.315429440081074,0.0516848239168989,0.00202685583987839,0.000506713959969597,2488,0.630352166202179,1459,0.369647833797821
"E02001757",2,45,801,930,168,24,5,1975,0.0010126582278481,0.0227848101265823,0.405569620253165,0.470886075949367,0.0850632911392405,0.0121518987341772,0.00253164556962025,848,0.429367088607595,1127,0.570632911392405
"E02001758",14,224,955,481,59,4,1,1738,0.00805523590333717,0.128883774453395,0.549482163406214,0.276754890678941,0.0339470655926352,0.00230149597238205,0.000575373993095512,1193,0.686421173762946,545,0.313578826237054
"E02001759",2,164,1391,1377,446,67,16,3463,0.000577533930118394,0.0473577822697083,0.401674848397343,0.397632110886515,0.128790066416402,0.0193473866589662,0.00462027144094716,1557,0.44961016459717,1906,0.55038983540283
"E02001760",71,394,1544,1319,167,21,1,3517,0.0201876599374467,0.112027295990901,0.439010520329827,0.375035541654819,0.0474836508387831,0.00597099800966733,0.000284333238555587,2009,0.571225476258175,1508,0.428774523741825
"E02001761",15,210,861,645,101,17,3,1852,0.00809935205183585,0.113390928725702,0.464902807775378,0.348272138228942,0.0545356371490281,0.0091792656587473,0.00161987041036717,1086,0.586393088552916,766,0.413606911447084
"E02001762",27,613,1090,755,139,9,4,2637,0.0102389078498294,0.232461130072052,0.413348502085703,0.286310200985969,0.0527114144861585,0.00341296928327645,0.00151687523701176,1730,0.656048540007584,907,0.343951459992416
"E02001763",0,156,1237,980,139,15,3,2530,0,0.0616600790513834,0.488932806324111,0.387351778656126,0.0549407114624506,0.00592885375494071,0.00118577075098814,1393,0.550592885375494,1137,0.449407114624506
"E02001764",3,382,2064,1248,228,31,6,3962,0.000757193336698637,0.0964159515396265,0.520949015648662,0.314992428066633,0.0575466935890964,0.00782433114588592,0.00151438667339727,2449,0.618122160524987,1513,0.381877839475013
"E02001765",0,360,1926,1048,220,30,11,3595,0,0.100139082058414,0.535744089012517,0.291515994436718,0.0611961057023644,0.00834492350486787,0.00305980528511822,2286,0.635883171070932,1309,0.364116828929068
"E02001766",25,288,1424,1407,312,40,9,3505,0.00713266761768902,0.0821683309557775,0.406276747503566,0.401426533523538,0.0890156918687589,0.0114122681883024,0.00256776034236805,1737,0.495577746077033,1768,0.504422253922967
"E02001767",106,109,1182,1349,296,39,10,3091,0.0342931090262051,0.035263668715626,0.382400517631834,0.436428340342931,0.0957618893561954,0.0126172759624717,0.00323519896473633,1397,0.451957295373665,1694,0.548042704626335
"E02001768",1,160,1404,1275,469,61,7,3377,0.000296120817293456,0.0473793307669529,0.415753627480012,0.377554042049156,0.138880663310631,0.0180633698549008,0.00207284572105419,1565,0.463429079064258,1812,0.536570920935742
"E02001769",36,540,2013,1545,357,46,19,4556,0.00790166812993854,0.118525021949078,0.441834942932397,0.339113257243196,0.0783582089552239,0.0100965759438104,0.00417032484635645,2589,0.568261633011414,1967,0.431738366988586
"E02001770",1,39,866,1292,419,56,6,2679,0.000373273609555804,0.0145576707726764,0.323254945875327,0.482269503546099,0.156401642403882,0.020903322135125,0.00223964165733483,906,0.338185890257559,1773,0.661814109742441
"E02001771",18,337,899,1130,211,18,2,2615,0.00688336520076482,0.12887189292543,0.343785850860421,0.432122370936902,0.0806883365200765,0.00688336520076482,0.000764818355640535,1254,0.479541108986616,1361,0.520458891013384
"E02001772",1,108,678,1022,277,29,8,2123,0.000471031559114461,0.0508714083843618,0.319359397079604,0.481394253414979,0.130475741874706,0.0136599152143194,0.00376825247291569,787,0.370701837023081,1336,0.629298162976919
"E02001773",0,7,312,873,239,41,6,1478,0,0.0047361299052774,0.211096075778078,0.590663058186739,0.1617050067659,0.0277401894451962,0.0040595399188092,319,0.215832205683356,1159,0.784167794316644
"E02001774",14,157,1273,893,245,39,6,2627,0.00532927293490674,0.0597639893414541,0.48458317472402,0.339931480776551,0.0932622763608679,0.0148458317472402,0.00228397411496003,1444,0.549676437000381,1183,0.450323562999619
"E02001775",0,108,932,1057,147,7,3,2254,0,0.0479148181011535,0.413487133984028,0.468944099378882,0.0652173913043478,0.0031055900621118,0.00133096716947649,1040,0.461401952085182,1214,0.538598047914818
"E02001776",15,772,1438,1486,303,34,5,4053,0.00370096225018505,0.19047619047619,0.354798914384407,0.366641993584999,0.074759437453738,0.00838884776708611,0.00123365408339502,2225,0.548976067110782,1828,0.451023932889218
"E02001777",3,424,1093,902,239,29,0,2690,0.00111524163568773,0.157620817843866,0.40631970260223,0.335315985130112,0.0888475836431227,0.0107806691449814,0,1520,0.565055762081784,1170,0.434944237918216
"E02001778",2,140,1158,1124,251,23,6,2704,0.000739644970414201,0.0517751479289941,0.428254437869822,0.415680473372781,0.0928254437869823,0.00850591715976331,0.0022189349112426,1300,0.480769230769231,1404,0.519230769230769
"E02001779",8,327,950,1032,142,12,2,2473,0.00323493732308936,0.132228063081278,0.384148807116862,0.417306914678528,0.0574201374848362,0.00485240598463405,0.000808734330772341,1285,0.519611807521229,1188,0.480388192478771
"E02001780",2,339,1039,1154,202,28,1,2765,0.000723327305605787,0.122603978300181,0.375768535262206,0.417359855334539,0.0730560578661845,0.010126582278481,0.000361663652802893,1380,0.499095840867993,1385,0.500904159132007
"E02001781",1,82,1056,1319,205,24,2,2689,0.000371885459278542,0.0304946076608405,0.392711044998141,0.490516920788397,0.0762365191521012,0.00892525102268501,0.000743770918557084,1139,0.42357753811826,1550,0.57642246188174
"E02001782",13,607,1420,1668,206,12,3,3929,0.00330872995673199,0.154492237210486,0.361415118350725,0.424535505217613,0.0524306439297531,0.00305421226775261,0.000763553066938152,2040,0.519216085517944,1889,0.480783914482056
"E02001783",11,76,1740,1141,169,10,2,3149,0.00349317243569387,0.0241346459193395,0.552556367100667,0.36233724992061,0.0536678310574786,0.00317561130517625,0.000635122261035249,1827,0.5801841854557,1322,0.4198158145443
"E02001784",1,139,655,1477,292,24,1,2589,0.000386249517188104,0.0536886828891464,0.252993433758208,0.570490536886829,0.112784859018926,0.00926998841251448,0.000386249517188104,795,0.307068366164542,1794,0.692931633835458
"E02001785",1,303,1035,1585,299,32,12,3267,0.000306091215182124,0.0927456382001837,0.316804407713499,0.485154576063667,0.0915212733394552,0.00979491888582798,0.00367309458218549,1339,0.409856137128864,1928,0.590143862871136
"E02001786",0,82,1110,1443,125,11,2,2773,0,0.0295708618824378,0.400288496213487,0.520375045077533,0.0450775333573747,0.00396682293544897,0.000721240533717995,1192,0.429859358095925,1581,0.570140641904075
"E02001787",7,60,699,967,172,20,3,1928,0.00363070539419087,0.0311203319502075,0.362551867219917,0.50155601659751,0.0892116182572614,0.0103734439834025,0.00155601659751037,766,0.397302904564315,1162,0.602697095435685
"E02001788",2,127,873,963,166,27,7,2165,0.00092378752886836,0.0586605080831409,0.403233256351039,0.444803695150115,0.0766743648960739,0.0124711316397229,0.00323325635103926,1002,0.462817551963048,1163,0.537182448036951
"E02001789",0,79,392,826,217,39,8,1561,0,0.0506085842408712,0.251121076233184,0.52914798206278,0.139013452914798,0.0249839846252402,0.0051249199231262,471,0.301729660474055,1090,0.698270339525945
"E02001790",6,145,688,870,248,31,6,1994,0.00300902708124373,0.0727181544633902,0.345035105315948,0.436308926780341,0.124373119358074,0.0155466399197593,0.00300902708124373,839,0.420762286860582,1155,0.579237713139418
"E02001791",0,29,300,795,242,22,6,1394,0,0.0208034433285509,0.215208034433286,0.570301291248207,0.173601147776184,0.0157819225251076,0.00430416068866571,329,0.236011477761836,1065,0.763988522238163
"E02001792",1,188,409,1043,440,48,5,2134,0.000468603561387067,0.0880974695407685,0.19165885660731,0.48875351452671,0.206185567010309,0.0224929709465792,0.00234301780693533,598,0.280224929709466,1536,0.719775070290534
"E02001793",133,286,2066,1341,191,20,0,4037,0.0329452563784989,0.0708446866485014,0.511766162992321,0.332177359425316,0.0473123606638593,0.00495417389150359,0,2485,0.615556106019321,1552,0.384443893980679
"E02001794",36,490,1544,1418,179,16,2,3685,0.00976933514246947,0.132971506105834,0.418995929443691,0.384803256445047,0.0485753052917232,0.00434192672998643,0.000542740841248304,2070,0.561736770691995,1615,0.438263229308005
"E02001795",9,472,939,1355,603,74,17,3469,0.00259440761026232,0.136062265782646,0.270683194004036,0.390602479100605,0.173825309887576,0.0213317959066013,0.00490054770827328,1420,0.409339867396944,2049,0.590660132603056
"E02001796",1,150,1289,1844,600,58,20,3962,0.000252397778899546,0.0378596668349319,0.325340737001514,0.465421504290762,0.151438667339727,0.0146390711761737,0.00504795557799091,1440,0.363452801615346,2522,0.636547198384654
"E02001797",3,152,775,770,165,12,2,1879,0.00159659393294305,0.0808940926024481,0.412453432676956,0.409792442788717,0.087812666311868,0.00638637573177222,0.00106439595529537,930,0.494944119212347,949,0.505055880787653
"E02001798",32,252,1228,1239,260,18,9,3038,0.010533245556287,0.0829493087557604,0.404213298222515,0.407834101382488,0.0855826201448321,0.00592495062541146,0.00296247531270573,1512,0.497695852534562,1526,0.502304147465438
"E02001799",0,254,1937,1887,260,29,8,4375,0,0.0580571428571429,0.442742857142857,0.431314285714286,0.0594285714285714,0.00662857142857143,0.00182857142857143,2191,0.5008,2184,0.4992
"E02001800",28,257,1251,889,123,40,1,2589,0.0108149864812669,0.0992661259173426,0.483198146002317,0.343375820780224,0.0475086906141367,0.0154499806875241,0.000386249517188104,1536,0.593279258400927,1053,0.406720741599073
"E02001801",0,93,424,1129,652,80,22,2400,0,0.03875,0.176666666666667,0.470416666666667,0.271666666666667,0.0333333333333333,0.00916666666666667,517,0.215416666666667,1883,0.784583333333333
"E02001802",53,572,1186,1277,207,14,1,3310,0.016012084592145,0.172809667673716,0.358308157099698,0.385800604229607,0.0625377643504532,0.00422960725075529,0.000302114803625378,1811,0.547129909365559,1499,0.452870090634441
"E02001803",22,442,2241,1960,833,118,34,5650,0.00389380530973451,0.0782300884955752,0.396637168141593,0.346902654867257,0.147433628318584,0.0208849557522124,0.00601769911504425,2705,0.478761061946903,2945,0.521238938053097
"E02001804",24,219,949,951,155,18,6,2322,0.0103359173126615,0.0943152454780362,0.40869939707149,0.409560723514212,0.0667527993109388,0.00775193798449612,0.00258397932816537,1192,0.513350559862188,1130,0.486649440137812
"E02001805",1,8,297,1023,432,49,8,1818,0.00055005500550055,0.0044004400440044,0.163366336633663,0.562706270627063,0.237623762376238,0.026952695269527,0.0044004400440044,306,0.168316831683168,1512,0.831683168316832
"E02001806",1,476,2081,1635,870,120,43,5226,0.000191350937619594,0.0910830463069269,0.398201301186376,0.312858783008037,0.166475315729047,0.0229621125143513,0.00822809031764256,2558,0.489475698430922,2668,0.510524301569078
"E02001807",9,580,1325,1186,160,16,4,3280,0.00274390243902439,0.176829268292683,0.403963414634146,0.361585365853659,0.0487804878048781,0.0048780487804878,0.00121951219512195,1914,0.583536585365854,1366,0.416463414634146
"E02001808",0,12,318,1081,563,66,16,2056,0,0.00583657587548638,0.154669260700389,0.525778210116732,0.273832684824903,0.0321011673151751,0.00778210116731518,330,0.160505836575875,1726,0.839494163424125
"E02001809",5,219,841,1008,136,11,3,2223,0.00224921277552856,0.0985155195681511,0.378317588843905,0.453441295546559,0.061178587494377,0.00494826810616284,0.00134952766531714,1065,0.479082321187584,1158,0.520917678812416
"E02001810",10,320,1681,859,78,5,0,2953,0.00338638672536404,0.108364375211649,0.569251608533694,0.290890619708771,0.0264138164578395,0.00169319336268202,0,2011,0.681002370470708,942,0.318997629529292
"E02001811",10,434,1758,1496,206,13,1,3918,0.00255232261357836,0.110770801429301,0.448698315467075,0.381827462991322,0.0525778458397141,0.00331801939765186,0.000255232261357836,2202,0.562021439509954,1716,0.437978560490046
"E02001812",5,77,679,1470,497,74,6,2808,0.00178062678062678,0.0274216524216524,0.241809116809117,0.523504273504274,0.176994301994302,0.0263532763532764,0.00213675213675214,761,0.271011396011396,2047,0.728988603988604
"E02001813",2,103,1645,2263,259,13,3,4288,0.000466417910447761,0.0240205223880597,0.383628731343284,0.527751865671642,0.0604011194029851,0.00303171641791045,0.000699626865671642,1750,0.408115671641791,2538,0.591884328358209
"E02001814",1,69,729,1116,258,30,5,2208,0.000452898550724638,0.03125,0.330163043478261,0.505434782608696,0.116847826086957,0.0135869565217391,0.00226449275362319,799,0.361865942028985,1409,0.638134057971015
"E02001815",4,193,1468,1300,187,18,3,3173,0.00126063662149385,0.0608257169870785,0.462653640088245,0.409706901985503,0.0589347620548377,0.00567286479672234,0.000945477466120391,1665,0.524739993696817,1508,0.475260006303183
"E02001816",1,530,1280,1163,189,11,1,3175,0.00031496062992126,0.166929133858268,0.403149606299213,0.366299212598425,0.0595275590551181,0.00346456692913386,0.00031496062992126,1811,0.570393700787402,1364,0.429606299212598
"E02001817",1,684,719,957,274,39,5,2679,0.000373273609555804,0.25531914893617,0.268383725270623,0.357222844344905,0.10227696901829,0.0145576707726764,0.00186636804777902,1404,0.524076147816349,1275,0.475923852183651
"E02001818",114,788,1117,1441,251,30,5,3746,0.0304324612920448,0.210357714895889,0.298184730379071,0.384676988788041,0.0670048051254672,0.00800854244527496,0.00133475707421249,2019,0.538974906567005,1727,0.461025093432995
"E02001819",6,400,586,1063,250,27,6,2338,0.00256629597946963,0.171086398631309,0.250641573994867,0.454662104362703,0.106928999144568,0.0115483319076133,0.00256629597946963,992,0.424294268605646,1346,0.575705731394354
"E02001820",37,811,1073,1508,265,40,2,3736,0.00990364025695931,0.217077087794433,0.28720556745182,0.403640256959315,0.07093147751606,0.0107066381156317,0.000535331905781585,1921,0.514186295503212,1815,0.485813704496788
"E02001821",42,565,659,795,95,10,6,2172,0.0193370165745856,0.260128913443831,0.303406998158379,0.366022099447514,0.0437384898710866,0.00460405156537753,0.00276243093922652,1266,0.582872928176795,906,0.417127071823204
"E02001822",3,380,656,1214,333,70,21,2677,0.00112065745237206,0.141949943967127,0.245050429585357,0.45349271572656,0.124392977213298,0.0261486738886814,0.00784460216660441,1039,0.388121031004856,1638,0.611878968995144
"E02001823",78,1034,1059,1071,290,27,7,3566,0.0218732473359506,0.289960740325294,0.296971396522715,0.300336511497476,0.0813236118900729,0.00757150869321368,0.00196298373527762,2171,0.60880538418396,1395,0.39119461581604
"E02001824",32,278,1101,1426,340,34,5,3216,0.00995024875621891,0.0864427860696517,0.342350746268657,0.443407960199005,0.105721393034826,0.0105721393034826,0.0015547263681592,1411,0.438743781094527,1805,0.561256218905473
"E02001825",4,826,874,1303,349,46,19,3421,0.00116924875767319,0.241449868459515,0.255480853551593,0.380882782812043,0.102016954106986,0.0134463607132417,0.00555393159894768,1704,0.498099970768781,1717,0.501900029231219
"E02001826",15,358,1224,1265,278,35,10,3185,0.00470957613814757,0.112401883830455,0.384301412872841,0.397174254317111,0.0872841444270016,0.010989010989011,0.00313971742543171,1597,0.501412872841444,1588,0.498587127158556
"E02001827",2,95,755,898,234,52,9,2045,0.00097799511002445,0.0464547677261614,0.36919315403423,0.439119804400978,0.114425427872861,0.0254278728606357,0.00440097799511002,852,0.416625916870416,1193,0.583374083129584
"E02001828",2,132,715,1136,518,99,17,2619,0.000763650248186331,0.0504009163802978,0.273004963726613,0.433753340969836,0.19778541428026,0.0378006872852234,0.00649102710958381,849,0.324169530355097,1770,0.675830469644903
"E02001829",4,115,941,1207,406,66,9,2748,0.00145560407569141,0.0418486171761281,0.342430858806405,0.439228529839884,0.147743813682678,0.0240174672489083,0.00327510917030568,1060,0.385735080058224,1688,0.614264919941776
"E02001830",3,230,863,1294,617,151,13,3171,0.000946073793755913,0.0725323241879533,0.272153894670451,0.40807316304005,0.194575843582466,0.0476190476190476,0.00409965310627562,1096,0.34563229265216,2075,0.65436770734784
"E02001831",39,314,1693,1515,340,54,4,3959,0.0098509724677949,0.0793129578176307,0.427633240717353,0.382672392018186,0.0858802727961606,0.0136398080323314,0.00101035615054307,2046,0.516797171002778,1913,0.483202828997222
"E02001832",1,89,950,1130,310,48,11,2539,0.000393855848759354,0.0350531705395825,0.374163056321386,0.44505710909807,0.1220953131154,0.018905080740449,0.00433241433635289,1040,0.409610082709728,1499,0.590389917290272
"E02001833",1,8,226,857,428,70,13,1603,0.000623830318153462,0.0049906425452277,0.140985651902682,0.534622582657517,0.266999376169682,0.0436681222707424,0.00810979413599501,235,0.146600124766064,1368,0.853399875233936
"E02001834",3,21,481,1040,263,51,36,1895,0.00158311345646438,0.0110817941952507,0.253825857519789,0.548812664907652,0.138786279683377,0.0269129287598945,0.0189973614775726,505,0.266490765171504,1390,0.733509234828496
"E02001835",1,231,844,1208,688,182,21,3175,0.00031496062992126,0.072755905511811,0.265826771653543,0.380472440944882,0.216692913385827,0.0573228346456693,0.00661417322834646,1076,0.338897637795276,2099,0.661102362204724
"E02001836",2,124,545,1316,595,89,13,2684,0.000745156482861401,0.0461997019374069,0.203055141579732,0.490312965722802,0.221684053651267,0.0331594634873323,0.00484351713859911,671,0.25,2013,0.75
"E02001837",4,67,777,1866,454,73,53,3294,0.00121432908318154,0.0203400121432908,0.235883424408015,0.566484517304189,0.137826350941105,0.0221615057680631,0.0160898603521554,848,0.257437765634487,2446,0.742562234365513
"E02001838",2,166,656,1069,282,40,13,2228,0.000897666068222621,0.0745062836624776,0.29443447037702,0.479802513464991,0.12657091561939,0.0179533213644524,0.00583482944344704,824,0.36983842010772,1404,0.63016157989228
"E02001839",0,73,547,1115,403,61,22,2221,0,0.0328680774425934,0.246285457001351,0.5020261143629,0.181449797388564,0.0274651058081945,0.00990544799639802,620,0.279153534443944,1601,0.720846465556056
"E02001840",3,331,1028,1583,396,68,43,3452,0.000869061413673233,0.0958864426419467,0.297798377752028,0.458574739281576,0.114716106604867,0.0196987253765933,0.0124565469293163,1362,0.394553881807648,2090,0.605446118192352
"E02001841",1,112,310,834,419,86,11,1773,0.000564015792442188,0.0631697687535251,0.174844895657078,0.470389170896785,0.236322617033277,0.0485053581500282,0.00620417371686407,423,0.238578680203046,1350,0.761421319796954
"E02001842",9,179,195,1219,577,89,24,2292,0.00392670157068063,0.0780977312390925,0.0850785340314136,0.531849912739965,0.25174520069808,0.0388307155322862,0.0104712041884817,383,0.167102966841187,1909,0.832897033158813
"E02001843",0,29,196,1094,624,104,27,2074,0,0.0139826422372228,0.09450337512054,0.5274831243973,0.300867888138862,0.0501446480231437,0.0130183220829315,225,0.108486017357763,1849,0.891513982642237
"E02001844",9,507,913,1522,961,194,43,4149,0.00216919739696312,0.122198120028923,0.220053024825259,0.366835382019764,0.231622077609062,0.0467582550012051,0.0103639431188238,1429,0.344420342251145,2720,0.655579657748855
"E02001845",0,165,508,1058,274,57,18,2080,0,0.0793269230769231,0.244230769230769,0.508653846153846,0.131730769230769,0.0274038461538462,0.00865384615384615,673,0.323557692307692,1407,0.676442307692308
"E02001846",3,41,618,1485,511,96,33,2787,0.00107642626480086,0.0147111589522784,0.221743810548977,0.532831001076426,0.18335127377108,0.0344456404736276,0.0118406889128095,662,0.237531395766057,2125,0.762468604233943
"E02001847",1,47,593,916,290,44,4,1895,0.000527704485488127,0.024802110817942,0.312928759894459,0.483377308707124,0.153034300791557,0.0232189973614776,0.00211081794195251,641,0.338258575197889,1254,0.661741424802111
"E02001848",14,79,751,1086,356,62,22,2370,0.00590717299578059,0.0333333333333333,0.316877637130802,0.458227848101266,0.150210970464135,0.0261603375527426,0.00928270042194093,844,0.356118143459916,1526,0.643881856540084
"E02001849",4,438,864,1540,818,142,31,3837,0.00104248110502997,0.114151681000782,0.225175918686474,0.401355225436539,0.213187385978629,0.037008079228564,0.00807922856398228,1306,0.340370080792286,2531,0.659629919207714
"E02001850",0,63,323,1268,616,108,43,2421,0,0.0260223048327138,0.133415943824866,0.523750516315572,0.254440313919868,0.0446096654275093,0.0177612556794713,386,0.15943824865758,2035,0.840561751342421
"E02001851",1,298,1228,1400,434,79,15,3455,0.000289435600578871,0.0862518089725036,0.355426917510854,0.40520984081042,0.12561505065123,0.0228654124457308,0.00434153400868307,1527,0.441968162083936,1928,0.558031837916064
"E02001852",0,60,505,1307,634,97,30,2633,0,0.0227876946448918,0.191796429927839,0.496391948347892,0.240789973414356,0.036840106342575,0.0113938473224459,565,0.214584124572731,2068,0.785415875427269
"E02001855",16,269,2311,906,128,18,3,3651,0.00438236099698713,0.0736784442618461,0.632977266502328,0.248151191454396,0.035058887975897,0.00493015612161052,0.000821692686935086,2596,0.711038071761161,1055,0.288961928238839
"E02001856",5,138,632,1613,910,137,60,3495,0.00143061516452074,0.0394849785407725,0.180829756795422,0.461516452074392,0.260371959942775,0.0391988555078684,0.0171673819742489,775,0.221745350500715,2720,0.778254649499285
"E02001857",4,206,1617,2403,1219,230,98,5777,0.00069240090012117,0.0356586463562403,0.279903063873983,0.415959840747793,0.211009174311927,0.0398130517569673,0.0169638220529687,1827,0.316254111130345,3950,0.683745888869655
"E02001858",1,64,1436,1410,619,95,55,3680,0.000271739130434783,0.0173913043478261,0.390217391304348,0.383152173913043,0.16820652173913,0.0258152173913043,0.014945652173913,1501,0.407880434782609,2179,0.592119565217391
"E02001859",1,1022,610,1429,763,97,15,3937,0.000254000508001016,0.259588519177038,0.15494030988062,0.362966725933452,0.193802387604775,0.0246380492760986,0.00381000762001524,1633,0.414782829565659,2304,0.585217170434341
"E02001860",0,61,485,1588,823,91,30,3078,0,0.0198180636777128,0.157569850552307,0.51591942820013,0.267381416504224,0.0295646523716699,0.00974658869395711,546,0.177387914230019,2532,0.822612085769981
"E02001861",41,291,1019,1789,852,112,24,4128,0.00993217054263566,0.0704941860465116,0.246850775193798,0.433381782945736,0.206395348837209,0.0271317829457364,0.00581395348837209,1351,0.327277131782946,2777,0.672722868217054
"E02001862",1,59,919,1716,803,106,37,3641,0.000274649821477616,0.0162043394671793,0.252403185937929,0.471299093655589,0.220543806646526,0.0291128810766273,0.0101620433946718,979,0.268882175226586,2662,0.731117824773414
"E02001863",3,69,952,972,630,64,18,2708,0.00110782865583456,0.025480059084195,0.351550960118168,0.358936484490399,0.232644017725259,0.0236336779911374,0.00664697193500739,1024,0.378138847858198,1684,0.621861152141802
"E02001865",2,68,660,1856,1027,122,39,3774,0.000529941706412295,0.018018018018018,0.174880763116057,0.491785903550609,0.272125066242713,0.03232644409115,0.0103338632750397,730,0.193428722840488,3044,0.806571277159512
"E02001866",0,114,1083,1429,708,91,44,3469,0,0.0328624963966561,0.312193715768233,0.411934275007207,0.204093398673969,0.0262323436148746,0.0126837705390602,1197,0.345056212164889,2272,0.654943787835111
"E02001867",40,344,1257,901,375,65,20,3002,0.0133244503664224,0.114590273151233,0.418720852764823,0.300133244503664,0.12491672218521,0.0216522318454364,0.00666222518321119,1641,0.546635576282478,1361,0.453364423717522
"E02001868",8,61,216,1131,612,108,23,2159,0.00370541917554423,0.0282538212135248,0.100046317739694,0.523853635942566,0.283464566929134,0.0500231588698472,0.0106530801296897,285,0.132005558128763,1874,0.867994441871237
"E02001869",2,219,1527,674,113,14,6,2555,0.000782778864970646,0.0857142857142857,0.597651663405088,0.263796477495108,0.0442270058708415,0.00547945205479452,0.00234833659491194,1748,0.684148727984344,807,0.315851272015656
"E02001870",24,177,506,1613,717,158,66,3261,0.00735970561177553,0.0542778288868445,0.155167126648267,0.494633547991414,0.219871205151794,0.0484513952775222,0.0202391904323827,707,0.216804661146887,2554,0.783195338853113
"E02001871",1,142,1371,1387,357,61,19,3338,0.000299580587177951,0.042540443379269,0.410724985020971,0.415518274415818,0.106950269622528,0.018274415817855,0.00569203115638107,1514,0.453565008987418,1824,0.546434991012582
"E02001872",8,56,1257,1132,195,48,11,2707,0.00295530107129664,0.0206871074990765,0.464351680827484,0.418175101588474,0.0720354636128556,0.0177318064277798,0.00406353897303288,1321,0.487994089397857,1386,0.512005910602143
"E02001873",10,167,1901,2015,637,93,39,4862,0.00205676676264912,0.0343480049362402,0.390991361579597,0.414438502673797,0.131016042780749,0.0191279308926368,0.00802139037433155,2078,0.427396133278486,2784,0.572603866721514
"E02001874",0,46,810,1359,518,60,30,2823,0,0.016294721927028,0.286928799149841,0.481402763018066,0.18349273822175,0.0212539851222104,0.0106269925611052,856,0.303223521076869,1967,0.696776478923131
"E02001875",2,932,2543,1273,387,55,25,5217,0.000383362085489745,0.178646731838221,0.487444891700211,0.244009967414223,0.0741805635422657,0.010542457350968,0.00479202606862181,3477,0.666474985623922,1740,0.333525014376078
"E02001876",0,2530,2615,1437,315,66,8,6971,0,0.362932147468082,0.375125520011476,0.206139721704203,0.0451872041314015,0.00946779515134127,0.00114761153349591,5145,0.738057667479558,1826,0.261942332520442
"E02001877",18,203,642,1396,641,73,23,2996,0.00600801068090788,0.0677570093457944,0.214285714285714,0.465954606141522,0.213951935914553,0.0243658210947931,0.00767690253671562,863,0.288050734312417,2133,0.711949265687583
"E02001878",2,46,1207,1197,449,56,8,2965,0.000674536256323777,0.0155143338954469,0.4070826306914,0.403709949409781,0.151433389544688,0.0188870151770658,0.00269814502529511,1255,0.42327150084317,1710,0.57672849915683
"E02001879",2,710,1115,1570,772,114,34,4317,0.000463284688441047,0.164466064396572,0.258281213805884,0.363678480426222,0.178827889738244,0.0264072272411397,0.0078758397034978,1827,0.423210562890896,2490,0.576789437109104
"E02001880",0,83,972,1361,275,92,41,2824,0,0.0293909348441926,0.344192634560907,0.481940509915014,0.0973796033994334,0.0325779036827195,0.0145184135977337,1055,0.373583569405099,1769,0.626416430594901
"E02001881",2,53,376,1407,567,86,57,2548,0.000784929356357928,0.0208006279434851,0.14756671899529,0.552197802197802,0.222527472527473,0.0337519623233909,0.0223704866562009,431,0.169152276295133,2117,0.830847723704867
"E02001882",15,169,916,1140,548,97,30,2915,0.00514579759862779,0.0579759862778731,0.314236706689537,0.391080617495712,0.187993138936535,0.0332761578044597,0.0102915951972556,1100,0.377358490566038,1815,0.622641509433962
"E02001883",42,163,1286,1650,346,67,29,3583,0.011722020653084,0.0454926039631594,0.358917108568239,0.4605079542283,0.0965671225230254,0.0186994138989673,0.00809377616522467,1491,0.416131733184482,2092,0.583868266815518
"E02001884",1,11,399,1242,589,72,41,2355,0.000424628450106157,0.00467091295116773,0.169426751592357,0.527388535031847,0.250106157112527,0.0305732484076433,0.0174097664543524,411,0.174522292993631,1944,0.825477707006369
"E02001886",1,293,933,1483,736,146,40,3632,0.000275330396475771,0.0806718061674009,0.256883259911894,0.408314977973568,0.202643171806167,0.0401982378854626,0.0110132158590308,1227,0.337830396475771,2405,0.662169603524229
"E02001888",4,363,662,894,226,38,18,2205,0.0018140589569161,0.164625850340136,0.300226757369615,0.405442176870748,0.10249433106576,0.0172335600907029,0.00816326530612245,1029,0.466666666666667,1176,0.533333333333333
"E02001889",0,20,257,1105,647,84,31,2144,0,0.00932835820895522,0.119869402985075,0.515391791044776,0.301772388059701,0.0391791044776119,0.0144589552238806,277,0.12919776119403,1867,0.87080223880597
"E02001890",4,380,1812,2172,984,158,58,5568,0.000718390804597701,0.0682471264367816,0.325431034482759,0.390086206896552,0.176724137931034,0.0283764367816092,0.0104166666666667,2196,0.394396551724138,3372,0.605603448275862
"E02001892",5,41,808,1708,525,61,60,3208,0.00155860349127182,0.0127805486284289,0.251870324189526,0.532418952618454,0.163653366583541,0.0190149625935162,0.0187032418952618,854,0.266209476309227,2354,0.733790523690773
"E02001893",1,69,480,1268,630,113,29,2590,0.000386100386100386,0.0266409266409266,0.185328185328185,0.48957528957529,0.243243243243243,0.0436293436293436,0.0111969111969112,550,0.212355212355212,2040,0.787644787644788
"E02001895",5,309,1019,1299,347,74,33,3086,0.0016202203499676,0.100129617627997,0.330200907323396,0.420933246921581,0.112443292287751,0.0239792611795204,0.0106934543097861,1333,0.431950745301361,1753,0.568049254698639
"E02001896",1,31,388,1183,757,107,40,2507,0.000398883127243718,0.0123653769445552,0.154766653370562,0.471878739529318,0.301954527323494,0.0426804946150778,0.0159553250897487,420,0.167530913442361,2087,0.832469086557639
"E02001897",12,426,1907,1067,361,101,17,3891,0.0030840400925212,0.109483423284503,0.490105371369828,0.274222564893344,0.0927782061166795,0.0259573374453868,0.00436905679773837,2345,0.602672834746852,1546,0.397327165253148
"E02001898",0,15,244,1018,504,83,27,1891,0,0.00793231094658911,0.129032258064516,0.538339502908514,0.266525647805394,0.0438921205711264,0.0142781597038604,259,0.136964569011105,1632,0.863035430988895
"E02001899",4,458,616,1209,658,115,11,3071,0.00130250732660371,0.149137088896125,0.200586128296972,0.393682839465972,0.214262455226311,0.0374470856398567,0.00358189514816021,1078,0.3510257245197,1993,0.6489742754803
"E02001900",13,172,1136,1070,398,91,10,2890,0.00449826989619377,0.0595155709342561,0.393079584775087,0.370242214532872,0.137716262975779,0.0314878892733564,0.00346020761245675,1321,0.457093425605536,1569,0.542906574394464
"E02001901",5,191,1030,1687,1018,147,36,4114,0.00121536217792902,0.0464268351968887,0.250364608653379,0.410063198833252,0.247447739426349,0.0357316480311133,0.00875060768108897,1226,0.298006806028196,2888,0.701993193971804
"E02001902",0,28,358,1107,439,66,26,2024,0,0.0138339920948617,0.176877470355731,0.546936758893281,0.216897233201581,0.0326086956521739,0.0128458498023715,386,0.190711462450593,1638,0.809288537549407
"E02001903",1,48,528,897,536,69,24,2103,0.000475511174512601,0.0228245363766049,0.251069900142653,0.426533523537803,0.254873989538754,0.0328102710413695,0.0114122681883024,577,0.274369947693771,1526,0.725630052306229
"E02001904",0,45,627,1268,689,121,54,2804,0,0.0160485021398003,0.223609129814551,0.452211126961484,0.245720399429387,0.0431526390870185,0.0192582025677603,672,0.239657631954351,2132,0.760342368045649
"E02001905",6,845,914,952,450,100,13,3280,0.00182926829268293,0.257621951219512,0.278658536585366,0.290243902439024,0.13719512195122,0.0304878048780488,0.00396341463414634,1765,0.538109756097561,1515,0.461890243902439
"E02001906",5,50,674,1477,573,93,13,2885,0.00173310225303293,0.0173310225303293,0.233622183708839,0.511958405545927,0.198613518197574,0.0322357019064125,0.00450606585788562,729,0.252686308492201,2156,0.747313691507799
"E02001907",1,216,842,1814,783,103,40,3799,0.000263227165043432,0.0568570676493814,0.22163727296657,0.477494077388787,0.206106870229008,0.0271123979994735,0.0105290866017373,1059,0.278757567780995,2740,0.721242432219005
"E02001908",0,20,278,1002,696,78,23,2097,0,0.00953743443013829,0.132570338578922,0.477825464949928,0.331902718168813,0.0371959942775393,0.010968049594659,298,0.142107773009061,1799,0.857892226990939
"E02001909",0,50,788,1111,608,64,22,2643,0,0.0189178963299281,0.298146046159667,0.420355656451003,0.230041619371926,0.024214907302308,0.00832387438516837,838,0.317063942489595,1805,0.682936057510405
"E02001910",2,432,964,1010,474,74,14,2970,0.000673400673400673,0.145454545454545,0.324579124579125,0.34006734006734,0.15959595959596,0.0249158249158249,0.00471380471380471,1398,0.470707070707071,1572,0.529292929292929
"E02001911",3,197,996,1393,472,95,28,3184,0.000942211055276382,0.0618718592964824,0.312814070351759,0.4375,0.148241206030151,0.0298366834170854,0.00879396984924623,1196,0.375628140703518,1988,0.624371859296482
"E02001913",6,88,1079,1559,529,88,15,3364,0.00178359096313912,0.0261593341260404,0.320749108204518,0.463436385255648,0.157253269916766,0.0261593341260404,0.0044589774078478,1173,0.348692033293698,2191,0.651307966706302
"E02001914",0,105,681,854,516,100,29,2285,0,0.0459518599562363,0.298030634573304,0.373741794310722,0.22582056892779,0.0437636761487965,0.012691466083151,786,0.34398249452954,1499,0.656017505470459
"E02001915",1,180,1248,2064,889,155,47,4584,0.000218150087260035,0.0392670157068063,0.272251308900524,0.450261780104712,0.193935427574171,0.0338132635253054,0.0102530541012216,1429,0.31173647469459,3155,0.68826352530541
"E02001916",6,580,457,1470,533,93,57,3196,0.00187734668335419,0.181476846057572,0.142991239048811,0.459949937421777,0.166770963704631,0.02909887359199,0.0178347934918648,1043,0.326345431789737,2153,0.673654568210263
"E02001918",0,258,1559,1808,838,202,46,4711,0,0.054765442581193,0.330927616217364,0.383782636382934,0.177881553810231,0.042878369772872,0.0097643812354065,1817,0.385693058798557,2894,0.614306941201443
"E02001919",0,112,724,1034,639,119,30,2658,0,0.0421369450714823,0.272385252069225,0.389014296463506,0.240406320541761,0.04477050413845,0.0112866817155756,836,0.314522197140707,1822,0.685477802859293
"E02001920",2,133,967,1049,267,66,7,2491,0.000802890405459655,0.053392211963067,0.388197511039743,0.421116017663589,0.107185869128864,0.0264953833801686,0.00281011641910879,1102,0.44239261340827,1389,0.55760738659173
"E02001921",0,41,785,1412,371,54,19,2682,0,0.0152870991797166,0.29269202087994,0.526472781506339,0.138329604772558,0.0201342281879195,0.00708426547352722,826,0.307979120059657,1856,0.692020879940343
"E02001922",3,491,1571,1916,592,49,17,4639,0.000646691097219228,0.10584177624488,0.338650571243803,0.413020047424014,0.127613709851261,0.0105626212545807,0.00366458288424229,2065,0.445139038585902,2574,0.554860961414098
"E02001923",0,181,533,1356,838,142,55,3105,0,0.05829307568438,0.171658615136876,0.436714975845411,0.269887278582931,0.0457326892109501,0.0177133655394525,714,0.229951690821256,2391,0.770048309178744
"E02001924",0,220,272,1005,510,90,42,2139,0,0.102851799906498,0.127162225338943,0.46984572230014,0.238429172510519,0.0420757363253857,0.0196353436185133,492,0.230014025245442,1647,0.769985974754558
"E02001925",10,154,698,1228,449,87,17,2643,0.00378357926598562,0.0582671206961786,0.264093832765796,0.464623533863034,0.169882709042754,0.0329171396140749,0.00643208475217556,862,0.326144532727961,1781,0.673855467272039
"E02001926",12,280,557,1408,621,93,22,2993,0.00400935516204477,0.0935516204477113,0.186100902104911,0.47043100567992,0.207484129635817,0.031072502505847,0.00735048446374875,849,0.283661877714668,2144,0.716338122285332
"E02001927",14,46,948,1202,288,75,20,2593,0.00539915156189742,0.0177400694176629,0.365599691477054,0.463555726957192,0.11106826070189,0.0289240262244504,0.00771307365985345,1008,0.388738912456614,1585,0.611261087543386
"E02001928",2,95,859,1098,389,38,11,2492,0.000802568218298555,0.0381219903691814,0.34470304975923,0.440609951845907,0.156099518459069,0.0152487961476726,0.00441412520064205,956,0.38362760834671,1536,0.616372391653291
"E02001929",2,14,485,1911,481,84,51,3028,0.000660501981505945,0.00462351387054161,0.160171730515192,0.63110964332893,0.15885072655218,0.0277410832232497,0.0168428005284016,501,0.165455746367239,2527,0.834544253632761
"E02001930",5,67,433,1364,777,149,30,2825,0.00176991150442478,0.023716814159292,0.153274336283186,0.48283185840708,0.275044247787611,0.0527433628318584,0.0106194690265487,505,0.178761061946903,2320,0.821238938053097
"E02001931",2,181,613,1103,555,113,24,2591,0.000771902740254728,0.0698571979930529,0.236588189888074,0.425704361250482,0.214203010420687,0.0436125048243921,0.00926283288305673,796,0.307217290621382,1795,0.692782709378618
"E02001932",6,277,1371,1023,227,40,17,2961,0.00202634245187437,0.0935494765281999,0.463019250253293,0.34549138804458,0.0766632894292469,0.0135089496791624,0.00574130361364404,1654,0.558595069233367,1307,0.441404930766633
"E02001933",2,116,595,1277,486,65,27,2568,0.000778816199376947,0.0451713395638629,0.231697819314642,0.497274143302181,0.189252336448598,0.0253115264797508,0.0105140186915888,713,0.277647975077882,1855,0.722352024922118
"E02001934",1,26,243,866,444,77,25,1682,0.000594530321046373,0.0154577883472057,0.144470868014269,0.514863258026159,0.26397146254459,0.0457788347205707,0.0148632580261593,270,0.160523186682521,1412,0.839476813317479
"E02001935",1,229,950,1088,256,26,6,2556,0.000391236306729264,0.0895931142410016,0.371674491392801,0.42566510172144,0.100156494522692,0.0101721439749609,0.00234741784037559,1180,0.461658841940532,1376,0.538341158059468
"E02001936",1,76,458,808,372,100,12,1827,0.000547345374931582,0.0415982484948002,0.250684181718664,0.442255062944718,0.203612479474548,0.0547345374931582,0.00656814449917898,535,0.292829775588396,1292,0.707170224411604
"E02001937",12,130,800,1290,398,83,24,2737,0.00438436244062843,0.0474972597734746,0.292290829375228,0.471318962367556,0.145414687614176,0.0303251735476799,0.00876872488125685,942,0.344172451589331,1795,0.655827548410669
"E02001938",0,317,696,1535,650,95,35,3328,0,0.0952524038461538,0.209134615384615,0.461237980769231,0.1953125,0.0285456730769231,0.0105168269230769,1013,0.304387019230769,2315,0.695612980769231
"E02001939",0,356,1207,963,381,132,20,3059,0,0.116377901274926,0.394573389996731,0.314808761033017,0.124550506701536,0.0431513566525008,0.006538084341288,1563,0.510951291271657,1496,0.489048708728343
"E02001941",0,34,642,1027,318,60,30,2111,0,0.0161061108479394,0.304121269540502,0.486499289436286,0.150639507342492,0.0284225485551871,0.0142112742775936,676,0.320227380388441,1435,0.679772619611559
"E02001942",1,97,802,1091,629,136,45,2801,0.000357015351660121,0.0346304891110318,0.286326312031417,0.389503748661192,0.224562656194216,0.0485540878257765,0.0160656908247055,900,0.321313816494109,1901,0.678686183505891
"E02001943",0,144,562,952,346,65,10,2079,0,0.0692640692640693,0.27032227032227,0.457912457912458,0.166426166426166,0.0312650312650313,0.00481000481000481,706,0.33958633958634,1373,0.66041366041366
"E02001944",5,209,1090,1018,430,55,9,2816,0.00177556818181818,0.07421875,0.387073863636364,0.361505681818182,0.152698863636364,0.01953125,0.00319602272727273,1304,0.463068181818182,1512,0.536931818181818
"E02001945",33,281,498,1418,352,51,33,2666,0.0123780945236309,0.105401350337584,0.186796699174794,0.531882970742686,0.132033008252063,0.0191297824456114,0.0123780945236309,812,0.304576144036009,1854,0.695423855963991
"E02001946",0,177,619,1122,437,68,18,2441,0,0.0725112658746415,0.253584596476854,0.459647685374846,0.179024989758296,0.0278574354772634,0.00737402703809914,796,0.326095862351495,1645,0.673904137648505
"E02001947",6,22,602,1050,608,108,11,2407,0.00249272953884504,0.00914000830909846,0.250103863730785,0.436227669297881,0.25259659326963,0.0448691316992106,0.00457000415454923,630,0.261736601578729,1777,0.738263398421271
"E02001948",0,55,516,1207,409,71,35,2293,0,0.0239860444832098,0.225032708242477,0.526384648931531,0.178368948975142,0.0309638028783253,0.0152638464893153,571,0.249018752725687,1722,0.750981247274313
"E02001949",8,436,723,902,275,64,27,2435,0.00328542094455852,0.179055441478439,0.296919917864476,0.370431211498973,0.112936344969199,0.0262833675564682,0.011088295687885,1167,0.479260780287474,1268,0.520739219712526
"E02001950",1,231,760,1305,631,85,25,3038,0.00032916392363397,0.076036866359447,0.250164581961817,0.429558920342331,0.207702435813035,0.0279789335088874,0.00822909809084924,992,0.326530612244898,2046,0.673469387755102
"E02001951",2,440,1419,1218,218,27,4,3328,0.000600961538461538,0.132211538461538,0.426382211538462,0.365985576923077,0.0655048076923077,0.00811298076923077,0.00120192307692308,1861,0.559194711538462,1467,0.440805288461538
"E02001952",2,395,1295,1404,451,108,17,3672,0.000544662309368192,0.107570806100218,0.352668845315904,0.382352941176471,0.122821350762527,0.0294117647058824,0.00462962962962963,1692,0.46078431372549,1980,0.53921568627451
"E02001953",5,193,572,985,367,61,16,2199,0.0022737608003638,0.0877671668940428,0.260118235561619,0.447930877671669,0.166894042746703,0.0277398817644384,0.00727603456116417,770,0.350159163256025,1429,0.649840836743975
"E02001954",18,339,1139,976,223,47,9,2751,0.00654307524536532,0.123227917121047,0.414031261359506,0.35478007997092,0.0810614322064704,0.0170846964740094,0.00327153762268266,1496,0.543802253725918,1255,0.456197746274082
"E02001955",87,1035,1104,1002,270,37,12,3547,0.0245277699464336,0.291795883845503,0.311248942768537,0.28249224696927,0.0761206653510008,0.010431350436989,0.0033831406822667,2226,0.627572596560474,1321,0.372427403439526
"E02001956",4,219,771,975,240,39,9,2257,0.00177226406734603,0.0970314576871954,0.341603898980948,0.431989366415596,0.106335844040762,0.0172795746566238,0.00398759415152858,994,0.44040762073549,1263,0.559592379264511
"E02001957",0,102,531,1191,385,51,22,2282,0,0.0446976336546889,0.232690622261174,0.521910604732691,0.168711656441718,0.0223488168273444,0.00964066608238387,633,0.277388255915863,1649,0.722611744084137
"E02001958",1,236,1078,1247,522,79,25,3188,0.000313676286072773,0.0740276035131744,0.338143036386449,0.391154328732748,0.163739021329987,0.0247804265997491,0.00784190715181932,1315,0.412484316185696,1873,0.587515683814304
"E02001959",83,793,416,945,256,37,15,2545,0.0326129666011788,0.311591355599214,0.163457760314342,0.371316306483301,0.100589390962672,0.0145383104125737,0.00589390962671906,1292,0.507662082514735,1253,0.492337917485265
"E02001961",2,214,1056,1321,421,106,25,3145,0.000635930047694754,0.0680445151033386,0.33577106518283,0.420031796502385,0.133863275039746,0.0337042925278219,0.00794912559618442,1272,0.404451510333863,1873,0.595548489666137
"E02001962",3,427,526,1097,399,46,19,2517,0.00119189511323004,0.169646404449742,0.208978943186333,0.435836313071116,0.158522050059595,0.0182757250695272,0.00754866905045689,956,0.379817242749305,1561,0.620182757250695
"E02001963",0,68,519,844,337,71,6,1845,0,0.0368563685636856,0.28130081300813,0.457452574525745,0.182655826558266,0.0384823848238482,0.0032520325203252,587,0.318157181571816,1258,0.681842818428184
"E02001964",8,1375,1501,1251,302,52,19,4508,0.00177462289263532,0.305013309671695,0.332963620230701,0.277506654835847,0.0669920141969831,0.0115350488021295,0.00421472937000887,2884,0.639751552795031,1624,0.360248447204969
"E02001965",69,232,1159,1120,298,38,11,2927,0.0235736248718825,0.0792620430474889,0.395968568500171,0.382644345746498,0.10181072770755,0.012982576016399,0.00375811411001025,1460,0.498804236419542,1467,0.501195763580458
"E02001966",0,248,603,1107,428,44,23,2453,0,0.101100693028944,0.24582144313086,0.451284141867102,0.174480228291887,0.0179372197309417,0.00937627395026498,851,0.346922136159804,1602,0.653077863840196
"E02001967",2,447,522,898,314,70,17,2270,0.000881057268722467,0.196916299559471,0.229955947136564,0.395594713656388,0.138325991189427,0.0308370044052863,0.00748898678414097,971,0.427753303964758,1299,0.572246696035242
"E02001968",3,612,583,1165,342,63,22,2790,0.0010752688172043,0.219354838709677,0.208960573476703,0.417562724014337,0.12258064516129,0.0225806451612903,0.00788530465949821,1198,0.429390681003584,1592,0.570609318996416
"E02001969",0,33,660,1304,396,69,22,2484,0,0.0132850241545894,0.265700483091787,0.524959742351047,0.159420289855072,0.0277777777777778,0.00885668276972625,693,0.278985507246377,1791,0.721014492753623
"E02001970",9,281,479,952,348,64,13,2146,0.00419384902143523,0.1309412861137,0.223205964585275,0.443616029822926,0.162162162162162,0.0298229263746505,0.00605778191985089,769,0.35834109972041,1377,0.64165890027959
"E02001971",0,108,267,995,365,50,9,1794,0,0.0602006688963211,0.148829431438127,0.554626532887402,0.20345596432553,0.0278706800445931,0.00501672240802676,375,0.209030100334448,1419,0.790969899665552
"E02001972",5,749,1666,1962,627,91,38,5138,0.000973141300116777,0.145776566757493,0.32425068119891,0.381860646165823,0.122031919034644,0.0177111716621253,0.00739587388088751,2420,0.47100038925652,2718,0.52899961074348
"E02001973",2,167,1258,1481,473,65,18,3464,0.000577367205542725,0.0482101616628176,0.363163972286374,0.427540415704388,0.136547344110855,0.0187644341801386,0.00519630484988453,1427,0.411951501154734,2037,0.588048498845266
"E02001974",10,142,715,1476,482,69,12,2906,0.00344115622849277,0.0488644184445974,0.246042670337233,0.507914659325533,0.165863730213352,0.0237439779766001,0.00412938747419133,867,0.298348245010323,2039,0.701651754989676
"E02001975",2,25,431,1241,377,61,22,2159,0.000926354793886058,0.0115794349235757,0.199629458082446,0.574803149606299,0.174617878647522,0.0282538212135248,0.0101899027327466,458,0.212135247799907,1701,0.787864752200093
"E02001976",5,136,1066,1132,359,39,12,2749,0.00181884321571481,0.0494725354674427,0.387777373590396,0.411786104037832,0.130592942888323,0.0141869770825755,0.00436522371771553,1207,0.439068752273554,1542,0.560931247726446
"E02001977",24,289,1959,1796,569,65,19,4721,0.00508366871425545,0.0612158441008261,0.414954458801101,0.380427875450117,0.120525312433806,0.0137682694344419,0.00402457106545224,2272,0.481253971616183,2449,0.518746028383817
"E02001978",0,52,422,1090,347,64,11,1986,0,0.0261832829808661,0.212487411883182,0.548841893252769,0.17472306143001,0.0322255790533736,0.00553877139979859,474,0.238670694864048,1512,0.761329305135952
"E02001979",1,14,456,886,254,44,6,1661,0.000602046959662854,0.00842865743527995,0.274533413606261,0.533413606261288,0.152919927754365,0.0264900662251656,0.00361228175797712,471,0.283564118001204,1190,0.716435881998796
"E02001980",4,29,495,860,227,36,5,1656,0.00241545893719807,0.017512077294686,0.298913043478261,0.519323671497585,0.13707729468599,0.0217391304347826,0.00301932367149758,528,0.318840579710145,1128,0.681159420289855
"E02001981",3,412,2215,2104,546,75,21,5376,0.000558035714285714,0.0766369047619048,0.412016369047619,0.391369047619048,0.1015625,0.0139508928571429,0.00390625,2630,0.48921130952381,2746,0.51078869047619
"E02001982",16,718,1582,845,192,27,3,3383,0.00472953000295596,0.212237658882649,0.46763227904227,0.249778303281111,0.0567543600354715,0.00798108187998818,0.000886786875554242,2316,0.684599467927875,1067,0.315400532072125
"E02001983",2,44,519,1413,516,112,22,2628,0.00076103500761035,0.0167427701674277,0.197488584474886,0.537671232876712,0.19634703196347,0.0426179604261796,0.00837138508371385,565,0.214992389649924,2063,0.785007610350076
"E02001984",56,438,615,1567,653,94,29,3452,0.0162224797219003,0.126882966396292,0.178157589803013,0.453939745075319,0.189165701042874,0.0272305909617613,0.00840092699884125,1109,0.321263035921205,2343,0.678736964078795
"E02001985",2,301,1258,2001,658,60,24,4304,0.000464684014869888,0.0699349442379182,0.29228624535316,0.464916356877323,0.152881040892193,0.0139405204460967,0.00557620817843866,1561,0.362685873605948,2743,0.637314126394052
"E02001986",7,156,1400,1552,351,50,7,3523,0.00198694294635254,0.044280442804428,0.397388589270508,0.440533636105592,0.0996309963099631,0.0141924496168039,0.00198694294635254,1563,0.443655975021289,1960,0.556344024978711
"E02001987",1,379,604,1553,531,58,18,3144,0.000318066157760814,0.120547073791349,0.192111959287532,0.493956743002545,0.168893129770992,0.0184478371501272,0.00572519083969466,984,0.312977099236641,2160,0.687022900763359
"E02001988",1,882,2852,1596,490,88,13,5922,0.000168861870989531,0.148936170212766,0.481594056062141,0.269503546099291,0.08274231678487,0.0148598446470787,0.0021952043228639,3735,0.630699088145897,2187,0.369300911854103
"E02001989",2,272,430,1057,305,37,4,2107,0.00094921689606075,0.129093497864262,0.204081632653061,0.501661129568106,0.144755576649264,0.0175605125771239,0.0018984337921215,704,0.334124347413384,1403,0.665875652586616
"E02001990",5,131,862,1257,243,30,12,2540,0.00196850393700787,0.0515748031496063,0.339370078740157,0.49488188976378,0.0956692913385827,0.0118110236220472,0.0047244094488189,998,0.392913385826772,1542,0.607086614173228
"E02001991",1,132,649,1446,753,139,23,3143,0.000318167356029271,0.0419980909958638,0.206490614062997,0.460069996818326,0.239580019090041,0.0442252624880687,0.00731784918867324,782,0.24880687241489,2361,0.75119312758511
"E02001992",16,429,1826,1435,371,43,5,4125,0.00387878787878788,0.104,0.442666666666667,0.347878787878788,0.0899393939393939,0.0104242424242424,0.00121212121212121,2271,0.550545454545455,1854,0.449454545454545
"E02001993",37,705,1335,1156,320,33,6,3592,0.0103006681514477,0.196269487750557,0.371659242761693,0.321826280623608,0.089086859688196,0.00918708240534521,0.00167037861915367,2077,0.578229398663697,1515,0.421770601336303
"E02001994",1,138,658,1463,462,70,14,2806,0.000356379187455453,0.0491803278688525,0.234497505345688,0.521382751247327,0.164647184604419,0.0249465431218817,0.00498930862437634,797,0.284034212401996,2009,0.715965787598004
"E02001995",6,546,1982,1370,494,62,14,4474,0.00134108180599017,0.122038444345105,0.443004023245418,0.306213679034421,0.110415735359857,0.013857845328565,0.00312919088064372,2534,0.566383549396513,1940,0.433616450603487
"E02001996",8,469,1505,1149,440,119,10,3700,0.00216216216216216,0.126756756756757,0.406756756756757,0.310540540540541,0.118918918918919,0.0321621621621622,0.0027027027027027,1982,0.535675675675676,1718,0.464324324324324
"E02001997",1,32,593,1258,388,65,10,2347,0.000426075841499787,0.0136344269279932,0.252662974009374,0.536003408606732,0.165317426501917,0.0276949296974862,0.00426075841499787,626,0.266723476778867,1721,0.733276523221133
"E02001998",0,13,320,898,264,30,7,1532,0,0.00848563968668407,0.2088772845953,0.586161879895561,0.172323759791123,0.0195822454308094,0.00456919060052219,333,0.217362924281984,1199,0.782637075718016
"E02001999",2,145,661,868,250,32,10,1968,0.00101626016260163,0.0736788617886179,0.335873983739837,0.441056910569106,0.127032520325203,0.016260162601626,0.00508130081300813,808,0.410569105691057,1160,0.589430894308943
"E02002000",3,451,1374,1200,337,54,18,3437,0.000872854233343032,0.131219086412569,0.399767238871109,0.349141693337213,0.0980506255455339,0.0157113762001746,0.00523712540005819,1828,0.531859179517021,1609,0.468140820482979
"E02002001",7,93,821,1052,266,63,15,2317,0.00302114803625378,0.0401381096245145,0.354337505394907,0.454035390591282,0.114803625377644,0.027190332326284,0.00647388864911524,921,0.397496763055675,1396,0.602503236944325
"E02002002",1,143,533,875,293,47,4,1896,0.000527426160337553,0.07542194092827,0.281118143459916,0.461497890295359,0.154535864978903,0.024789029535865,0.00210970464135021,677,0.357067510548523,1219,0.642932489451477
"E02002003",28,131,1151,1212,387,71,12,2992,0.00935828877005348,0.043783422459893,0.384692513368984,0.405080213903743,0.129344919786096,0.0237299465240642,0.00401069518716578,1310,0.437834224598931,1682,0.562165775401069
"E02002004",3,103,1154,1220,240,47,20,2787,0.00107642626480086,0.0369573017581629,0.414065303193398,0.437746681019017,0.0861141011840689,0.0168640114818802,0.00717617509867241,1260,0.452099031216362,1527,0.547900968783638
"E02002005",0,626,1288,1443,364,56,20,3797,0,0.164867000263366,0.339215169870951,0.380036871214116,0.09586515670266,0.0147484856465631,0.00526731630234396,1914,0.504082170134317,1883,0.495917829865683
"E02002006",1,137,1337,1019,235,40,8,2777,0.000360100828231905,0.049333813467771,0.481454807346057,0.366942743968311,0.0846236946344977,0.0144040331292762,0.00288080662585524,1475,0.53114872164206,1302,0.46885127835794
"E02002007",8,151,997,1393,397,68,17,3031,0.00263939293962389,0.0498185417354009,0.328934345100627,0.459584295612009,0.130979874628835,0.022434839986803,0.00560870999670076,1156,0.381392279775652,1875,0.618607720224348
"E02002008",3,85,661,1042,194,36,6,2027,0.00148001973359645,0.0419338924518994,0.326097681302417,0.514060187469166,0.0957079427725703,0.0177602368031574,0.0029600394671929,749,0.369511593487913,1278,0.630488406512087
"E02002009",5,54,1132,1200,415,47,13,2866,0.00174459176552687,0.0188415910676902,0.394975575715283,0.418702023726448,0.14480111653873,0.0163991625959525,0.00453593859036985,1191,0.4155617585485,1675,0.5844382414515
"E02002010",7,235,1670,1342,563,121,27,3965,0.00176544766708701,0.0592686002522068,0.421185372005044,0.338461538461538,0.141992433795712,0.0305170239596469,0.00680958385876419,1912,0.482219419924338,2053,0.517780580075662
"E02002011",13,411,441,768,248,31,4,1916,0.00678496868475992,0.214509394572025,0.230167014613779,0.400835073068894,0.129436325678497,0.0161795407098121,0.00208768267223382,865,0.451461377870564,1051,0.548538622129436
"E02002012",3,316,1416,1702,460,71,24,3992,0.000751503006012024,0.0791583166332665,0.354709418837675,0.426352705410822,0.115230460921844,0.0177855711422846,0.00601202404809619,1735,0.434619238476954,2257,0.565380761523046
"E02002013",2,49,409,1031,282,45,9,1827,0.00109469074986316,0.0268199233716475,0.223864258347017,0.564313081554461,0.154351395730706,0.0246305418719212,0.00492610837438424,460,0.251778872468528,1367,0.748221127531472
"E02002014",7,193,1038,1332,482,72,23,3147,0.00222434064188116,0.0613282491261519,0.329837940896092,0.4232602478551,0.15316174134096,0.0228789323164919,0.0073085478233238,1238,0.393390530664125,1909,0.606609469335875
"E02002015",0,141,969,835,241,55,9,2250,0,0.0626666666666667,0.430666666666667,0.371111111111111,0.107111111111111,0.0244444444444444,0.004,1110,0.493333333333333,1140,0.506666666666667
"E02002016",2,258,977,1777,529,87,20,3650,0.000547945205479452,0.0706849315068493,0.267671232876712,0.486849315068493,0.144931506849315,0.0238356164383562,0.00547945205479452,1237,0.338904109589041,2413,0.661095890410959
"E02002017",8,155,1195,1430,502,77,18,3385,0.00236336779911374,0.0457902511078287,0.353028064992614,0.422451994091581,0.148301329394387,0.0227474150664697,0.00531757754800591,1358,0.401181683899557,2027,0.598818316100443
"E02002018",1,75,591,1283,363,62,13,2388,0.000418760469011725,0.0314070351758794,0.24748743718593,0.537269681742044,0.152010050251256,0.025963149078727,0.00544388609715243,667,0.279313232830821,1721,0.720686767169179
"E02002019",0,48,892,1337,330,81,18,2706,0,0.0177383592017738,0.329637841832964,0.494087213599409,0.121951219512195,0.0299334811529933,0.00665188470066519,940,0.347376201034738,1766,0.652623798965262
"E02002020",28,271,1025,1419,430,64,24,3261,0.00858632321373812,0.0831033425329653,0.314320760502913,0.435142594296228,0.131861392210978,0.0196258816314014,0.00735970561177553,1324,0.406010426249617,1937,0.593989573750383
"E02002021",2,266,1812,1706,601,80,25,4492,0.000445235975066785,0.0592163846838825,0.403383793410508,0.379786286731968,0.133793410507569,0.0178094390026714,0.00556544968833482,2080,0.463045414069457,2412,0.536954585930543
"E02002022",2,241,1014,1538,445,88,30,3358,0.000595592614651578,0.0717689100655152,0.30196545562835,0.458010720667064,0.132519356759976,0.0262060750446694,0.00893388921977368,1257,0.374329958308517,2101,0.625670041691483
"E02002023",6,112,422,856,215,24,9,1644,0.00364963503649635,0.0681265206812652,0.25669099756691,0.520681265206813,0.130778588807786,0.0145985401459854,0.00547445255474453,540,0.328467153284672,1104,0.671532846715329
"E02002024",1,237,886,1323,464,85,30,3026,0.000330469266358229,0.0783212161269002,0.292795769993391,0.437210839391937,0.153337739590218,0.0280898876404494,0.00991407799074686,1124,0.371447455386649,1902,0.628552544613351
"E02002025",14,362,730,1381,560,89,24,3160,0.00443037974683544,0.114556962025316,0.231012658227848,0.437025316455696,0.177215189873418,0.0281645569620253,0.00759493670886076,1106,0.35,2054,0.65
"E02002026",1,21,409,944,299,49,14,1737,0.000575705238917674,0.0120898100172712,0.235463442717329,0.543465745538284,0.172135866436385,0.028209556706966,0.00805987334484744,431,0.248128957973518,1306,0.751871042026482
"E02002027",2,41,468,731,98,8,2,1350,0.00148148148148148,0.0303703703703704,0.346666666666667,0.541481481481481,0.0725925925925926,0.00592592592592593,0.00148148148148148,511,0.378518518518519,839,0.621481481481481
"E02002028",8,115,698,970,319,56,5,2171,0.00368493781667434,0.0529709811146937,0.321510824504836,0.446798710271764,0.146936895439889,0.0257945647167204,0.00230308613542146,821,0.378166743436204,1350,0.621833256563796
"E02002029",1,73,356,893,399,79,17,1818,0.00055005500550055,0.0401540154015402,0.195819581958196,0.491199119911991,0.219471947194719,0.0434543454345435,0.00935093509350935,430,0.236523652365237,1388,0.763476347634763
"E02002030",24,511,1057,925,275,37,15,2844,0.00843881856540084,0.179676511954993,0.371659634317862,0.325246132208158,0.0966947960618847,0.0130098452883263,0.00527426160337553,1592,0.559774964838256,1252,0.440225035161744
"E02002031",18,376,479,816,424,71,16,2200,0.00818181818181818,0.170909090909091,0.217727272727273,0.370909090909091,0.192727272727273,0.0322727272727273,0.00727272727272727,873,0.396818181818182,1327,0.603181818181818
"E02002032",2,268,1412,1769,491,89,25,4056,0.000493096646942801,0.0660749506903353,0.348126232741617,0.436143984220907,0.121055226824458,0.0219428007889546,0.00616370808678501,1682,0.414694280078895,2374,0.585305719921104
"E02002033",2,105,782,1180,356,47,14,2486,0.00080450522928399,0.0422365245374095,0.31456154465004,0.474658085277554,0.14320193081255,0.0189058728881738,0.00563153660498793,889,0.357602574416734,1597,0.642397425583266
"E02002034",5,285,1343,1504,648,109,28,3922,0.0012748597654258,0.0726670066292708,0.342427332993371,0.383477817440082,0.165221825599184,0.0277919428862825,0.0071392146863845,1633,0.416369199388067,2289,0.583630800611933
"E02002035",2,25,415,828,316,68,11,1665,0.0012012012012012,0.015015015015015,0.249249249249249,0.497297297297297,0.18978978978979,0.0408408408408408,0.00660660660660661,442,0.265465465465465,1223,0.734534534534535
"E02002036",0,92,1159,1292,365,47,26,2981,0,0.0308621268030862,0.38879570613888,0.433411606843341,0.122442133512244,0.0157665213015767,0.00872190540087219,1251,0.419657832941966,1730,0.580342167058034
"E02002037",0,43,622,920,276,46,10,1917,0,0.0224308815858112,0.324465310380803,0.479916536254564,0.143974960876369,0.0239958268127282,0.00521648408972353,665,0.346896191966614,1252,0.653103808033386
"E02002038",3,260,1365,1818,491,81,25,4043,0.000742023250061835,0.0643086816720257,0.337620578778135,0.449666089537472,0.121444471926787,0.0200346277516696,0.00618352708384863,1628,0.402671283700223,2415,0.597328716299777
"E02002039",0,61,563,999,421,69,26,2139,0,0.0285179990649836,0.263207106124357,0.467040673211781,0.196820944366526,0.032258064516129,0.0121552127162225,624,0.291725105189341,1515,0.708274894810659
"E02002040",0,60,446,826,317,61,7,1717,0,0.034944670937682,0.259755387303436,0.481071636575422,0.18462434478742,0.0355270821199767,0.0040768782760629,506,0.294700058241118,1211,0.705299941758882
"E02002041",2,26,553,1053,271,24,5,1934,0.00103412616339193,0.0134436401240951,0.28593588417787,0.544467425025853,0.140124095139607,0.0124095139607032,0.00258531540847983,581,0.300413650465357,1353,0.699586349534643
"E02002042",3,118,700,1219,270,44,8,2362,0.0012701100762066,0.0499576629974598,0.296359017781541,0.516088060965284,0.114309906858594,0.0186282811176969,0.00338696020321761,821,0.347586790855207,1541,0.652413209144793
"E02002043",8,75,607,1244,473,73,23,2503,0.00319616460247703,0.0299640431482221,0.242508989212944,0.497003595685178,0.188973232121454,0.0291650019976029,0.00918897323212145,690,0.275669196963644,1813,0.724330803036356
"E02002044",3,175,1013,938,178,31,12,2350,0.00127659574468085,0.074468085106383,0.431063829787234,0.399148936170213,0.0757446808510638,0.0131914893617021,0.0051063829787234,1191,0.506808510638298,1159,0.493191489361702
"E02002045",1,49,868,1265,347,59,14,2603,0.000384172109104879,0.0188244333461391,0.333461390703035,0.485977718017672,0.133307721859393,0.0226661544371879,0.00537840952746831,918,0.352669996158279,1685,0.647330003841721
"E02002046",2,70,491,723,146,27,7,1466,0.00136425648021828,0.0477489768076398,0.334924965893588,0.493178717598909,0.0995907230559345,0.0184174624829468,0.00477489768076398,563,0.384038199181446,903,0.615961800818554
"E02002047",11,132,978,1095,406,52,17,2691,0.00408769973987365,0.0490523968784838,0.363433667781494,0.406911928651059,0.150873281308064,0.0193236714975845,0.0063173541434411,1121,0.416573764399851,1570,0.583426235600149
"E02002048",2,36,527,922,357,72,15,1931,0.00103573278094252,0.0186431900569653,0.272915587778353,0.4774728120145,0.184878301398239,0.0372863801139306,0.00776799585706888,565,0.292594510616261,1366,0.707405489383739
"E02002049",0,177,676,686,155,26,4,1724,0,0.102668213457077,0.392111368909513,0.397911832946636,0.089907192575406,0.0150812064965197,0.00232018561484919,853,0.494779582366589,871,0.505220417633411
"E02002051",0,131,654,892,184,25,9,1895,0,0.0691292875989446,0.345118733509235,0.470712401055409,0.0970976253298153,0.0131926121372032,0.00474934036939314,785,0.414248021108179,1110,0.585751978891821
"E02002052",2,432,1645,1232,301,75,23,3710,0.000539083557951483,0.11644204851752,0.443396226415094,0.332075471698113,0.0811320754716981,0.0202156334231806,0.00619946091644205,2079,0.560377358490566,1631,0.439622641509434
"E02002053",0,132,555,912,343,62,13,2017,0,0.0654437283093704,0.275161130391671,0.452156668319286,0.170054536440258,0.030738720872583,0.00644521566683193,687,0.340604858701041,1330,0.659395141298959
"E02002054",11,58,484,796,233,37,12,1631,0.00674432863274065,0.0355610055180871,0.296750459840589,0.488044144696505,0.142857142857143,0.0226854690374004,0.00735744941753525,553,0.339055793991416,1078,0.660944206008584
"E02002055",11,720,1378,1152,263,44,19,3587,0.00306662949540006,0.200724839698913,0.384165040423752,0.32115974351826,0.0733203233900195,0.0122665179816002,0.00529690549205464,2109,0.587956509618065,1478,0.412043490381935
"E02002056",0,326,1662,1211,264,36,19,3518,0,0.0926662876634451,0.472427515633883,0.344229675952246,0.0750426378624218,0.0102330869812393,0.00540079590676521,1988,0.565093803297328,1530,0.434906196702672
"E02002057",0,425,1372,1211,421,62,21,3512,0,0.121013667425968,0.390660592255125,0.344817767653759,0.119874715261959,0.0176537585421412,0.00597949886104784,1797,0.511674259681093,1715,0.488325740318907
"E02002058",16,338,2116,1364,292,47,19,4192,0.00381679389312977,0.0806297709923664,0.504770992366412,0.325381679389313,0.0696564885496183,0.0112118320610687,0.0045324427480916,2470,0.589217557251908,1722,0.410782442748092
"E02002059",1,290,1516,1420,567,71,29,3894,0.000256805341551104,0.0744735490498202,0.389316897791474,0.364663585002568,0.145608628659476,0.0182331792501284,0.00744735490498202,1807,0.464047252182845,2087,0.535952747817155
"E02002060",7,364,805,892,242,47,14,2371,0.00295234078447912,0.153521720792914,0.339519190215099,0.376212568536482,0.102066638549135,0.0198228595529313,0.00590468156895825,1176,0.495993251792493,1195,0.504006748207507
"E02002061",4,341,751,871,407,47,19,2440,0.00163934426229508,0.139754098360656,0.307786885245902,0.356967213114754,0.166803278688525,0.0192622950819672,0.00778688524590164,1096,0.449180327868852,1344,0.550819672131148
"E02002062",5,714,1330,1096,410,69,25,3649,0.00137023842148534,0.195670046588106,0.3644834201151,0.300356261989586,0.112359550561798,0.0189092902164977,0.00685119210742669,2049,0.561523705124692,1600,0.438476294875308
"E02002063",6,255,1466,1391,439,52,18,3627,0.00165425971877585,0.0703060380479735,0.404190791287565,0.383512544802867,0.121036669423766,0.014336917562724,0.00496277915632754,1727,0.476151089054315,1900,0.523848910945685
"E02002064",1,138,1262,1940,481,82,32,3936,0.000254065040650407,0.0350609756097561,0.320630081300813,0.492886178861789,0.122205284552846,0.0208333333333333,0.00813008130081301,1401,0.35594512195122,2535,0.644054878048781
"E02002065",18,278,1259,1596,759,99,38,4047,0.0044477390659748,0.068692858907833,0.311094638003459,0.394366197183099,0.187546330615271,0.0244625648628614,0.00938967136150235,1555,0.384235235977267,2492,0.615764764022733
"E02002066",66,269,819,1202,445,67,29,2897,0.0227821884708319,0.09285467725233,0.282706247842596,0.414911977908181,0.153607179841215,0.0231273731446324,0.010010355540214,1154,0.398343113565758,1743,0.601656886434242
"E02002067",11,312,563,793,235,28,4,1946,0.00565262076053443,0.16032887975334,0.289311408016444,0.407502569373073,0.120760534429599,0.0143884892086331,0.00205549845837616,886,0.455292908530319,1060,0.544707091469681
"E02002069",4,243,1105,991,292,35,12,2682,0.00149142431021626,0.0906040268456376,0.412005965697241,0.369500372856078,0.108873974645787,0.0130499627143922,0.00447427293064877,1352,0.504101416853095,1330,0.495898583146905
"E02002070",0,200,734,1773,735,117,35,3594,0,0.0556483027267668,0.204229271007234,0.493322203672788,0.204507512520868,0.0325542570951586,0.0097384529771842,934,0.259877573734001,2660,0.740122426265999
"E02002071",4,73,804,899,181,37,9,2007,0.00199302441454908,0.0363726955655207,0.400597907324365,0.447932237169905,0.0901843547583458,0.018435475834579,0.00448430493273543,881,0.438963627304435,1126,0.561036372695565
"E02002072",7,287,835,1319,580,114,29,3171,0.0022075055187638,0.0905077262693157,0.263323872595396,0.41595711132135,0.182907600126143,0.0359508041627247,0.00914538000630716,1129,0.356039104383475,2042,0.643960895616525
"E02002073",0,31,503,1506,459,66,19,2584,0,0.0119969040247678,0.194659442724458,0.5828173374613,0.177631578947368,0.0255417956656347,0.00735294117647059,534,0.206656346749226,2050,0.793343653250774
"E02002074",8,29,650,1475,345,55,24,2586,0.00309358081979892,0.0112142304717711,0.251353441608662,0.570378963650425,0.133410672853828,0.0212683681361176,0.00928074245939675,687,0.265661252900232,1899,0.734338747099768
"E02002075",3,195,1057,1330,445,74,30,3134,0.000957243139757498,0.0622208040842374,0.337268666241225,0.424377791959158,0.141991065730696,0.0236119974473516,0.00957243139757498,1255,0.40044671346522,1879,0.59955328653478
"E02002076",1,53,548,2289,1331,142,55,4419,0.000226295541977823,0.0119936637248246,0.124009957003847,0.517990495587237,0.301199366372482,0.0321339669608509,0.0124462548087803,602,0.136229916270649,3817,0.863770083729351
"E02002077",4,200,1869,1392,490,91,31,4077,0.000981113563895021,0.049055678194751,0.458425312729948,0.341427520235467,0.12018641157714,0.0223203335786117,0.00760363012018641,2073,0.508462104488595,2004,0.491537895511405
"E02002078",0,46,253,976,360,76,13,1724,0,0.0266821345707657,0.146751740139211,0.566125290023202,0.208816705336427,0.0440835266821346,0.00754060324825986,299,0.173433874709977,1425,0.826566125290023
"E02002079",3,222,973,1269,397,78,17,2959,0.00101385603244339,0.0750253464008111,0.328827306522474,0.428861101723555,0.134166948293342,0.0263602568435282,0.00574518418384589,1198,0.404866508955728,1761,0.595133491044272
"E02002080",0,354,931,1061,381,67,26,2820,0,0.125531914893617,0.330141843971631,0.376241134751773,0.135106382978723,0.0237588652482269,0.00921985815602837,1285,0.455673758865248,1535,0.544326241134752
"E02002081",2,33,761,865,230,30,11,1932,0.0010351966873706,0.0170807453416149,0.393892339544513,0.447722567287785,0.119047619047619,0.015527950310559,0.0056935817805383,796,0.412008281573499,1136,0.587991718426501
"E02002082",2,119,1035,673,126,19,6,1980,0.00101010101010101,0.0601010101010101,0.522727272727273,0.33989898989899,0.0636363636363636,0.0095959595959596,0.00303030303030303,1156,0.583838383838384,824,0.416161616161616
"E02002083",3,128,247,815,339,51,17,1600,0.001875,0.08,0.154375,0.509375,0.211875,0.031875,0.010625,378,0.23625,1222,0.76375
"E02002084",30,419,970,813,201,25,7,2465,0.0121703853955375,0.169979716024341,0.393509127789047,0.329817444219067,0.0815415821501014,0.0101419878296146,0.00283975659229209,1419,0.575659229208925,1046,0.424340770791075
"E02002085",42,279,935,774,220,25,6,2281,0.0184129767645769,0.122314774221833,0.409907935116177,0.339324857518632,0.0964489259096887,0.0109601052170101,0.00263042525208242,1256,0.550635686102587,1025,0.449364313897413
"E02002086",15,318,1107,655,177,14,1,2287,0.00655881066899869,0.139046786182772,0.484040227372103,0.286401399212943,0.0773939658941845,0.00612155662439878,0.000437254044599913,1440,0.629645824223874,847,0.370354175776126
"E02002087",6,124,1012,852,203,22,1,2220,0.0027027027027027,0.0558558558558559,0.455855855855856,0.383783783783784,0.0914414414414414,0.00990990990990991,0.00045045045045045,1142,0.514414414414414,1078,0.485585585585586
"E02002088",11,442,1804,1060,259,23,6,3605,0.00305131761442441,0.122607489597781,0.500416088765603,0.294036061026352,0.0718446601941748,0.00638002773925104,0.00166435506241331,2257,0.626074895977809,1348,0.373925104022191
"E02002089",5,204,852,946,456,60,13,2536,0.00197160883280757,0.0804416403785489,0.33596214511041,0.373028391167192,0.17981072555205,0.0236593059936909,0.00512618296529968,1061,0.418375394321767,1475,0.581624605678233
"E02002090",2,44,163,1052,437,56,17,1771,0.00112930547713156,0.0248447204968944,0.0920383963862225,0.594014680971203,0.246753246753247,0.0316205533596838,0.00959909655561829,209,0.118012422360248,1562,0.881987577639752
"E02002091",0,39,572,1278,454,83,20,2446,0,0.0159443990188062,0.233851185609158,0.522485690923957,0.185609157808667,0.0339329517579722,0.00817661488143908,611,0.249795584627964,1835,0.750204415372036
"E02002092",7,36,740,1163,377,64,17,2404,0.00291181364392679,0.0149750415973378,0.307820299500832,0.483777038269551,0.156821963394343,0.0266222961730449,0.00707154742096506,783,0.325707154742096,1621,0.674292845257903
"E02002093",3,178,871,1057,382,78,17,2586,0.00116009280742459,0.0688321732405259,0.336813611755607,0.408739365815932,0.147718484145398,0.0301624129930394,0.0065738592420727,1052,0.406805877803558,1534,0.593194122196442
"E02002094",1,93,549,773,321,76,7,1820,0.000549450549450549,0.0510989010989011,0.301648351648352,0.424725274725275,0.176373626373626,0.0417582417582418,0.00384615384615385,643,0.353296703296703,1177,0.646703296703297
"E02002095",5,181,1160,1193,307,59,16,2921,0.00171174255391989,0.0619650804519,0.397124272509415,0.408421773365286,0.105100992810681,0.0201985621362547,0.00547757617254365,1346,0.460801095515235,1575,0.539198904484765
"E02002096",1,402,1282,1478,682,117,11,3973,0.000251698968034231,0.101182985149761,0.322678077019884,0.372011074754593,0.171658696199346,0.029448779260005,0.00276868864837654,1685,0.424112761137679,2288,0.575887238862321
"E02002097",8,254,699,897,442,137,25,2462,0.00324939073923639,0.103168155970755,0.28391551584078,0.364337936636881,0.179528838342811,0.0556458164094232,0.0101543460601137,961,0.390333062550772,1501,0.609666937449228
"E02002098",0,265,816,1415,493,82,16,3087,0,0.0858438613540654,0.264334305150632,0.458373825720765,0.159701976028507,0.0265630061548429,0.00518302559118886,1081,0.350178166504697,2006,0.649821833495303
"E02002099",2,282,898,964,419,78,9,2652,0.000754147812971342,0.106334841628959,0.338612368024133,0.363499245852187,0.157993966817496,0.0294117647058824,0.00339366515837104,1182,0.445701357466063,1470,0.554298642533937
"E02002101",4,283,648,992,371,43,12,2353,0.00169995750106247,0.12027199320017,0.275393115172121,0.421589460263493,0.157671058223544,0.0182745431364216,0.00509987250318742,935,0.397365065873353,1418,0.602634934126647
"E02002102",19,756,724,1259,532,91,23,3404,0.00558166862514689,0.222091656874266,0.212690951821387,0.369858989424207,0.156286721504113,0.0267332549941246,0.00675675675675676,1499,0.440364277320799,1905,0.559635722679201
"E02002103",4,18,472,924,275,46,7,1746,0.00229095074455899,0.0103092783505155,0.270332187857961,0.529209621993127,0.157502863688431,0.0263459335624284,0.00400916380297824,494,0.282932416953036,1252,0.717067583046964
"E02002104",5,28,530,907,149,16,3,1638,0.00305250305250305,0.0170940170940171,0.323565323565324,0.553724053724054,0.090964590964591,0.00976800976800977,0.00183150183150183,563,0.343711843711844,1075,0.656288156288156
"E02002105",5,286,876,1030,300,63,22,2582,0.00193648334624322,0.110766847405112,0.339271882261813,0.398915569326104,0.116189000774593,0.0243996901626646,0.00852052672347018,1167,0.451975213013168,1415,0.548024786986832
"E02002106",4,354,926,1330,453,65,15,3147,0.00127105179536066,0.112488083889418,0.294248490625993,0.42262472195742,0.143946615824595,0.0206545916746107,0.00476644423260248,1284,0.408007626310772,1863,0.591992373689228
"E02002107",0,31,587,849,76,5,1,1549,0,0.0200129115558425,0.378954163976759,0.548095545513234,0.0490639122014203,0.00322788896061975,0.000645577792123951,618,0.398967075532602,931,0.601032924467398
"E02002108",4,322,924,1375,345,63,8,3041,0.00131535679052943,0.105886221637619,0.303847418612299,0.452153896744492,0.113449523183163,0.0207168694508385,0.00263071358105886,1250,0.411048997040447,1791,0.588951002959553
"E02002109",10,2144,1679,1110,320,61,17,5341,0.0018723085564501,0.401422954502902,0.314360606627972,0.207826249765961,0.0599138738064033,0.0114210821943456,0.00318292454596518,3833,0.717655869687324,1508,0.282344130312676
"E02002110",7,202,770,864,198,24,5,2070,0.00338164251207729,0.0975845410628019,0.371980676328502,0.417391304347826,0.0956521739130435,0.0115942028985507,0.00241545893719807,979,0.472946859903382,1091,0.527053140096618
"E02002111",61,420,726,812,259,24,16,2318,0.0263157894736842,0.181190681622088,0.313201035375324,0.35030198446937,0.111734253666954,0.0103537532355479,0.00690250215703192,1207,0.520707506471096,1111,0.479292493528904
"E02002112",1,45,437,816,172,20,4,1495,0.000668896321070234,0.0301003344481605,0.292307692307692,0.545819397993311,0.11505016722408,0.0133779264214047,0.00267558528428094,483,0.323076923076923,1012,0.676923076923077
"E02002113",0,105,714,864,275,37,4,1999,0,0.0525262631315658,0.357178589294647,0.432216108054027,0.137568784392196,0.0185092546273137,0.00200100050025012,819,0.409704852426213,1180,0.590295147573787
"E02002114",4,51,717,803,252,50,7,1884,0.00212314225053079,0.0270700636942675,0.380573248407643,0.426220806794055,0.133757961783439,0.0265392781316348,0.00371549893842887,772,0.409766454352442,1112,0.590233545647558
"E02002115",4,84,721,974,286,64,17,2150,0.00186046511627907,0.0390697674418605,0.335348837209302,0.453023255813953,0.133023255813953,0.0297674418604651,0.00790697674418605,809,0.376279069767442,1341,0.623720930232558
"E02002116",2,100,598,991,237,30,7,1965,0.00101781170483461,0.0508905852417303,0.304325699745547,0.504325699745547,0.120610687022901,0.0152671755725191,0.00356234096692112,700,0.356234096692112,1265,0.643765903307888
"E02002117",1,123,829,930,250,17,5,2155,0.000464037122969838,0.05707656612529,0.384686774941995,0.431554524361949,0.116009280742459,0.00788863109048724,0.00232018561484919,953,0.442227378190255,1202,0.557772621809745
"E02002118",10,317,1109,1007,223,42,16,2724,0.00367107195301028,0.116372980910426,0.40712187958884,0.369676945668135,0.0818649045521292,0.0154185022026432,0.00587371512481645,1436,0.527165932452276,1288,0.472834067547724
"E02002119",0,82,545,879,261,31,4,1802,0,0.0455049944506104,0.302441731409545,0.487791342952275,0.144839067702553,0.0172031076581576,0.00221975582685905,627,0.347946725860155,1175,0.652053274139845
"E02002120",11,36,506,730,120,22,3,1428,0.007703081232493,0.0252100840336134,0.354341736694678,0.511204481792717,0.0840336134453782,0.015406162464986,0.00210084033613445,553,0.387254901960784,875,0.612745098039216
"E02002121",8,239,779,912,405,54,21,2418,0.0033085194375517,0.0988420181968569,0.322167080231596,0.377171215880893,0.167493796526055,0.0223325062034739,0.0086848635235732,1026,0.424317617866005,1392,0.575682382133995
"E02002122",43,832,629,765,241,26,16,2552,0.0168495297805643,0.326018808777429,0.246473354231975,0.299764890282132,0.094435736677116,0.0101880877742947,0.00626959247648903,1504,0.589341692789969,1048,0.410658307210031
"E02002123",3,126,762,940,242,54,11,2138,0.00140318054256314,0.058933582787652,0.356407857811038,0.439663236669785,0.113189897100094,0.0252572497661366,0.00514499532273152,891,0.416744621141253,1247,0.583255378858746
"E02002124",1,299,1091,1054,300,40,12,2799,0.000357270453733476,0.106823865666309,0.389782065023223,0.376563058235084,0.107181136120043,0.0142908181493391,0.00428724544480171,1391,0.496963201143265,1406,0.502322257949268
"E02002125",7,212,728,875,301,38,10,2171,0.00322432058959005,0.0976508521418701,0.335329341317365,0.403040073698756,0.138645785352372,0.0175034546292031,0.00460617227084293,947,0.436204514048825,1224,0.563795485951175
"E02002126",4,205,1173,863,413,39,16,2713,0.00147438260228529,0.0755621083671213,0.432362698120162,0.318098046443052,0.152230003685957,0.0143752303722816,0.00589753040914117,1382,0.509399189089569,1331,0.490600810910431
"E02002127",2,799,1120,1212,407,57,17,3614,0.000553403431101273,0.221084670724958,0.309905921416713,0.335362479247371,0.112617598229109,0.0157719977863863,0.00470392916436082,1921,0.531543995572773,1693,0.468456004427227
"E02002128",7,223,598,688,181,24,7,1728,0.00405092592592593,0.129050925925926,0.346064814814815,0.398148148148148,0.10474537037037,0.0138888888888889,0.00405092592592593,828,0.479166666666667,900,0.520833333333333
"E02002129",3,156,438,838,270,47,11,1763,0.00170164492342598,0.0884855360181509,0.248440158820193,0.475326148610323,0.153148043108338,0.0266591038003403,0.00623936471922859,597,0.33862733976177,1166,0.66137266023823
"E02002130",15,360,1164,871,210,32,11,2663,0.00563274502440856,0.135185880585805,0.437101013894104,0.327074727750657,0.0788584303417199,0.0120165227187383,0.00413067968456628,1539,0.577919639504318,1124,0.422080360495682
"E02002131",3,138,482,1028,352,52,8,2063,0.00145419292292777,0.0668928744546776,0.233640329617063,0.498303441589918,0.170625302956859,0.0252060106640814,0.00387784779447407,623,0.301987396994668,1440,0.698012603005332
"E02002132",6,217,742,835,194,22,7,2023,0.00296589223924864,0.107266435986159,0.366782006920415,0.412753336628769,0.0958971824023727,0.0108749382105783,0.00346020761245675,965,0.477014335145823,1058,0.522985664854177
"E02002133",8,164,1099,1083,488,121,23,2986,0.00267916945746818,0.0549229738780978,0.368050904219692,0.362692565304756,0.163429336905559,0.0405224380442063,0.00770261219022103,1271,0.425653047555258,1715,0.574346952444742
"E02002134",0,304,1319,1210,419,90,26,3368,0,0.0902612826603325,0.391627078384798,0.359263657957245,0.124406175771971,0.0267220902612827,0.00771971496437055,1623,0.481888361045131,1745,0.518111638954869
"E02002135",3,452,1111,1127,455,83,27,3258,0.000920810313075506,0.138735420503376,0.341006752608963,0.345917740945365,0.139656230816452,0.025475751995089,0.00828729281767956,1566,0.480662983425414,1692,0.519337016574586
"E02002136",5,172,1113,1058,355,62,23,2788,0.00179340028694405,0.0616929698708752,0.399210903873745,0.37948350071736,0.127331420373027,0.0222381635581062,0.00824964131994261,1290,0.462697274031564,1498,0.537302725968436
"E02002137",1,93,495,827,374,56,15,1861,0.000537345513164965,0.0499731327243417,0.265986029016658,0.444384739387426,0.200967221923697,0.030091348737238,0.00806018269747448,589,0.316496507254164,1272,0.683503492745836
"E02002138",1,78,365,885,497,92,21,1939,0.000515729757607014,0.0402269210933471,0.18824136152656,0.456420835482207,0.256317689530686,0.0474471376998453,0.0108303249097473,444,0.228984012377514,1495,0.771015987622486
"E02002139",73,437,1704,1713,855,154,35,4971,0.0146851740092537,0.087909877288272,0.342788171394086,0.344598672299336,0.171997585998793,0.0309796821565077,0.00704083685375176,2214,0.445383222691611,2757,0.554616777308389
"E02002140",1,220,852,1313,514,69,19,2988,0.000334672021419009,0.0736278447121821,0.285140562248996,0.439424364123159,0.172021419009371,0.0230923694779116,0.00635876840696118,1073,0.359103078982597,1915,0.640896921017403
"E02002141",3,96,566,820,228,37,9,1759,0.00170551449687322,0.0545764638999431,0.321773735076748,0.466173962478681,0.129619101762365,0.0210346787947698,0.00511654349061967,665,0.378055713473565,1094,0.621944286526435
"E02002142",0,309,813,903,468,72,27,2592,0,0.119212962962963,0.313657407407407,0.34837962962963,0.180555555555556,0.0277777777777778,0.0104166666666667,1122,0.43287037037037,1470,0.56712962962963
"E02002143",2,64,829,1539,631,83,17,3165,0.000631911532385466,0.0202211690363349,0.261927330173776,0.486255924170616,0.199368088467615,0.0262243285939968,0.00537124802527646,895,0.282780410742496,2270,0.717219589257504
"E02002144",4,52,365,839,354,68,4,1686,0.00237247924080664,0.0308422301304864,0.216488730723606,0.497627520759193,0.209964412811388,0.0403321470937129,0.00237247924080664,421,0.249703440094899,1265,0.750296559905101
"E02002145",3,409,1167,1032,386,55,14,3066,0.000978473581213307,0.133398564905414,0.380626223091977,0.336594911937378,0.125896934116112,0.017938682322244,0.0045662100456621,1579,0.515003261578604,1487,0.484996738421396
"E02002146",3,130,515,819,264,37,9,1777,0.00168823860438942,0.0731570061902082,0.289814293753517,0.460889138998312,0.148564997186269,0.0208216094541362,0.00506471581316826,648,0.364659538548115,1129,0.635340461451885
"E02002147",2,559,904,1063,308,50,11,2897,0.000690369347600966,0.19295823265447,0.312046945115637,0.366931308249914,0.106316879530549,0.0172592336900242,0.00379703141180532,1465,0.505695547117708,1432,0.494304452882292
"E02002148",2,258,878,1566,493,69,28,3294,0.000607164541590771,0.0783242258652095,0.266545233758348,0.475409836065574,0.149666059502125,0.0209471766848816,0.00850030358227079,1138,0.345476624165149,2156,0.654523375834851
"E02002149",51,241,1017,1401,392,71,18,3191,0.0159824506424318,0.0755249138201191,0.3187088686932,0.439047320589157,0.122845502977123,0.0222500783453463,0.005640864932623,1309,0.410216233155751,1882,0.589783766844249
"E02002150",1,77,457,847,280,44,12,1718,0.000582072176949942,0.0448195576251455,0.266006984866123,0.493015133876601,0.162980209545984,0.0256111757857974,0.0069848661233993,535,0.311408614668219,1183,0.688591385331781
"E02002151",3,72,1184,593,103,17,1,1973,0.0015205271160669,0.0364926507856057,0.600101368474404,0.300557526609225,0.052204764318297,0.00861632032437912,0.000506842372022301,1259,0.638114546376077,714,0.361885453623923
"E02002152",2,71,605,803,184,21,1,1687,0.001185536455246,0.042086544161233,0.358624777711915,0.475992886781268,0.109069353882632,0.012448132780083,0.000592768227622999,678,0.401896858328394,1009,0.598103141671606
"E02002153",15,134,987,1107,162,59,13,2477,0.0060557125555107,0.0540976988292289,0.398465886152604,0.44691158659669,0.0654016955995155,0.0238191360516754,0.00524828421477594,1136,0.458619297537344,1341,0.541380702462656
"E02002154",24,714,836,854,354,75,15,2872,0.00835654596100279,0.248607242339833,0.29108635097493,0.297353760445682,0.123259052924791,0.0261142061281337,0.00522284122562674,1574,0.548050139275766,1298,0.451949860724234
"E02002155",125,264,923,580,138,15,10,2055,0.0608272506082725,0.128467153284672,0.449148418491484,0.282238442822384,0.0671532846715329,0.0072992700729927,0.0048661800486618,1312,0.638442822384428,743,0.361557177615572
"E02002156",18,47,560,1219,468,67,19,2399,0.00750312630262609,0.019591496456857,0.233430596081701,0.508128386827845,0.195081283868278,0.0279283034597749,0.00791996665277199,625,0.260525218841184,1773,0.73905794080867
"E02002157",1,62,482,1128,553,106,25,2357,0.000424268137462877,0.0263046245226983,0.204497242257106,0.478574459058125,0.234620280016971,0.0449724225710649,0.0106067034365719,545,0.231226134917268,1812,0.768773865082732
"E02002158",62,251,1000,1033,277,70,12,2705,0.0229205175600739,0.0927911275415896,0.369685767097967,0.3818853974122,0.102402957486137,0.0258780036968577,0.0044362292051756,1313,0.48539741219963,1392,0.51460258780037
"E02002159",2,45,507,965,318,45,14,1896,0.00105485232067511,0.0237341772151899,0.267405063291139,0.508966244725738,0.167721518987342,0.0237341772151899,0.00738396624472574,554,0.292194092827004,1342,0.707805907172996
"E02002160",24,254,461,1021,327,41,24,2152,0.0111524163568773,0.118029739776952,0.214219330855019,0.474442379182156,0.151951672862454,0.0190520446096654,0.0111524163568773,739,0.343401486988848,1413,0.656598513011152
"E02002161",2,94,1100,959,300,47,17,2519,0.000793965859468043,0.037316395394998,0.436681222707424,0.380706629614927,0.119094878920206,0.018658197697499,0.00674870980547836,1196,0.47479158396189,1323,0.52520841603811
"E02002162",3,169,634,1263,512,108,8,2697,0.00111234705228031,0.0626622172784575,0.235076010381906,0.468298109010011,0.189840563589173,0.0400444938820912,0.00296625880608083,806,0.298850574712644,1891,0.701149425287356
"E02002163",2,608,2002,1529,524,69,20,4754,0.000420698359276399,0.127892301220025,0.421119057635675,0.321623895666807,0.110222970130416,0.0145140933950358,0.00420698359276399,2612,0.549432057214977,2142,0.450567942785023
"E02002164",0,56,1196,1115,476,98,26,2967,0,0.0188742837883384,0.403100775193798,0.375800471857095,0.160431412200876,0.0330299966295922,0.00876306033029997,1252,0.421975058982137,1715,0.578024941017863
"E02002165",3,82,944,1482,1059,267,79,3916,0.00076608784473953,0.0209397344228805,0.241062308478039,0.378447395301328,0.270429009193054,0.0681818181818182,0.020173646578141,1029,0.262768130745659,2887,0.737231869254341
"E02002166",10,213,1210,1317,281,41,24,3096,0.00322997416020672,0.0687984496124031,0.390826873385013,0.425387596899225,0.0907622739018088,0.0132428940568475,0.00775193798449612,1433,0.462855297157623,1663,0.537144702842377
"E02002167",1,76,650,1070,426,91,13,2327,0.000429737859905458,0.0326600773528148,0.279329608938547,0.45981951009884,0.183068328319725,0.0391061452513966,0.00558659217877095,727,0.312419424151268,1600,0.687580575848732
"E02002168",76,385,2149,2387,979,160,47,6183,0.012291767750283,0.0622675076823548,0.347565906517872,0.3860585476306,0.158337376677988,0.0258774057900695,0.00760148795083293,2610,0.422125181950509,3573,0.577874818049491
"E02002169",4,111,506,1237,612,143,28,2641,0.00151457781143506,0.042029534267323,0.191594093146535,0.468383188186293,0.231730405149565,0.0541461567588035,0.0106020446800454,621,0.235138205225293,2020,0.764861794774707
"E02002170",4,59,487,925,271,38,17,1801,0.00222098833981122,0.0327595780122154,0.270405330372016,0.513603553581344,0.15047196002221,0.0210993892282066,0.00943920044419767,550,0.305385896724042,1251,0.694614103275958
"E02002171",6,124,849,1094,302,43,10,2428,0.00247116968698517,0.0510708401976936,0.349670510708402,0.450576606260297,0.124382207578254,0.0177100494233937,0.00411861614497529,979,0.403212520593081,1449,0.596787479406919
"E02002174",2,135,408,1033,635,134,25,2372,0.000843170320404722,0.0569139966273187,0.172006745362563,0.435497470489039,0.267706576728499,0.0564924114671164,0.010539629005059,545,0.229763912310287,1827,0.770236087689713
"E02002175",8,255,1143,1104,374,74,26,2984,0.00268096514745308,0.085455764075067,0.383042895442359,0.369973190348525,0.125335120643432,0.024798927613941,0.00871313672922252,1406,0.471179624664879,1578,0.528820375335121
"E02002176",1,106,959,848,350,75,18,2357,0.000424268137462877,0.0449724225710649,0.406873143826899,0.359779380568519,0.148493848112007,0.0318201103097157,0.00763682647433178,1066,0.452269834535426,1291,0.547730165464574
"E02002177",8,938,1783,1331,440,76,29,4605,0.00173724212812161,0.203691639522258,0.387187839305103,0.289033659066232,0.0955483170466884,0.0165038002171553,0.00629750271444083,2729,0.592616720955483,1876,0.407383279044517
"E02002178",0,83,305,930,554,75,28,1975,0,0.0420253164556962,0.154430379746835,0.470886075949367,0.280506329113924,0.0379746835443038,0.0141772151898734,388,0.196455696202532,1587,0.803544303797468
"E02002179",1,53,324,897,400,85,17,1777,0.00056274620146314,0.0298255486775464,0.182329769274057,0.504783342712437,0.225098480585256,0.0478334271243669,0.00956668542487338,378,0.212718064153067,1399,0.787281935846933
"E02002180",8,70,608,778,272,36,7,1779,0.00449690837549185,0.0393479482855537,0.341765036537381,0.437324339516582,0.152894884766723,0.0202360876897133,0.00393479482855537,686,0.385609893198426,1093,0.614390106801574
"E02002181",26,423,1392,931,192,27,10,3001,0.00866377874041986,0.140953015661446,0.463845384871709,0.31022992335888,0.0639786737754082,0.00899700099966678,0.00333222259246918,1841,0.613462179273575,1160,0.386537820726425
"E02002182",2,35,665,801,253,45,10,1811,0.00110436223081171,0.0193263390392049,0.367200441744892,0.442297073440088,0.139701822197681,0.0248481501932634,0.00552181115405853,702,0.387631143014909,1109,0.612368856985091
"E02002183",5,233,719,901,331,67,14,2270,0.00220264317180617,0.102643171806167,0.316740088105727,0.396916299559471,0.145814977973568,0.0295154185022026,0.00616740088105727,957,0.4215859030837,1313,0.5784140969163
"E02002184",5,573,1391,1952,909,129,21,4980,0.00100401606425703,0.115060240963855,0.279317269076305,0.391967871485944,0.182530120481928,0.0259036144578313,0.00421686746987952,1969,0.395381526104418,3011,0.604618473895582
"E02002185",22,207,598,974,306,39,7,2153,0.0102183000464468,0.096144914073386,0.277751973989782,0.452392011147236,0.142127264282397,0.0181142591732466,0.00325127728750581,827,0.384115188109614,1326,0.615884811890386
"E02002187",3,393,560,890,338,73,10,2267,0.00132333480370534,0.173356859285399,0.247022496691663,0.39258932509925,0.149095721217468,0.0322011468901632,0.00441111601235112,956,0.421702690780767,1311,0.578297309219232
"E02002188",4,88,543,1193,550,97,41,2516,0.00158982511923688,0.0349761526232114,0.215818759936407,0.474165341812401,0.218600953895072,0.0385532591414944,0.0162957074721781,635,0.252384737678855,1881,0.747615262321145
"E02002189",7,79,340,841,626,112,53,2058,0.00340136054421769,0.0383867832847425,0.165208940719145,0.408649173955296,0.304178814382896,0.054421768707483,0.0257531584062196,426,0.206997084548105,1632,0.793002915451895
"E02002190",0,118,845,1677,1372,181,144,4337,0,0.027207747290754,0.194835139497348,0.386672815310122,0.316347705787411,0.0417339174544616,0.0332026746599032,963,0.222042886788102,3374,0.777957113211898
"E02002191",0,119,994,1533,818,121,88,3673,0,0.0323985842635448,0.270623468554315,0.41736999727743,0.222706234685543,0.0329430982847808,0.0239586169343861,1113,0.30302205281786,2560,0.69697794718214
"E02002192",5,227,976,1294,431,71,21,3025,0.00165289256198347,0.0750413223140496,0.322644628099174,0.427768595041322,0.142479338842975,0.0234710743801653,0.00694214876033058,1208,0.399338842975207,1817,0.600661157024793
"E02002193",0,262,1073,1208,568,101,50,3262,0,0.0803188228080932,0.328939301042305,0.370324954015941,0.174126302881668,0.0309625996321275,0.0153280196198651,1335,0.409258123850399,1927,0.590741876149601
"E02002194",2,255,661,1327,343,59,19,2666,0.000750187546886722,0.095648912228057,0.247936984246062,0.49774943735934,0.128657164291073,0.0221305326331583,0.00712678169542386,918,0.344336084021005,1748,0.655663915978995
"E02002195",2,81,573,963,294,61,13,1987,0.00100654252642174,0.0407649723200805,0.288374433819829,0.484650226472068,0.147961751383996,0.0306995470558631,0.00654252642174132,656,0.330145948666331,1331,0.669854051333669
"E02002196",1,137,544,996,348,59,22,2107,0.000474608448030375,0.0650213573801614,0.258186995728524,0.472710014238253,0.16516373991457,0.0280018984337921,0.0104413858566682,682,0.323682961556716,1425,0.676317038443284
"E02002197",2,407,1387,1385,653,84,32,3950,0.000506329113924051,0.103037974683544,0.351139240506329,0.350632911392405,0.165316455696203,0.0212658227848101,0.00810126582278481,1796,0.454683544303797,2154,0.545316455696203
"E02002198",1,180,1047,1459,493,89,19,3288,0.000304136253041363,0.0547445255474453,0.318430656934307,0.443734793187348,0.149939172749392,0.0270681265206813,0.00577858880778589,1228,0.373479318734793,2060,0.626520681265207
"E02002199",3,611,747,1015,288,43,15,2722,0.00110213078618663,0.224467303453343,0.27443056576047,0.372887582659809,0.105804555473916,0.0157972079353417,0.00551065393093314,1361,0.5,1361,0.5
"E02002200",10,151,624,1546,650,112,28,3121,0.00320410124959949,0.0483819288689523,0.199935917975008,0.495354053188081,0.208266581223967,0.0358859339955143,0.00897148349887856,785,0.25152194809356,2336,0.74847805190644
"E02002201",6,459,2130,1829,511,80,36,5051,0.00118788358740843,0.0908730944367452,0.421698673529994,0.362106513561671,0.101168085527618,0.0158384478321125,0.0071273015244506,2595,0.513759651554148,2456,0.486240348445852
"E02002202",1,483,1306,1277,748,119,27,3961,0.000252461499621308,0.121938904317092,0.329714718505428,0.32239333501641,0.188841201716738,0.0300429184549356,0.00681646048977531,1790,0.451906084322141,2171,0.548093915677859
"E02002203",8,200,994,1383,412,47,15,3059,0.0026152337365152,0.06538084341288,0.324942791762014,0.452108532200065,0.134684537430533,0.0153644982020268,0.004903563255966,1202,0.392938868911409,1857,0.607061131088591
"E02002204",2,269,1108,1764,597,85,16,3841,0.000520697734964853,0.0700338453527727,0.288466545170528,0.459255402239,0.155428273887009,0.0221296537360062,0.00416558187971882,1379,0.359021088258266,2462,0.640978911741734
"E02002205",6,265,834,1519,805,147,62,3638,0.00164925783397471,0.0728422210005498,0.229246838922485,0.417537108301264,0.221275426058274,0.0404068169323804,0.017042330951072,1105,0.303738317757009,2533,0.696261682242991
"E02002206",1,162,813,1471,359,72,12,2890,0.000346020761245675,0.0560553633217993,0.281314878892734,0.508996539792388,0.124221453287197,0.0249134948096886,0.0041522491349481,976,0.337716262975779,1914,0.662283737024221
"E02002207",1,40,300,961,712,120,35,2169,0.000461041954817888,0.0184416781927155,0.138312586445367,0.443061318579991,0.328261871830337,0.0553250345781466,0.0161364684186261,341,0.1572153065929,1828,0.8427846934071
"E02002208",0,316,1132,1321,516,76,27,3388,0,0.0932703659976387,0.334120425029516,0.389905548996458,0.152302243211334,0.0224321133412042,0.00796930342384888,1448,0.427390791027155,1940,0.572609208972845
"E02002209",10,708,1323,1048,163,28,18,3298,0.00303214069132808,0.214675560946028,0.401152213462705,0.317768344451183,0.0494238932686477,0.00848999393571862,0.00545785324439054,2041,0.618859915100061,1257,0.381140084899939
"E02002210",4,31,542,1196,346,59,19,2197,0.00182066454255803,0.0141101502048248,0.246700045516614,0.544378698224852,0.15748748293127,0.026854802002731,0.00864815657715066,577,0.262630860263996,1620,0.737369139736004
"E02002211",0,32,325,770,650,120,45,1942,0,0.0164778578784758,0.16735324407827,0.396498455200824,0.33470648815654,0.0617919670442842,0.0231719876416066,357,0.183831101956746,1585,0.816168898043254
"E02002212",1,413,811,1186,391,65,24,2891,0.000345901072293324,0.142857142857143,0.280525769629886,0.410238671739882,0.13524731926669,0.0224835696990661,0.00830162573503978,1225,0.423728813559322,1666,0.576271186440678
"E02002213",36,605,853,1141,383,81,32,3131,0.011497923985947,0.193229000319387,0.272436921111466,0.364420312999042,0.12232513573938,0.0258703289683807,0.0102203768763973,1494,0.4771638454168,1637,0.5228361545832
"E02002214",15,317,426,986,484,78,27,2333,0.00642948992713245,0.135876553793399,0.182597513930562,0.422631804543506,0.207458208315474,0.0334333476210887,0.0115730818688384,758,0.324903557651093,1575,0.675096442348907
"E02002215",0,62,672,1043,976,113,61,2927,0,0.0211820977109669,0.229586607447899,0.356337546976426,0.333447215579091,0.0386060813119235,0.0208404509736932,734,0.250768705158866,2193,0.749231294841134
"E02002216",15,277,862,967,849,131,113,3214,0.00466708151835719,0.0861854387056627,0.268201617921593,0.300871188550093,0.264156813939017,0.0407591785936528,0.0351586807716241,1154,0.359054138145613,2060,0.640945861854387
"E02002217",0,225,824,1114,935,128,77,3303,0,0.0681198910081744,0.249470178625492,0.33726914925825,0.283075991522858,0.0387526491068725,0.023312140478353,1049,0.317590069633666,2254,0.682409930366334
"E02002218",3,298,1101,1781,597,67,24,3871,0.000774993541720486,0.0769826918109016,0.284422629811418,0.460087832601395,0.154223714802377,0.0173081890984242,0.00619994833376389,1402,0.36218031516404,2469,0.63781968483596
"E02002219",0,28,361,841,818,112,40,2200,0,0.0127272727272727,0.164090909090909,0.382272727272727,0.371818181818182,0.0509090909090909,0.0181818181818182,389,0.176818181818182,1811,0.823181818181818
"E02002220",6,16,428,1259,700,87,41,2537,0.00236499802916831,0.00630666141111549,0.168703192747339,0.49625541978715,0.275916436736303,0.0342924714229405,0.0161608198659834,450,0.177374852187623,2087,0.822625147812377
"E02002222",3,118,847,1276,340,71,23,2678,0.00112023898431665,0.0440627333831217,0.316280806572069,0.47647498132935,0.126960418222554,0.0265123226288275,0.00858849887976102,968,0.361463778939507,1710,0.638536221060493
"E02002223",1,255,597,950,724,103,42,2672,0.000374251497005988,0.0954341317365269,0.223428143712575,0.355538922155689,0.270958083832335,0.0385479041916168,0.0157185628742515,853,0.319236526946108,1819,0.680763473053892
"E02002224",0,19,448,1107,1220,149,72,3015,0,0.00630182421227197,0.148590381426202,0.367164179104478,0.404643449419569,0.0494195688225539,0.0238805970149254,467,0.154892205638474,2548,0.845107794361526
"E02002225",2,335,883,1326,484,82,41,3153,0.000634316523945449,0.106248017760863,0.280050745321916,0.420551855375833,0.153504598794799,0.0260069774817634,0.0130034887408817,1220,0.386933079606724,1933,0.613066920393276
"E02002226",0,239,581,1537,1439,207,57,4060,0,0.0588669950738916,0.143103448275862,0.378571428571429,0.354433497536946,0.0509852216748768,0.0140394088669951,820,0.201970443349754,3240,0.798029556650246
"E02002227",0,102,700,1005,612,97,56,2572,0,0.0396578538102644,0.272161741835148,0.390746500777605,0.237947122861586,0.0377138413685848,0.0217729393468118,802,0.311819595645412,1770,0.688180404354588
"E02002228",13,357,978,1101,442,59,30,2980,0.00436241610738255,0.119798657718121,0.328187919463087,0.369463087248322,0.148322147651007,0.0197986577181208,0.0100671140939597,1348,0.452348993288591,1632,0.547651006711409
"E02002229",1,294,750,1317,453,55,26,2896,0.000345303867403315,0.101519337016575,0.258977900552486,0.454765193370166,0.156422651933702,0.0189917127071823,0.00897790055248619,1045,0.360842541436464,1851,0.639157458563536
"E02002230",0,200,847,1048,766,93,53,3007,0,0.066511473229132,0.281676089125374,0.348520119720652,0.254738942467576,0.0309278350515464,0.01762554040572,1047,0.348187562354506,1960,0.651812437645494
"E02002231",10,122,1260,1777,807,99,40,4115,0.00243013365735115,0.0296476306196841,0.306196840826245,0.4318347509113,0.196111786148238,0.0240583232077764,0.00972053462940462,1392,0.338274605103281,2723,0.661725394896719
"E02002232",0,66,614,1029,726,121,72,2628,0,0.0251141552511416,0.233637747336377,0.391552511415525,0.276255707762557,0.0460426179604262,0.0273972602739726,680,0.258751902587519,1948,0.741248097412481
"E02002233",0,51,572,1227,724,75,53,2702,0,0.0188749074759437,0.211695040710585,0.454108068097705,0.267949666913397,0.0277572168763879,0.0196150999259808,623,0.230569948186529,2079,0.769430051813472
"E02002234",2,74,1781,1357,197,29,21,3461,0.000577867668303958,0.0213811037272465,0.514591158624675,0.392083212944236,0.0569199653279399,0.0083790811904074,0.00606761051719156,1857,0.536550130020225,1604,0.463449869979775
"E02002235",0,72,584,892,850,88,34,2520,0,0.0285714285714286,0.231746031746032,0.353968253968254,0.337301587301587,0.0349206349206349,0.0134920634920635,656,0.26031746031746,1864,0.73968253968254
"E02002236",1,15,422,1065,532,77,34,2146,0.000465983224603914,0.00698974836905871,0.196644920782852,0.496272134203169,0.247903075489282,0.0358807082945014,0.0158434296365331,438,0.204100652376514,1708,0.795899347623486
"E02002237",0,110,664,1441,455,79,35,2784,0,0.0395114942528736,0.238505747126437,0.517600574712644,0.163433908045977,0.0283764367816092,0.0125718390804598,774,0.27801724137931,2010,0.72198275862069
"E02002238",0,49,699,1059,427,70,30,2334,0,0.0209940017137961,0.299485861182519,0.453727506426735,0.182947729220223,0.0299914310197087,0.012853470437018,748,0.320479862896315,1586,0.679520137103685
"E02002239",4,387,1392,1415,546,81,37,3862,0.00103573278094252,0.100207146556189,0.360435007767996,0.366390471258415,0.141377524598654,0.020973588814086,0.00958052822371828,1783,0.461677887105127,2079,0.538322112894873
"E02002240",7,483,920,1999,629,93,39,4170,0.00167865707434053,0.115827338129496,0.220623501199041,0.479376498800959,0.15083932853717,0.0223021582733813,0.00935251798561151,1410,0.338129496402878,2760,0.661870503597122
"E02002241",5,290,1517,2158,485,76,26,4557,0.0010972130787799,0.0636383585692342,0.332894448101821,0.473557164801404,0.10642966864165,0.0166776387974545,0.00570550800965547,1812,0.397630019749835,2745,0.602369980250165
"E02002242",7,198,720,1140,462,64,19,2610,0.00268199233716475,0.0758620689655172,0.275862068965517,0.436781609195402,0.177011494252874,0.0245210727969349,0.00727969348659004,925,0.354406130268199,1685,0.645593869731801
"E02002243",2,158,1256,1725,631,103,35,3910,0.00051150895140665,0.0404092071611253,0.321227621483376,0.441176470588235,0.161381074168798,0.0263427109974425,0.00895140664961637,1416,0.362148337595908,2494,0.637851662404092
"E02002244",5,146,737,816,226,36,12,1979,0.00252652854977261,0.0737746336533603,0.372410308236483,0.41232945932289,0.114199090449722,0.0181910055583628,0.00606366851945427,888,0.448711470439616,1090,0.55078322385043
"E02002245",4,207,1229,936,170,34,94,2674,0.00149588631264024,0.0774121166791324,0.459611069558714,0.350037397157816,0.0635751682872102,0.012715033657442,0.0351533283470456,1440,0.538519072550486,1234,0.461480927449514
"E02002246",11,183,771,1492,567,89,37,3150,0.00349206349206349,0.0580952380952381,0.244761904761905,0.473650793650794,0.18,0.0282539682539683,0.0117460317460317,965,0.306349206349206,2185,0.693650793650794
"E02002247",7,154,912,1431,900,232,71,3707,0.00188831939573779,0.0415430267062315,0.246021041273267,0.38602643647154,0.242783922309145,0.062584299973024,0.0191529538710548,1073,0.289452387375236,2634,0.710547612624764
"E02002248",1,254,1136,1435,425,56,20,3327,0.000300571085061617,0.0763450556056507,0.341448752629997,0.43131950706342,0.127742711151187,0.0168319807634506,0.00601142170123234,1391,0.418094379320709,1936,0.581905620679291
"E02002249",0,67,898,1065,415,79,32,2556,0,0.0262128325508607,0.35133020344288,0.416666666666667,0.162363067292645,0.0309076682316119,0.0125195618153365,965,0.37754303599374,1591,0.62245696400626
"E02002250",19,108,951,1363,602,140,53,3236,0.00587144622991347,0.0333745364647713,0.293881334981459,0.421199011124845,0.186032138442522,0.0432632880098888,0.0163782447466007,1078,0.333127317676143,2158,0.666872682323857
"E02002251",3,420,1824,1840,880,170,83,5220,0.000574712643678161,0.0804597701149425,0.349425287356322,0.352490421455939,0.168582375478927,0.0325670498084291,0.0159003831417625,2247,0.430459770114943,2973,0.569540229885057
"E02002252",1,152,678,967,322,71,16,2207,0.000453103760761214,0.0688717716357046,0.307204349796103,0.438151336656094,0.145899410965111,0.0321703670140462,0.00724966017217943,831,0.376529225192569,1376,0.623470774807431
"E02002253",1,70,644,1338,818,119,53,3043,0.000328623069339468,0.0230036148537627,0.211633256654617,0.439697666776208,0.268813670719685,0.0391061452513966,0.0174170226749918,715,0.234965494577719,2328,0.765034505422281
"E02002254",7,376,433,877,400,65,15,2173,0.00322135296824666,0.173032673722964,0.199263690750115,0.403589507593189,0.184077312471238,0.0299125632765762,0.00690289921767142,816,0.375517717441325,1357,0.624482282558675
"E02002255",1,193,989,944,893,131,89,3240,0.000308641975308642,0.0595679012345679,0.305246913580247,0.291358024691358,0.275617283950617,0.0404320987654321,0.0274691358024691,1183,0.365123456790123,2057,0.634876543209877
"E02002256",15,177,974,1400,897,193,68,3730,0.00402144772117962,0.0474530831099196,0.26112600536193,0.375335120643432,0.240482573726542,0.0517426273458445,0.018230563002681,1166,0.31260053619303,2558,0.685790884718499
"E02002257",0,55,258,866,868,153,81,2281,0,0.0241122314774222,0.113108285839544,0.379658044717229,0.38053485313459,0.0670758439281017,0.0355107409031127,313,0.137220517316966,1968,0.862779482683034
"E02002258",2,180,1136,1370,576,99,28,3391,0.000589796520200531,0.0530816868180478,0.335004423473902,0.404010616337364,0.169861397817753,0.0291949277499263,0.00825715128280743,1318,0.38867590681215,2073,0.61132409318785
"E02002259",0,255,550,1139,869,111,39,2963,0,0.0860614242321971,0.185622679716504,0.384407694903814,0.293283833952076,0.0374620317246034,0.0131623354708066,805,0.271684103948701,2158,0.728315896051299
"E02002260",18,278,1269,1475,901,126,49,4116,0.0043731778425656,0.0675413022351798,0.308309037900875,0.358357628765792,0.218901846452867,0.0306122448979592,0.0119047619047619,1565,0.38022351797862,2551,0.61977648202138
"E02002261",1,167,924,1423,533,88,40,3176,0.000314861460957179,0.0525818639798489,0.290931989924433,0.448047858942066,0.167821158690176,0.0277078085642317,0.0125944584382872,1092,0.343828715365239,2084,0.656171284634761
"E02002262",21,177,864,1513,597,117,37,3326,0.00631389055923031,0.0532170775706554,0.259771497294047,0.454900781719784,0.179494888755262,0.0351773902585688,0.0111244738424534,1062,0.319302465423933,2264,0.680697534576067
"E02002263",5,92,723,1124,376,86,27,2433,0.0020550760378134,0.0378133990957665,0.297163995067817,0.461981093300452,0.154541718043568,0.0353473078503905,0.0110974106041924,820,0.337032470201397,1613,0.662967529798603
"E02002264",1,142,611,971,579,100,18,2422,0.000412881915772089,0.0586292320396367,0.252270850536746,0.400908340214699,0.23905862923204,0.0412881915772089,0.0074318744838976,754,0.311312964492155,1668,0.688687035507845
"E02002265",2,139,533,825,462,112,44,2117,0.000944733112895607,0.0656589513462447,0.251771374586679,0.389702409069438,0.218233349078885,0.052905054322154,0.0207841284837034,674,0.31837505904582,1443,0.68162494095418
"E02002266",6,128,514,933,338,63,22,2004,0.0029940119760479,0.063872255489022,0.256487025948104,0.465568862275449,0.168662674650699,0.031437125748503,0.0109780439121756,648,0.323353293413174,1356,0.676646706586826
"E02002267",2,327,1214,1169,297,50,23,3082,0.000648929266709929,0.106099935107073,0.393900064892927,0.379299156391953,0.0963659961064244,0.0162232316677482,0.00746268656716418,1543,0.50064892926671,1539,0.49935107073329
"E02002268",2,430,1245,1815,778,115,53,4438,0.000450653447498873,0.0968904912122578,0.280531771068049,0.408968003605228,0.175304191077062,0.0259125732311852,0.0119423163587201,1677,0.377872915727805,2761,0.622127084272195
"E02002269",5,220,960,1542,568,99,31,3425,0.00145985401459854,0.0642335766423358,0.28029197080292,0.45021897810219,0.165839416058394,0.0289051094890511,0.00905109489051095,1185,0.345985401459854,2240,0.654014598540146
"E02002270",6,180,878,1056,470,115,59,2764,0.00217076700434153,0.065123010130246,0.317655571635311,0.38205499276411,0.170043415340087,0.0416063675832127,0.0213458755426917,1064,0.384949348769899,1700,0.615050651230101
"E02002271",3,258,694,1110,337,59,16,2477,0.00121114251110214,0.104158255954784,0.280177634234962,0.448122729107792,0.136051675413807,0.0238191360516754,0.00645942672587808,955,0.385547032700848,1522,0.614452967299152
"E02002272",72,237,1201,1421,340,58,19,3348,0.021505376344086,0.0707885304659498,0.358721624850657,0.424432497013142,0.101553166069295,0.0173237753882915,0.00567502986857826,1510,0.451015531660693,1838,0.548984468339307
"E02002273",9,344,517,1085,291,58,16,2320,0.00387931034482759,0.148275862068966,0.222844827586207,0.467672413793103,0.125431034482759,0.025,0.00689655172413793,870,0.375,1450,0.625
"E02002274",21,144,796,908,240,35,11,2155,0.00974477958236659,0.0668213457076566,0.369373549883991,0.421345707656613,0.111368909512761,0.0162412993039443,0.00510440835266821,961,0.445939675174014,1194,0.554060324825986
"E02002275",1,319,1264,1387,432,81,21,3505,0.000285306704707561,0.0910128388017118,0.360627674750357,0.395720399429387,0.123252496433666,0.0231098430813124,0.00599144079885877,1584,0.451925820256776,1921,0.548074179743224
"E02002276",1,172,676,1145,317,51,14,2376,0.000420875420875421,0.0723905723905724,0.284511784511784,0.481902356902357,0.133417508417508,0.0214646464646465,0.00589225589225589,849,0.357323232323232,1527,0.642676767676768
"E02002277",60,104,521,971,396,78,19,2149,0.027919962773383,0.0483946021405305,0.242438343415542,0.451838064215914,0.184271754304328,0.0362959516053979,0.00884132154490461,685,0.318752908329456,1464,0.681247091670544
"E02002278",32,279,816,834,214,33,7,2215,0.0144469525959368,0.125959367945824,0.368397291196388,0.376523702031603,0.0966139954853273,0.0148984198645598,0.00316027088036117,1127,0.508803611738149,1088,0.491196388261851
"E02002279",2,157,883,990,344,46,17,2439,0.000820008200082001,0.0643706437064371,0.362033620336203,0.40590405904059,0.141041410414104,0.018860188601886,0.00697006970069701,1042,0.427224272242722,1397,0.572775727757278
"E02002280",0,215,1315,826,317,63,25,2761,0,0.0778703368344803,0.476276711336472,0.299166968489678,0.11481347337921,0.0228178196305686,0.00905469032959073,1530,0.554147048170953,1231,0.445852951829047
"E02002281",4,222,1162,1583,548,111,45,3675,0.00108843537414966,0.0604081632653061,0.316190476190476,0.430748299319728,0.149115646258503,0.0302040816326531,0.0122448979591837,1388,0.377687074829932,2287,0.622312925170068
"E02002282",0,153,771,907,354,58,23,2266,0,0.0675198587819947,0.340247131509267,0.400264783759929,0.156222418358341,0.0255957634598411,0.0101500441306267,924,0.407766990291262,1342,0.592233009708738
"E02002283",1,41,543,846,439,84,21,1975,0.000506329113924051,0.0207594936708861,0.274936708860759,0.428354430379747,0.222278481012658,0.0425316455696203,0.0106329113924051,585,0.29620253164557,1390,0.70379746835443
"E02002284",6,419,549,926,268,52,11,2231,0.00268937696100403,0.187808157776782,0.246077991931869,0.415060510981623,0.12012550425818,0.023307933662035,0.0049305244285074,974,0.436575526669655,1257,0.563424473330345
"E02002285",3,116,739,1134,338,57,24,2411,0.0012442969722107,0.0481128162588138,0.306511820821236,0.470344255495645,0.140190792202406,0.0236416424720033,0.00995437577768561,858,0.35586893405226,1553,0.64413106594774
"E02002286",0,85,881,829,198,39,19,2051,0,0.0414431984397855,0.429546562652365,0.404193076548025,0.0965382740126767,0.0190151145782545,0.00926377376889322,966,0.47098976109215,1085,0.52901023890785
"E02002287",0,90,1063,927,498,99,25,2702,0,0.0333086602516654,0.393412287194671,0.343079200592154,0.184307920059215,0.036639526276832,0.00925240562546262,1153,0.426720947446336,1549,0.573279052553664
"E02002288",1,438,1210,1268,302,60,25,3304,0.000302663438256659,0.132566585956416,0.366222760290557,0.383777239709443,0.0914043583535109,0.0181598062953995,0.00756658595641646,1649,0.49909200968523,1655,0.50090799031477
"E02002289",0,70,764,687,259,35,18,1833,0,0.0381887615930169,0.416803055100927,0.374795417348609,0.141298417894163,0.0190943807965085,0.00981996726677578,834,0.454991816693944,999,0.545008183306056
"E02002290",2,225,534,1029,223,30,9,2052,0.000974658869395711,0.109649122807018,0.260233918128655,0.501461988304094,0.108674463937622,0.0146198830409357,0.0043859649122807,761,0.370857699805068,1291,0.629142300194932
"E02002291",1,250,664,925,250,33,13,2136,0.000468164794007491,0.117041198501873,0.310861423220974,0.433052434456929,0.117041198501873,0.0154494382022472,0.00608614232209738,915,0.428370786516854,1221,0.571629213483146
"E02002292",17,251,540,843,231,43,10,1935,0.00878552971576227,0.129715762273902,0.27906976744186,0.435658914728682,0.11937984496124,0.0222222222222222,0.00516795865633075,808,0.417571059431525,1127,0.582428940568475
"E02002293",2,89,864,888,433,64,28,2368,0.000844594594594595,0.0375844594594595,0.364864864864865,0.375,0.18285472972973,0.027027027027027,0.0118243243243243,955,0.403293918918919,1413,0.596706081081081
"E02002294",1,195,782,1067,458,50,15,2568,0.000389408099688474,0.0759345794392523,0.304517133956386,0.415498442367601,0.178348909657321,0.0194704049844237,0.0058411214953271,978,0.380841121495327,1590,0.619158878504673
"E02002295",1,111,1393,848,190,38,18,2599,0.000384763370527126,0.042708734128511,0.535975375144286,0.326279338207003,0.0731050404001539,0.0146210080800308,0.00692574066948826,1505,0.579068872643324,1094,0.420931127356676
"E02002296",0,387,869,1020,348,48,11,2683,0,0.144241520685799,0.323891166604547,0.380171449869549,0.129705553484905,0.0178904211703317,0.00409988818486769,1256,0.468132687290347,1427,0.531867312709653
"E02002297",8,227,573,1005,371,62,14,2260,0.00353982300884956,0.100442477876106,0.25353982300885,0.444690265486726,0.164159292035398,0.0274336283185841,0.00619469026548673,808,0.357522123893805,1452,0.642477876106195
"E02002298",2,70,822,980,231,48,12,2165,0.00092378752886836,0.0323325635103926,0.379676674364896,0.452655889145497,0.106697459584296,0.0221709006928406,0.00554272517321016,894,0.412933025404157,1271,0.587066974595843
"E02002299",21,271,1095,1448,475,80,40,3430,0.00612244897959184,0.0790087463556851,0.319241982507289,0.422157434402332,0.138483965014577,0.0233236151603499,0.0116618075801749,1387,0.404373177842566,2043,0.595626822157434
"E02002300",4,972,763,936,243,33,7,2958,0.00135226504394861,0.328600405679513,0.257944557133198,0.316430020283976,0.0821501014198783,0.0111561866125761,0.00236646382691007,1739,0.58789722785666,1219,0.41210277214334
"E02002301",3,129,649,1263,730,98,61,2933,0.00102284350494374,0.043982270712581,0.22127514490283,0.430617115581316,0.248891919536311,0.0334128878281623,0.0207978179338561,781,0.266280259120355,2152,0.733719740879645
"E02002302",2,95,634,790,237,54,10,1822,0.00109769484083425,0.0521405049396268,0.347969264544457,0.433589462129528,0.130076838638858,0.0296377607025247,0.00548847420417124,731,0.401207464324918,1091,0.598792535675082
"E02002303",0,153,713,1202,470,76,24,2638,0,0.0579984836997726,0.270280515542077,0.455648218347233,0.178165276724792,0.0288097043214556,0.0090978013646702,866,0.32827899924185,1772,0.67172100075815
"E02002304",0,90,868,1232,688,117,33,3028,0,0.0297225891677675,0.28665785997358,0.406869220607662,0.227212681638045,0.0386393659180978,0.0108982826948481,958,0.316380449141347,2070,0.683619550858653
"E02002305",0,70,891,970,253,40,14,2238,0,0.031277926720286,0.398123324396783,0.433422698838248,0.113047363717605,0.0178731009830206,0.00625558534405719,961,0.429401251117069,1277,0.570598748882931
"E02002306",5,125,486,899,284,54,15,1868,0.00267665952890792,0.0669164882226981,0.26017130620985,0.481263383297645,0.15203426124197,0.0289079229122056,0.00802997858672377,616,0.329764453961456,1252,0.670235546038544
"E02002307",29,29,611,938,264,54,21,1946,0.0149023638232271,0.0149023638232271,0.313977389516958,0.482014388489209,0.135662898252826,0.0277492291880781,0.0107913669064748,669,0.343782117163412,1277,0.656217882836588
"E02002308",0,285,684,1049,377,54,15,2464,0,0.115665584415584,0.277597402597403,0.425730519480519,0.153003246753247,0.0219155844155844,0.00608766233766234,969,0.393262987012987,1495,0.606737012987013
"E02002309",1,130,818,1075,523,102,20,2669,0.000374672161858374,0.0487073810415886,0.30648182840015,0.402772573997752,0.19595354065193,0.0382165605095541,0.00749344323716748,949,0.355563881603597,1720,0.644436118396403
"E02002310",8,145,755,1007,358,54,20,2347,0.0034086067319983,0.0617809970174691,0.321687260332339,0.429058372390285,0.152535151256924,0.0230080954409885,0.00852151682999574,908,0.386876864081807,1439,0.613123135918193
"E02002311",4,189,837,1009,268,52,8,2367,0.00168990283058724,0.0798479087452472,0.35361216730038,0.426277989015632,0.113223489649345,0.0219687367976341,0.00337980566117448,1030,0.435149978876215,1337,0.564850021123785
"E02002312",13,339,1092,1352,435,48,23,3302,0.00393700787401575,0.102665051483949,0.330708661417323,0.409448818897638,0.131738340399758,0.0145366444579043,0.00696547546941248,1444,0.437310720775288,1858,0.562689279224712
"E02002313",0,42,396,1240,747,111,53,2589,0,0.0162224797219003,0.152954808806489,0.478949401313248,0.288528389339513,0.0428736964078795,0.0204712244109695,438,0.169177288528389,2151,0.830822711471611
"E02002314",1,36,460,1059,280,58,18,1912,0.000523012552301255,0.0188284518828452,0.240585774058577,0.553870292887029,0.146443514644351,0.0303347280334728,0.00941422594142259,497,0.259937238493724,1415,0.740062761506276
"E02002315",3,217,696,1345,566,91,27,2945,0.00101867572156197,0.0736842105263158,0.236332767402377,0.456706281833616,0.192190152801358,0.0308998302207131,0.00916808149405773,916,0.311035653650255,2029,0.688964346349745
"E02002316",9,255,604,897,238,40,13,2056,0.00437743190661479,0.124027237354086,0.293774319066148,0.436284046692607,0.115758754863813,0.0194552529182879,0.00632295719844358,868,0.422178988326848,1188,0.577821011673152
"E02002317",0,303,647,1199,496,76,24,2745,0,0.110382513661202,0.235701275045537,0.436794171220401,0.180692167577413,0.0276867030965392,0.0087431693989071,950,0.34608378870674,1795,0.65391621129326
"E02002318",8,119,736,979,324,51,17,2234,0.0035810205908684,0.0532676812891674,0.329453894359893,0.43822739480752,0.14503133393017,0.022829006266786,0.00760966875559534,863,0.386302596239928,1371,0.613697403760072
"E02002319",8,239,600,1075,372,80,26,2400,0.00333333333333333,0.0995833333333333,0.25,0.447916666666667,0.155,0.0333333333333333,0.0108333333333333,847,0.352916666666667,1553,0.647083333333333
"E02002320",9,155,752,1038,347,44,15,2360,0.0038135593220339,0.0656779661016949,0.31864406779661,0.439830508474576,0.147033898305085,0.0186440677966102,0.00635593220338983,916,0.388135593220339,1444,0.611864406779661
"E02002321",2,276,684,840,263,63,21,2149,0.000930665425779432,0.128431828757562,0.318287575616566,0.390879478827362,0.122382503489995,0.0293159609120521,0.00977198697068404,962,0.447650069799907,1187,0.552349930200093
"E02002322",3,125,454,981,392,111,48,2114,0.00141911069063387,0.0591296121097446,0.214758751182592,0.464049195837275,0.185430463576159,0.0525070955534532,0.0227057710501419,582,0.275307473982971,1532,0.724692526017029
"E02002323",15,301,802,1217,371,81,25,2812,0.00533428165007112,0.107041251778094,0.285206258890469,0.432788051209104,0.131934566145092,0.0288051209103841,0.00889046941678521,1118,0.397581792318634,1694,0.602418207681366
"E02002324",44,494,595,988,257,56,21,2455,0.0179226069246436,0.20122199592668,0.242362525458248,0.40244399185336,0.104684317718941,0.0228105906313646,0.00855397148676171,1133,0.461507128309572,1322,0.538492871690428
"E02002325",7,456,984,1214,356,47,29,3093,0.00226317491108956,0.147429679922405,0.318137730358875,0.392499191723246,0.115098609763983,0.0151956029744585,0.00937601034594245,1447,0.46783058519237,1646,0.53216941480763
"E02002326",1,128,449,837,276,67,14,1772,0.000564334085778781,0.072234762979684,0.253386004514673,0.47234762979684,0.155756207674944,0.0378103837471783,0.00790067720090293,578,0.326185101580135,1194,0.673814898419865
"E02002327",7,363,968,1310,457,88,35,3228,0.00216852540272615,0.112453531598513,0.299876084262701,0.405824039653036,0.141573729863693,0.0272614622057001,0.0108426270136307,1338,0.414498141263941,1890,0.585501858736059
"E02002328",10,261,671,900,323,101,31,2297,0.0043535045711798,0.113626469307793,0.292120156726165,0.391815411406182,0.140618197649108,0.043970396168916,0.0134958641706574,942,0.410100130605137,1355,0.589899869394863
"E02002329",12,426,1180,1692,591,123,45,4069,0.00294912754976653,0.104694028016712,0.289997542393709,0.41582698451708,0.145244531826001,0.0302285573851069,0.0110592283116245,1618,0.397640697960187,2451,0.602359302039813
"E02002330",15,364,463,1011,249,29,3,2134,0.007029053420806,0.170571696344892,0.216963448922212,0.473758200562324,0.11668228678538,0.0135895032802249,0.0014058106841612,842,0.39456419868791,1292,0.60543580131209
"E02002331",58,602,933,897,259,43,18,2810,0.0206405693950178,0.21423487544484,0.33202846975089,0.319217081850534,0.0921708185053381,0.0153024911032028,0.00640569395017794,1593,0.566903914590747,1217,0.433096085409253
"E02002332",0,291,659,927,257,46,23,2203,0,0.132092600998638,0.299137539718566,0.420789832047208,0.116659101225601,0.0208806173399909,0.0104403086699955,950,0.431230140717204,1253,0.568769859282796
"E02002333",7,130,785,1365,570,87,26,2970,0.00235690235690236,0.0437710437710438,0.264309764309764,0.45959595959596,0.191919191919192,0.0292929292929293,0.00875420875420875,922,0.31043771043771,2048,0.689562289562289
"E02002334",24,251,804,1106,358,87,19,2649,0.00906002265005663,0.0947527368818422,0.303510758776897,0.417516043790109,0.135145337863345,0.0328425821064553,0.00717251793129483,1079,0.407323518308796,1570,0.592676481691204
"E02002335",10,180,575,1061,439,86,20,2371,0.00421762969211303,0.0759173344580346,0.242513707296499,0.447490510333193,0.185153943483762,0.0362716153521721,0.00843525938422606,765,0.322648671446647,1606,0.677351328553353
"E02002336",5,389,510,932,423,101,37,2397,0.00208594075928244,0.162286191072174,0.212765957446809,0.388819357530246,0.176470588235294,0.0421360033375052,0.01543596161869,904,0.377138089278264,1493,0.622861910721735
"E02002337",9,263,930,983,343,57,15,2600,0.00346153846153846,0.101153846153846,0.357692307692308,0.378076923076923,0.131923076923077,0.0219230769230769,0.00576923076923077,1202,0.462307692307692,1398,0.537692307692308
"E02002338",1,304,905,1004,323,46,12,2595,0.000385356454720617,0.117148362235067,0.348747591522158,0.386897880539499,0.124470134874759,0.0177263969171484,0.0046242774566474,1210,0.466281310211946,1385,0.533718689788054
"E02002339",1,49,886,950,286,51,15,2238,0.000446827524575514,0.0218945487042002,0.395889186773905,0.424486148346738,0.127792672028597,0.0227882037533512,0.00670241286863271,936,0.418230563002681,1302,0.581769436997319
"E02002340",0,188,609,1005,344,52,12,2210,0,0.0850678733031674,0.275565610859729,0.454751131221719,0.155656108597285,0.0235294117647059,0.00542986425339366,797,0.360633484162896,1413,0.639366515837104
"E02002341",4,93,626,1119,346,64,10,2262,0.0017683465959328,0.0411140583554377,0.276746242263484,0.494694960212202,0.152961980548187,0.0282935455349248,0.00442086648983201,723,0.319628647214854,1539,0.680371352785146
"E02002342",16,241,688,1100,215,23,2,2285,0.00700218818380744,0.1054704595186,0.30109409190372,0.481400437636761,0.0940919037199125,0.0100656455142232,0.00087527352297593,945,0.413566739606127,1340,0.586433260393873
"E02002343",0,60,568,1046,287,43,5,2009,0,0.0298656047784968,0.282727725236436,0.520657043305127,0.142857142857143,0.0214036834245893,0.00248880039820806,628,0.312593330014933,1381,0.687406669985067
"E02002344",0,157,916,1503,385,52,6,3019,0,0.0520039748261014,0.303411725736999,0.497846969195098,0.127525670751905,0.0172242464392183,0.00198741305067903,1073,0.3554157005631,1946,0.6445842994369
"E02002345",22,326,443,972,254,42,7,2066,0.010648596321394,0.157792836398838,0.214424007744434,0.470474346563408,0.122942884801549,0.0203291384317522,0.00338818973862536,791,0.382865440464666,1275,0.617134559535334
"E02002346",0,81,847,1118,254,39,6,2345,0,0.0345415778251599,0.361194029850746,0.476759061833689,0.108315565031983,0.0166311300639659,0.00255863539445629,928,0.395735607675906,1417,0.604264392324094
"E02002347",0,91,904,1083,365,60,20,2523,0,0.0360681728101467,0.358303606817281,0.429250891795482,0.144669044787951,0.0237812128418549,0.00792707094728498,995,0.394371779627428,1528,0.605628220372572
"E02002348",0,284,813,1218,341,48,17,2721,0,0.104373392135244,0.298787210584344,0.447629547960309,0.125321572951121,0.0176405733186329,0.00624770305034914,1097,0.403160602719588,1624,0.596839397280412
"E02002349",0,116,806,986,403,111,25,2447,0,0.0474049856967716,0.329382917858602,0.402942378422558,0.164691458929301,0.0453616673477728,0.0102165917449939,922,0.376787903555374,1525,0.623212096444626
"E02002350",0,47,438,1001,321,41,11,1859,0,0.0252824098977945,0.235610543302851,0.538461538461538,0.172673480365788,0.0220548682087144,0.00591715976331361,485,0.260892953200646,1374,0.739107046799354
"E02002351",16,239,348,797,280,71,13,1764,0.0090702947845805,0.135487528344671,0.197278911564626,0.451814058956916,0.158730158730159,0.040249433106576,0.00736961451247166,603,0.341836734693878,1161,0.658163265306122
"E02002352",3,105,802,1285,471,75,13,2754,0.00108932461873638,0.0381263616557734,0.29121278140886,0.466594045025418,0.171023965141612,0.0272331154684096,0.004720406681191,910,0.33042846768337,1844,0.66957153231663
"E02002353",0,89,398,870,345,63,11,1776,0,0.0501126126126126,0.224099099099099,0.489864864864865,0.194256756756757,0.035472972972973,0.00619369369369369,487,0.274211711711712,1289,0.725788288288288
"E02002354",0,199,827,1305,451,67,10,2859,0,0.0696047569080098,0.289261979713186,0.456453305351522,0.157747464148304,0.0234347674011892,0.00349772647778944,1026,0.358866736621196,1833,0.641133263378804
"E02002356",68,609,700,1267,537,77,27,3285,0.0207001522070015,0.185388127853881,0.213089802130898,0.385692541856925,0.163470319634703,0.0234398782343988,0.00821917808219178,1377,0.419178082191781,1908,0.580821917808219
"E02002357",0,130,1102,1529,410,57,12,3240,0,0.0401234567901235,0.340123456790123,0.471913580246914,0.126543209876543,0.0175925925925926,0.0037037037037037,1232,0.380246913580247,2008,0.619753086419753
"E02002358",15,513,960,1082,227,43,7,2847,0.00526870389884088,0.180189673340358,0.337197049525817,0.380049174569723,0.0797330523357921,0.0151036178433439,0.00245872848612575,1488,0.522655426765016,1359,0.477344573234984
"E02002359",46,230,600,914,297,70,13,2170,0.0211981566820276,0.105990783410138,0.276497695852535,0.421198156682028,0.136866359447005,0.032258064516129,0.00599078341013825,876,0.4036866359447,1294,0.5963133640553
"E02002360",0,87,1284,1165,329,26,9,2900,0,0.03,0.442758620689655,0.401724137931035,0.113448275862069,0.00896551724137931,0.00310344827586207,1371,0.472758620689655,1529,0.527241379310345
"E02002361",2,56,604,906,424,73,14,2079,0.000962000962000962,0.0269360269360269,0.290524290524291,0.435786435786436,0.203944203944204,0.0351130351130351,0.00673400673400673,662,0.318422318422318,1417,0.681577681577682
"E02002362",17,189,1410,1309,431,97,24,3477,0.00488927236123095,0.0543572044866264,0.405522001725626,0.376473971814783,0.123957434570032,0.0278976128846707,0.00690250215703192,1616,0.464768478573483,1861,0.535231521426517
"E02002363",0,172,1045,1398,562,68,20,3265,0,0.0526799387442573,0.320061255742726,0.428177641653905,0.172128637059724,0.0208269525267994,0.00612557427258806,1217,0.372741194486983,2048,0.627258805513017
"E02002364",12,157,1306,908,242,74,17,2716,0.00441826215022091,0.0578055964653903,0.480854197349043,0.334315169366716,0.0891016200294551,0.0272459499263623,0.00625920471281296,1475,0.543078055964654,1241,0.456921944035346
"E02002366",0,74,595,1154,502,98,34,2457,0,0.0301180301180301,0.242165242165242,0.46967846967847,0.204314204314204,0.0398860398860399,0.0138380138380138,669,0.272283272283272,1788,0.727716727716728
"E02002367",44,245,1019,988,328,64,17,2705,0.0162661737523105,0.0905730129390018,0.376709796672828,0.365249537892791,0.121256931608133,0.0236598890942699,0.00628465804066543,1308,0.48354898336414,1397,0.51645101663586
"E02002368",1,219,827,1367,483,73,14,2984,0.000335120643431635,0.0733914209115281,0.277144772117962,0.458109919571046,0.16186327077748,0.0244638069705094,0.0046916890080429,1047,0.350871313672922,1937,0.649128686327078
"E02002369",140,519,1284,1178,358,127,47,3653,0.0383246646591842,0.14207500684369,0.351491924445661,0.322474678346564,0.0980016424856282,0.0347659457979743,0.0128661374212976,1943,0.531891595948535,1710,0.468108404051465
"E02002370",5,306,1427,931,293,108,28,3098,0.00161394448030988,0.0987734021949645,0.460619754680439,0.300516462233699,0.0945771465461588,0.0348612007746934,0.00903808908973531,1738,0.561007101355713,1360,0.438992898644287
"E02002371",2,200,1512,1733,703,120,38,4308,0.000464252553389044,0.0464252553389044,0.350974930362117,0.402274837511606,0.163184772516249,0.0278551532033426,0.00882079851439183,1714,0.39786443825441,2594,0.60213556174559
"E02002373",0,147,959,1691,658,47,20,3522,0,0.0417376490630324,0.27228847245883,0.480124929017604,0.186825667234526,0.0133446905167518,0.0056785917092561,1106,0.314026121521863,2416,0.685973878478137
"E02002374",1,247,1030,1363,514,125,45,3325,0.000300751879699248,0.0742857142857143,0.309774436090226,0.409924812030075,0.154586466165414,0.037593984962406,0.0135338345864662,1278,0.384360902255639,2047,0.615639097744361
"E02002375",0,218,974,885,207,58,11,2353,0,0.0926476838079048,0.413939651508712,0.376115597110072,0.087972800679983,0.0246493837654059,0.0046748831279218,1192,0.506587335316617,1161,0.493412664683383
"E02002376",1,222,834,853,341,63,21,2335,0.000428265524625268,0.0950749464668094,0.357173447537473,0.365310492505353,0.146038543897216,0.0269807280513919,0.00899357601713062,1057,0.452676659528908,1278,0.547323340471092
"E02002377",0,47,550,1274,899,90,40,2900,0,0.0162068965517241,0.189655172413793,0.439310344827586,0.31,0.0310344827586207,0.0137931034482759,597,0.205862068965517,2303,0.794137931034483
"E02002379",2,429,977,669,122,42,15,2256,0.000886524822695035,0.190159574468085,0.433067375886525,0.296542553191489,0.0540780141843972,0.0186170212765957,0.00664893617021277,1408,0.624113475177305,848,0.375886524822695
"E02002380",4,58,587,909,304,48,9,1919,0.00208441896821261,0.0302240750390829,0.305888483585201,0.473684210526316,0.158415841584158,0.0250130276185513,0.00468994267847837,649,0.338196977592496,1270,0.661803022407504
"E02002381",1,108,1053,1126,321,46,13,2668,0.000374812593703148,0.04047976011994,0.394677661169415,0.422038980509745,0.120314842578711,0.0172413793103448,0.00487256371814093,1162,0.435532233883058,1506,0.564467766116942
"E02002382",0,15,271,1385,1134,82,69,2956,0,0.0050744248985115,0.0916779431664411,0.468538565629229,0.38362652232747,0.0277401894451962,0.0233423545331529,286,0.0967523680649526,2670,0.903247631935047
"E02002383",0,36,813,1664,634,30,10,3187,0,0.0112958895513022,0.255098839033574,0.522121117037967,0.198933165986821,0.0094132412927518,0.00313774709758393,849,0.266394728584876,2338,0.733605271415124
"E02002384",1,1300,3426,1253,441,67,16,6504,0.000153751537515375,0.199876998769988,0.526752767527675,0.192650676506765,0.0678044280442804,0.0103013530135301,0.002460024600246,4727,0.726783517835178,1777,0.273216482164822
"E02002385",0,47,987,2260,722,84,30,4130,0,0.0113801452784504,0.238983050847458,0.547215496368039,0.174818401937046,0.0203389830508475,0.00726392251815981,1034,0.250363196125908,3096,0.749636803874092
"E02002386",18,346,775,1476,439,56,27,3137,0.00573796620975454,0.110296461587504,0.247051322919987,0.470513229199872,0.139942620337902,0.0178514504303475,0.00860694931463181,1139,0.363085750717246,1998,0.636914249282754
"E02002387",1,187,953,955,494,63,18,2671,0.000374391613627855,0.0700112317484088,0.356795207787346,0.357543991014601,0.18494945713216,0.0235866716585548,0.00673904904530139,1141,0.427180831149382,1530,0.572819168850618
"E02002388",5,149,1329,1270,324,63,16,3156,0.00158428390367554,0.0472116603295311,0.421102661596958,0.402408111533587,0.102661596958175,0.0199619771863118,0.00506970849176172,1483,0.469898605830165,1673,0.530101394169835
"E02002389",8,213,1319,1003,247,76,30,2896,0.00276243093922652,0.0735497237569061,0.455455801104972,0.346339779005525,0.0852900552486188,0.0262430939226519,0.0103591160220994,1540,0.531767955801105,1356,0.468232044198895
"E02002390",106,744,955,832,283,28,9,2957,0.0358471423740277,0.251606357795063,0.322962461954684,0.281366249577274,0.0957051065268854,0.00946905647615827,0.00304362529590801,1805,0.610415962123774,1152,0.389584037876226
"E02002391",2,59,866,1432,519,66,24,2968,0.000673854447439353,0.0198787061994609,0.29177897574124,0.482479784366577,0.174865229110512,0.0222371967654987,0.00808625336927224,927,0.31233153638814,2041,0.68766846361186
"E02002392",0,570,1924,1120,366,66,30,4076,0,0.139842983316977,0.472031403336605,0.2747791952895,0.0897939156035329,0.0161923454367027,0.00736015701668302,2494,0.611874386653582,1582,0.388125613346418
"E02002393",0,484,1517,1231,960,401,85,4678,0,0.103463018383925,0.324283882000855,0.2631466438649,0.205215904232578,0.0857203933304831,0.0181701581872595,2001,0.42774690038478,2677,0.57225309961522
"E02002394",0,91,1024,1317,845,147,64,3488,0,0.0260894495412844,0.293577981651376,0.377580275229358,0.242259174311927,0.042144495412844,0.018348623853211,1115,0.319667431192661,2373,0.680332568807339
"E02002395",0,119,547,1109,411,48,14,2248,0,0.0529359430604982,0.243327402135231,0.493327402135231,0.182829181494662,0.0213523131672598,0.00622775800711744,666,0.29626334519573,1582,0.703736654804271
"E02002396",2,176,1298,1716,718,106,31,4047,0.000494193229552755,0.0434890042006425,0.320731405979738,0.424017790956264,0.177415369409439,0.026192241166296,0.0076599950580677,1476,0.364714603409933,2571,0.635285396590067
"E02002397",2,110,1032,1229,347,87,48,2855,0.000700525394045534,0.0385288966725044,0.361471103327496,0.430472854640981,0.1215411558669,0.0304728546409807,0.0168126094570928,1144,0.400700525394045,1711,0.599299474605954
"E02002398",20,102,472,1286,466,54,19,2419,0.00826787928896238,0.0421661843737081,0.195121951219512,0.531624638280281,0.192641587432823,0.0223232740801984,0.00785448532451426,594,0.245556014882183,1825,0.754443985117817
"E02002399",2,58,472,1104,555,81,31,2303,0.000868432479374729,0.0251845419018671,0.204950065132436,0.47937472861485,0.240990013026487,0.0351715154146765,0.0134607034303083,532,0.231003039513678,1771,0.768996960486322
"E02002400",1,230,1610,1653,726,89,53,4362,0.000229252636405319,0.0527281063732233,0.369096744612563,0.378954607977992,0.166437414030261,0.0204034846400734,0.0121503897294819,1841,0.422054103622192,2521,0.577945896377808
"E02002401",8,412,757,1071,175,26,9,2458,0.0032546786004882,0.167615947925142,0.307973962571196,0.435720097640358,0.0711960943856794,0.0105777054515867,0.00366151342554923,1177,0.478844589096827,1281,0.521155410903173
"E02002402",33,277,495,826,183,27,4,1845,0.0178861788617886,0.150135501355014,0.268292682926829,0.44769647696477,0.0991869918699187,0.0146341463414634,0.0021680216802168,805,0.436314363143631,1040,0.563685636856369
"E02002403",7,169,623,1002,308,43,9,2161,0.003239241092087,0.0782045349375289,0.288292457195743,0.463674224895882,0.142526608051828,0.019898195279963,0.004164738546969,799,0.369736233225359,1362,0.630263766774641
"E02002404",2,1359,2898,1731,644,93,41,6768,0.000295508274231678,0.200797872340426,0.428191489361702,0.255762411347518,0.0951536643026005,0.0137411347517731,0.00605791962174941,4259,0.629284869976359,2509,0.370715130023641
"E02002405",4,676,927,1129,383,67,23,3209,0.00124649423496416,0.210657525708944,0.288875038952945,0.351822997818635,0.119351822997819,0.0208787784356497,0.00716734185104394,1607,0.500779058896853,1602,0.499220941103147
"E02002406",15,301,399,980,213,25,10,1943,0.00772002058672156,0.154915079773546,0.205352547606794,0.504374678332476,0.109624292331446,0.0128667009778693,0.00514668039114771,715,0.367987647967061,1228,0.632012352032939
"E02002407",0,249,1085,1103,368,201,56,3062,0,0.081319399085565,0.354343566296538,0.360222077073808,0.12018288700196,0.065643370346179,0.0182887001959504,1334,0.435662965382103,1728,0.564337034617897
"E02002408",1,182,979,1272,398,40,17,2889,0.000346140533056421,0.0629975770162686,0.338871581862236,0.440290758047767,0.137763932156456,0.0138456213222568,0.00588438906195916,1162,0.402215299411561,1727,0.597784700588439
"E02002409",1,212,791,889,248,65,22,2228,0.000448833034111311,0.0951526032315978,0.355026929982047,0.399012567324955,0.111310592459605,0.0291741472172352,0.00987432675044883,1004,0.450628366247756,1224,0.549371633752244
"E02002410",0,174,1037,1117,345,67,23,2763,0,0.0629750271444083,0.375316684762939,0.404270720231632,0.12486427795874,0.0242490047050308,0.00832428519724937,1211,0.438291711907347,1552,0.561708288092653
"E02002411",5,2644,2235,1544,706,77,73,7284,0.000686436024162548,0.362987369577155,0.306836902800659,0.211971444261395,0.0969247666117518,0.0105711147721032,0.0100219659527732,4884,0.670510708401977,2400,0.329489291598023
"E02002412",3,290,918,1122,375,60,29,2797,0.00107257776188774,0.103682516982481,0.328208795137648,0.401144082946014,0.134072220235967,0.0214515552377547,0.0103682516982481,1211,0.432963889882016,1586,0.567036110117984
"E02002414",46,409,1238,946,391,139,65,3234,0.0142238713667285,0.126468769325912,0.382807668521954,0.292517006802721,0.120902906617192,0.0429808286951144,0.0200989486703772,1693,0.523500309214595,1541,0.476499690785405
"E02002415",0,102,671,1605,1121,143,86,3728,0,0.0273605150214592,0.179989270386266,0.430525751072961,0.300697424892704,0.0383583690987124,0.023068669527897,773,0.207349785407725,2955,0.792650214592275
"E02002416",13,241,765,929,228,44,9,2229,0.00583221175414984,0.10812023328847,0.343203230148048,0.416778824585016,0.10228802153432,0.0197397936294302,0.00403768506056528,1019,0.457155675190668,1210,0.542844324809331
"E02002417",92,905,756,891,247,54,15,2960,0.0310810810810811,0.305743243243243,0.255405405405405,0.301013513513514,0.0834459459459459,0.0182432432432432,0.00506756756756757,1753,0.59222972972973,1207,0.40777027027027
"E02002418",3,88,653,1132,302,47,9,2234,0.00134288272157565,0.0393912264995524,0.292300805729633,0.506714413607878,0.135183527305282,0.0210384959713518,0.00402864816472695,744,0.333034914950761,1490,0.666965085049239
"E02002419",15,262,1462,1020,316,68,18,3161,0.00474533375514078,0.0828851629231256,0.462511863334388,0.322682695349573,0.0999683644416324,0.0215121796899715,0.00569440050616893,1739,0.550142360012654,1422,0.449857639987346
"E02002420",0,50,487,1465,634,103,46,2785,0,0.0179533213644524,0.174865350089767,0.526032315978456,0.227648114901257,0.036983842010772,0.0165170556552962,537,0.192818671454219,2248,0.807181328545781
"E02002421",23,50,1441,969,185,38,17,2723,0.00844656628718325,0.0183621006243114,0.529195739992655,0.355857510099155,0.0679397723099523,0.0139551964744767,0.00624311421226588,1514,0.55600440690415,1209,0.44399559309585
"E02002422",18,275,727,966,233,37,4,2260,0.0079646017699115,0.121681415929204,0.321681415929204,0.427433628318584,0.103097345132743,0.0163716814159292,0.00176991150442478,1020,0.451327433628319,1240,0.548672566371681
"E02002423",2,95,1025,752,154,59,12,2099,0.000952834683182468,0.0452596474511672,0.488327775131015,0.358265840876608,0.07336827060505,0.0281086231538828,0.00571700809909481,1122,0.534540257265364,977,0.465459742734636
"E02002424",1,71,837,1154,268,43,17,2391,0.000418235048097031,0.0296946884148892,0.350062735257215,0.482643245503973,0.112086992890004,0.0179841070681723,0.00710999581764952,909,0.380175658720201,1482,0.619824341279799
"E02002425",46,426,871,1287,378,49,16,3073,0.0149690855841198,0.138626749105109,0.283436381386267,0.41880898145135,0.123006833712984,0.0159453302961276,0.00520663846404165,1343,0.437032216075496,1730,0.562967783924504
"E02002426",43,344,710,1166,299,53,8,2623,0.0163934426229508,0.131147540983607,0.270682424704537,0.444529165078155,0.113991612657263,0.0202058711399161,0.00304994281357225,1097,0.418223408311094,1526,0.581776591688906
"E02002427",1,70,761,1079,262,28,12,2213,0.000451875282422052,0.0316312697695436,0.343877089923181,0.487573429733394,0.118391323994577,0.0126525079078174,0.00542250338906462,832,0.375960234975147,1381,0.624039765024853
"E02002428",1,134,1595,1126,220,48,7,3131,0.000319386777387416,0.0427978281699138,0.509421909932929,0.359629511338231,0.0702650910252316,0.015330565314596,0.00223570744171191,1730,0.55253912488023,1401,0.44746087511977
"E02002429",9,297,1004,1216,309,36,12,2883,0.00312174817898023,0.103017689906348,0.348248352410683,0.421782865071106,0.107180020811655,0.0124869927159209,0.00416233090530697,1310,0.454387790496011,1573,0.545612209503989
"E02002430",9,458,1257,1006,217,84,26,3057,0.00294406280667321,0.149820085050703,0.411187438665358,0.329080798168139,0.0709846254497874,0.0274779195289499,0.00850507033038927,1724,0.563951586522735,1333,0.436048413477265
"E02002431",7,533,1108,1475,372,62,15,3572,0.00195968645016797,0.149216125419933,0.310190369540873,0.412933930571109,0.104143337066069,0.0173572228443449,0.0041993281075028,1648,0.461366181410974,1924,0.538633818589026
"E02002432",6,348,585,1064,285,46,11,2345,0.00255863539445629,0.148400852878465,0.249466950959488,0.453731343283582,0.121535181236674,0.0196162046908316,0.0046908315565032,939,0.400426439232409,1406,0.599573560767591
"E02002433",1,222,1166,1217,593,78,36,3313,0.000301841231512225,0.0670087533957139,0.351946875943254,0.367340778750377,0.178991850286749,0.0235436160579535,0.0108662843344401,1389,0.41925747057048,1924,0.58074252942952
"E02002434",4,448,1833,1154,200,25,13,3677,0.00108784335055752,0.121838455262442,0.498504215392983,0.313842806635844,0.054392167527876,0.0067990209409845,0.00353549088931194,2285,0.621430514005983,1392,0.378569485994017
"E02002435",11,529,840,1180,340,63,22,2985,0.00368509212730318,0.177219430485762,0.281407035175879,0.395309882747069,0.113902847571189,0.021105527638191,0.00737018425460636,1380,0.462311557788945,1605,0.537688442211055
"E02002436",26,464,647,1078,266,44,9,2534,0.0102604577742699,0.183109707971586,0.255327545382794,0.425414364640884,0.104972375690608,0.0173638516179953,0.00355169692186267,1137,0.44869771112865,1397,0.55130228887135
"E02002437",10,187,415,977,207,30,11,1837,0.00544365813826892,0.101796407185629,0.22591181273816,0.531845400108873,0.112683723462167,0.0163309744148067,0.00598802395209581,612,0.333151878062058,1225,0.666848121937942
"E02002438",81,209,1667,2916,273,38,10,5194,0.0155949172121679,0.0402387370042357,0.320947246823258,0.561417019638044,0.0525606469002695,0.00731613400077012,0.00192529842125529,1957,0.376780901039661,3237,0.623219098960339
"E02002439",2,634,1190,1808,605,96,32,4367,0.000457980306846806,0.145179757270437,0.272498282573849,0.414014197389512,0.138539042821159,0.0219830547286467,0.00732768490954889,1826,0.418136020151133,2541,0.581863979848867
"E02002440",17,161,1228,2156,316,67,8,3953,0.00430053124209461,0.040728560586896,0.310650139134834,0.545408550467999,0.0799392866177587,0.0169491525423729,0.00202377940804452,1406,0.355679230963825,2547,0.644320769036175
"E02002441",20,508,1872,2031,447,55,11,4944,0.0040453074433657,0.102750809061489,0.378640776699029,0.410800970873786,0.0904126213592233,0.0111245954692557,0.00222491909385113,2400,0.485436893203884,2544,0.514563106796117
"E02002442",0,365,619,1147,302,46,11,2490,0,0.146586345381526,0.24859437751004,0.460642570281124,0.121285140562249,0.0184738955823293,0.00441767068273092,984,0.395180722891566,1506,0.604819277108434
"E02002443",13,101,639,938,192,26,6,1915,0.00678851174934726,0.0527415143603133,0.333681462140992,0.489817232375979,0.100261096605744,0.0135770234986945,0.0031331592689295,753,0.393211488250653,1162,0.606788511749347
"E02002444",190,1101,847,1136,250,32,7,3563,0.0533258490036486,0.309009261857985,0.237721021611002,0.318832444569183,0.0701655907942745,0.00898119562166714,0.00196463654223969,2138,0.600056132472635,1425,0.399943867527365
"E02002445",6,835,887,1455,289,46,12,3530,0.00169971671388102,0.236543909348442,0.251274787535411,0.412181303116147,0.0818696883852691,0.0130311614730878,0.00339943342776204,1728,0.489518413597734,1802,0.510481586402266
"E02002446",9,123,547,1077,297,46,13,2112,0.00426136363636364,0.0582386363636364,0.258996212121212,0.509943181818182,0.140625,0.021780303030303,0.00615530303030303,679,0.321496212121212,1433,0.678503787878788
"E02002447",20,165,1136,1020,283,35,11,2670,0.00749063670411985,0.0617977528089888,0.425468164794008,0.382022471910112,0.105992509363296,0.0131086142322097,0.00411985018726592,1321,0.494756554307116,1349,0.505243445692884
"E02002448",22,675,1667,1536,185,40,12,4137,0.00531786318588349,0.163161711385062,0.402948996857626,0.371283538796229,0.0447183949722021,0.0096688421561518,0.00290065264684554,2364,0.571428571428571,1773,0.428571428571429
"E02002449",144,1037,906,1269,206,25,5,3592,0.0400890868596882,0.28869710467706,0.252227171492205,0.353285077951002,0.0573496659242762,0.00695991091314031,0.00139198218262806,2087,0.581013363028953,1505,0.418986636971047
"E02002450",33,551,935,1301,208,27,4,3059,0.0107878391631252,0.180124223602484,0.305655442955214,0.425302386400785,0.0679960771493952,0.0088264138607388,0.0013076168682576,1519,0.496567505720824,1540,0.503432494279176
"E02002451",28,467,674,1343,256,42,4,2814,0.00995024875621891,0.165955934612651,0.239516702203269,0.4772565742715,0.0909737029140014,0.0149253731343284,0.00142146410803127,1169,0.415422885572139,1645,0.584577114427861
"E02002452",8,828,1938,2159,335,56,11,5335,0.00149953139643861,0.155201499531396,0.363261480787254,0.404686035613871,0.0627928772258669,0.0104967197750703,0.00206185567010309,2774,0.519962511715089,2561,0.480037488284911
"E02002453",25,319,1399,2416,402,67,14,4642,0.00538560965101249,0.0687203791469194,0.301378716070659,0.520465316673847,0.0866006031882809,0.0144334338647135,0.003015941404567,1743,0.375484704868591,2899,0.624515295131409
"E02002454",55,632,1717,1431,633,108,30,4606,0.0119409465914025,0.137212331741207,0.372774641771602,0.310681719496309,0.137429439861051,0.0234476769431177,0.00651324359531046,2404,0.521927920104212,2202,0.478072079895788
"E02002455",54,312,1424,1783,167,24,1,3765,0.0143426294820717,0.0828685258964143,0.378220451527224,0.473572377158035,0.0443559096945551,0.00637450199203187,0.000265604249667995,1790,0.475431606905711,1975,0.524568393094289
"E02002456",11,468,948,1348,457,66,24,3322,0.0033112582781457,0.140878988561108,0.285370258880193,0.405779650812763,0.137567730282962,0.0198675496688742,0.00722456351595424,1427,0.429560505719446,1895,0.570439494280554
"E02002457",8,35,1436,1975,267,45,5,3771,0.00212145319543888,0.00928135773004508,0.380800848581278,0.523733757623972,0.0708035003977725,0.0119331742243437,0.0013259082471493,1479,0.392203659506762,2292,0.607796340493238
"E02002458",7,211,941,1847,348,62,13,3429,0.00204141149023039,0.0615339749198017,0.274424030329542,0.538641003207932,0.101487314085739,0.0180810731991834,0.00379119276757072,1159,0.337999416739574,2270,0.662000583260426
"E02002459",7,247,1292,2076,432,64,15,4133,0.00169368497459473,0.0597628841035567,0.312605855310912,0.502298572465521,0.104524558432132,0.0154851197677232,0.00362932494556013,1546,0.374062424389064,2587,0.625937575610936
"E02002460",36,311,610,1403,309,67,6,2742,0.0131291028446389,0.113420860685631,0.222465353756382,0.511670313639679,0.112691466083151,0.024434719183078,0.00218818380743982,957,0.349015317286652,1785,0.650984682713348
"E02002461",18,1084,1437,1841,377,61,22,4840,0.00371900826446281,0.22396694214876,0.296900826446281,0.380371900826446,0.0778925619834711,0.012603305785124,0.00454545454545455,2539,0.524586776859504,2301,0.475413223140496
"E02002462",8,255,1015,1563,348,55,11,3255,0.00245775729646697,0.0783410138248848,0.311827956989247,0.480184331797235,0.106912442396313,0.0168970814132104,0.00337941628264209,1278,0.392626728110599,1977,0.607373271889401
"E02002463",22,623,1661,2728,232,36,8,5310,0.00414312617702448,0.117325800376648,0.312806026365348,0.513747645951036,0.0436911487758945,0.00677966101694915,0.00150659133709981,2306,0.434274952919021,3004,0.565725047080979
"E02002464",42,816,1342,1856,366,61,13,4496,0.00934163701067616,0.181494661921708,0.298487544483986,0.412811387900356,0.0814056939501779,0.013567615658363,0.0028914590747331,2200,0.48932384341637,2296,0.51067615658363
"E02002465",3,207,883,1083,361,51,11,2599,0.00115429011158138,0.079646017699115,0.339746056175452,0.416698730280877,0.138899576760292,0.0196229318968834,0.00423239707579838,1093,0.420546363986149,1506,0.579453636013851
"E02002466",13,185,1105,2037,346,62,16,3764,0.00345377258235919,0.0491498405951116,0.293570669500531,0.541179596174283,0.09192348565356,0.0164718384697131,0.00425079702444208,1303,0.346174282678002,2461,0.653825717321998
"E02002467",15,607,1547,1925,585,79,24,4782,0.00313676286072773,0.126934337097449,0.323504809703053,0.402551233793392,0.122333751568381,0.0165202843998327,0.00501882057716437,2169,0.45357590966123,2613,0.54642409033877
"E02002468",16,121,651,1070,361,57,12,2288,0.00699300699300699,0.0528846153846154,0.284527972027972,0.467657342657343,0.15777972027972,0.0249125874125874,0.00524475524475524,788,0.344405594405594,1500,0.655594405594406
"E02002469",35,297,566,1107,189,28,8,2230,0.015695067264574,0.133183856502242,0.253811659192825,0.496412556053812,0.0847533632286996,0.0125560538116592,0.00358744394618834,898,0.402690582959641,1332,0.597309417040359
"E02002470",6,114,468,911,294,40,6,1839,0.0032626427406199,0.0619902120717781,0.254486133768352,0.495377922784122,0.159869494290375,0.0217509516041327,0.0032626427406199,588,0.31973898858075,1251,0.68026101141925
"E02002471",31,520,1100,1674,513,104,28,3970,0.00780856423173804,0.130982367758186,0.277078085642317,0.421662468513854,0.129219143576826,0.0261964735516373,0.00705289672544081,1651,0.415869017632242,2319,0.584130982367758
"E02002472",1,65,525,1170,232,47,10,2050,0.00048780487804878,0.0317073170731707,0.25609756097561,0.570731707317073,0.113170731707317,0.0229268292682927,0.0048780487804878,591,0.288292682926829,1459,0.711707317073171
"E02002473",2,139,591,1092,335,49,14,2222,0.0009000900090009,0.0625562556255626,0.265976597659766,0.491449144914491,0.150765076507651,0.0220522052205221,0.0063006300630063,732,0.329432943294329,1490,0.670567056705671
"E02002474",3,301,902,1630,216,29,11,3092,0.000970245795601552,0.0973479948253558,0.291720569210867,0.527166882276843,0.0698576972833118,0.00937904269081501,0.00355756791720569,1206,0.390038809831824,1886,0.609961190168176
"E02002475",6,281,710,863,294,80,31,2265,0.00264900662251656,0.124061810154525,0.313465783664459,0.381015452538631,0.129801324503311,0.0353200883002208,0.0136865342163355,997,0.440176600441501,1268,0.559823399558499
"E02002476",12,511,798,1867,175,27,9,3399,0.00353045013239188,0.150338334804354,0.23477493380406,0.549279199764637,0.0514857310973816,0.00794351279788173,0.00264783759929391,1321,0.388643718740806,2078,0.611356281259194
"E02002477",13,149,747,1325,279,51,9,2573,0.00505246793626117,0.0579090555771473,0.290322580645161,0.514963078118927,0.108433734939759,0.0198212203653323,0.00349786241741158,909,0.35328410415857,1664,0.64671589584143
"E02002478",20,287,704,1223,240,34,16,2524,0.00792393026941363,0.113708399366086,0.27892234548336,0.484548335974643,0.0950871632329636,0.0134706814580032,0.0063391442155309,1011,0.400554675118859,1513,0.599445324881141
"E02002479",27,213,1119,1877,368,59,7,3670,0.00735694822888283,0.0580381471389646,0.304904632152589,0.511444141689373,0.100272479564033,0.0160762942779292,0.00190735694822888,1359,0.370299727520436,2311,0.629700272479564
"E02002480",5,59,929,1565,272,30,3,2863,0.00174641983932937,0.0206077541040866,0.324484806147398,0.546629409710094,0.095005239259518,0.0104785190359762,0.00104785190359762,993,0.346838980090814,1870,0.653161019909186
"E02002481",21,517,930,1832,243,45,10,3598,0.00583657587548638,0.143690939410784,0.258476931628683,0.50917176209005,0.0675375208449138,0.0125069483046137,0.00277932184546971,1468,0.408004446914953,2130,0.591995553085047
"E02002482",41,285,1055,1594,269,42,9,3295,0.012443095599393,0.08649468892261,0.320182094081942,0.483763277693475,0.081638846737481,0.0127465857359636,0.00273141122913505,1381,0.419119878603945,1914,0.580880121396054
"E02002483",7,930,1773,1181,139,18,0,4048,0.00172924901185771,0.229743083003953,0.437994071146245,0.291749011857708,0.0343379446640316,0.00444664031620553,0,2710,0.669466403162055,1338,0.330533596837945
"E02002484",5,598,2154,2288,377,85,15,5522,0.000905469032959073,0.108294096341905,0.390076059398769,0.414342629482072,0.0682723650851141,0.0153929735603042,0.00271640709887722,2757,0.499275624773633,2765,0.500724375226367
"E02002485",7,377,1408,1556,234,35,12,3629,0.00192890603472031,0.103885367869937,0.387985670983742,0.428768255717829,0.0644805731606503,0.00964453017360154,0.00330669605952053,1792,0.493799944888399,1837,0.506200055111601
"E02002489",14,221,1060,1351,944,200,53,3843,0.00364298724954463,0.0575071558678116,0.275826177465522,0.351548269581056,0.245641425969295,0.0520426749934947,0.0137913088732761,1295,0.336976320582878,2548,0.663023679417122
"E02002490",10,137,765,1367,558,75,44,2956,0.003382949932341,0.0463464140730717,0.258795669824087,0.462449255751015,0.188768606224628,0.0253721244925575,0.0148849797023004,912,0.308525033829499,2044,0.691474966170501
"E02002491",9,244,784,1336,268,34,8,2683,0.0033544539694372,0.0909429742825196,0.292210212448751,0.497950055907566,0.0998881848676854,0.0126723816623183,0.00298173686172195,1037,0.386507640700708,1646,0.613492359299292
"E02002492",24,341,1009,1091,232,22,3,2722,0.00881704628949302,0.125275532696547,0.370683321087436,0.400808229243204,0.0852314474650992,0.00808229243203527,0.00110213078618663,1374,0.504775900073475,1348,0.495224099926525
"E02002493",19,458,634,856,207,32,4,2210,0.0085972850678733,0.207239819004525,0.286877828054299,0.387330316742081,0.0936651583710407,0.0144796380090498,0.00180995475113122,1111,0.502714932126697,1099,0.497285067873303
"E02002494",19,159,1405,1713,228,21,7,3552,0.0053490990990991,0.0447635135135135,0.395551801801802,0.482263513513513,0.0641891891891892,0.00591216216216216,0.00197072072072072,1583,0.445664414414414,1969,0.554335585585585
"E02002496",7,599,2647,2152,1003,122,63,6593,0.00106173214014864,0.0908539359927196,0.401486424996208,0.326406795085697,0.152131048081298,0.0185044744425906,0.00955558926133778,3253,0.493402093129076,3340,0.506597906870924
"E02002497",10,175,727,1631,588,73,50,3254,0.00307314074984634,0.053779963122311,0.223417332513829,0.501229256299939,0.180700676090965,0.0224339274738783,0.0153657037492317,912,0.280270436385986,2342,0.719729563614014
"E02002498",2,137,1328,2373,1042,134,73,5089,0.000393004519551975,0.0269208095893103,0.260955000982511,0.466299862448418,0.204755354686579,0.0263313028099823,0.0143446649636471,1467,0.288268815091374,3622,0.711731184908626
"E02002499",3,251,1385,1202,169,26,5,3041,0.000986517592897073,0.0825386386057218,0.455442288720816,0.395264715554094,0.0555738243998685,0.0085498191384413,0.00164419598816179,1639,0.538967444919434,1402,0.461032555080566
"E02002500",0,11,483,1042,552,84,16,2188,0,0.00502742230347349,0.220749542961609,0.476234003656307,0.252285191956124,0.0383912248628885,0.00731261425959781,494,0.225776965265082,1694,0.774223034734918
"E02002501",5,484,932,719,259,38,12,2449,0.00204164965291956,0.197631686402613,0.380563495304206,0.293589220089833,0.105757452021233,0.0155165373621886,0.00489995916700694,1421,0.580236831359739,1028,0.419763168640261
"E02002502",28,496,1777,1681,249,23,8,4262,0.00656968559361802,0.116377287658376,0.416940403566401,0.394415767245425,0.0584232754575317,0.00539652745190052,0.00187705302674801,2301,0.539887376818395,1961,0.460112623181605
"E02002503",4,438,804,1011,296,37,5,2595,0.00154142581888247,0.16878612716763,0.309826589595376,0.389595375722543,0.114065510597303,0.0142581888246628,0.00192678227360308,1246,0.480154142581888,1349,0.519845857418112
"E02002504",1,129,950,1272,692,135,16,3195,0.000312989045383412,0.0403755868544601,0.297339593114241,0.3981220657277,0.216588419405321,0.0422535211267606,0.00500782472613458,1080,0.338028169014085,2115,0.661971830985915
"E02002505",2,62,1267,1079,103,23,3,2539,0.000787711697518708,0.02441906262308,0.499015360378102,0.424970460811343,0.0405671524222135,0.00905868452146514,0.00118156754627806,1331,0.5242221346987,1208,0.4757778653013
"E02002506",1,67,1073,1250,132,24,17,2564,0.000390015600624025,0.0261310452418097,0.418486739469579,0.487519500780031,0.0514820592823713,0.0093603744149766,0.00663026521060842,1141,0.445007800312012,1423,0.554992199687988
"E02002507",0,210,364,875,280,27,9,1765,0,0.118980169971671,0.206232294617564,0.495750708215297,0.158640226628895,0.0152974504249292,0.00509915014164306,574,0.325212464589235,1191,0.674787535410765
"E02002508",0,364,376,722,232,31,3,1728,0,0.210648148148148,0.217592592592593,0.417824074074074,0.134259259259259,0.0179398148148148,0.00173611111111111,740,0.428240740740741,988,0.571759259259259
"E02002509",4,22,814,854,124,15,3,1836,0.00217864923747277,0.0119825708061002,0.443355119825708,0.465141612200436,0.0675381263616558,0.00816993464052288,0.00163398692810458,840,0.457516339869281,996,0.542483660130719
"E02002510",0,769,367,820,244,30,4,2234,0,0.344225604297225,0.164279319606088,0.367054610564011,0.109221128021486,0.0134288272157565,0.0017905102954342,1136,0.508504923903312,1098,0.491495076096688
"E02002512",2,216,459,806,154,27,1,1665,0.0012012012012012,0.12972972972973,0.275675675675676,0.484084084084084,0.0924924924924925,0.0162162162162162,0.000600600600600601,677,0.406606606606607,988,0.593393393393393
"E02002513",53,1385,2058,1074,182,25,3,4780,0.0110878661087866,0.289748953974895,0.430543933054393,0.224686192468619,0.0380753138075314,0.00523012552301255,0.000627615062761506,3496,0.731380753138075,1284,0.268619246861925
"E02002514",3,59,1980,1098,103,5,0,3248,0.000923645320197044,0.0181650246305419,0.609605911330049,0.338054187192118,0.0317118226600985,0.00153940886699507,0,2042,0.628694581280788,1206,0.371305418719212
"E02002515",0,100,851,1426,861,128,75,3441,0,0.0290613193839,0.247311827956989,0.414414414414414,0.250217959895379,0.037198488811392,0.021795989537925,951,0.276373147340889,2490,0.723626852659111
"E02002516",9,365,520,794,265,34,8,1995,0.00451127819548872,0.182957393483709,0.260651629072682,0.397994987468672,0.132832080200501,0.0170426065162907,0.00401002506265664,894,0.44812030075188,1101,0.55187969924812
"E02002517",11,500,664,844,238,39,9,2305,0.00477223427331887,0.216919739696312,0.288069414316703,0.366160520607375,0.103253796095445,0.0169197396963124,0.00390455531453362,1175,0.509761388286334,1130,0.490238611713666
"E02002518",1,338,680,1758,555,76,10,3418,0.000292568753657109,0.098888238736103,0.198946752486834,0.514335868929198,0.162375658279696,0.0222352252779403,0.00292568753657109,1019,0.298127559976595,2399,0.701872440023405
"E02002519",5,388,1550,769,163,28,5,2908,0.00171939477303989,0.133425034387895,0.533012379642366,0.264442916093535,0.0560522696011004,0.00962861072902338,0.00171939477303989,1943,0.668156808803301,965,0.331843191196699
"E02002520",5,420,1228,1928,472,78,8,4139,0.0012080212611742,0.101473785938633,0.296690021744383,0.46581299830877,0.114037207054844,0.0188451316743175,0.00193283401787871,1653,0.399371828944189,2486,0.60062817105581
"E02002521",2,140,666,1133,528,118,26,2613,0.000765403750478377,0.0535782625334864,0.2548794489093,0.433601224646001,0.202066590126292,0.0451588212782243,0.00995024875621891,808,0.309223115193264,1805,0.690776884806735
"E02002523",0,115,1456,1034,180,30,6,2821,0,0.0407656859269762,0.516129032258065,0.366536689117334,0.0638071605813541,0.010634526763559,0.0021269053527118,1571,0.556894718185041,1250,0.443105281814959
"E02002524",3,109,543,824,236,46,22,1783,0.00168255748738082,0.0611329220415031,0.304542905215928,0.462142456533932,0.132361189007291,0.0257992148065059,0.0123387549074593,655,0.367358384744812,1128,0.632641615255188
"E02002525",3,180,1099,1290,360,77,19,3028,0.000990752972258917,0.059445178335535,0.362945838837517,0.426023778071334,0.11889035667107,0.0254293262879789,0.00627476882430647,1282,0.42338177014531,1746,0.57661822985469
"E02002526",22,334,882,1043,396,71,21,2769,0.00794510653665583,0.120621162874684,0.318526543878657,0.376670278078729,0.143011917659805,0.0256410256410256,0.0075839653304442,1238,0.447092813289996,1531,0.552907186710004
"E02002527",6,287,468,855,374,86,39,2115,0.00283687943262411,0.135697399527187,0.221276595744681,0.404255319148936,0.176832151300236,0.040661938534279,0.0184397163120567,761,0.359810874704492,1354,0.640189125295508
"E02002529",11,443,927,793,205,38,5,2422,0.00454170107349298,0.182906688687035,0.382741535920727,0.327415359207267,0.0846407927332783,0.0156895127993394,0.00206440957886045,1381,0.570189925681255,1041,0.429810074318745
"E02002530",2,124,711,901,516,221,70,2545,0.000785854616895874,0.0487229862475442,0.279371316306483,0.354027504911591,0.202750491159136,0.0868369351669941,0.0275049115913556,837,0.328880157170923,1708,0.671119842829077
"E02002532",12,425,900,1102,470,89,25,3023,0.00396956665564009,0.14058881905392,0.297717499173007,0.364538537876282,0.15547469401257,0.0294409526959974,0.00826993053258353,1337,0.442275884882567,1686,0.557724115117433
"E02002533",20,563,472,821,221,33,4,2134,0.00937207122774133,0.263823805060918,0.221180880974695,0.384723523898782,0.103561387066542,0.0154639175257732,0.00187441424554827,1055,0.494376757263355,1079,0.505623242736645
"E02002534",8,63,304,784,258,55,11,1483,0.00539447066756575,0.0424814565070802,0.204989885367498,0.528658125421443,0.173971679028995,0.0370869858395145,0.0074173971679029,375,0.252865812542144,1108,0.747134187457856
"E02002535",9,65,1032,1389,233,33,1,2762,0.00325850832729906,0.0235336712527154,0.373642288196959,0.502896451846488,0.0843591600289645,0.0119478638667632,0.000362056480811006,1106,0.400434467776973,1656,0.599565532223027
"E02002536",12,178,1430,1603,424,63,29,3739,0.00320941428189355,0.0476063118480877,0.382455201925649,0.428724257822947,0.113399304626906,0.0168494249799412,0.00775608451457609,1620,0.43327092805563,2119,0.56672907194437
"E02002537",3,106,1536,1540,304,36,10,3535,0.000848656294200849,0.02998585572843,0.434512022630834,0.435643564356436,0.085997171145686,0.0101838755304102,0.00282885431400283,1645,0.465346534653465,1890,0.534653465346535
"E02002538",3,131,701,969,234,25,6,2069,0.0014499758337361,0.0633156114064766,0.338811019816336,0.468342194296762,0.113098115031416,0.0120831319478009,0.00289995166747221,835,0.403576607056549,1234,0.596423392943451
"E02002539",54,1104,1016,1042,256,67,22,3561,0.0151642796967144,0.310025273799495,0.285313114293738,0.292614434147711,0.0718899185622016,0.0188149396237012,0.0061780398764392,2174,0.610502667789947,1387,0.389497332210053
"E02002540",11,217,591,955,225,32,2,2033,0.00541072306935563,0.106738809640925,0.290703393999016,0.469749139203148,0.110673880964092,0.0157402852926709,0.000983767830791933,819,0.402852926709297,1214,0.597147073290703
"E02002541",0,53,652,1203,446,71,12,2437,0,0.0217480508822323,0.267542059909725,0.493639720968404,0.183011899876898,0.0291341813705375,0.00492408699220353,705,0.289290110791957,1732,0.710709889208043
"E02002542",14,202,1124,1662,206,20,7,3235,0.00432766615146832,0.0624420401854714,0.347449768160742,0.513755795981453,0.0636785162287481,0.00618238021638331,0.00216383307573416,1340,0.414219474497682,1895,0.585780525502318
"E02002543",7,738,2084,1150,150,21,3,4153,0.00168552853359018,0.177702865398507,0.501805923428847,0.276908259089815,0.0361184685769323,0.00505658560077053,0.000722369371538647,2829,0.681194317360944,1324,0.318805682639056
"E02002544",2,525,1179,1375,417,72,11,3581,0.000558503211393465,0.146607092990785,0.329237643116448,0.383970957833008,0.116447919575538,0.0201061156101648,0.00307176766266406,1706,0.476403239318626,1875,0.523596760681374
"E02002545",1,26,472,799,159,18,4,1479,0.000676132521974307,0.017579445571332,0.319134550371873,0.540229885057471,0.107505070993915,0.0121703853955375,0.00270453008789723,499,0.337390128465179,980,0.662609871534821
"E02002546",1,40,985,1572,591,75,20,3284,0.000304506699147381,0.0121802679658952,0.299939098660171,0.478684531059683,0.179963459196102,0.0228380024360536,0.00609013398294762,1026,0.312423873325213,2258,0.687576126674787
"E02002547",1,41,714,941,253,23,6,1979,0.000505305709954523,0.0207175341081354,0.360788276907529,0.475492673067206,0.127842344618494,0.011622031328954,0.00303183425972713,756,0.382011116725619,1223,0.617988883274381
"E02002549",29,295,582,1266,270,30,6,2478,0.0117029862792575,0.119047619047619,0.234866828087167,0.51089588377724,0.108958837772397,0.0121065375302663,0.00242130750605327,906,0.365617433414044,1572,0.634382566585956
"E02002550",0,67,639,995,552,115,22,2390,0,0.0280334728033473,0.267364016736402,0.416317991631799,0.230962343096234,0.0481171548117155,0.00920502092050209,706,0.295397489539749,1684,0.704602510460251
"E02002551",1,251,1372,1322,445,55,23,3469,0.000288267512251369,0.0723551455750937,0.395503026808879,0.38108965119631,0.128279042951859,0.0158547131738253,0.00663015278178149,1624,0.468146439896224,1845,0.531853560103776
"E02002552",19,231,1187,927,208,19,4,2595,0.00732177263969172,0.0890173410404624,0.457418111753372,0.357225433526012,0.0801541425818882,0.00732177263969172,0.00154142581888247,1437,0.553757225433526,1158,0.446242774566474
"E02002553",4,295,779,832,216,42,5,2173,0.00184077312471238,0.135757017947538,0.358490566037736,0.382880809940175,0.0994017487344685,0.01932811780948,0.00230096640589047,1078,0.496088357109986,1095,0.503911642890014
"E02002554",3,89,882,899,227,11,4,2115,0.00141843971631206,0.042080378250591,0.417021276595745,0.425059101654846,0.107328605200946,0.00520094562647754,0.00189125295508274,974,0.460520094562648,1141,0.539479905437352
"E02002555",83,623,1056,1568,370,51,10,3761,0.022068598776921,0.165647434193034,0.280776389258176,0.416910396171231,0.0983780909332624,0.0135602233448551,0.00265886732252061,1762,0.468492422228131,1999,0.531507577771869
"E02002556",9,324,580,1101,108,18,1,2141,0.00420364315740308,0.151331153666511,0.270901447921532,0.514245679588977,0.050443717888837,0.00840728631480617,0.000467071461933676,913,0.426436244745446,1228,0.573563755254554
"E02002558",21,1315,1259,1531,308,41,9,4484,0.00468331846565566,0.293264942016057,0.280776092774309,0.341436217662801,0.0686886708296164,0.00914362176628011,0.002007136485281,2595,0.578724353256021,1889,0.421275646743979
"E02002559",65,1429,1191,973,432,143,41,4274,0.015208235844642,0.334347215722976,0.278661675245671,0.227655591951334,0.101076275152082,0.0334581188582124,0.00959288722508189,2685,0.62821712681329,1589,0.37178287318671
"E02002560",22,141,403,967,356,51,18,1958,0.0112359550561798,0.0720122574055158,0.20582226762002,0.493871297242084,0.181818181818182,0.026046986721144,0.00919305413687436,566,0.289070480081716,1392,0.710929519918284
"E02002561",1,33,653,942,371,41,3,2044,0.000489236790606654,0.0161448140900196,0.319471624266145,0.460861056751468,0.181506849315068,0.0200587084148728,0.00146771037181996,687,0.336105675146771,1357,0.663894324853229
"E02002562",0,36,908,1340,484,68,20,2856,0,0.0126050420168067,0.317927170868347,0.469187675070028,0.169467787114846,0.0238095238095238,0.00700280112044818,944,0.330532212885154,1912,0.669467787114846
"E02002563",3,169,862,760,152,34,4,1984,0.00151209677419355,0.0851814516129032,0.434475806451613,0.383064516129032,0.0766129032258065,0.0171370967741935,0.00201612903225806,1034,0.52116935483871,950,0.47883064516129
"E02002564",5,360,1317,1386,421,72,10,3571,0.00140016802016242,0.100812097451694,0.368804256510781,0.388126575189023,0.117894147297676,0.0201624194903388,0.00280033604032484,1682,0.471016521982638,1889,0.528983478017362
"E02002567",28,1309,998,1314,352,51,13,4065,0.00688806888068881,0.322017220172202,0.245510455104551,0.323247232472325,0.0865928659286593,0.0125461254612546,0.0031980319803198,2335,0.574415744157442,1730,0.425584255842558
"E02002568",0,223,722,815,498,112,11,2381,0,0.0936581268374632,0.303233935321294,0.342293154136917,0.209155816883662,0.0470390592188156,0.00461990760184796,945,0.396892062158757,1436,0.603107937841243
"E02002569",1,212,593,1316,527,79,9,2737,0.000365363536719035,0.0774570697844355,0.216660577274388,0.480818414322251,0.192546583850932,0.0288637194008038,0.00328827183047132,806,0.294483010595543,1931,0.705516989404457
"E02002570",12,207,1178,1511,566,91,23,3588,0.00334448160535117,0.0576923076923077,0.328316610925307,0.421125975473802,0.157748049052397,0.0253623188405797,0.00641025641025641,1397,0.389353400222965,2191,0.610646599777035
"E02002571",8,89,1051,851,309,52,8,2368,0.00337837837837838,0.0375844594594595,0.443834459459459,0.359375,0.130489864864865,0.0219594594594595,0.00337837837837838,1148,0.484797297297297,1220,0.515202702702703
"E02002572",11,126,835,1015,447,74,20,2528,0.00435126582278481,0.0498417721518987,0.330300632911392,0.401503164556962,0.176819620253165,0.0292721518987342,0.00791139240506329,972,0.384493670886076,1556,0.615506329113924
"E02002573",45,1103,957,1103,351,99,19,3677,0.0122382376937721,0.299972803916236,0.260266521620887,0.299972803916236,0.0954582540114224,0.0269241229262986,0.00516725591514822,2105,0.572477563230895,1572,0.427522436769105
"E02002574",29,727,799,807,250,49,13,2674,0.0108451757666417,0.271877337322364,0.298803290949888,0.301795063575168,0.093492894540015,0.0183246073298429,0.00486163051608078,1555,0.581525804038893,1119,0.418474195961107
"E02002575",5,203,1159,909,178,36,2,2492,0.00200642054574639,0.0814606741573034,0.465088282504013,0.364767255216693,0.0714285714285714,0.014446227929374,0.000802568218298555,1367,0.548555377207063,1125,0.451444622792937
"E02002576",1,317,1078,1058,282,35,23,2794,0.000357909806728704,0.113457408732999,0.385826771653543,0.378668575518969,0.100930565497495,0.0125268432355047,0.0082319255547602,1396,0.499642090193271,1398,0.500357909806729
"E02002577",0,125,1429,779,215,33,3,2584,0,0.048374613003096,0.553018575851393,0.301470588235294,0.0832043343653251,0.0127708978328173,0.0011609907120743,1554,0.601393188854489,1030,0.398606811145511
"E02002578",0,274,814,1026,362,38,9,2523,0,0.108600871977804,0.322631787554499,0.406658739595719,0.143479984145858,0.0150614347998415,0.00356718192627824,1088,0.431232659532303,1435,0.568767340467697
"E02002579",11,226,920,1076,284,43,16,2576,0.00427018633540373,0.0877329192546584,0.357142857142857,0.417701863354037,0.110248447204969,0.0166925465838509,0.0062111801242236,1157,0.449145962732919,1419,0.550854037267081
"E02002580",0,293,1324,1480,444,68,22,3631,0,0.0806940236849353,0.364637840815202,0.407601211787386,0.122280363536216,0.0187276232442853,0.00605893693197466,1617,0.445331864500138,2014,0.554668135499862
"E02002581",15,108,761,917,310,74,18,2203,0.00680889695869269,0.0490240581025874,0.345438039037676,0.41625056740808,0.140717203812982,0.0335905583295506,0.00817067635043123,884,0.401270994098956,1319,0.598729005901044
"E02002582",71,1164,746,958,187,55,19,3200,0.0221875,0.36375,0.233125,0.299375,0.0584375,0.0171875,0.0059375,1981,0.6190625,1219,0.3809375
"E02002583",0,884,1419,851,160,37,4,3355,0,0.263487332339791,0.422950819672131,0.253651266766021,0.0476900149031297,0.0110283159463487,0.00119225037257824,2303,0.686438152011922,1052,0.313561847988078
"E02002584",1,286,607,1174,324,47,9,2448,0.000408496732026144,0.116830065359477,0.247957516339869,0.479575163398693,0.132352941176471,0.0191993464052288,0.00367647058823529,894,0.365196078431373,1554,0.634803921568628
"E02002585",7,459,1607,1885,565,115,29,4667,0.00149989286479537,0.0983501178487251,0.344332547675166,0.403899721448468,0.121062781229912,0.0246410970644954,0.00621384186843797,2073,0.444182558388687,2594,0.555817441611314
"E02002586",22,239,1638,1251,299,45,5,3499,0.00628751071734781,0.0683052300657331,0.468133752500714,0.357530723063733,0.0854529865675907,0.0128608173763933,0.00142897970848814,1899,0.542726493283795,1600,0.457273506716205
"E02002587",1,66,1419,754,112,8,2,2362,0.000423370025402202,0.0279424216765453,0.600762066045724,0.31922099915326,0.0474174428450466,0.00338696020321761,0.000846740050804403,1486,0.629127857747671,876,0.370872142252329
"E02002588",2,68,1713,801,186,8,3,2781,0.000719165767709457,0.0244516361021215,0.61596548004315,0.288025889967638,0.0668824163969795,0.00287666307083783,0.00107874865156419,1783,0.641136281912981,998,0.358863718087019
"E02002589",3,75,467,842,182,35,7,1611,0.00186219739292365,0.0465549348230912,0.289882060831782,0.522656734947238,0.112973308504035,0.0217256362507759,0.00434512725015518,545,0.338299193047796,1066,0.661700806952204
"E02002590",3,166,525,894,269,49,16,1922,0.00156087408949011,0.0863683662851197,0.27315296566077,0.465140478668054,0.139958376690947,0.0254942767950052,0.00832466181061394,694,0.36108220603538,1228,0.63891779396462
"E02002591",13,180,762,1051,286,42,19,2353,0.00552486187845304,0.0764980875478113,0.323841903952401,0.446663833404165,0.121546961325967,0.017849553761156,0.00807479813004675,955,0.405864853378666,1398,0.594135146621334
"E02002592",2,98,616,999,261,57,16,2049,0.000976085895558809,0.0478282088823817,0.300634455832113,0.487554904831625,0.127379209370425,0.0278184480234261,0.00780868716447047,716,0.349438750610054,1333,0.650561249389946
"E02002593",3,108,834,800,147,16,1,1909,0.00157150340492404,0.0565741225772656,0.436877946568884,0.419067574646412,0.0770036668412782,0.00838135149292824,0.000523834468308015,945,0.495023572551074,964,0.504976427448926
"E02002594",3,108,1145,850,130,14,0,2250,0.00133333333333333,0.048,0.508888888888889,0.377777777777778,0.0577777777777778,0.00622222222222222,0,1256,0.558222222222222,994,0.441777777777778
"E02002595",9,139,2058,1844,209,47,11,4317,0.00208478109798471,0.0321982858466528,0.476719944405837,0.427148482742645,0.0484132499420894,0.0108871901783646,0.00254806578642576,2206,0.511003011350475,2111,0.488996988649525
"E02002596",1,82,967,1093,212,28,2,2385,0.000419287211740042,0.0343815513626834,0.405450733752621,0.458280922431866,0.0888888888888889,0.0117400419287212,0.000838574423480084,1050,0.440251572327044,1335,0.559748427672956
"E02002597",17,211,2529,1222,196,26,10,4211,0.00403704583234386,0.050106862977915,0.600569935882213,0.290192353360247,0.0465447637140822,0.00617430539064355,0.00237473284255521,2757,0.654713844692472,1454,0.345286155307528
"E02002598",18,1773,1545,794,91,6,3,4230,0.00425531914893617,0.419148936170213,0.365248226950355,0.187706855791962,0.0215130023640662,0.00141843971631206,0.000709219858156028,3336,0.788652482269504,894,0.211347517730496
"E02002599",3,327,1640,1181,124,9,1,3285,0.00091324200913242,0.0995433789954338,0.49923896499239,0.359512937595129,0.0377473363774734,0.00273972602739726,0.00030441400304414,1970,0.599695585996956,1315,0.400304414003044
"E02002600",8,192,1268,1830,495,68,29,3890,0.00205655526992288,0.0493573264781491,0.325964010282776,0.470437017994859,0.127249357326478,0.0174807197943445,0.00745501285347044,1468,0.377377892030848,2422,0.622622107969152
"E02002601",6,458,862,1148,327,52,10,2863,0.00209570380719525,0.159972057282571,0.301082780300384,0.400977995110024,0.114215857492141,0.0181627663290255,0.00349283967865875,1326,0.46315054139015,1537,0.53684945860985
"E02002602",8,456,1893,1564,269,35,14,4239,0.00188723755602736,0.10757254069356,0.446567586694975,0.36895494220335,0.0634583628214201,0.00825666430761972,0.00330266572304789,2357,0.556027364944562,1882,0.443972635055438
"E02002603",5,65,535,916,228,27,7,1783,0.00280426247896803,0.0364554122265844,0.300056085249579,0.513740886146943,0.127874369040942,0.0151430173864274,0.00392596747055524,605,0.339315759955132,1178,0.660684240044868
"E02002604",5,245,614,1025,203,33,6,2131,0.00234631628343501,0.114969497888315,0.288127639605819,0.480994838104176,0.0952604411074613,0.015485687470671,0.00281557954012201,864,0.405443453777569,1267,0.594556546222431
"E02002605",5,180,1198,1142,254,35,9,2823,0.00177116542685087,0.0637619553666312,0.424371236273468,0.404534183492738,0.0899752036840241,0.0123981579879561,0.00318809776833156,1383,0.48990435706695,1440,0.51009564293305
"E02002606",6,751,2735,1992,483,73,23,6063,0.000989609104403761,0.123866072901204,0.451096816757381,0.328550222662048,0.0796635329045027,0.0120402441035791,0.00379350156688108,3492,0.575952498762989,2571,0.424047501237011
"E02002607",51,1705,3071,1935,493,70,27,7352,0.00693688792165397,0.231909684439608,0.417709466811752,0.263193688792165,0.0670565832426551,0.00952121871599565,0.00367247007616975,4827,0.656556039173014,2525,0.343443960826986
"E02002608",1,132,528,1132,325,67,13,2198,0.000454959053685168,0.0600545950864422,0.240218380345769,0.515013648771611,0.14786169244768,0.0304822565969063,0.00591446769790719,661,0.300727934485896,1537,0.699272065514104
"E02002609",3,675,2522,1786,309,52,23,5370,0.000558659217877095,0.125698324022346,0.469646182495345,0.332588454376164,0.0575418994413408,0.00968342644320298,0.00428305400372439,3200,0.595903165735568,2170,0.404096834264432
"E02002610",7,430,1869,1816,576,99,17,4814,0.00145409223099294,0.0893228084752804,0.388242625675114,0.377233070211882,0.119651017864562,0.0205650186954715,0.00353136684669713,2306,0.479019526381388,2508,0.520980473618612
"E02002611",2,264,679,1076,388,61,8,2478,0.000807102502017756,0.106537530266344,0.274011299435028,0.434221146085553,0.156577885391445,0.0246166263115416,0.00322841000807102,945,0.38135593220339,1533,0.61864406779661
"E02002612",3,174,1110,1577,564,94,11,3533,0.000849136711010473,0.0492499292386074,0.314180583073875,0.446362864421172,0.159637701669969,0.0266062836116615,0.00311350127370507,1287,0.364279649023493,2246,0.635720350976507
"E02002613",18,648,415,812,288,75,18,2274,0.0079155672823219,0.284960422163588,0.18249780123131,0.357080035180299,0.12664907651715,0.0329815303430079,0.0079155672823219,1081,0.475373790677221,1193,0.524626209322779
"E02002614",1,98,480,763,228,44,8,1622,0.00061652281134402,0.0604192355117139,0.295930949445129,0.470406905055487,0.140567200986436,0.0271270036991369,0.00493218249075216,579,0.356966707768187,1043,0.643033292231813
"E02002615",16,416,854,1794,628,112,35,3855,0.00415045395590143,0.107911802853437,0.221530479896239,0.465369649805447,0.162905317769131,0.02905317769131,0.00907911802853437,1286,0.333592736705577,2569,0.666407263294423
"E02002616",13,366,387,1276,613,131,22,2808,0.00462962962962963,0.13034188034188,0.137820512820513,0.454415954415954,0.218304843304843,0.0466524216524217,0.00783475783475784,766,0.272792022792023,2042,0.727207977207977
"E02002617",2,122,922,909,455,89,30,2529,0.000790826413602214,0.0482404112297351,0.364570976670621,0.359430604982206,0.179913009094504,0.0351917754052985,0.0118623962040332,1046,0.413602214313958,1483,0.586397785686042
"E02002618",9,67,520,710,388,70,15,1779,0.00505902192242833,0.0376616076447442,0.29229904440697,0.399100618324902,0.218100056211355,0.0393479482855537,0.00843170320404722,596,0.335019673974143,1183,0.664980326025857
"E02002619",19,75,743,1165,655,166,44,2867,0.00662713637949076,0.0261597488664109,0.259155912103244,0.406348099058249,0.228461806766655,0.0579002441576561,0.0153470526682944,837,0.291942797349145,2030,0.708057202650854
"E02002620",5,334,1700,1011,373,59,19,3501,0.00142816338189089,0.0954013139103113,0.485575549842902,0.288774635818338,0.10654098828906,0.0168523279063125,0.00542702085118538,2039,0.582405027135104,1462,0.417594972864896
"E02002621",0,90,1063,775,332,66,24,2350,0,0.0382978723404255,0.452340425531915,0.329787234042553,0.141276595744681,0.0280851063829787,0.0102127659574468,1153,0.49063829787234,1197,0.50936170212766
"E02002622",3,252,1809,1627,416,79,25,4211,0.000712419852766564,0.0598432676323914,0.429589171218238,0.386369033483733,0.0987888862502968,0.0187603894561862,0.00593683210638803,2064,0.490144858703396,2147,0.509855141296604
"E02002623",4,647,1858,2089,621,135,46,5400,0.000740740740740741,0.119814814814815,0.344074074074074,0.386851851851852,0.115,0.025,0.00851851851851852,2509,0.46462962962963,2891,0.53537037037037
"E02002624",37,718,562,1121,349,78,14,2879,0.0128516846127127,0.249392150052101,0.195206668982286,0.389371309482459,0.121222646752345,0.027092740534908,0.00486279958318861,1317,0.4574505036471,1562,0.5425494963529
"E02002625",8,561,1643,1465,279,38,11,4005,0.00199750312109863,0.140074906367041,0.41023720349563,0.365792759051186,0.0696629213483146,0.00948813982521848,0.00274656679151061,2212,0.55230961298377,1793,0.44769038701623
"E02002626",11,208,1089,1227,266,54,8,2863,0.00384212364652462,0.072651065316102,0.380370241005938,0.428571428571429,0.0929095354523227,0.0188613342647572,0.002794271742927,1308,0.456863429968564,1555,0.543136570031436
"E02002627",5,95,794,981,228,51,13,2167,0.00230733733271804,0.0438394093216428,0.366405168435625,0.45269958467928,0.105214582371943,0.023534840793724,0.00599907706506691,894,0.412551915089986,1273,0.587448084910014
"E02002628",5,74,973,1495,453,88,24,3112,0.00160668380462725,0.0237789203084833,0.312660668380463,0.480398457583548,0.145565552699229,0.0282776349614396,0.0077120822622108,1052,0.338046272493573,2060,0.661953727506427
"E02002629",9,377,843,1160,409,73,22,2893,0.00311095748358106,0.130314552367784,0.291393017628759,0.400967853439336,0.141375734531628,0.0252333218112686,0.00760456273764259,1229,0.424818527480124,1664,0.575181472519876
"E02002630",16,395,721,1158,453,71,26,2840,0.00563380281690141,0.139084507042254,0.25387323943662,0.407746478873239,0.159507042253521,0.025,0.00915492957746479,1132,0.398591549295775,1708,0.601408450704225
"E02002631",16,460,911,1516,449,69,18,3439,0.00465251526606572,0.133759813899389,0.264902587961617,0.440825821459727,0.130561209653969,0.0200639720849084,0.00523407967432393,1387,0.403314917127072,2052,0.596685082872928
"E02002632",7,148,409,807,373,133,39,1916,0.00365344467640919,0.0772442588726514,0.213465553235908,0.421189979123173,0.194676409185804,0.0694154488517745,0.0203549060542797,564,0.294363256784969,1352,0.705636743215031
"E02002633",0,28,557,1663,555,120,18,2941,0,0.00952057123427406,0.189391363481809,0.565453927235634,0.188711322679361,0.0408024481468888,0.00612036722203332,585,0.198911934716083,2356,0.801088065283917
"E02002634",20,256,1204,1407,528,77,11,3503,0.00570939194975735,0.0730802169568941,0.343705395375393,0.40165572366543,0.150727947473594,0.0219811590065658,0.00314016557236654,1480,0.422495004282044,2023,0.577504995717956
"E02002635",1,79,681,1665,713,100,32,3271,0.00030571690614491,0.0241516355854479,0.208193213084684,0.509018648731275,0.217976154081321,0.030571690614491,0.00978294099663711,761,0.232650565576276,2510,0.767349434423724
"E02002636",0,18,1036,1429,463,60,19,3025,0,0.0059504132231405,0.342479338842975,0.472396694214876,0.153057851239669,0.0198347107438017,0.00628099173553719,1054,0.348429752066116,1971,0.651570247933884
"E02002637",0,9,371,1225,456,89,20,2170,0,0.00414746543778802,0.170967741935484,0.564516129032258,0.210138248847926,0.0410138248847926,0.00921658986175115,380,0.175115207373272,1790,0.824884792626728
"E02002638",4,47,1140,1731,1030,224,116,4292,0.000931966449207828,0.010950605778192,0.265610438024231,0.403308480894688,0.239981360671016,0.0521901211556384,0.027027027027027,1191,0.277493010251631,3101,0.722506989748369
"E02002639",95,163,1067,1038,333,52,9,2757,0.0344577439245557,0.0591222343126587,0.387014871236852,0.376496191512514,0.120783460282916,0.0188610808850199,0.00326441784548422,1325,0.480594849474066,1432,0.519405150525934
"E02002640",1,369,1318,1442,546,94,45,3815,0.000262123197903014,0.0967234600262123,0.345478374836173,0.377981651376147,0.143119266055046,0.0246395806028834,0.0117955439056356,1688,0.442463958060288,2127,0.557536041939712
"E02002641",1,66,767,1728,541,106,35,3244,0.00030826140567201,0.0203452527743527,0.236436498150432,0.532675709001233,0.166769420468557,0.032675709001233,0.0107891491985203,834,0.257090012330456,2410,0.742909987669544
"E02002642",0,99,1564,2033,1196,234,133,5259,0,0.0188248716486024,0.297394942004183,0.386575394561704,0.227419661532611,0.0444951511694238,0.0252899790834759,1663,0.316219813652786,3596,0.683780186347214
"E02002643",1,49,1016,1748,685,118,48,3665,0.000272851296043656,0.0133697135061392,0.277216916780355,0.476944065484311,0.186903137789904,0.0321964529331514,0.0130968622100955,1066,0.290859481582537,2599,0.709140518417463
"E02002644",0,27,639,1500,563,107,25,2861,0,0.0094372596994058,0.223348479552604,0.524292205522545,0.196784341139462,0.0373995106606082,0.00873820342537574,666,0.23278573925201,2195,0.76721426074799
"E02002645",2,320,1130,1591,1050,244,133,4470,0.000447427293064877,0.0715883668903803,0.252796420581655,0.35592841163311,0.23489932885906,0.054586129753915,0.0297539149888143,1452,0.324832214765101,3018,0.675167785234899
"E02002646",2,449,899,1183,363,66,18,2986,0.000669792364367046,0.150368385800402,0.301071667782987,0.396182183523108,0.121567314132619,0.0221031480241125,0.00602813127930342,1350,0.452109845947756,1630,0.545880776959143
"E02002647",1,97,897,1767,684,121,67,3634,0.000275178866263071,0.0266923500275179,0.246835443037975,0.486241056686846,0.188222344523941,0.0332966428178316,0.0184369840396258,995,0.273802971931756,2639,0.726197028068244
"E02002648",0,57,698,1369,470,91,30,2715,0,0.0209944751381215,0.257090239410681,0.504235727440147,0.173112338858195,0.0335174953959484,0.0110497237569061,755,0.278084714548803,1960,0.721915285451197
"E02002649",0,17,920,1800,872,194,61,3864,0,0.00439958592132505,0.238095238095238,0.46583850931677,0.225672877846791,0.0502070393374741,0.0157867494824017,937,0.242494824016563,2927,0.757505175983437
"E02002650",3,317,842,1314,458,95,30,3059,0.0009807126511932,0.103628636809415,0.275253350768225,0.429552141222622,0.149722131415495,0.031055900621118,0.009807126511932,1162,0.379862700228833,1897,0.620137299771167
"E02002651",1,44,632,1396,512,89,25,2699,0.000370507595405706,0.0163023341978511,0.234160800296406,0.517228603186365,0.189699888847721,0.0329751759911078,0.00926268988514265,677,0.250833642089663,2022,0.749166357910337
"E02002653",25,37,1963,1283,134,21,13,3476,0.0071921749136939,0.010644418872267,0.564729574223245,0.369102416570771,0.0385500575373993,0.00604142692750288,0.00373993095512083,2025,0.582566168009206,1451,0.417433831990794
"E02002654",0,298,1029,1554,105,33,10,3029,0,0.0983823043908881,0.339716077913503,0.513040607461208,0.0346649059095411,0.0108946847144272,0.00330141961043249,1327,0.438098382304391,1702,0.561901617695609
"E02002655",5,97,1951,847,117,28,12,3057,0.00163559044815178,0.0317304546941446,0.638207392868826,0.277069021916912,0.0382728164867517,0.00915930650964998,0.00392541707556428,2053,0.671573438011122,1004,0.328426561988878
"E02002656",1,27,496,970,223,25,6,1748,0.0005720823798627,0.0154462242562929,0.283752860411899,0.554919908466819,0.127574370709382,0.0143020594965675,0.0034324942791762,524,0.299771167048055,1224,0.700228832951945
"E02002657",6,72,1180,879,129,15,6,2287,0.00262352426759948,0.0314822912111937,0.515959772627897,0.384346305203323,0.0564057717533887,0.00655881066899869,0.00262352426759948,1258,0.55006558810669,1029,0.44993441189331
"E02002658",1,230,843,1103,199,29,6,2411,0.000414765657403567,0.0953961012028204,0.349647449191207,0.457486520116134,0.0825383658233098,0.0120282040647034,0.0024885939444214,1074,0.445458316051431,1337,0.554541683948569
"E02002659",0,49,1721,2266,264,49,16,4365,0,0.0112256586483391,0.394272623138603,0.519129438717068,0.0604810996563574,0.0112256586483391,0.00366552119129439,1770,0.405498281786942,2595,0.594501718213058
"E02002660",1,40,1175,1263,157,38,10,2684,0.0003725782414307,0.014903129657228,0.437779433681073,0.470566318926975,0.05849478390462,0.0141579731743666,0.003725782414307,1216,0.453055141579732,1468,0.546944858420268
"E02002661",11,174,1104,1523,158,36,12,3018,0.00364479787939032,0.0576540755467197,0.365805168986084,0.504638833664679,0.0523525513585156,0.0119284294234592,0.00397614314115308,1289,0.427104042412194,1729,0.572895957587807
"E02002662",8,655,1566,851,185,38,7,3310,0.00241691842900302,0.197885196374622,0.473111782477341,0.257099697885196,0.0558912386706949,0.0114803625377644,0.00211480362537764,2229,0.673413897280967,1081,0.326586102719033
"E02002663",0,81,495,1265,406,48,9,2304,0,0.03515625,0.21484375,0.549045138888889,0.176215277777778,0.0208333333333333,0.00390625,576,0.25,1728,0.75
"E02002664",2,22,521,953,249,33,7,1787,0.00111919418019026,0.0123111359820929,0.291550083939563,0.53329602686066,0.139339675433688,0.0184667039731393,0.00391717963066592,545,0.304980414101847,1242,0.695019585898153
"E02002665",0,67,524,1381,468,63,10,2513,0,0.0266613609231994,0.208515718265022,0.549542379625945,0.186231595702348,0.0250696378830084,0.00397930760047752,591,0.235177079188221,1922,0.764822920811779
"E02002666",1,107,1351,2212,724,88,42,4525,0.000220994475138122,0.023646408839779,0.298563535911602,0.488839779005525,0.16,0.0194475138121547,0.0092817679558011,1459,0.322430939226519,3066,0.677569060773481
"E02002667",9,138,613,1640,454,68,29,2951,0.00304981362250085,0.0467638088783463,0.207726194510335,0.55574381565571,0.153846153846154,0.0230430362588953,0.00982717722805829,760,0.257539817011183,2191,0.742460182988817
"E02002668",100,499,1485,1790,223,19,14,4130,0.0242130750605327,0.120823244552058,0.35956416464891,0.433414043583535,0.0539951573849879,0.00460048426150121,0.00338983050847458,2084,0.504600484261501,2046,0.495399515738499
"E02002669",1,82,825,2045,796,114,26,3889,0.000257135510413988,0.021085111853947,0.21213679609154,0.525842118796606,0.204679866289535,0.0293134481871947,0.00668552327076369,908,0.233479043455901,2981,0.766520956544099
"E02002670",10,128,1088,1675,333,47,11,3292,0.00303766707168894,0.0388821385176185,0.330498177399757,0.508809234507898,0.101154313487242,0.014277035236938,0.00334143377885784,1226,0.372417982989064,2066,0.627582017010936
"E02002671",12,310,748,1517,453,58,23,3121,0.00384492149951938,0.0993271387375841,0.239666773470042,0.486062159564242,0.145145786606857,0.018583787247677,0.00736943287407882,1070,0.342838833707145,2051,0.657161166292855
"E02002672",0,214,1302,1663,104,21,4,3308,0,0.0646916565900846,0.393591293833132,0.502720677146312,0.0314389359129383,0.00634824667472793,0.00120918984280532,1516,0.458282950423216,1792,0.541717049576783
"E02002673",0,95,641,1871,577,65,31,3280,0,0.0289634146341463,0.195426829268293,0.570426829268293,0.175914634146341,0.0198170731707317,0.00945121951219512,736,0.224390243902439,2544,0.775609756097561
"E02002674",0,17,760,1681,247,39,11,2755,0,0.00617059891107078,0.275862068965517,0.61016333938294,0.0896551724137931,0.0141560798548094,0.00399274047186933,777,0.282032667876588,1978,0.717967332123412
"E02002675",1,189,1909,1656,629,88,28,4500,0.000222222222222222,0.042,0.424222222222222,0.368,0.139777777777778,0.0195555555555556,0.00622222222222222,2099,0.466444444444444,2401,0.533555555555556
"E02002676",0,28,572,2023,698,98,27,3446,0,0.00812536273940801,0.165989553105049,0.587057457922229,0.202553685432385,0.028438769587928,0.00783517121300058,600,0.174114915844457,2846,0.825885084155543
"E02002677",0,120,1942,1811,473,53,31,4430,0,0.0270880361173815,0.438374717832957,0.408803611738149,0.106772009029345,0.0119638826185102,0.00699774266365689,2062,0.465462753950339,2368,0.534537246049661
"E02002678",2,423,678,1689,560,74,32,3458,0.000578368999421631,0.122325043377675,0.196067090803933,0.488432620011567,0.161943319838057,0.0213996529786003,0.0092539039907461,1103,0.318970503181029,2355,0.681029496818971
"E02002679",1,222,648,1200,418,56,17,2562,0.00039032006245121,0.0866510538641686,0.252927400468384,0.468384074941452,0.163153786104606,0.0218579234972678,0.00663544106167057,871,0.339968774395004,1691,0.660031225604996
"E02002680",6,646,3873,2031,639,91,25,7311,0.000820681165367255,0.0883600054712078,0.529749692244563,0.277800574476816,0.0874025441116126,0.0124469976747367,0.0034195048556969,4525,0.618930378881138,2786,0.381069621118862
"E02002681",0,117,1617,2267,796,123,114,5034,0,0.0232419547079857,0.321215733015495,0.450337703615415,0.158124751688518,0.0244338498212157,0.0226460071513707,1734,0.34445768772348,3300,0.65554231227652
"E02002682",3,1065,1507,1699,340,29,16,4659,0.000643915003219575,0.228589826142949,0.323459969950633,0.364670530156686,0.0729770336982185,0.00622451169778923,0.0034342133505044,2575,0.552693711096802,2084,0.447306288903198
"E02002684",77,559,1332,2062,397,67,23,4517,0.0170467124197476,0.123754704449856,0.294885986274076,0.456497675448306,0.0878901926057118,0.0148328536639362,0.00509187513836617,1968,0.435687403143679,2549,0.564312596856321
"E02002685",5,100,783,1558,516,123,45,3130,0.00159744408945687,0.0319488817891374,0.250159744408946,0.49776357827476,0.164856230031949,0.039297124600639,0.0143769968051118,888,0.28370607028754,2242,0.71629392971246
"E02002686",16,195,1551,1293,412,75,33,3575,0.00447552447552448,0.0545454545454545,0.433846153846154,0.361678321678322,0.115244755244755,0.020979020979021,0.00923076923076923,1762,0.492867132867133,1813,0.507132867132867
"E02002687",2,119,766,1236,720,123,43,3009,0.000664672648720505,0.0395480225988701,0.254569624459953,0.410767696909272,0.239282153539382,0.0408773678963111,0.0142904619474909,887,0.294782319707544,2122,0.705217680292456
"E02002688",4,47,710,1267,897,151,82,3158,0.0012666244458518,0.0148828372387587,0.224825839138695,0.401203293223559,0.284040531982267,0.0478150728309056,0.025965801139962,761,0.240975300823306,2397,0.759024699176694
"E02002689",8,353,468,852,528,224,76,2509,0.00318852132323635,0.140693503387804,0.186528497409326,0.339577520924671,0.210442407333599,0.0892785970506178,0.0302909525707453,829,0.330410522120367,1680,0.669589477879633
"E02002691",9,324,649,1139,594,203,72,2990,0.00301003344481605,0.108361204013378,0.217056856187291,0.380936454849498,0.19866220735786,0.0678929765886288,0.0240802675585284,982,0.328428093645485,2008,0.671571906354515
"E02002692",8,506,753,1154,413,128,29,2991,0.00267469073888332,0.16917418923437,0.251755265797392,0.385824139083918,0.138080909394851,0.0427950518221331,0.00969575392845202,1267,0.423604145770645,1724,0.576395854229355
"E02002693",58,340,690,849,498,199,76,2710,0.0214022140221402,0.125461254612546,0.254612546125461,0.313284132841328,0.183763837638376,0.0734317343173432,0.0280442804428044,1088,0.401476014760148,1622,0.598523985239852
"E02002694",22,1870,1568,1597,584,130,35,5806,0.00378918360316914,0.322080606269377,0.270065449534964,0.275060282466414,0.100585601102308,0.0223906303823631,0.00602824664140544,3460,0.595935239407509,2346,0.404064760592491
"E02002695",1,186,903,1455,673,143,45,3406,0.000293599530240752,0.0546095126247798,0.265120375807399,0.427187316500294,0.197592483852026,0.0419847328244275,0.0132119788608338,1090,0.320023487962419,2316,0.679976512037581
"E02002696",6,184,330,829,460,177,60,2046,0.00293255131964809,0.0899315738025415,0.161290322580645,0.405180840664712,0.224828934506354,0.0865102639296188,0.0293255131964809,520,0.254154447702835,1526,0.745845552297165
"E02002697",20,266,682,973,361,142,41,2485,0.00804828973843058,0.107042253521127,0.274446680080483,0.391549295774648,0.145271629778672,0.0571428571428571,0.0164989939637827,968,0.38953722334004,1517,0.61046277665996
"E02002698",16,821,1343,950,252,76,15,3473,0.00460696803915923,0.236395047509358,0.386697379786928,0.273538727325079,0.0725597466167578,0.0218830981860063,0.00431903253671178,2180,0.627699395335445,1293,0.372300604664555
"E02002699",2,481,784,1542,320,51,15,3195,0.000625978090766823,0.150547730829421,0.245383411580595,0.482629107981221,0.100156494522692,0.015962441314554,0.00469483568075117,1267,0.396557120500782,1928,0.603442879499218
"E02002700",1,107,1231,935,220,29,6,2529,0.000395413206801107,0.0423092131277185,0.486753657572163,0.369711348359035,0.0869909054962436,0.0114669829972321,0.00237247924080664,1339,0.529458283906682,1190,0.470541716093317
"E02002701",31,284,578,1120,562,214,62,2851,0.0108733777621887,0.099614170466503,0.202735882146615,0.392844615924237,0.19712381620484,0.0750613819712382,0.0217467555243774,893,0.313223430375307,1958,0.686776569624693
"E02002702",10,467,1791,1952,589,90,37,4936,0.0020259319286872,0.0946110210696921,0.362844408427877,0.395461912479741,0.119327390599676,0.0182333873581848,0.00749594813614263,2268,0.459481361426256,2668,0.540518638573744
"E02002703",105,1624,871,1196,238,61,13,4108,0.0255598831548199,0.395326192794547,0.212025316455696,0.291139240506329,0.057935735150925,0.0148490749756573,0.00316455696202532,2600,0.632911392405063,1508,0.367088607594937
"E02002704",3,130,430,987,498,183,65,2296,0.00130662020905923,0.0566202090592334,0.187282229965157,0.429878048780488,0.216898954703833,0.0797038327526132,0.0283101045296167,563,0.245209059233449,1733,0.754790940766551
"E02002705",15,818,473,913,338,54,17,2628,0.00570776255707763,0.311263318112633,0.179984779299848,0.347412480974125,0.128614916286149,0.0205479452054795,0.00646879756468798,1306,0.496955859969559,1322,0.503044140030441
"E02002706",6,378,574,1133,392,77,16,2576,0.00232919254658385,0.146739130434783,0.222826086956522,0.439829192546584,0.152173913043478,0.0298913043478261,0.0062111801242236,958,0.371894409937888,1618,0.628105590062112
"E02002707",6,285,417,930,433,143,32,2246,0.00267141585040071,0.126892252894034,0.185663401602849,0.41406945681211,0.192787177203918,0.0636687444345503,0.0142475512021371,708,0.315227070347284,1538,0.684772929652716
"E02002708",2,143,782,1103,321,52,7,2410,0.000829875518672199,0.0593360995850622,0.32448132780083,0.457676348547718,0.133195020746888,0.0215767634854772,0.0029045643153527,927,0.384647302904564,1483,0.615352697095436
"E02002709",8,240,815,958,389,150,47,2607,0.0030686612965094,0.0920598388952819,0.312619869581895,0.367472190257,0.149213655542769,0.0575373993095512,0.0180283851169927,1063,0.407748369773686,1544,0.592251630226314
"E02002710",1,72,527,1202,335,54,19,2210,0.000452488687782805,0.032579185520362,0.238461538461538,0.543891402714932,0.15158371040724,0.0244343891402715,0.0085972850678733,600,0.271493212669683,1610,0.728506787330317
"E02002711",29,770,474,1041,466,97,11,2888,0.0100415512465374,0.266620498614958,0.164127423822715,0.360457063711911,0.161357340720222,0.0335872576177285,0.00380886426592798,1273,0.440789473684211,1615,0.559210526315789
"E02002712",19,135,840,1253,272,44,15,2578,0.0073700543056633,0.052366175329713,0.325833979829325,0.486035686578743,0.105508145849496,0.0170674941815361,0.00581846392552366,994,0.385570209464701,1584,0.614429790535299
"E02002714",9,107,735,1094,461,131,41,2578,0.0034910783553142,0.0415050426687355,0.285104732350659,0.424359968968192,0.178820791311094,0.0508145849495733,0.0159038013964313,851,0.330100853374709,1727,0.669899146625291
"E02002715",23,946,2252,1415,322,77,19,5054,0.00455085081123862,0.187178472497032,0.445587653343886,0.27997625643055,0.0637119113573407,0.0152354570637119,0.0037593984962406,3221,0.637316976652157,1833,0.362683023347843
"E02002716",10,106,1048,1263,246,61,15,2749,0.00363768643142961,0.0385594761731539,0.381229538013823,0.45943979628956,0.0894870862131684,0.0221898872317206,0.00545652964714442,1164,0.423426700618407,1585,0.576573299381593
"E02002717",2,356,1048,1349,381,64,13,3213,0.000622471210706505,0.110799875505758,0.326174914410209,0.419856831621538,0.118580765639589,0.0199190787426082,0.00404606286959228,1406,0.437597261126673,1807,0.562402738873327
"E02002718",19,404,647,1139,377,77,9,2672,0.00711077844311377,0.151197604790419,0.242140718562874,0.42627245508982,0.141092814371257,0.0288173652694611,0.00336826347305389,1070,0.400449101796407,1602,0.599550898203593
"E02002719",8,973,447,873,331,59,8,2699,0.00296406076324565,0.360503890329752,0.165616895146351,0.323453130789181,0.122638014079289,0.0218599481289366,0.00296406076324565,1428,0.529084846239348,1271,0.470915153760652
"E02002720",18,297,866,959,260,63,17,2480,0.00725806451612903,0.119758064516129,0.349193548387097,0.386693548387097,0.104838709677419,0.0254032258064516,0.00685483870967742,1181,0.476209677419355,1299,0.523790322580645
"E02002721",4,788,777,871,387,157,62,3046,0.00131319763624425,0.258699934340118,0.255088640840446,0.285948785292186,0.127051871306632,0.051543007222587,0.0203545633617859,1569,0.515101772816809,1477,0.484898227183191
"E02002722",2,77,928,1490,691,175,63,3426,0.000583771161704612,0.0224751897256276,0.27086981903094,0.434909515469936,0.201692936368943,0.0510799766491535,0.0183887915936953,1007,0.293928779918272,2419,0.706071220081728
"E02002723",29,298,760,1539,722,130,43,3521,0.00823629650667424,0.084635046861687,0.215847770519739,0.437091735302471,0.205055381993752,0.03692132916785,0.0122124396478273,1087,0.3087191138881,2434,0.6912808861119
"E02002724",2,140,1211,1586,645,106,40,3730,0.000536193029490617,0.0375335120643432,0.324664879356568,0.425201072386059,0.172922252010724,0.0284182305630027,0.0107238605898123,1353,0.362734584450402,2377,0.637265415549598
"E02002725",21,276,706,884,249,80,25,2241,0.00937081659973226,0.123159303882195,0.315037929495761,0.394466755912539,0.111111111111111,0.035698348951361,0.0111557340473003,1003,0.447568049977689,1238,0.552431950022311
"E02002726",35,268,1554,1539,409,63,13,3881,0.00901829425405823,0.0690543674310745,0.400412264880185,0.396547281628446,0.105385209997423,0.0162329296573048,0.00334965215150734,1857,0.478484926565318,2024,0.521515073434682
"E02002727",8,247,1277,1076,383,56,17,3064,0.00261096605744125,0.0806135770234987,0.41677545691906,0.351174934725849,0.125,0.0182767624020888,0.00554830287206266,1532,0.5,1532,0.5
"E02002728",0,290,1068,2001,637,93,36,4125,0,0.0703030303030303,0.258909090909091,0.485090909090909,0.154424242424242,0.0225454545454545,0.00872727272727273,1358,0.329212121212121,2767,0.670787878787879
"E02002729",2,84,932,942,183,39,2,2184,0.000915750915750916,0.0384615384615385,0.426739926739927,0.431318681318681,0.0837912087912088,0.0178571428571429,0.000915750915750916,1018,0.466117216117216,1166,0.533882783882784
"E02002730",0,14,432,1899,648,82,41,3116,0,0.00449293966623877,0.138639281129653,0.609435173299101,0.20795892169448,0.0263157894736842,0.0131578947368421,446,0.143132220795892,2670,0.856867779204108
"E02002731",1,24,468,1472,442,54,29,2490,0.000401606425702811,0.00963855421686747,0.187951807228916,0.591164658634538,0.177510040160643,0.0216867469879518,0.0116465863453815,493,0.197991967871486,1997,0.802008032128514
"E02002732",5,518,814,1077,268,53,12,2747,0.0018201674554059,0.188569348380051,0.29632326174008,0.39206406989443,0.0975609756097561,0.0192937750273025,0.00436840189297415,1337,0.486712777575537,1410,0.513287222424463
"E02002733",1,39,677,1193,398,50,18,2376,0.000420875420875421,0.0164141414141414,0.28493265993266,0.502104377104377,0.167508417508417,0.021043771043771,0.00757575757575758,717,0.301767676767677,1659,0.698232323232323
"E02002734",5,187,776,876,227,32,6,2109,0.00237079184447606,0.0886676149834045,0.367946894262684,0.415362731152205,0.107633949739213,0.0151730678046468,0.00284495021337127,968,0.458985301090564,1141,0.541014698909436
"E02002736",0,127,487,1305,509,58,27,2513,0,0.0505372065260645,0.193792280143255,0.519299641862316,0.202546756864306,0.0230799840827696,0.0107441305212893,614,0.24432948666932,1899,0.75567051333068
"E02002737",0,64,563,1201,429,67,15,2339,0,0.0273621205643437,0.240701154339461,0.513467293715263,0.183411714407867,0.0286447199657974,0.00641299700726806,627,0.268063274903805,1712,0.731936725096195
"E02002738",3,35,812,1075,209,19,5,2158,0.00139017608897127,0.0162187210379981,0.376274328081557,0.498146431881372,0.0968489341983318,0.00880444856348471,0.00231696014828545,850,0.393883225208526,1308,0.606116774791474
"E02002739",0,123,800,1198,405,74,15,2615,0,0.0470363288718929,0.305927342256214,0.458126195028681,0.154875717017208,0.0282982791586998,0.00573613766730402,923,0.352963671128107,1692,0.647036328871893
"E02002740",1,43,626,985,291,36,8,1990,0.00050251256281407,0.021608040201005,0.314572864321608,0.494974874371859,0.146231155778894,0.0180904522613065,0.00402010050251256,670,0.336683417085427,1320,0.663316582914573
"E02002741",1,198,547,1605,690,100,20,3161,0.000316355583676052,0.0626384055678583,0.1730465042708,0.507750711800063,0.218285352736476,0.0316355583676052,0.00632711167352104,746,0.236001265422335,2415,0.763998734577665
"E02002743",3,23,833,887,143,19,4,1912,0.00156903765690377,0.0120292887029289,0.435669456066946,0.463912133891213,0.0747907949790795,0.00993723849372385,0.00209205020920502,859,0.449267782426778,1053,0.550732217573222
"E02002744",1,122,1233,1007,310,24,6,2703,0.000369959304476508,0.0451350351461339,0.456159822419534,0.372549019607843,0.114687384387717,0.00887902330743618,0.00221975582685905,1356,0.501664816870144,1347,0.498335183129856
"E02002745",3,106,549,1227,297,100,84,2366,0.00126796280642434,0.0448013524936602,0.232037193575655,0.518596787827557,0.12552831783601,0.0422654268808115,0.0355029585798817,658,0.27810650887574,1708,0.72189349112426
"E02002746",22,700,1481,1243,268,28,4,3746,0.00587293112653497,0.186865990389749,0.395355045381741,0.331820608649226,0.0715429791777896,0.00747463961558996,0.00106780565936999,2203,0.588093966898025,1543,0.411906033101975
"E02002747",33,1282,874,1192,285,36,6,3708,0.00889967637540453,0.345738942826321,0.235706580366775,0.321467098166127,0.0768608414239482,0.00970873786407767,0.00161812297734628,2189,0.590345199568501,1519,0.409654800431499
"E02002748",13,354,686,1156,389,95,18,2711,0.00479527849502029,0.130579122095168,0.253043157506455,0.426410918480266,0.143489487274069,0.0350424197713021,0.0066396163777204,1053,0.388417558096643,1658,0.611582441903357
"E02002749",6,513,1664,1714,525,84,20,4526,0.00132567388422448,0.113345117101193,0.367653557224923,0.37870083959346,0.115996464869642,0.0185594343791427,0.00441891294741494,2183,0.48232434821034,2343,0.51767565178966
"E02002750",6,174,670,840,307,83,26,2106,0.00284900284900285,0.0826210826210826,0.318138651471985,0.398860398860399,0.145773979107312,0.0394112060778727,0.0123456790123457,850,0.40360873694207,1256,0.59639126305793
"E02002751",6,296,597,840,325,87,18,2169,0.00276625172890733,0.136468418626095,0.275242047026279,0.387275242047026,0.149838635315814,0.0401106500691563,0.00829875518672199,899,0.414476717381282,1270,0.585523282618718
"E02002752",11,264,694,953,405,143,36,2506,0.00438946528332003,0.105347166799681,0.276935355147646,0.380287310454908,0.161612130885874,0.0570630486831604,0.014365522745411,969,0.386671987230646,1537,0.613328012769353
"E02002753",7,152,846,1441,423,97,40,3006,0.00232867598137059,0.0505655355954757,0.281437125748503,0.479374584165003,0.140718562874251,0.0322687957418496,0.0133067198935462,1005,0.334331337325349,2001,0.665668662674651
"E02002754",22,226,692,1150,629,222,71,3012,0.00730411686586985,0.0750332005312085,0.229747675962815,0.381806108897742,0.208831341301461,0.0737051792828685,0.0235723771580345,940,0.312084993359894,2072,0.687915006640106
"E02002755",1,216,1116,1191,315,47,14,2900,0.000344827586206897,0.0744827586206896,0.384827586206897,0.410689655172414,0.108620689655172,0.0162068965517241,0.00482758620689655,1333,0.459655172413793,1567,0.540344827586207
"E02002756",2,191,1168,1701,522,89,33,3706,0.000539665407447383,0.051538046411225,0.315164597949271,0.458985429033999,0.140852671343767,0.0240151106314085,0.00890447922288181,1361,0.367242309767944,2345,0.632757690232056
"E02002757",10,57,434,926,376,47,5,1855,0.00539083557951483,0.0307277628032345,0.233962264150943,0.499191374663073,0.202695417789757,0.0253369272237197,0.00269541778975741,501,0.270080862533693,1354,0.729919137466307
"E02002758",29,205,570,1117,417,51,9,2398,0.01209341117598,0.085487906588824,0.237698081734779,0.46580483736447,0.173894912427023,0.0212677231025855,0.00375312760633862,804,0.335279399499583,1594,0.664720600500417
"E02002759",18,329,1024,1470,467,102,18,3428,0.00525087514585764,0.0959743290548425,0.298716452742124,0.428821470245041,0.136231038506418,0.02975495915986,0.00525087514585764,1371,0.399941656942824,2057,0.600058343057176
"E02002760",5,166,624,858,271,35,2,1961,0.00254971953085161,0.0846506884242733,0.31820499745028,0.437531871494136,0.138194798572157,0.0178480367159612,0.00101988781234064,795,0.405405405405405,1166,0.594594594594595
"E02002761",6,91,680,993,361,69,36,2236,0.00268336314847943,0.0406976744186047,0.304114490161002,0.444096601073345,0.161449016100179,0.0308586762075134,0.0161001788908766,777,0.347495527728086,1459,0.652504472271914
"E02002762",3,110,989,950,252,26,8,2338,0.00128314798973482,0.0470487596236099,0.423011120615911,0.406330196749358,0.107784431137725,0.0111206159110351,0.00342172797262618,1102,0.471343028229256,1236,0.528656971770744
"E02002763",9,442,1774,1034,268,45,7,3579,0.00251466890192791,0.123498183850238,0.495669181335569,0.28890751606594,0.0748812517462979,0.0125733445096396,0.00195585359038838,2225,0.621682034087734,1354,0.378317965912266
"E02002764",7,78,1024,684,110,13,3,1919,0.00364773319437207,0.0406461698801459,0.533611255862428,0.356435643564356,0.0573215216258468,0.00677436164669099,0.00156331422615946,1109,0.577905158936946,810,0.422094841063054
"E02002765",25,313,695,1040,337,48,24,2482,0.0100725221595488,0.12610797743755,0.280016116035455,0.419016921837228,0.135777598710717,0.0193392425463336,0.0096696212731668,1033,0.416196615632554,1449,0.583803384367446
"E02002766",3,280,1201,1174,216,27,1,2902,0.00103376981392143,0.0964851826326671,0.413852515506547,0.404548587181254,0.0744314266023432,0.0093039283252929,0.000344589937973811,1484,0.511371467953136,1418,0.488628532046864
"E02002767",3,138,584,1053,232,30,4,2044,0.00146771037181996,0.0675146771037182,0.285714285714286,0.515166340508806,0.113502935420744,0.0146771037181996,0.00195694716242661,725,0.354696673189824,1319,0.645303326810176
"E02002768",16,234,912,1035,287,74,20,2578,0.00620636152055857,0.0907680372381691,0.353762606671839,0.401474010861133,0.111326609775019,0.0287044220325834,0.00775795190069822,1162,0.450737005430566,1416,0.549262994569434
"E02002769",5,71,428,851,255,57,15,1682,0.00297265160523187,0.0422116527942925,0.254458977407848,0.505945303210464,0.151605231866825,0.0338882282996433,0.0089179548156956,504,0.299643281807372,1178,0.700356718192628
"E02002770",31,333,743,995,349,95,16,2562,0.0120999219359875,0.129976580796253,0.290007806401249,0.388368462138954,0.136221701795472,0.0370804059328649,0.00624512099921936,1107,0.432084309133489,1455,0.567915690866511
"E02002771",13,175,563,908,362,145,44,2210,0.00588235294117647,0.0791855203619909,0.254751131221719,0.410859728506787,0.163800904977376,0.0656108597285068,0.0199095022624434,751,0.339819004524887,1459,0.660180995475113
"E02002772",7,135,727,1033,139,27,10,2078,0.00336862367661213,0.0649663137632339,0.349855630413859,0.49711260827719,0.0668912415784408,0.0129932627526468,0.00481231953801732,869,0.418190567853705,1209,0.581809432146295
"E02002773",3,72,618,893,191,28,3,1808,0.00165929203539823,0.0398230088495575,0.341814159292035,0.49391592920354,0.105641592920354,0.0154867256637168,0.00165929203539823,693,0.383296460176991,1115,0.616703539823009
"E02002774",5,86,591,917,232,20,6,1857,0.00269251480883145,0.0463112547119009,0.318255250403877,0.493807215939688,0.124932687129779,0.0107700592353258,0.00323101777059774,682,0.36725901992461,1175,0.63274098007539
"E02002775",21,235,1033,1025,167,25,4,2510,0.00836653386454183,0.0936254980079681,0.411553784860558,0.408366533864542,0.0665338645418327,0.0099601593625498,0.00159362549800797,1289,0.513545816733068,1221,0.486454183266932
"E02002776",26,239,792,1074,204,28,6,2369,0.0109750949767835,0.100886449978894,0.334318277754327,0.45335584634867,0.0861122836639932,0.0118193330519206,0.00253271422541157,1057,0.446179822710004,1312,0.553820177289996
"E02002777",5,371,1193,1307,156,19,3,3054,0.00163719711853307,0.121480026195154,0.390635232481991,0.427963326784545,0.0510805500982318,0.00622134905042567,0.000982318271119843,1569,0.513752455795678,1485,0.486247544204322
"E02002778",12,158,949,1328,409,57,17,2930,0.00409556313993174,0.0539249146757679,0.323890784982935,0.453242320819113,0.139590443686007,0.0194539249146758,0.00580204778156997,1119,0.381911262798635,1811,0.618088737201365
"E02002779",20,139,827,1469,496,84,24,3059,0.006538084341288,0.0454396861719516,0.270349787512259,0.480222294867604,0.162144491663942,0.0274599542334096,0.0078457012095456,986,0.322327558025499,2073,0.677672441974502
"E02002780",35,101,982,1521,312,39,15,3005,0.0116472545757072,0.0336106489184692,0.326788685524126,0.506156405990017,0.103826955074875,0.0129783693843594,0.00499168053244592,1118,0.372046589018303,1887,0.627953410981697
"E02002781",19,398,1838,1756,405,35,12,4463,0.00425722608111136,0.0891776831727537,0.411830607214878,0.393457315706924,0.0907461348868474,0.0078422585704683,0.0026887743670177,2255,0.505265516468743,2208,0.494734483531257
"E02002782",74,175,456,862,273,58,16,1914,0.038662486938349,0.0914315569487983,0.238244514106583,0.450365726227795,0.142633228840125,0.0303030303030303,0.00835945663531871,705,0.36833855799373,1209,0.63166144200627
"E02002783",5,215,1066,1441,334,46,6,3113,0.0016061676839062,0.0690652104079666,0.342434950208802,0.462897526501767,0.107292001284934,0.014776742691937,0.00192740122068744,1286,0.413106328300675,1827,0.586893671699325
"E02002784",6,920,2895,2082,808,129,41,6881,0.000871966283970353,0.133701496875454,0.420723732015695,0.302572300537713,0.117424792908008,0.0187472751053626,0.00595843627379741,3821,0.55529719517512,3060,0.44470280482488
"E02002785",3,602,801,1046,201,26,6,2685,0.00111731843575419,0.224208566108007,0.298324022346369,0.389571694599628,0.0748603351955307,0.00968342644320298,0.00223463687150838,1406,0.52364990689013,1279,0.47635009310987
"E02002786",6,326,1487,1583,251,29,9,3691,0.00162557572473584,0.0883229477106475,0.402871850447033,0.428881062042807,0.0680032511514495,0.00785694933622325,0.00243836358710377,1819,0.492820373882417,1872,0.507179626117583
"E02002787",76,266,1168,1717,441,71,13,3752,0.0202558635394456,0.0708955223880597,0.311300639658849,0.457622601279318,0.117537313432836,0.0189232409381663,0.00346481876332623,1510,0.402452025586354,2242,0.597547974413646
"E02002788",2,211,1360,1799,536,72,21,4001,0.000499875031242189,0.052736815796051,0.339915021244689,0.449637590602349,0.133966508372907,0.0179955011247188,0.00524868782804299,1573,0.393151712071982,2428,0.606848287928018
"E02002789",11,204,1378,1209,135,26,5,2968,0.00370619946091644,0.068733153638814,0.464285714285714,0.407345013477089,0.0454851752021563,0.00876010781671159,0.00168463611859838,1593,0.536725067385445,1375,0.463274932614555
"E02002790",3,242,1680,1986,533,65,18,4527,0.000662690523525514,0.0534570355643914,0.371106693174288,0.43870112657389,0.117738016346366,0.0143582946763861,0.00397614314115308,1925,0.425226419262205,2602,0.574773580737795
"E02002791",7,88,512,978,235,39,9,1868,0.00374732334047109,0.0471092077087794,0.274089935760171,0.52355460385439,0.125802997858672,0.0208779443254818,0.00481798715203426,607,0.324946466809422,1261,0.675053533190578
"E02002792",4,615,1019,1451,346,38,14,3487,0.00114711786636077,0.176369371952968,0.292228276455406,0.416117006022369,0.0992256954402065,0.0108976197304273,0.00401491253226269,1638,0.469744766274735,1849,0.530255233725265
"E02002793",17,135,1266,1523,208,28,10,3187,0.00533417006589269,0.0423595858173831,0.397238782554126,0.477878882962033,0.0652651396297458,0.00878569187323502,0.00313774709758393,1418,0.444932538437402,1769,0.555067461562598
"E02002794",8,494,451,725,324,60,24,2086,0.00383509108341323,0.236816874400767,0.216203259827421,0.347555129434324,0.155321188878236,0.0287631831255992,0.0115052732502397,953,0.456855225311601,1133,0.543144774688399
"E02002795",19,123,704,1176,262,56,6,2346,0.00809889173060529,0.0524296675191816,0.300085251491901,0.501278772378517,0.111679454390452,0.0238704177323103,0.00255754475703325,846,0.360613810741688,1500,0.639386189258312
"E02002796",6,78,425,925,298,60,3,1795,0.00334261838440111,0.0434540389972145,0.236768802228412,0.515320334261838,0.166016713091922,0.0334261838440111,0.00167130919220056,509,0.283565459610028,1286,0.716434540389972
"E02002797",1,58,640,1280,424,73,7,2483,0.000402738622633911,0.0233588401127668,0.257752718485703,0.515505436971406,0.170761175996778,0.0293999194522755,0.00281917035843737,699,0.281514297221104,1784,0.718485702778897
"E02002798",8,302,1005,1807,292,17,4,3435,0.00232896652110626,0.0879184861717613,0.292576419213974,0.526055312954876,0.0850072780203785,0.0049490538573508,0.00116448326055313,1315,0.382823871906841,2120,0.617176128093159
"E02002799",4,286,732,814,234,33,14,2117,0.00188946622579121,0.135096835144072,0.345772319319792,0.384506376948512,0.110533774208786,0.0155880963627775,0.00661313179026925,1022,0.482758620689655,1095,0.517241379310345
"E02002800",2,189,909,1233,532,107,22,2994,0.000668002672010688,0.06312625250501,0.303607214428858,0.411823647294589,0.177688710754843,0.0357381429525718,0.00734802939211757,1100,0.367401469605878,1894,0.632598530394122
"E02002801",3,73,485,1091,407,59,10,2128,0.00140977443609023,0.0343045112781955,0.227913533834586,0.512687969924812,0.191259398496241,0.0277255639097744,0.00469924812030075,561,0.263627819548872,1567,0.736372180451128
"E02002802",2,74,808,1466,424,89,14,2877,0.000695168578380257,0.0257212374000695,0.280848105665624,0.509558567952729,0.147375738616615,0.0309350017379214,0.0048661800486618,884,0.307264511644074,1993,0.692735488355926
"E02002803",20,837,1811,1242,508,60,17,4495,0.00444938820912125,0.186206896551724,0.402892102335929,0.276307007786429,0.11301446051168,0.0133481646273637,0.00378197997775306,2668,0.593548387096774,1827,0.406451612903226
"E02002804",6,348,1363,1058,382,71,17,3245,0.00184899845916795,0.107241910631741,0.420030816640986,0.326040061633282,0.117719568567026,0.0218798151001541,0.00523882896764253,1717,0.529121725731895,1528,0.470878274268105
"E02002805",5,77,377,762,341,64,13,1639,0.00305064063453325,0.0469798657718121,0.230018303843807,0.464917632702868,0.208053691275168,0.0390482001220256,0.00793166564978645,459,0.280048810250153,1180,0.719951189749847
"E02002806",2,134,1013,1472,565,67,12,3265,0.000612557427258805,0.04104134762634,0.310260336906585,0.450842266462481,0.173047473200613,0.02052067381317,0.00367534456355283,1149,0.351914241960184,2116,0.648085758039816
"E02002807",10,57,795,1197,498,93,18,2668,0.00374812593703148,0.0213643178410795,0.297976011994003,0.448650674662669,0.186656671664168,0.0348575712143928,0.00674662668665667,862,0.323088455772114,1806,0.676911544227886
"E02002808",2,904,2918,2726,1226,157,29,7962,0.000251193167545843,0.113539311730721,0.366490831449385,0.342376287364984,0.153981411705602,0.0197186636523487,0.00364230092941472,3824,0.480281336347651,4138,0.519718663652349
"E02002809",3,386,900,856,292,56,9,2502,0.00119904076738609,0.15427657873701,0.359712230215827,0.342126298960831,0.116706634692246,0.0223820943245404,0.00359712230215827,1289,0.515187849720224,1213,0.484812150279776
"E02002810",8,1043,947,1106,299,45,8,3456,0.00231481481481481,0.301793981481481,0.274016203703704,0.320023148148148,0.0865162037037037,0.0130208333333333,0.00231481481481481,1998,0.578125,1458,0.421875
"E02002811",1,143,1049,1794,1178,166,33,4364,0.000229147571035747,0.0327681026581118,0.240375802016499,0.41109074243813,0.26993583868011,0.038038496791934,0.00756186984417965,1193,0.273373052245646,3171,0.726626947754354
"E02002812",16,686,766,910,405,88,18,2889,0.00553824852890273,0.237452405676705,0.265143648321218,0.314987885081343,0.14018691588785,0.030460366908965,0.00623052959501558,1468,0.508134302526826,1421,0.491865697473174
"E02002813",9,1311,1636,1563,931,131,41,5622,0.0016008537886873,0.233191035218783,0.290999644254714,0.278014941302028,0.165599430807542,0.0233013162575596,0.00729277837068659,2956,0.525791533262184,2666,0.474208466737816
"E02002814",18,145,780,1120,377,56,8,2504,0.00718849840255591,0.0579073482428115,0.311501597444089,0.447284345047923,0.15055910543131,0.0223642172523962,0.00319488817891374,943,0.376597444089457,1561,0.623402555910543
"E02002815",1,32,321,1212,790,117,30,2503,0.000399520575309628,0.0127846584099081,0.128246104674391,0.48421893727527,0.315621254494606,0.0467439073112265,0.0119856172592889,354,0.141430283659608,2149,0.858569716340391
"E02002816",1,125,1245,1243,314,40,5,2973,0.000336360578540195,0.0420450723175244,0.418768920282543,0.418096199125462,0.105617221661621,0.0134544231416078,0.00168180289270098,1371,0.461150353178607,1602,0.538849646821392
"E02002817",3,44,307,895,342,65,4,1660,0.00180722891566265,0.0265060240963855,0.184939759036145,0.539156626506024,0.206024096385542,0.0391566265060241,0.00240963855421687,354,0.213253012048193,1306,0.786746987951807
"E02002818",1,132,634,1258,528,123,17,2693,0.000371333085777943,0.0490159673226885,0.235425176383216,0.467137021908652,0.196063869290754,0.045673969550687,0.00631266245822503,767,0.284812476791682,1926,0.715187523208318
"E02002819",9,252,1414,1064,397,58,12,3206,0.00280723643169058,0.0786026200873362,0.441048034934498,0.331877729257642,0.123830318153462,0.0180910792264504,0.00374298190892077,1675,0.522457891453525,1531,0.477542108546475
"E02002820",2,78,696,1857,810,141,37,3621,0.000552333609500138,0.0215410107705054,0.192212096106048,0.512841756420878,0.223695111847556,0.0389395194697597,0.0102181717757526,776,0.214305440486054,2845,0.785694559513946
"E02002821",49,482,1459,1997,725,106,31,4849,0.0101051763250155,0.0994019385440297,0.300886780779542,0.411837492266447,0.149515363992576,0.0218601773561559,0.00639307073623427,1990,0.410393895648587,2859,0.589606104351413
"E02002822",2,74,750,1018,300,59,11,2214,0.000903342366757001,0.033423667570009,0.338753387533875,0.459801264679313,0.13550135501355,0.0266485998193315,0.0049683830171635,826,0.373080397470641,1388,0.626919602529359
"E02002823",11,220,1013,902,337,60,9,2552,0.00431034482758621,0.0862068965517241,0.396943573667712,0.353448275862069,0.13205329153605,0.0235109717868339,0.00352664576802508,1244,0.487460815047022,1308,0.512539184952978
"E02002824",6,372,1446,1194,361,58,7,3444,0.00174216027874564,0.10801393728223,0.4198606271777,0.346689895470383,0.104819976771196,0.0168408826945412,0.00203252032520325,1824,0.529616724738676,1620,0.470383275261324
"E02002825",17,176,1602,917,307,58,11,3088,0.00550518134715026,0.0569948186528497,0.518782383419689,0.296955958549223,0.0994170984455959,0.0187823834196891,0.00356217616580311,1795,0.581282383419689,1293,0.418717616580311
"E02002826",7,437,766,893,247,26,7,2383,0.0029374737725556,0.183382291229543,0.321443558539656,0.374737725556022,0.103650860260176,0.0109106168694922,0.0029374737725556,1210,0.507763323541754,1173,0.492236676458246
"E02002827",45,298,1151,750,128,22,2,2396,0.0187813021702838,0.124373956594324,0.480383973288815,0.313021702838063,0.0534223706176962,0.00918196994991653,0.000834724540901503,1494,0.623539232053422,902,0.376460767946578
"E02002828",111,377,725,931,380,63,8,2595,0.0427745664739884,0.145279383429672,0.279383429672447,0.358766859344894,0.146435452793834,0.0242774566473988,0.00308285163776493,1213,0.467437379576108,1382,0.532562620423892
"E02002829",11,199,1485,1742,474,70,32,4013,0.00274109145277847,0.0495888362820832,0.370047346125093,0.434089210067281,0.118116122601545,0.0174433092449539,0.00797408422626464,1695,0.422377273859955,2318,0.577622726140045
"E02002830",17,528,2129,1010,199,18,2,3903,0.00435562387906738,0.135280553420446,0.545477837560851,0.258775301050474,0.0509864207020241,0.00461183704842429,0.00051242633871381,2674,0.685114014860364,1229,0.314885985139636
"E02002831",2,46,503,933,331,55,18,1888,0.00105932203389831,0.024364406779661,0.266419491525424,0.494173728813559,0.175317796610169,0.0291313559322034,0.00953389830508475,551,0.291843220338983,1337,0.708156779661017
"E02002832",4,524,713,1261,488,72,14,3076,0.00130039011703511,0.170351105331599,0.231794538361508,0.409947984395319,0.158647594278283,0.023407022106632,0.00455136540962289,1241,0.403446033810143,1835,0.596553966189857
"E02002833",4,26,449,1244,520,70,16,2329,0.0017174753112924,0.0111635895234006,0.192786603692572,0.534134821811936,0.223271790468012,0.030055817947617,0.0068699012451696,479,0.205667668527265,1850,0.794332331472735
"E02002834",14,1610,1868,1375,483,96,17,5463,0.00256269449020685,0.294709866373787,0.341936664836171,0.251693208859601,0.0884129599121362,0.0175727622185612,0.00311184330953688,3492,0.639209225700165,1971,0.360790774299835
"E02002836",1,6,538,1594,591,61,16,2807,0.000356252226576416,0.0021375133594585,0.191663697898112,0.567866049162807,0.210545065906662,0.0217313858211614,0.00570003562522266,545,0.194157463484147,2262,0.805842536515853
"E02002837",106,157,808,1122,353,53,20,2619,0.0404734631538755,0.059946544482627,0.308514700267278,0.428407789232531,0.134784268804887,0.0202367315769378,0.00763650248186331,1071,0.40893470790378,1548,0.59106529209622
"E02002838",17,127,1163,1273,249,28,5,2862,0.00593990216631726,0.0443745632424878,0.406359189378057,0.444793850454228,0.0870020964360587,0.00978336827393431,0.00174703004891684,1307,0.456673654786862,1555,0.543326345213138
"E02002839",25,138,619,1133,355,56,15,2341,0.0106791969243913,0.0589491670226399,0.264416915847928,0.483981204613413,0.151644596326356,0.0239214011106365,0.00640751815463477,782,0.334045279794959,1559,0.665954720205041
"E02002842",1,310,670,2170,1014,116,27,4308,0.000232126276694522,0.0719591457753018,0.15552460538533,0.503714020427112,0.235376044568245,0.0269266480965645,0.00626740947075209,981,0.227715877437326,3327,0.772284122562674
"E02002843",44,50,771,1838,926,111,33,3773,0.0116618075801749,0.0132520540683806,0.204346673734429,0.487145507553671,0.245428041346409,0.0294195600318049,0.0087463556851312,865,0.229260535382984,2908,0.770739464617016
"E02002844",0,32,1537,1395,474,33,5,3476,0,0.00920598388952819,0.442174913693901,0.40132336018412,0.136363636363636,0.00949367088607595,0.00143843498273878,1569,0.451380897583429,1907,0.548619102416571
"E02002845",3,255,1341,1362,452,149,18,3580,0.000837988826815642,0.0712290502793296,0.374581005586592,0.380446927374302,0.126256983240223,0.0416201117318436,0.00502793296089385,1599,0.446648044692737,1981,0.553351955307263
"E02002846",8,47,447,1194,634,104,14,2448,0.00326797385620915,0.0191993464052288,0.182598039215686,0.487745098039216,0.258986928104575,0.042483660130719,0.00571895424836601,502,0.205065359477124,1946,0.794934640522876
"E02002847",0,26,233,1271,736,96,23,2385,0,0.0109014675052411,0.0976939203354298,0.532914046121593,0.308595387840671,0.040251572327044,0.00964360587002096,259,0.108595387840671,2126,0.891404612159329
"E02002848",1,25,608,1839,921,104,25,3523,0.000283848992336077,0.00709622480840193,0.172580187340335,0.521998296906046,0.261424921941527,0.029520295202952,0.00709622480840193,634,0.179960261141073,2889,0.820039738858927
"E02002849",16,153,1687,2958,1506,182,36,6538,0.00244723156928724,0.0234016518813093,0.258029978586724,0.452431936371979,0.230345671459162,0.0278372591006424,0.0055062710308963,1856,0.28387886203732,4682,0.71612113796268
"E02002851",5,68,530,1014,405,96,9,2127,0.00235072872590503,0.0319699106723084,0.249177244945933,0.47672778561354,0.190409026798307,0.0451339915373766,0.00423131170662906,603,0.283497884344147,1524,0.716502115655853
"E02002852",17,87,471,1288,215,25,8,2111,0.00805305542396968,0.0412126954050213,0.223117006158219,0.61013737565135,0.101847465656087,0.0118427285646613,0.00378967314069162,575,0.27238275698721,1536,0.72761724301279
"E02002853",7,111,798,1901,978,147,24,3966,0.00176500252143217,0.0279878971255673,0.201210287443268,0.479324256177509,0.246596066565809,0.0370650529500756,0.00605143721633888,916,0.230963187090267,3050,0.769036812909733
"E02002854",15,49,846,1363,460,66,20,2819,0.00532103582830791,0.0173820503724725,0.300106420716566,0.483504788932245,0.163178432068109,0.0234125576445548,0.00709471443774388,910,0.322809506917347,1909,0.677190493082653
"E02002855",13,342,635,1375,770,99,27,3261,0.00398650720637841,0.104875804967801,0.194725544311561,0.42164980067464,0.236123888377798,0.0303587856485741,0.00827966881324747,990,0.303587856485741,2271,0.69641214351426
"E02002856",4,166,1186,2456,1452,235,34,5533,0.000722935116573288,0.0300018073377914,0.21435026206398,0.443882161575999,0.262425447316103,0.0424724380986806,0.00614494849087294,1356,0.245075004518344,4177,0.754924995481656
"E02002857",24,302,607,1514,871,118,25,3461,0.0069344120196475,0.0872580179138977,0.175382837330251,0.437445824906097,0.251661369546374,0.0340941924299335,0.00722334585379948,933,0.269575267263797,2528,0.730424732736203
"E02002858",2,70,428,1007,679,151,15,2352,0.000850340136054422,0.0297619047619048,0.181972789115646,0.428146258503401,0.288690476190476,0.0642006802721088,0.00637755102040816,500,0.212585034013605,1852,0.787414965986395
"E02002860",3,245,729,1261,519,96,25,2878,0.00104239054899236,0.0851285615010424,0.253300903405142,0.43815149409312,0.180333564975678,0.0333564975677554,0.00868658790826963,977,0.339471855455177,1901,0.660528144544823
"E02002861",3,99,1147,743,238,33,4,2267,0.00132333480370534,0.0436700485222761,0.505955006616674,0.327745919717689,0.104984561093957,0.0145566828407587,0.00176444640494045,1249,0.550948389942655,1018,0.449051610057345
"E02002862",6,50,1271,1361,277,33,7,3005,0.00199667221297837,0.0166389351081531,0.422961730449251,0.452911813643927,0.0921797004991681,0.010981697171381,0.00232945091514143,1327,0.441597337770383,1678,0.558402662229617
"E02002863",6,156,665,1204,422,149,33,2635,0.00227703984819734,0.0592030360531309,0.252371916508539,0.456925996204934,0.160151802656546,0.0565464895635674,0.0125237191650854,827,0.313851992409867,1808,0.686148007590133
"E02002864",5,1265,782,820,289,52,17,3230,0.00154798761609907,0.391640866873065,0.242105263157895,0.253869969040248,0.0894736842105263,0.0160990712074303,0.00526315789473684,2052,0.635294117647059,1178,0.364705882352941
"E02002865",7,387,1139,1247,352,43,8,3183,0.00219918316054037,0.121583411875589,0.357838517122212,0.39176877159912,0.110587496072887,0.0135092679861766,0.00251335218347471,1533,0.481621112158341,1650,0.518378887841659
"E02002866",7,162,661,1024,510,187,30,2581,0.00271212708252615,0.0627663696241767,0.256102285935684,0.396745447500969,0.197597830298334,0.0724525377760558,0.0116234017822549,830,0.321580782642387,1751,0.678419217357613
"E02002867",10,281,890,1002,683,183,66,3115,0.00321027287319422,0.0902086677367576,0.285714285714286,0.321669341894061,0.219261637239165,0.0587479935794543,0.0211878009630819,1181,0.379133226324238,1934,0.620866773675762
"E02002868",29,102,694,795,198,20,5,1843,0.015735214324471,0.0553445469343462,0.376559956592512,0.431361909929463,0.107433532284319,0.010851871947911,0.00271296798697775,825,0.447639717851329,1018,0.552360282148671
"E02002869",14,149,1272,1636,458,65,10,3604,0.00388457269700333,0.0413429522752497,0.352941176470588,0.453940066592675,0.12708102108768,0.0180355160932297,0.00277469478357381,1435,0.398168701442841,2169,0.601831298557159
"E02002871",12,114,907,1235,573,108,15,2964,0.00404858299595142,0.0384615384615385,0.306005398110661,0.416666666666667,0.19331983805668,0.0364372469635627,0.00506072874493927,1033,0.348515519568151,1931,0.651484480431849
"E02002872",6,140,1988,1457,277,26,9,3903,0.00153727901614143,0.0358698437099667,0.509351780681527,0.373302587753011,0.0709710479118627,0.00666154240327953,0.00230591852421214,2134,0.546758903407635,1769,0.453241096592365
"E02002873",132,366,2047,1584,201,24,7,4361,0.0302682870901169,0.0839257051135061,0.469387755102041,0.363219445081403,0.0460903462508599,0.00550332492547581,0.00160513643659711,2545,0.583581747305664,1816,0.416418252694336
"E02002874",3,212,549,1504,600,108,13,2989,0.00100368016058883,0.070926731348277,0.183673469387755,0.503178320508531,0.200736032117765,0.0361324857811977,0.00434928069588491,764,0.255603880896621,2225,0.744396119103379
"E02002875",18,194,1119,1681,695,90,19,3816,0.00471698113207547,0.0508385744234801,0.293238993710692,0.440513626834382,0.182127882599581,0.0235849056603774,0.004979035639413,1331,0.348794549266247,2485,0.651205450733753
"E02002876",1,119,1164,1504,427,50,12,3277,0.000305157155935307,0.0363137015563015,0.355202929508697,0.458956362526701,0.130302105584376,0.0152578577967653,0.00366188587122368,1284,0.391821788220934,1993,0.608178211779066
"E02002877",5,217,780,1658,1099,175,33,3967,0.00126039828585833,0.0547012856062516,0.1966221325939,0.417948071590623,0.277035543231661,0.0441139400050416,0.00831862868666499,1002,0.25258381648601,2965,0.747416183513991
"E02002878",22,78,1437,2098,273,34,14,3956,0.00556117290192113,0.0197168857431749,0.36324570273003,0.530333670374115,0.0690091001011122,0.00859453993933266,0.00353892821031345,1537,0.388523761375126,2419,0.611476238624874
"E02002879",5,308,1295,1687,805,148,22,4270,0.00117096018735363,0.0721311475409836,0.30327868852459,0.395081967213115,0.188524590163934,0.0346604215456674,0.00515222482435597,1608,0.376580796252927,2662,0.623419203747072
"E02002880",3,96,1241,1757,468,67,17,3649,0.000822143052891203,0.0263085776925185,0.340093176212661,0.481501781309948,0.128254316251028,0.0183611948479035,0.00465881063305015,1340,0.367223896958071,2309,0.632776103041929
"E02002881",19,568,1174,1082,168,25,9,3045,0.00623973727422003,0.186535303776683,0.385550082101806,0.355336617405583,0.0551724137931034,0.00821018062397373,0.00295566502463054,1761,0.578325123152709,1284,0.421674876847291
"E02002882",1,150,1129,1830,1110,185,26,4431,0.000225682690137666,0.03385240352065,0.254795757165425,0.41299932295193,0.25050778605281,0.0417512976754683,0.00586774994357933,1280,0.288873843376213,3151,0.711126156623787
"E02002883",39,325,1544,1410,463,74,17,3872,0.0100723140495868,0.0839359504132231,0.398760330578512,0.364152892561983,0.119576446280992,0.0191115702479339,0.0043904958677686,1908,0.492768595041322,1964,0.507231404958678
"E02002884",0,74,655,1477,785,114,17,3122,0,0.0237027546444587,0.209801409352979,0.473094170403587,0.251441383728379,0.0365150544522742,0.00544522741832159,729,0.233504163997438,2393,0.766495836002562
"E02002885",2,93,1284,1933,774,86,21,4193,0.000476985451943716,0.0221798235153828,0.306224660147865,0.461006439303601,0.184593369902218,0.0205103744335798,0.00500834724540901,1379,0.328881469115192,2814,0.671118530884808
"E02002886",0,441,976,1523,596,118,11,3665,0,0.120327421555252,0.266302864938608,0.415552523874488,0.162619372442019,0.0321964529331514,0.00300136425648022,1417,0.386630286493861,2248,0.613369713506139
"E02002887",37,354,956,1337,304,44,8,3040,0.0121710526315789,0.116447368421053,0.314473684210526,0.439802631578947,0.1,0.0144736842105263,0.00263157894736842,1347,0.443092105263158,1693,0.556907894736842
"E02002888",35,571,1678,893,333,62,12,3584,0.009765625,0.159319196428571,0.468191964285714,0.249162946428571,0.0929129464285714,0.0172991071428571,0.00334821428571429,2284,0.637276785714286,1300,0.362723214285714
"E02002889",0,554,2002,1279,455,63,20,4373,0,0.1266864852504,0.457809284244226,0.292476560713469,0.10404756460096,0.0144065858678253,0.00457351932311914,2556,0.584495769494626,1817,0.415504230505374
"E02002890",21,1168,3166,1228,360,62,18,6023,0.00348663456749128,0.193923294039515,0.525651668603686,0.20388510708949,0.0597708782998506,0.0102938734849743,0.00298854391499253,4355,0.723061597210692,1668,0.276938402789308
"E02002891",3,128,641,1400,704,236,25,3137,0.000956327701625757,0.0408033152693656,0.20433535224737,0.446286260758687,0.224418233981511,0.0752311125278929,0.00796939751354798,772,0.246094995218361,2365,0.753905004781638
"E02002892",23,194,990,1115,259,34,5,2620,0.00877862595419847,0.0740458015267176,0.377862595419847,0.425572519083969,0.0988549618320611,0.0129770992366412,0.00190839694656489,1207,0.460687022900763,1413,0.539312977099237
"E02002893",42,442,2532,1801,628,69,11,5525,0.00760180995475113,0.08,0.458280542986425,0.325972850678733,0.113665158371041,0.0124886877828054,0.00199095022624434,3016,0.545882352941176,2509,0.454117647058824
"E02002895",4,789,2233,1662,677,99,18,5482,0.000729660707770887,0.143925574607807,0.407333090113097,0.303174024078803,0.123495074790223,0.0180591025173294,0.00328347318496899,3026,0.551988325428676,2456,0.448011674571324
"E02002896",24,456,1431,2245,1065,154,27,5402,0.00444279896334691,0.0844131803035913,0.264901888189559,0.415586819696409,0.197149203998519,0.0285079600148093,0.00499814883376527,1911,0.353757867456498,3491,0.646242132543502
"E02002897",1,64,531,1191,472,91,6,2356,0.000424448217317487,0.0271646859083192,0.225382003395586,0.505517826825127,0.200339558573854,0.0386247877758913,0.00254668930390492,596,0.252971137521222,1760,0.747028862478778
"E02002898",85,226,1121,1996,750,61,14,4253,0.0199858923113097,0.0531389607335998,0.263578650364449,0.469315777098519,0.176346108629203,0.0143428168351752,0.00329179402774512,1432,0.336703503409358,2821,0.663296496590642
"E02002901",5,334,904,871,325,61,10,2510,0.00199203187250996,0.133067729083665,0.360159362549801,0.347011952191235,0.129482071713147,0.0243027888446215,0.00398406374501992,1243,0.495219123505976,1267,0.504780876494024
"E02002902",51,184,1603,1334,309,42,11,3534,0.0144312393887946,0.0520656479909451,0.453593661573288,0.377475947934352,0.0874363327674024,0.0118845500848896,0.00311262026032824,1838,0.520090548953028,1696,0.479909451046972
"E02002903",15,504,1147,1028,250,35,8,2987,0.00502176096417811,0.168731168396384,0.383997321727486,0.344158018078339,0.0836960160696351,0.0117174422497489,0.00267827251422832,1666,0.557750251088048,1321,0.442249748911952
"E02002904",6,92,1048,1185,341,47,13,2732,0.00219619326500732,0.0336749633967789,0.383601756954612,0.433748169838946,0.124816983894583,0.017203513909224,0.00475841874084919,1146,0.419472913616398,1586,0.580527086383602
"E02002905",10,161,342,650,732,352,124,2371,0.00421762969211303,0.0679038380430198,0.144242935470266,0.274145929987347,0.308730493462674,0.148460565162379,0.0522986081822016,513,0.216364403205399,1858,0.783635596794601
"E02002906",1,60,748,989,276,41,15,2130,0.000469483568075117,0.028169014084507,0.351173708920188,0.464319248826291,0.129577464788732,0.0192488262910798,0.00704225352112676,809,0.37981220657277,1321,0.62018779342723
"E02002907",7,296,728,995,447,128,46,2647,0.00264450321118247,0.111824707215716,0.275028333962977,0.375897242160937,0.168870419342652,0.0483566301473366,0.0173781639591991,1031,0.389497544389875,1616,0.610502455610125
"E02002908",21,289,471,863,769,371,145,2929,0.00716968248548993,0.098668487538409,0.160805735745988,0.294639808808467,0.262546944349607,0.126664390576989,0.0495049504950495,781,0.266643905769887,2148,0.733356094230113
"E02002909",21,261,1075,1335,736,393,140,3961,0.00530169149204746,0.0658924514011613,0.271396112092906,0.337036101994446,0.185811663721282,0.099217369351174,0.0353446099469831,1357,0.342590254986115,2604,0.657409745013885
"E02002910",26,185,594,899,728,374,207,3013,0.0086292731496847,0.0614005974112181,0.197145701958181,0.298373713906406,0.241619648191172,0.124128775307003,0.0687022900763359,805,0.267175572519084,2208,0.732824427480916
"E02002911",50,313,791,1146,658,226,90,3274,0.015271838729383,0.0956017104459377,0.241600488698839,0.350030543677459,0.200977397678681,0.0690287110568112,0.0274893097128894,1154,0.35247403787416,2120,0.64752596212584
"E02002912",11,507,601,868,332,80,31,2430,0.00452674897119342,0.208641975308642,0.247325102880658,0.357201646090535,0.136625514403292,0.0329218106995885,0.0127572016460905,1119,0.460493827160494,1311,0.539506172839506
"E02002913",38,259,528,699,382,150,48,2104,0.0180608365019011,0.123098859315589,0.250950570342205,0.33222433460076,0.181558935361217,0.0712927756653992,0.0228136882129278,825,0.392110266159696,1279,0.607889733840304
"E02002914",5,228,1179,1431,424,61,9,3337,0.00149835181300569,0.0683248426730596,0.353311357506743,0.42882828888223,0.127060233742883,0.0182798921186695,0.00269703326341025,1412,0.423134551992808,1925,0.576865448007192
"E02002915",23,1257,916,850,289,64,19,3418,0.00672908133411352,0.367758923346987,0.267992978349912,0.248683440608543,0.0845523698069046,0.018724400234055,0.00555880631948508,2196,0.642480983031012,1222,0.357519016968988
"E02002916",9,352,1537,1823,724,112,41,4598,0.0019573727707699,0.076555023923445,0.334275772074815,0.396476729012614,0.157459765115268,0.0243584167029143,0.00891692040017399,1898,0.41278816876903,2700,0.58721183123097
"E02002917",3,176,885,1080,546,92,26,2808,0.00106837606837607,0.0626780626780627,0.31517094017094,0.384615384615385,0.194444444444444,0.0327635327635328,0.00925925925925926,1064,0.378917378917379,1744,0.621082621082621
"E02002918",10,60,578,846,206,35,5,1740,0.00574712643678161,0.0344827586206897,0.332183908045977,0.486206896551724,0.118390804597701,0.0201149425287356,0.0028735632183908,648,0.372413793103448,1092,0.627586206896552
"E02002919",6,276,1568,1222,296,64,11,3443,0.00174266627940749,0.0801626488527447,0.455416787685158,0.354923032239326,0.0859715364507697,0.0185884403136799,0.00319488817891374,1850,0.537322102817311,1593,0.462677897182689
"E02002920",8,213,851,926,231,67,19,2315,0.00345572354211663,0.0920086393088553,0.367602591792657,0.4,0.0997840172786177,0.0289416846652268,0.008207343412527,1072,0.463066954643629,1243,0.536933045356372
"E02002921",1,386,1127,1028,214,41,14,2811,0.000355745286374956,0.137317680540733,0.400924937744575,0.365706154393454,0.0761294912842405,0.0145855567413732,0.00498043400924938,1514,0.538598363571683,1297,0.461401636428317
"E02002922",42,243,337,667,508,211,83,2091,0.0200860832137733,0.116212338593974,0.161166905786705,0.318986131037781,0.242945958871353,0.100908656145385,0.0396939263510282,622,0.297465327594452,1469,0.702534672405548
"E02002923",40,618,1461,1425,500,93,27,4164,0.00960614793467819,0.148414985590778,0.350864553314121,0.342219020172911,0.120076849183477,0.0223342939481268,0.00648414985590778,2119,0.508885686839577,2045,0.491114313160423
"E02002924",48,121,245,554,620,298,144,2030,0.0236453201970443,0.0596059113300493,0.120689655172414,0.272906403940887,0.305418719211823,0.14679802955665,0.070935960591133,414,0.203940886699507,1616,0.796059113300493
"E02002925",56,406,895,1190,802,374,149,3872,0.0144628099173554,0.104855371900826,0.231146694214876,0.307334710743802,0.207128099173554,0.0965909090909091,0.0384814049586777,1357,0.350464876033058,2515,0.649535123966942
"E02002926",99,789,1616,1580,583,111,46,4824,0.0205223880597015,0.163557213930348,0.334991708126036,0.327529021558872,0.120854063018242,0.0230099502487562,0.00953565505804312,2504,0.519071310116086,2320,0.480928689883914
"E02002927",95,306,663,1276,1213,524,167,4244,0.0223845428840716,0.0721017907634307,0.1562205466541,0.300659754948162,0.285815268614515,0.123468426013195,0.0393496701225259,1064,0.250706880301602,3180,0.749293119698398
"E02002928",7,264,726,901,172,21,3,2094,0.00334288443170965,0.126074498567335,0.346704871060172,0.430276981852913,0.0821394460362942,0.0100286532951289,0.00143266475644699,997,0.476122254059217,1097,0.523877745940783
"E02002929",12,718,351,601,316,140,39,2177,0.00551217271474506,0.329811667432246,0.161231051906293,0.276067983463482,0.145153881488287,0.0643086816720257,0.0179145613229215,1081,0.496554892053284,1096,0.503445107946716
"E02002930",12,895,805,902,259,34,7,2914,0.00411805078929307,0.307137954701441,0.276252573781743,0.309540150995196,0.0888812628689087,0.0116678105696637,0.00240219629375429,1712,0.587508579272478,1202,0.412491420727522
"E02002931",260,569,607,859,154,40,16,2505,0.103792415169661,0.227145708582834,0.242315369261477,0.342914171656687,0.0614770459081836,0.0159680638722555,0.0063872255489022,1436,0.573253493013972,1069,0.426746506986028
"E02002932",2,365,1368,1218,243,35,15,3246,0.000616142945163278,0.112446087492298,0.421441774491682,0.375231053604436,0.0748613678373383,0.0107825015403574,0.00462107208872458,1735,0.534504004929144,1511,0.465495995070856
"E02002933",8,421,948,1213,204,21,4,2819,0.00283788577509755,0.149343738914509,0.33628946434906,0.430294430649166,0.0723660872649876,0.00744945015963107,0.00141894288754878,1377,0.488471089038666,1442,0.511528910961334
"E02002934",16,562,801,876,111,10,1,2377,0.00673117374842238,0.236432477913336,0.336979385780395,0.368531762726125,0.0466975178796803,0.00420698359276399,0.000420698359276399,1379,0.580143037442154,998,0.419856962557846
"E02002935",33,311,626,960,228,43,9,2210,0.0149321266968326,0.140723981900452,0.283257918552036,0.434389140271493,0.10316742081448,0.0194570135746606,0.00407239819004525,970,0.438914027149321,1240,0.561085972850679
"E02002936",12,1252,1608,909,232,25,9,4047,0.00296515937731653,0.309364961700025,0.397331356560415,0.224610822831727,0.0573264146281196,0.00617741536940944,0.0022238695329874,2872,0.709661477637756,1175,0.290338522362244
"E02002937",11,1016,938,1268,589,202,58,4082,0.00269475747182754,0.248897599216071,0.229789318961293,0.31063204311612,0.144292013718765,0.0494855463008329,0.0142087212150906,1965,0.481381675649192,2117,0.518618324350808
"E02002938",33,423,926,1042,329,45,10,2808,0.0117521367521368,0.150641025641026,0.32977207977208,0.371082621082621,0.117165242165242,0.016025641025641,0.00356125356125356,1382,0.492165242165242,1426,0.507834757834758
"E02002939",5,665,1077,984,317,43,6,3097,0.00161446561188247,0.214723926380368,0.347755892799483,0.317726832418469,0.102357119793348,0.0138844042621892,0.00193735873425896,1747,0.564094284791734,1350,0.435905715208266
"E02002940",0,99,1086,872,231,35,10,2333,0,0.0424346335190742,0.465495070724389,0.3737676810973,0.0990141448778397,0.015002143163309,0.0042863266180883,1185,0.507929704243463,1148,0.492070295756537
"E02002941",29,494,1831,1368,300,62,11,4095,0.00708180708180708,0.120634920634921,0.447130647130647,0.334065934065934,0.0732600732600733,0.0151404151404151,0.00268620268620269,2354,0.574847374847375,1741,0.425152625152625
"E02002942",20,1666,774,902,144,13,2,3521,0.00568020448736154,0.473161033797217,0.219823913660892,0.256177222380006,0.0408974723090031,0.003692132916785,0.000568020448736154,2460,0.69866515194547,1061,0.30133484805453
"E02002944",37,479,1788,878,140,17,11,3350,0.011044776119403,0.142985074626866,0.533731343283582,0.262089552238806,0.0417910447761194,0.00507462686567164,0.00328358208955224,2304,0.687761194029851,1046,0.312238805970149
"E02002945",7,158,1835,1111,266,18,0,3395,0.00206185567010309,0.046539027982327,0.540500736377025,0.327245949926362,0.0783505154639175,0.0053019145802651,0,2000,0.589101620029455,1395,0.410898379970545
"E02002946",7,178,1292,1216,209,36,10,2948,0.00237449118046133,0.0603799185888738,0.438263229308005,0.412483039348711,0.0708955223880597,0.0122116689280868,0.0033921302578019,1477,0.501017639077341,1471,0.498982360922659
"E02002947",3,107,1356,873,124,14,1,2478,0.00121065375302663,0.04317998385795,0.547215496368039,0.352300242130751,0.0500403551251009,0.00564971751412429,0.000403551251008878,1466,0.591606133979015,1012,0.408393866020985
"E02002948",1,350,1559,847,156,11,1,2925,0.000341880341880342,0.11965811965812,0.532991452991453,0.28957264957265,0.0533333333333333,0.00376068376068376,0.000341880341880342,1910,0.652991452991453,1015,0.347008547008547
"E02002949",2,163,998,857,191,37,6,2254,0.000887311446317658,0.0723158828748891,0.442768411712511,0.380212954747116,0.0847382431233363,0.0164152617568767,0.00266193433895297,1163,0.515971606033718,1091,0.484028393966282
"E02002950",1,132,898,1096,180,13,2,2322,0.000430663221360896,0.0568475452196382,0.386735572782084,0.472006890611542,0.0775193798449612,0.00559862187769164,0.000861326442721792,1031,0.444013781223084,1291,0.555986218776916
"E02002951",8,358,749,1138,256,37,9,2555,0.00313111545988258,0.140117416829746,0.293150684931507,0.445401174168297,0.100195694716243,0.0144814090019569,0.00352250489236791,1115,0.436399217221135,1440,0.563600782778865
"E02002952",6,410,907,1087,273,30,8,2721,0.00220507166482911,0.150679897096656,0.333333333333333,0.399485483278207,0.100330760749724,0.0110253583241455,0.00294009555310548,1323,0.486218302094818,1398,0.513781697905182
"E02002953",0,284,793,1009,241,22,6,2355,0,0.120594479830149,0.336730360934183,0.428450106157113,0.102335456475584,0.00934182590233546,0.00254777070063694,1077,0.457324840764331,1278,0.542675159235669
"E02002954",2,76,1044,1404,357,53,13,2949,0.000678195998643608,0.0257714479484571,0.354018311291963,0.476093591047813,0.121057985757884,0.0179721939640556,0.00440827399118345,1122,0.380467955239064,1827,0.619532044760936
"E02002955",0,65,941,1500,526,73,37,3142,0,0.0206874602164227,0.299490770210057,0.477402928071292,0.167409293443666,0.0232336091661362,0.0117759388924252,1006,0.32017823042648,2136,0.67982176957352
"E02002956",0,43,805,1710,525,79,28,3190,0,0.0134796238244514,0.252351097178683,0.536050156739812,0.164576802507837,0.0247648902821317,0.00877742946708464,848,0.265830721003135,2342,0.734169278996865
"E02002957",5,86,943,1321,434,80,21,2890,0.00173010380622837,0.029757785467128,0.326297577854671,0.457093425605536,0.150173010380623,0.027681660899654,0.00726643598615917,1034,0.357785467128028,1856,0.642214532871972
"E02002958",4,125,1189,1449,384,52,14,3217,0.00124339446689462,0.038856077090457,0.369599005284426,0.450419645632577,0.119365868821884,0.0161641280696301,0.00435188063413118,1318,0.409698476841778,1899,0.590301523158222
"E02002959",10,682,1618,1632,556,87,34,4619,0.00216497077289457,0.147651006711409,0.350292271054341,0.353323230136393,0.120372374972938,0.0188352457241827,0.00736090062784152,2310,0.500108248538645,2309,0.499891751461355
"E02002960",3,46,518,913,206,21,5,1712,0.00175233644859813,0.0268691588785047,0.302570093457944,0.533294392523365,0.120327102803738,0.0122663551401869,0.00292056074766355,567,0.331191588785047,1145,0.668808411214953
"E02002961",8,346,942,1451,423,78,26,3274,0.00244349419670128,0.10568112400733,0.287721441661576,0.443188759926695,0.12919975565058,0.0238240684178375,0.00794135613927917,1296,0.395846059865608,1978,0.604153940134392
"E02002962",0,491,964,1227,257,37,8,2984,0,0.164544235924933,0.323056300268097,0.411193029490617,0.0861260053619303,0.0123994638069705,0.00268096514745308,1455,0.487600536193029,1529,0.512399463806971
"E02002963",6,79,832,1872,654,103,39,3585,0.00167364016736402,0.0220362622036262,0.23207810320781,0.522175732217573,0.182426778242678,0.0287308228730823,0.0108786610878661,917,0.255788005578801,2668,0.744211994421199
"E02002964",3,74,924,1407,375,57,14,2854,0.00105115627189909,0.0259285213735109,0.323756131744919,0.492992291520673,0.131394533987386,0.0199719691660827,0.00490539593552908,1001,0.350735809390329,1853,0.649264190609671
"E02002965",5,405,1004,1286,474,69,36,3279,0.00152485513876182,0.123513266239707,0.306190911863373,0.392192741689539,0.14455626715462,0.0210430009149131,0.0109789569990851,1414,0.431229033241842,1865,0.568770966758158
"E02002966",1,982,1587,1679,678,92,23,5042,0.000198333994446648,0.194763982546608,0.314756049186831,0.333002776675922,0.134470448234827,0.0182467274890916,0.00456168187227291,2570,0.509718365727886,2472,0.490281634272114
"E02002967",2,56,2142,1408,333,27,5,3973,0.000503397936068462,0.0140951422099169,0.539139189529323,0.354392146992197,0.0838157563553989,0.00679587213692424,0.00125849484017116,2200,0.553737729675308,1773,0.446262270324692
"E02002968",8,310,975,1703,689,113,22,3820,0.00209424083769634,0.081151832460733,0.255235602094241,0.445811518324607,0.180366492146597,0.0295811518324607,0.00575916230366492,1293,0.33848167539267,2527,0.66151832460733
"E02002969",1,652,1149,2058,819,116,29,4824,0.000207296849087894,0.135157545605307,0.23818407960199,0.426616915422886,0.169776119402985,0.0240464344941957,0.00601160862354892,1802,0.373548922056385,3022,0.626451077943615
"E02002970",0,260,905,1769,643,126,39,3742,0,0.0694815606627472,0.241849278460716,0.472741849278461,0.171833244254409,0.0336718332442544,0.0104222340994121,1165,0.311330839123463,2577,0.688669160876537
"E02002973",6,109,921,1319,429,66,15,2865,0.00209424083769634,0.0380453752181501,0.321465968586387,0.460383944153578,0.149738219895288,0.0230366492146597,0.00523560209424084,1036,0.361605584642234,1829,0.638394415357766
"E02002974",4,181,541,870,242,35,7,1880,0.00212765957446809,0.0962765957446809,0.287765957446808,0.462765957446808,0.128723404255319,0.0186170212765957,0.00372340425531915,726,0.386170212765957,1154,0.613829787234042
"E02002975",9,71,653,1076,186,22,4,2021,0.00445324096981692,0.0351311232063335,0.323107372587828,0.532409698169223,0.0920336467095497,0.0108857001484414,0.00197921820880752,733,0.362691736763978,1288,0.637308263236022
"E02002976",0,39,642,820,225,33,8,1767,0,0.0220713073005093,0.363327674023769,0.464063384267119,0.127334465195246,0.0186757215619694,0.00452744765138653,681,0.385398981324278,1086,0.614601018675722
"E02002977",3,54,702,1134,307,56,9,2265,0.00132450331125828,0.023841059602649,0.309933774834437,0.500662251655629,0.135540838852097,0.0247240618101545,0.00397350993377483,759,0.335099337748344,1506,0.664900662251656
"E02002978",17,491,909,1163,277,27,11,2895,0.00587219343696028,0.169602763385147,0.3139896373057,0.401727115716753,0.0956822107081174,0.00932642487046632,0.00379965457685665,1417,0.489464594127807,1478,0.510535405872193
"E02002979",1,77,385,862,414,78,20,1837,0.000544365813826892,0.0419161676646707,0.209580838323353,0.469243331518781,0.225367446924333,0.0424605334784975,0.0108873162765378,463,0.252041371801851,1374,0.747958628198149
"E02002980",40,53,461,986,296,40,14,1890,0.0211640211640212,0.028042328042328,0.243915343915344,0.521693121693122,0.156613756613757,0.0211640211640212,0.00740740740740741,554,0.293121693121693,1336,0.706878306878307
"E02002981",0,98,922,1323,286,30,12,2671,0,0.0366903781355298,0.345189067764882,0.495320104829652,0.107076001497566,0.0112317484088356,0.00449269936353426,1020,0.381879445900412,1651,0.618120554099588
"E02002982",15,681,1385,975,202,19,7,3284,0.00456760048721072,0.207369062119367,0.421741778319123,0.296894031668697,0.061510353227771,0.00578562728380024,0.00213154689403167,2081,0.6336784409257,1203,0.3663215590743
"E02002983",2,31,447,789,130,20,2,1421,0.00140745953553835,0.0218156228008445,0.314567206192822,0.55524278676988,0.091484869809993,0.0140745953553835,0.00140745953553835,480,0.337790288529205,941,0.662209711470795
"E02002984",3,137,383,808,192,31,4,1558,0.00192554557124519,0.0879332477535302,0.245827984595635,0.518613607188703,0.123234916559692,0.0198973042362003,0.00256739409499358,523,0.335686777920411,1035,0.664313222079589
"E02002985",5,789,801,773,273,52,6,2699,0.00185253797702853,0.292330492775102,0.29677658391997,0.286402371248611,0.101148573545758,0.0192663949610967,0.00222304557243423,1595,0.590959614672101,1104,0.409040385327899
"E02002986",19,899,1065,766,181,33,4,2967,0.00640377485675767,0.302999662959218,0.358948432760364,0.258173238961914,0.0610043815301652,0.0111223458038423,0.00134816312773846,1983,0.66835187057634,984,0.33164812942366
"E02002987",28,312,664,763,244,45,5,2061,0.0135856380397865,0.151382823871907,0.322173702086366,0.370208636584182,0.118389131489568,0.0218340611353712,0.00242600679281902,1004,0.487142163998059,1057,0.512857836001941
"E02002988",1,148,708,873,360,47,13,2150,0.000465116279069767,0.0688372093023256,0.329302325581395,0.406046511627907,0.167441860465116,0.0218604651162791,0.00604651162790698,857,0.398604651162791,1293,0.601395348837209
"E02002989",3,153,780,900,253,40,3,2132,0.00140712945590994,0.0717636022514071,0.365853658536585,0.422138836772983,0.118667917448405,0.0187617260787993,0.00140712945590994,936,0.439024390243902,1196,0.560975609756098
"E02002990",0,284,965,1236,564,78,17,3144,0,0.0903307888040712,0.306933842239186,0.393129770992366,0.179389312977099,0.0248091603053435,0.00540712468193384,1249,0.397264631043257,1895,0.602735368956743
"E02002991",2,796,2147,2587,1302,221,64,7119,0.000280938334035679,0.1118134569462,0.301587301587302,0.363393735075151,0.182890855457227,0.0310436859109425,0.00899002668914173,2945,0.413681696867538,4174,0.586318303132462
"E02002992",1,47,741,921,341,62,10,2123,0.000471031559114461,0.0221384832783797,0.349034385303815,0.433820065944418,0.160621761658031,0.0292039566650966,0.00471031559114461,789,0.371643900141309,1334,0.628356099858691
"E02002993",0,284,996,1290,582,103,26,3281,0,0.086558975921975,0.303565985979884,0.393172813166717,0.177384943614752,0.0313928680280402,0.00792441328863151,1280,0.390124961901859,2001,0.609875038098141
"E02002994",14,337,801,1386,762,229,55,3584,0.00390625,0.0940290178571429,0.223493303571429,0.38671875,0.212611607142857,0.0638950892857143,0.0153459821428571,1152,0.321428571428571,2432,0.678571428571429
"E02002995",11,166,1389,936,188,14,2,2706,0.0040650406504065,0.0613451589061345,0.51330376940133,0.34589800443459,0.0694752402069475,0.00517368810051737,0.00073909830007391,1566,0.578713968957871,1140,0.421286031042129
"E02002996",31,432,884,1419,717,180,27,3690,0.00840108401084011,0.117073170731707,0.239566395663957,0.384552845528455,0.194308943089431,0.0487804878048781,0.00731707317073171,1347,0.365040650406504,2343,0.634959349593496
"E02002997",0,1110,795,1181,423,55,10,3574,0,0.310576385002798,0.222439843312815,0.330442081701175,0.11835478455512,0.0153889199776161,0.00279798545047566,1905,0.533016228315613,1669,0.466983771684387
"E02002998",1,63,753,1040,331,48,6,2242,0.000446030330062444,0.028099910793934,0.335860838537021,0.463871543264942,0.147636039250669,0.0214094558429973,0.00267618198037467,817,0.364406779661017,1425,0.635593220338983
"E02002999",9,44,824,979,185,23,6,2070,0.00434782608695652,0.021256038647343,0.398067632850242,0.472946859903382,0.0893719806763285,0.0111111111111111,0.00289855072463768,877,0.423671497584541,1193,0.576328502415459
"E02003000",24,190,787,1254,551,137,34,2977,0.00806180718844474,0.0638226402418542,0.264360094054417,0.421229425596238,0.185085656701377,0.0460194827007054,0.0114208935169634,1001,0.336244541484716,1976,0.663755458515284
"E02003001",3,81,428,812,421,82,15,1842,0.00162866449511401,0.0439739413680782,0.232356134636265,0.440825190010858,0.228555917480999,0.0445168295331162,0.00814332247557003,512,0.277958740499457,1330,0.722041259500543
"E02003002",52,680,831,848,309,45,12,2777,0.0187252430680591,0.244868563197695,0.299243788260713,0.305365502340655,0.111271155923659,0.0162045372704357,0.00432120993878286,1563,0.562837594526467,1214,0.437162405473533
"E02003003",1,105,918,812,248,31,6,2121,0.000471475719000471,0.0495049504950495,0.432814710042433,0.382838283828383,0.116925978312117,0.0146157472890146,0.00282885431400283,1024,0.482791136256483,1097,0.517208863743517
"E02003004",21,491,438,670,415,144,37,2216,0.00947653429602888,0.221570397111913,0.197653429602888,0.302346570397112,0.187274368231047,0.0649819494584837,0.0166967509025271,950,0.42870036101083,1266,0.57129963898917
"E02003005",17,221,447,717,425,154,48,2029,0.00837851158206013,0.108920650566782,0.220305569245934,0.353376047313948,0.209462789551503,0.0758994578610153,0.023656973878758,685,0.337604731394776,1344,0.662395268605224
"E02003006",14,137,1023,1216,431,160,53,3034,0.004614370468029,0.0451549110085695,0.337178642056691,0.400791034937376,0.142056690837179,0.0527356624917601,0.0174686882003955,1174,0.386947923533289,1860,0.613052076466711
"E02003007",13,474,970,1150,392,82,21,3102,0.00419084461637653,0.152804642166344,0.312701482914249,0.370728562217924,0.126370083816892,0.026434558349452,0.00676982591876209,1457,0.46969696969697,1645,0.53030303030303
"E02003008",0,385,818,706,330,61,23,2323,0,0.165733964700818,0.352130865260439,0.303917348256565,0.142057684029272,0.0262591476538958,0.0099009900990099,1203,0.517864829961257,1120,0.482135170038743
"E02003009",2,225,619,834,277,55,17,2029,0.00098570724494825,0.110892065056678,0.305076392311483,0.41103992114342,0.136520453425333,0.0271069492360769,0.00837851158206013,846,0.41695416461311,1183,0.58304583538689
"E02003010",4,420,721,781,177,27,6,2136,0.00187265917602996,0.196629213483146,0.337546816479401,0.36563670411985,0.0828651685393258,0.0126404494382022,0.00280898876404494,1145,0.536048689138577,991,0.463951310861423
"E02003011",1,402,593,714,198,34,11,1953,0.000512032770097286,0.205837173579109,0.303635432667691,0.365591397849462,0.101382488479263,0.0174091141833077,0.00563236047107015,996,0.509984639016897,957,0.490015360983103
"E02003012",30,493,1965,1343,430,80,9,4350,0.00689655172413793,0.113333333333333,0.451724137931034,0.308735632183908,0.0988505747126437,0.0183908045977011,0.00206896551724138,2488,0.571954022988506,1862,0.428045977011494
"E02003013",6,369,1815,1478,364,62,12,4106,0.00146127618119825,0.0898684851436922,0.44203604481247,0.359961032635168,0.0886507549926936,0.0150998538723819,0.00292255236239649,2190,0.53336580613736,1916,0.46663419386264
"E02003014",35,504,1435,825,266,50,8,3123,0.0112071725904579,0.161383285302594,0.459494076208774,0.26416906820365,0.08517451168748,0.016010246557797,0.00256163944924752,1974,0.632084534101825,1149,0.367915465898175
"E02003015",3,302,942,885,307,41,10,2490,0.00120481927710843,0.121285140562249,0.378313253012048,0.355421686746988,0.123293172690763,0.0164658634538153,0.00401606425702811,1247,0.500803212851406,1243,0.499196787148594
"E02003016",99,205,1621,839,255,31,9,3059,0.0323635174893756,0.067015364498202,0.529911735861393,0.274272638117032,0.083360575351422,0.0101340307289964,0.0029421379535796,1925,0.62929061784897,1134,0.37070938215103
"E02003017",7,86,656,985,443,112,18,2307,0.00303424360641526,0.0372778500216732,0.284351972258344,0.426961421759861,0.192024273948851,0.0485478977026441,0.00780234070221066,749,0.324664065886433,1558,0.675335934113567
"E02003018",6,66,643,738,266,55,3,1777,0.00337647720877884,0.0371412492965673,0.361845807540799,0.415306696679797,0.149690489589195,0.0309510410804727,0.00168823860438942,715,0.402363534046145,1062,0.597636465953855
"E02003019",14,241,1197,1416,499,87,18,3472,0.00403225806451613,0.0694124423963134,0.344758064516129,0.407834101382488,0.143721198156682,0.0250576036866359,0.00518433179723502,1452,0.418202764976959,2020,0.581797235023041
"E02003020",1,33,456,865,434,68,15,1872,0.000534188034188034,0.0176282051282051,0.243589743589744,0.46207264957265,0.231837606837607,0.0363247863247863,0.00801282051282051,490,0.261752136752137,1382,0.738247863247863
"E02003021",3,132,749,1190,419,54,9,2556,0.00117370892018779,0.0516431924882629,0.293035993740219,0.465571205007825,0.163928012519562,0.0211267605633803,0.00352112676056338,884,0.34585289514867,1672,0.65414710485133
"E02003022",3,42,389,784,404,77,12,1711,0.00175336060783168,0.0245470485096435,0.227352425482174,0.458211572180012,0.236119228521333,0.0450029222676797,0.00701344243132671,434,0.253652834599649,1277,0.746347165400351
"E02003023",2,66,800,888,268,59,7,2090,0.000956937799043062,0.0315789473684211,0.382775119617225,0.42488038277512,0.12822966507177,0.0282296650717703,0.00334928229665072,868,0.415311004784689,1222,0.584688995215311
"E02003024",69,656,1419,1338,443,56,14,3995,0.0172715894868586,0.164205256570713,0.355193992490613,0.334918648310388,0.110888610763454,0.014017521902378,0.00350438047559449,2144,0.536670838548185,1851,0.463329161451815
"E02003025",42,547,967,899,305,48,13,2821,0.0148883374689826,0.193902871322226,0.342786246012052,0.318681318681319,0.10811768876285,0.0170152428216944,0.00460829493087558,1556,0.551577454803261,1265,0.448422545196739
"E02003026",8,111,606,1055,606,124,19,2529,0.00316330565440886,0.0438908659549229,0.239620403321471,0.417160933175168,0.239620403321471,0.0490312376433373,0.00751285092922104,725,0.286674574930803,1804,0.713325425069197
"E02003027",2,462,1181,2104,813,99,30,4691,0.000426348326582818,0.098486463440631,0.251758686847154,0.448518439565125,0.173310594755916,0.0211042421658495,0.00639522489874227,1645,0.350671498614368,3046,0.649328501385632
"E02003028",5,134,646,1493,714,124,15,3131,0.00159693388693708,0.0427978281699138,0.206323858192271,0.476844458639412,0.228042159054615,0.0396039603960396,0.00479080166081124,785,0.250718620249122,2346,0.749281379750878
"E02003029",3,94,549,922,255,41,8,1872,0.0016025641025641,0.0502136752136752,0.293269230769231,0.492521367521368,0.136217948717949,0.0219017094017094,0.00427350427350427,646,0.34508547008547,1226,0.65491452991453
"E02003030",10,283,1106,1274,432,44,11,3160,0.00316455696202532,0.0895569620253165,0.35,0.403164556962025,0.136708860759494,0.0139240506329114,0.00348101265822785,1399,0.442721518987342,1761,0.557278481012658
"E02003031",3,211,945,1818,963,182,35,4157,0.000721674284339668,0.0507577579985567,0.227327399566995,0.437334616309839,0.231657445273033,0.0437815732499399,0.00841953331729613,1159,0.278806831849892,2998,0.721193168150108
"E02003032",12,456,1075,1086,389,71,6,3095,0.00387722132471729,0.147334410339257,0.347334410339257,0.350888529886914,0.125686591276252,0.0229402261712439,0.00193861066235864,1543,0.498546042003231,1552,0.501453957996769
"E02003033",6,133,983,1902,816,101,31,3972,0.00151057401812689,0.033484390735146,0.247482376636455,0.478851963746224,0.205438066465257,0.0254279959718026,0.00780463242698892,1122,0.282477341389728,2850,0.717522658610272
"E02003036",34,880,1264,1736,648,86,29,4677,0.00726961727603164,0.188154800085525,0.270258712850118,0.371178105623263,0.13855035279025,0.0183878554629036,0.00620055591190934,2178,0.465683130211674,2499,0.534316869788326
"E02003037",9,193,1341,2154,850,119,23,4689,0.00191938579654511,0.0411601620814673,0.285988483685221,0.459373000639795,0.18127532522926,0.0253785455320964,0.00490509703561527,1543,0.329068031563233,3146,0.670931968436767
"E02003038",7,187,872,1074,350,58,13,2561,0.00273330730183522,0.0730183522061695,0.34049199531433,0.419367434595861,0.136665365091761,0.0226474033580633,0.0050761421319797,1066,0.416243654822335,1495,0.583756345177665
"E02003039",8,237,1327,1365,454,77,16,3484,0.00229621125143513,0.0680252583237658,0.380884041331803,0.391791044776119,0.130309988518944,0.0221010332950631,0.00459242250287026,1572,0.451205510907003,1912,0.548794489092997
"E02003040",12,479,1525,2238,656,94,24,5028,0.00238663484486874,0.095266507557677,0.303301511535402,0.445107398568019,0.130469371519491,0.0186953062848051,0.00477326968973747,2016,0.400954653937947,3012,0.599045346062053
"E02003041",1,136,938,1369,573,100,23,3140,0.000318471337579618,0.043312101910828,0.298726114649682,0.435987261146497,0.182484076433121,0.0318471337579618,0.00732484076433121,1075,0.342356687898089,2065,0.657643312101911
"E02003044",12,101,788,923,281,45,6,2156,0.00556586270871985,0.0468460111317254,0.365491651205937,0.428107606679035,0.130333951762523,0.0208719851576994,0.00278293135435993,901,0.417903525046382,1255,0.582096474953618
"E02003045",1,135,1163,1150,517,80,19,3065,0.00032626427406199,0.0440456769983687,0.379445350734095,0.375203915171289,0.168678629690049,0.0261011419249592,0.00619902120717781,1299,0.423817292006525,1766,0.576182707993475
"E02003046",18,375,1403,1646,392,50,18,3902,0.00461301896463352,0.0961045617631984,0.359559200410046,0.421834956432599,0.100461301896463,0.0128139415684264,0.00461301896463352,1796,0.460276781137878,2106,0.539723218862122
"E02003047",24,338,1368,2146,738,93,14,4721,0.00508366871425545,0.0715950010590976,0.289769116712561,0.454564710866342,0.156322812963355,0.0196992162677399,0.00296547341664901,1730,0.366447786485914,2991,0.633552213514086
"E02003048",15,154,1057,1619,484,50,19,3398,0.00441436138905238,0.0453207769276045,0.311065332548558,0.476456739258387,0.142436727486757,0.0147145379635079,0.00559152442613302,1226,0.360800470865215,2172,0.639199529134785
"E02003049",9,190,922,1070,389,56,13,2649,0.00339750849377123,0.0717251793129483,0.348055870139675,0.403926009815025,0.146847867119668,0.0211400528501321,0.00490751226878067,1121,0.423178557946395,1528,0.576821442053605
"E02003050",22,1051,2433,1735,453,83,26,5803,0.00379114251249354,0.181113217301396,0.419265896949854,0.298983284508013,0.0780630708254351,0.0143029467516802,0.00448044115112873,3506,0.604170256763743,2297,0.395829743236257
"E02003051",5,239,911,1220,350,48,12,2785,0.00179533213644524,0.0858168761220826,0.327109515260323,0.438061041292639,0.125673249551167,0.0172351885098743,0.00430879712746858,1155,0.414721723518851,1630,0.585278276481149
"E02003052",0,251,622,1338,363,62,17,2653,0,0.0946098756125141,0.234451564266868,0.50433471541651,0.136826234451564,0.023369770071617,0.00640784018092725,873,0.329061439879382,1780,0.670938560120618
"E02003053",3,170,666,1314,475,69,11,2708,0.00110782865583456,0.0627769571639586,0.245937961595273,0.485228951255539,0.175406203840473,0.025480059084195,0.00406203840472674,839,0.309822747415066,1869,0.690177252584934
"E02003054",9,112,683,1101,350,48,8,2311,0.00389441800086543,0.0484638684552142,0.295543054954565,0.476417135439204,0.151449588922544,0.0207702293379489,0.00346170488965816,804,0.347901341410645,1507,0.652098658589355
"E02003055",15,460,913,911,214,60,3,2576,0.00582298136645963,0.178571428571429,0.354425465838509,0.353649068322981,0.0830745341614907,0.0232919254658385,0.00116459627329193,1388,0.538819875776398,1188,0.461180124223602
"E02003056",6,124,767,1153,186,50,4,2290,0.00262008733624454,0.0541484716157205,0.334934497816594,0.503493449781659,0.0812227074235808,0.0218340611353712,0.00174672489082969,897,0.391703056768559,1393,0.608296943231441
"E02003057",0,190,643,818,255,51,9,1966,0,0.0966429298067141,0.32706002034588,0.416073245167853,0.12970498474059,0.025940996948118,0.00457782299084435,833,0.423702950152594,1133,0.576297049847406
"E02003058",43,518,1267,1183,299,56,15,3381,0.0127181307305531,0.153209109730849,0.374741200828157,0.349896480331263,0.0884353741496599,0.0165631469979296,0.00443655723158829,1828,0.540668441289559,1553,0.459331558710441
"E02003059",3,390,1123,729,221,33,7,2506,0.00119712689545092,0.155626496408619,0.448124501197127,0.290901835594573,0.0881883479648843,0.0131683958499601,0.00279329608938547,1516,0.604948124501197,990,0.395051875498803
"E02003060",5,263,1253,1412,433,60,11,3437,0.00145475705557172,0.0765202211230724,0.364562118126273,0.410823392493454,0.125981961012511,0.0174570846668606,0.00320046552225778,1521,0.442537096304917,1916,0.557462903695083
"E02003061",6,97,883,693,299,48,12,2038,0.00294406280667321,0.0475956820412169,0.433267909715407,0.340039254170756,0.146712463199215,0.0235525024533857,0.00588812561334642,986,0.483807654563297,1052,0.516192345436703
"E02003062",1,98,897,662,221,51,12,1942,0.000514933058702369,0.0504634397528321,0.461894953656025,0.340885684860968,0.113800205973223,0.0262615859938208,0.00617919670442842,996,0.512873326467559,946,0.487126673532441
"E02003063",4,117,608,979,232,26,7,1973,0.0020273694880892,0.0593005575266092,0.308160162189559,0.496198682209833,0.117587430309174,0.0131779016725798,0.00354789660415611,729,0.369488089204257,1244,0.630511910795743
"E02003064",22,656,1856,635,178,45,4,3396,0.00647820965842167,0.193168433451119,0.546525323910483,0.18698468786808,0.052414605418139,0.0132508833922261,0.00117785630153121,2534,0.746171967020024,862,0.253828032979976
"E02003065",13,1241,2030,1070,347,63,9,4773,0.00272365388644458,0.260004190236748,0.425309029960193,0.224177666038131,0.0727006075843285,0.0131992457573853,0.00188560653676933,3284,0.688036874083386,1489,0.311963125916614
"E02003066",15,73,691,903,205,43,5,1935,0.00775193798449612,0.0377260981912145,0.357105943152455,0.466666666666667,0.10594315245478,0.0222222222222222,0.00258397932816537,779,0.402583979328165,1156,0.597416020671835
"E02003067",28,615,1570,746,133,27,4,3123,0.00896573807236632,0.196926032660903,0.502721741914825,0.238872878642331,0.04258725584374,0.00864553314121038,0.00128081972462376,2213,0.708613512648095,910,0.291386487351905
"E02003068",28,181,684,833,378,95,27,2226,0.0125786163522013,0.0813117699910153,0.307277628032345,0.374213836477987,0.169811320754717,0.0426774483378257,0.0121293800539084,893,0.401168014375562,1333,0.598831985624439
"E02003069",7,113,472,895,485,114,24,2110,0.0033175355450237,0.0535545023696682,0.223696682464455,0.424170616113744,0.229857819905213,0.0540284360189573,0.0113744075829384,592,0.280568720379147,1518,0.719431279620853
"E02003070",76,732,1542,1214,565,206,56,4391,0.0173081302664541,0.16670462309269,0.351172853564108,0.276474607150991,0.128672284217718,0.0469141425643361,0.012753359143703,2350,0.535185606923252,2041,0.464814393076748
"E02003071",12,337,1030,1263,566,99,23,3330,0.0036036036036036,0.101201201201201,0.309309309309309,0.379279279279279,0.16996996996997,0.0297297297297297,0.00690690690690691,1379,0.414114114114114,1951,0.585885885885886
"E02003072",124,570,1207,1548,394,52,10,3905,0.0317541613316261,0.145966709346991,0.309090909090909,0.396414852752881,0.10089628681178,0.0133162612035851,0.00256081946222791,1901,0.486811779769526,2004,0.513188220230474
"E02003073",43,73,668,851,150,28,6,1819,0.0236393622869709,0.040131940626718,0.367234744365036,0.467839472237493,0.0824628916987356,0.0153930731170973,0.00329851566794942,784,0.431006047278725,1035,0.568993952721275
"E02003074",15,178,1109,1151,229,23,4,2709,0.00553709856035437,0.0657069029162052,0.4093761535622,0.424880029531192,0.0845330380214101,0.00849021779254337,0.0014765596160945,1302,0.48062015503876,1407,0.51937984496124
"E02003075",26,171,450,737,374,128,28,1914,0.0135841170323929,0.0893416927899686,0.235109717868339,0.385057471264368,0.195402298850575,0.0668756530825496,0.0146290491118077,647,0.3380355276907,1267,0.6619644723093
"E02003076",141,705,849,1187,431,104,20,3437,0.0410241489671225,0.205120744835612,0.247017748036078,0.345359324992726,0.125400058190282,0.0302589467558918,0.00581902822228688,1695,0.493162641838813,1742,0.506837358161187
"E02003077",58,215,488,734,421,155,35,2106,0.0275403608736942,0.102089268755935,0.231718898385565,0.348528015194682,0.199905033238367,0.0735992402659069,0.01661918328585,761,0.361348528015195,1345,0.638651471984805
"E02003078",54,306,675,867,301,67,27,2297,0.0235089246843709,0.133217239878102,0.293861558554636,0.377448846321289,0.131040487592512,0.0291684806269047,0.0117544623421855,1035,0.450587723117109,1262,0.549412276882891
"E02003079",6,120,1405,1386,195,17,0,3129,0.00191754554170662,0.0383509108341323,0.449025247682966,0.442953020134228,0.062320230105465,0.00543304570150208,0,1531,0.489293704058805,1598,0.510706295941195
"E02003080",18,337,1201,1295,379,52,8,3290,0.00547112462006079,0.102431610942249,0.365045592705167,0.393617021276596,0.115197568389058,0.0158054711246201,0.00243161094224924,1556,0.472948328267477,1734,0.527051671732523
"E02003081",6,94,810,1609,530,113,13,3175,0.00188976377952756,0.0296062992125984,0.25511811023622,0.506771653543307,0.166929133858268,0.0355905511811024,0.00409448818897638,910,0.286614173228346,2265,0.713385826771654
"E02003082",3,232,1285,2048,1085,200,61,4914,0.000610500610500611,0.0472120472120472,0.261497761497761,0.416768416768417,0.220797720797721,0.0407000407000407,0.0124135124135124,1520,0.309320309320309,3394,0.690679690679691
"E02003084",45,284,1699,2183,1084,170,69,5534,0.00813155041561258,0.0513191181785327,0.307011203469462,0.394470545717383,0.19588001445609,0.0307191904589808,0.0124683773039393,2028,0.366461872063607,3506,0.633538127936393
"E02003085",39,597,1968,994,316,29,14,3957,0.00985595147839272,0.150871872630781,0.497346474601971,0.251200404346727,0.0798584786454385,0.007328784432651,0.00353803386403841,2604,0.658074298711145,1353,0.341925701288855
"E02003086",0,189,665,1208,659,106,23,2850,0,0.0663157894736842,0.233333333333333,0.423859649122807,0.231228070175439,0.0371929824561404,0.00807017543859649,854,0.299649122807018,1996,0.700350877192982
"E02003087",370,1542,819,1429,480,111,32,4783,0.0773573071294167,0.32239180430692,0.171231444699979,0.29876646456199,0.100355425465189,0.023207192138825,0.00669036169767928,2731,0.570980556136316,2052,0.429019443863684
"E02003088",117,703,707,1199,512,147,43,3428,0.0341306884480747,0.205075845974329,0.206242707117853,0.349766627771295,0.149358226371062,0.0428821470245041,0.0125437572928821,1527,0.445449241540257,1901,0.554550758459743
"E02003089",9,232,734,869,291,52,11,2198,0.00409463148316652,0.105550500454959,0.333939945404914,0.395359417652411,0.132393084622384,0.0236578707916288,0.00500454959053685,975,0.443585077343039,1223,0.556414922656961
"E02003090",47,1236,753,866,317,80,15,3314,0.0141822570911285,0.372963186481593,0.227217863608932,0.261315630657815,0.0956547978273989,0.024140012070006,0.00452625226312613,2036,0.614363307181654,1278,0.385636692818346
"E02003091",32,456,828,809,314,72,18,2529,0.0126532226176354,0.180308422301305,0.327402135231317,0.319889284302096,0.124159746935548,0.0284697508896797,0.00711743772241993,1316,0.520363780150257,1213,0.479636219849743
"E02003092",169,579,486,825,470,154,52,2735,0.0617915904936015,0.211700182815356,0.177696526508227,0.301645338208409,0.171846435100548,0.0563071297989031,0.0190127970749543,1234,0.451188299817185,1501,0.548811700182815
"E02003093",10,136,446,726,397,155,53,1923,0.00520020800832033,0.0707228289131565,0.231929277171087,0.377535101404056,0.206448257930317,0.0806032241289652,0.0275611024440978,592,0.307852314092564,1331,0.692147685907436
"E02003094",230,880,776,885,442,148,27,3388,0.0678866587957497,0.25974025974026,0.229043683589138,0.261216056670602,0.130460448642267,0.0436835891381346,0.00796930342384888,1886,0.556670602125148,1502,0.443329397874852
"E02003095",24,2117,836,837,183,21,3,4021,0.00596866451131559,0.526485948768963,0.207908480477493,0.208157174832131,0.0455110668987814,0.00522258144740114,0.000746083063914449,2977,0.740363093757772,1044,0.259636906242228
"E02003096",3,183,970,854,184,30,1,2225,0.00134831460674157,0.082247191011236,0.435955056179775,0.383820224719101,0.0826966292134831,0.0134831460674157,0.000449438202247191,1156,0.519550561797753,1069,0.480449438202247
"E02003097",75,303,614,870,245,53,5,2165,0.0346420323325635,0.139953810623557,0.283602771362587,0.401847575057737,0.113163972286374,0.0244803695150115,0.0023094688221709,992,0.458198614318707,1173,0.541801385681293
"E02003098",5,105,1893,1614,160,15,3,3795,0.00131752305665349,0.0276679841897233,0.498814229249012,0.425296442687747,0.0421607378129117,0.00395256916996047,0.000790513833992095,2003,0.527799736495389,1792,0.472200263504611
"E02003099",1,578,813,844,206,31,3,2476,0.000403877221324717,0.233441033925687,0.328352180936995,0.340872374798061,0.0831987075928918,0.0125201938610662,0.00121163166397415,1392,0.562197092084006,1084,0.437802907915994
"E02003101",12,250,2317,1558,236,9,1,4383,0.0027378507871321,0.0570385580652521,0.528633356148757,0.355464293862651,0.053844398813598,0.00205338809034908,0.000228154232261008,2579,0.588409765001141,1804,0.411590234998859
"E02003102",22,265,648,779,306,59,8,2087,0.0105414470531864,0.126976521322472,0.310493531384763,0.373263057019645,0.146621945376138,0.028270244369909,0.00383325347388596,935,0.448011499760422,1152,0.551988500239578
"E02003103",2,134,906,756,188,48,4,2038,0.00098135426889107,0.0657507360157017,0.444553483807655,0.370951913640824,0.0922473012757605,0.0235525024533857,0.00196270853778214,1042,0.511285574092247,996,0.488714425907753
"E02003104",1,72,879,1018,252,31,3,2256,0.000443262411347518,0.0319148936170213,0.389627659574468,0.451241134751773,0.111702127659574,0.0137411347517731,0.00132978723404255,952,0.421985815602837,1304,0.578014184397163
"E02003105",19,92,457,708,314,70,24,1684,0.0112826603325416,0.0546318289786223,0.271377672209026,0.420427553444181,0.18646080760095,0.0415676959619952,0.0142517814726841,568,0.33729216152019,1116,0.66270783847981
"E02003107",6,322,1469,1742,679,79,11,4308,0.00139275766016713,0.074744661095636,0.340993500464253,0.404363974001857,0.15761374187558,0.0183379758588672,0.00255338904363974,1797,0.417130919220056,2511,0.582869080779944
"E02003108",143,2270,1047,916,415,127,46,4964,0.0288074133763094,0.457292506043513,0.210918614020951,0.184528605962933,0.0836019339242546,0.0255842062852538,0.00926672038678485,3460,0.697018533440774,1504,0.302981466559226
"E02003109",0,33,370,795,313,51,7,1569,0,0.0210325047801147,0.235818992989165,0.506692160611855,0.19949012109624,0.0325047801147228,0.00446144040790312,403,0.25685149776928,1166,0.74314850223072
"E02003110",9,944,1686,1286,231,17,3,4176,0.0021551724137931,0.226053639846743,0.403735632183908,0.307950191570881,0.055316091954023,0.00407088122605364,0.000718390804597701,2639,0.631944444444444,1537,0.368055555555556
"E02003111",11,167,580,903,399,55,11,2126,0.00517403574788335,0.0785512699905927,0.272812793979304,0.424741298212606,0.187676387582314,0.0258701787394167,0.00517403574788335,758,0.35653809971778,1368,0.64346190028222
"E02003112",2,281,732,816,222,34,5,2092,0.000956022944550669,0.134321223709369,0.349904397705545,0.390057361376673,0.106118546845124,0.0162523900573614,0.00239005736137667,1015,0.485181644359465,1077,0.514818355640535
"E02003113",8,269,624,1085,745,282,82,3095,0.00258481421647819,0.0869143780290792,0.201615508885299,0.350565428109855,0.240710823909531,0.0911147011308562,0.0264943457189015,901,0.291114701130856,2194,0.708885298869144
"E02003114",2,181,696,998,406,73,16,2372,0.000843170320404722,0.0763069139966273,0.293423271500843,0.420741989881956,0.171163575042159,0.0307757166947723,0.00674536256323777,879,0.370573355817875,1493,0.629426644182125
"E02003115",3,348,1172,1482,570,63,10,3648,0.000822368421052632,0.0953947368421053,0.321271929824561,0.40625,0.15625,0.0172697368421053,0.00274122807017544,1523,0.417489035087719,2125,0.582510964912281
"E02003116",0,189,1074,1053,345,27,6,2694,0,0.0701559020044543,0.398663697104677,0.39086859688196,0.128062360801782,0.010022271714922,0.0022271714922049,1263,0.468819599109131,1431,0.531180400890869
"E02003117",10,516,1044,1167,506,88,5,3336,0.00299760191846523,0.154676258992806,0.31294964028777,0.349820143884892,0.151678657074341,0.026378896882494,0.00149880095923261,1570,0.470623501199041,1766,0.529376498800959
"E02003118",4,128,1334,1230,347,58,7,3108,0.00128700128700129,0.0411840411840412,0.429214929214929,0.395752895752896,0.111647361647362,0.0186615186615187,0.00225225225225225,1466,0.471685971685972,1642,0.528314028314028
"E02003119",39,189,1137,1320,328,63,18,3094,0.0126050420168067,0.0610859728506787,0.36748545572075,0.426632191338074,0.1060116354234,0.0203619909502262,0.00581771170006464,1365,0.441176470588235,1729,0.558823529411765
"E02003120",11,394,728,1113,407,58,9,2720,0.00404411764705882,0.144852941176471,0.267647058823529,0.409191176470588,0.149632352941176,0.0213235294117647,0.00330882352941176,1133,0.416544117647059,1587,0.583455882352941
"E02003121",3,232,1041,1302,297,44,7,2926,0.00102529049897471,0.0792891319207109,0.355775803144224,0.444976076555024,0.101503759398496,0.0150375939849624,0.00239234449760766,1276,0.43609022556391,1650,0.56390977443609
"E02003122",108,284,892,829,261,104,17,2495,0.0432865731462926,0.113827655310621,0.35751503006012,0.332264529058116,0.104609218436874,0.0416833667334669,0.00681362725450902,1284,0.514629258517034,1211,0.485370741482966
"E02003123",42,533,1283,1266,189,45,13,3371,0.0124592109166419,0.158113319489766,0.380599228715515,0.375556214773064,0.0560664491248888,0.0133491545535449,0.00385642242657965,1858,0.551171759121922,1513,0.448828240878078
"E02003124",29,355,1491,1091,191,30,10,3197,0.00907100406631217,0.111041601501408,0.466374726305912,0.341257428839537,0.0597435095401939,0.0093837973099781,0.00312793243665937,1875,0.586487331873632,1322,0.413512668126368
"E02003125",8,167,1144,778,173,38,9,2317,0.00345274061286146,0.072075960293483,0.493741907639189,0.335779024600777,0.074665515753129,0.0164005179110919,0.00388433318946914,1319,0.569270608545533,998,0.430729391454467
"E02003126",44,861,1249,680,61,16,1,2912,0.0151098901098901,0.295673076923077,0.428914835164835,0.233516483516484,0.0209478021978022,0.00549450549450549,0.000343406593406593,2154,0.739697802197802,758,0.260302197802198
"E02003127",25,163,1055,1103,281,44,16,2687,0.00930405656866394,0.0606624488276889,0.392631187197618,0.410494975809453,0.104577595831783,0.0163751395608485,0.00595459620394492,1243,0.462597692593971,1444,0.537402307406029
"E02003128",31,485,1771,1350,280,38,8,3963,0.00782235680040374,0.122382033812768,0.446883673984355,0.340651021953066,0.0706535452939692,0.00958869543275296,0.00201867272268483,2287,0.577088064597527,1676,0.422911935402473
"E02003129",4,195,1032,1109,222,41,11,2614,0.00153022188217292,0.0745983167559296,0.394797245600612,0.424254016832441,0.0849273144605968,0.0156847742922724,0.00420811017597552,1231,0.470925784238715,1383,0.529074215761285
"E02003130",1,276,1234,1822,507,88,41,3969,0.000251952632905014,0.0695389266817838,0.310909549004787,0.459057697152935,0.127739984882842,0.0221718316956412,0.0103300579491056,1511,0.380700428319476,2458,0.619299571680524
"E02003131",25,246,1112,987,160,31,8,2569,0.00973141300116777,0.0957571039314909,0.432853250291942,0.384196185286104,0.0622810432074737,0.012066952121448,0.00311405216037369,1383,0.538341767224601,1186,0.461658232775399
"E02003132",3,427,1032,1237,373,57,12,3141,0.000955109837631328,0.135943966889526,0.328557784145177,0.393823623049984,0.118751989812162,0.0181470869149952,0.00382043935052531,1462,0.465456860872334,1679,0.534543139127666
"E02003133",3,141,803,1041,236,50,13,2287,0.00131176213379974,0.0616528202885877,0.35111499781373,0.455181460428509,0.103191954525579,0.0218627022299956,0.00568430257979886,947,0.414079580236117,1340,0.585920419763883
"E02003134",58,1042,785,781,240,44,13,2963,0.0195747553155586,0.351670604117449,0.264934188322646,0.263584205197435,0.0809989875126561,0.0148498143773203,0.00438744515693554,1885,0.636179547755653,1078,0.363820452244347
"E02003135",6,311,780,1329,373,72,30,2901,0.00206825232678387,0.10720441227163,0.268872802481903,0.458117890382627,0.12857635298173,0.0248190279214064,0.0103412616339193,1097,0.378145467080317,1804,0.621854532919683
"E02003136",6,221,777,1046,292,58,7,2407,0.00249272953884504,0.0918155380141255,0.322808475280432,0.434565849605318,0.121312837557125,0.0240963855421687,0.00290818446198587,1004,0.417116742833403,1403,0.582883257166597
"E02003137",8,112,709,1161,418,91,15,2514,0.00318217979315831,0.0445505171042164,0.282020684168656,0.4618138424821,0.166268894192522,0.0361972951471758,0.00596658711217184,829,0.32975338106603,1685,0.67024661893397
"E02003138",3,61,491,1520,597,57,26,2755,0.00108892921960073,0.0221415607985481,0.178221415607985,0.551724137931034,0.216696914700544,0.0206896551724138,0.00943738656987296,555,0.201451905626134,2200,0.798548094373866
"E02003139",27,192,850,821,134,14,4,2042,0.0132223310479922,0.0940254652301665,0.416258570029383,0.40205680705191,0.0656219392752204,0.00685602350636631,0.0019588638589618,1069,0.523506366307542,973,0.476493633692458
"E02003140",12,150,621,1149,312,63,15,2322,0.00516795865633075,0.0645994832041344,0.267441860465116,0.494832041343669,0.134366925064599,0.0271317829457364,0.00645994832041344,783,0.337209302325581,1539,0.662790697674419
"E02003141",1,129,1064,1828,610,85,40,3757,0.000266169816342827,0.0343359063082246,0.283204684588768,0.486558424274687,0.162363587969124,0.0226244343891403,0.0106467926537131,1194,0.317806760713335,2563,0.682193239286665
"E02003142",5,250,1260,1578,396,68,26,3583,0.00139547864917667,0.0697739324588334,0.35166061959252,0.440413061680156,0.110521909014792,0.0189785096288027,0.00725648897571867,1515,0.42283003070053,2068,0.57716996929947
"E02003143",2,134,1316,1038,176,29,3,2698,0.000741289844329133,0.0496664195700519,0.487768717568569,0.38472942920682,0.0652335063009637,0.0107487027427724,0.0011119347664937,1452,0.53817642698295,1246,0.46182357301705
"E02003144",1,135,1257,1846,593,96,35,3963,0.000252334090335604,0.0340651021953066,0.317183951551855,0.465808730759526,0.149634115569013,0.024224072672218,0.00883169316174615,1393,0.351501387837497,2570,0.648498612162503
"E02003145",5,305,968,1142,395,74,24,2913,0.0017164435290079,0.104703055269482,0.332303467215929,0.392035702025403,0.135599038791624,0.0254033642293169,0.0082389289392379,1278,0.438722966014418,1635,0.561277033985582
"E02003146",0,28,1014,1958,596,76,28,3700,0,0.00756756756756757,0.274054054054054,0.529189189189189,0.161081081081081,0.0205405405405405,0.00756756756756757,1042,0.281621621621622,2658,0.718378378378378
"E02003147",23,1330,2306,996,290,41,16,5002,0.00459816073570572,0.265893642542983,0.461015593762495,0.199120351859256,0.0579768092762895,0.00819672131147541,0.00319872051179528,3659,0.731507397041184,1343,0.268492602958816
"E02003148",5,833,2464,1554,568,97,29,5550,0.000900900900900901,0.15009009009009,0.443963963963964,0.28,0.102342342342342,0.0174774774774775,0.00522522522522523,3302,0.594954954954955,2248,0.405045045045045
"E02003149",17,256,1403,2082,660,91,39,4548,0.00373790677220756,0.0562884784520668,0.308487247141601,0.45778364116095,0.145118733509235,0.0200087950747581,0.00857519788918206,1676,0.368513632365875,2872,0.631486367634125
"E02003151",21,395,650,1260,292,66,17,2701,0.00777489818585709,0.146242132543502,0.240651610514624,0.466493891151425,0.108108108108108,0.024435394298408,0.00629396519807479,1066,0.394668641243984,1635,0.605331358756016
"E02003152",32,878,989,1469,474,100,44,3986,0.00802809834420472,0.220270948319117,0.248118414450577,0.368539889613648,0.118916206723532,0.0250878073256397,0.0110386352232815,1899,0.476417461113899,2087,0.523582538886101
"E02003153",3,141,1262,1127,245,35,12,2825,0.00106194690265487,0.0499115044247788,0.446725663716814,0.398938053097345,0.0867256637168142,0.0123893805309735,0.00424778761061947,1406,0.497699115044248,1419,0.502300884955752
"E02003154",7,43,755,1105,245,56,15,2226,0.00314465408805031,0.0193171608265948,0.339173405211141,0.496406109613657,0.110062893081761,0.0251572327044025,0.00673854447439353,805,0.361635220125786,1421,0.638364779874214
"E02003155",1,251,757,1022,430,91,32,2584,0.000386996904024768,0.0971362229102167,0.292956656346749,0.395510835913313,0.16640866873065,0.0352167182662539,0.0123839009287926,1009,0.390479876160991,1575,0.609520123839009
"E02003156",34,436,1727,1334,281,34,16,3862,0.00880372863801139,0.112894873122734,0.447177628171932,0.345416882444329,0.0727602278612118,0.00880372863801139,0.00414293112377007,2197,0.568876229932677,1665,0.431123770067323
"E02003157",0,225,920,1143,475,91,21,2875,0,0.0782608695652174,0.32,0.397565217391304,0.165217391304348,0.0316521739130435,0.00730434782608696,1145,0.398260869565217,1730,0.601739130434783
"E02003158",1,145,800,1030,380,73,13,2442,0.00040950040950041,0.0593775593775594,0.327600327600328,0.421785421785422,0.155610155610156,0.0298935298935299,0.00532350532350532,946,0.387387387387387,1496,0.612612612612613
"E02003159",2,42,630,1146,462,71,33,2386,0.000838222967309304,0.0176026823134954,0.264040234702431,0.480301760268231,0.193629505448449,0.0297569153394803,0.0138306789606035,674,0.282481139983236,1712,0.717518860016764
"E02003161",1,344,1579,1691,910,150,63,4738,0.000211059518784297,0.0726044744617982,0.333262980160405,0.356901646264247,0.19206416209371,0.0316589278176446,0.0132967496834107,1924,0.406078514140988,2814,0.593921485859012
"E02003163",2,294,1546,1821,921,231,65,4880,0.00040983606557377,0.0602459016393443,0.316803278688525,0.373155737704918,0.188729508196721,0.0473360655737705,0.0133196721311475,1842,0.377459016393443,3038,0.622540983606557
"E02003164",3,154,809,1678,564,108,24,3340,0.000898203592814371,0.0461077844311377,0.242215568862275,0.502395209580838,0.168862275449102,0.0323353293413174,0.00718562874251497,966,0.289221556886228,2374,0.710778443113772
"E02003165",4,79,514,1363,423,80,15,2478,0.00161420500403551,0.0318805488297014,0.207425343018563,0.550040355125101,0.170702179176755,0.0322841000807102,0.00605326876513317,597,0.2409200968523,1881,0.7590799031477
"E02003166",6,1197,1379,1552,371,75,29,4609,0.00130180082447386,0.259709264482534,0.299197222824908,0.336732479930571,0.0804946843133001,0.0162725103059232,0.0062920373182903,2582,0.560208288131916,2027,0.439791711868084
"E02003167",0,300,1760,1969,1001,220,109,5359,0,0.05598059339429,0.328419481246501,0.367419294644523,0.186788579958948,0.0410524351558127,0.0203396155999254,2060,0.384400074640791,3299,0.615599925359209
"E02003168",0,395,861,1188,360,70,16,2890,0,0.136678200692042,0.297923875432526,0.411072664359862,0.124567474048443,0.0242214532871972,0.0055363321799308,1256,0.434602076124567,1634,0.565397923875433
"E02003169",9,111,588,1265,356,63,9,2401,0.00374843815077051,0.0462307371928363,0.244897959183673,0.526863806747189,0.148271553519367,0.0262390670553936,0.00374843815077051,708,0.29487713452728,1693,0.70512286547272
"E02003170",4,323,964,1935,1003,251,89,4569,0.000875465090829503,0.0706938060844824,0.21098708688991,0.423506237688772,0.219522871525498,0.0549354344495513,0.0194790982709564,1291,0.282556358065222,3278,0.717443641934778
"E02003171",2,155,692,1308,436,88,20,2701,0.000740466493891151,0.0573861532765642,0.256201406886338,0.484265087004813,0.161421695668271,0.0325805257312107,0.00740466493891151,849,0.314328026656794,1852,0.685671973343206
"E02003172",8,122,696,946,311,35,9,2127,0.00376116596144805,0.0573577809120827,0.32722143864598,0.444757874941232,0.146215326751293,0.0164551010813352,0.00423131170662906,826,0.388340385519511,1301,0.611659614480489
"E02003173",7,145,838,1078,276,42,7,2393,0.0029251984956122,0.0605933974091099,0.350188048474718,0.450480568324279,0.115336397826995,0.0175511909736732,0.0029251984956122,990,0.41370664437944,1403,0.58629335562056
"E02003174",10,149,640,1286,421,67,25,2598,0.00384911470361817,0.0573518090839107,0.246343341031563,0.494996150885296,0.162047729022325,0.0257890685142417,0.00962278675904542,799,0.307544264819092,1799,0.692455735180908
"E02003175",4,128,1265,1305,272,40,4,3018,0.00132538104705103,0.0424121935056329,0.419151756129887,0.432405566600398,0.0901259111994698,0.0132538104705103,0.00132538104705103,1397,0.462889330682571,1621,0.537110669317429
"E02003176",13,74,967,998,217,41,7,2317,0.00561070349589987,0.0319378506689685,0.417350021579629,0.430729391454467,0.0936555891238671,0.017695295640915,0.00302114803625378,1054,0.454898575744497,1263,0.545101424255503
"E02003177",2,81,567,1324,513,78,10,2575,0.000776699029126214,0.0314563106796117,0.220194174757282,0.514174757281553,0.199223300970874,0.0302912621359223,0.00388349514563107,650,0.252427184466019,1925,0.747572815533981
"E02003178",7,259,907,1363,346,55,19,2956,0.0023680649526387,0.0876184032476319,0.306833558863329,0.461096075778078,0.117050067658999,0.0186062246278755,0.0064276048714479,1173,0.396820027063599,1783,0.603179972936401
"E02003179",12,109,792,883,263,47,6,2112,0.00568181818181818,0.0516098484848485,0.375,0.418087121212121,0.124526515151515,0.0222537878787879,0.00284090909090909,913,0.432291666666667,1199,0.567708333333333
"E02003180",16,305,1227,1711,524,67,24,3874,0.00413009808982963,0.0787299948373774,0.31672689726381,0.441662364481156,0.135260712441921,0.0172947857511616,0.00619514713474445,1548,0.399586990191017,2326,0.600413009808983
"E02003181",4,123,731,1500,487,102,20,2967,0.00134816312773846,0.0414560161779575,0.246376811594203,0.505561172901921,0.164138860802157,0.0343781597573306,0.00674081563869228,858,0.289180990899899,2109,0.710819009100101
"E02003182",0,96,569,1068,318,42,8,2101,0,0.04569252736792,0.270823417420276,0.50832936696811,0.151356496906235,0.019990480723465,0.00380771061399334,665,0.316515944788196,1436,0.683484055211804
"E02003183",0,236,826,1120,438,77,8,2705,0,0.0872458410351201,0.305360443622921,0.414048059149723,0.161922365988909,0.0284658040665434,0.00295748613678373,1062,0.392606284658041,1643,0.607393715341959
"E02003184",0,255,1138,1538,484,92,16,3523,0,0.0723814930456997,0.323020153278456,0.436559750212887,0.137382912290661,0.0261141072949191,0.00454158387737724,1393,0.395401646324156,2130,0.604598353675844
"E02003185",4,92,686,1258,388,70,19,2517,0.00158919348430671,0.0365514501390544,0.272546682558601,0.499801350814462,0.154151767977751,0.0278108859753675,0.00754866905045689,782,0.310687326181963,1735,0.689312673818037
"E02003186",0,435,1557,1492,541,84,29,4138,0,0.105123247945868,0.376268728854519,0.360560657322378,0.130739487675205,0.0202996616723055,0.0070082165297245,1992,0.481391976800387,2146,0.518608023199613
"E02003187",5,458,1471,1685,650,130,40,4439,0.00112637981527371,0.103176391079072,0.331380941653526,0.37958999774724,0.146429375985582,0.0292858751971165,0.00901103852218968,1934,0.435683712547871,2505,0.564316287452129
"E02003188",0,1117,3084,1957,861,121,27,7167,0,0.155853216129482,0.430305567182922,0.273057067113158,0.120133947258267,0.0168829356774104,0.00376726663876099,4201,0.586158783312404,2966,0.413841216687596
"E02003189",2,527,1593,1532,564,104,19,4341,0.00046072333563695,0.121400598940336,0.366966136834831,0.352914075097904,0.12992398064962,0.0239576134531214,0.00437687168855103,2122,0.488827459110804,2219,0.511172540889196
"E02003190",2,778,3178,2150,958,185,48,7299,0.00027401013837512,0.106589943827922,0.435402109878065,0.294560898753254,0.131250856281682,0.0253459377996986,0.00657624332100288,3958,0.542266063844362,3341,0.457733936155638
"E02003191",6,505,1132,1304,546,118,20,3631,0.001652437345084,0.139080143211237,0.311759845772514,0.359129716331589,0.150371798402644,0.0324979344533186,0.00550812448361333,1643,0.452492426328835,1988,0.547507573671165
"E02003192",3,1084,3340,2104,916,153,42,7642,0.00039256739073541,0.141847683852395,0.437058361685423,0.275320596702434,0.119863909971212,0.0200209369275059,0.00549594347029573,4427,0.579298612928553,3215,0.420701387071447
"E02003194",56,128,406,870,240,37,6,1743,0.0321285140562249,0.0734366035570855,0.232931726907631,0.499139414802065,0.137693631669535,0.02122776821572,0.00344234079173838,590,0.338496844520941,1153,0.661503155479059
"E02003195",101,340,620,708,158,21,3,1951,0.0517683239364429,0.1742696053306,0.317785750896976,0.362890825217837,0.0809841107124551,0.0107637109174782,0.00153767298821117,1061,0.543823680164018,890,0.456176319835982
"E02003196",9,219,882,1483,382,47,4,3026,0.00297422339722406,0.0723727693324521,0.291473892927958,0.490085922009253,0.126239259748843,0.0155320555188367,0.00132187706543291,1110,0.366820885657634,1916,0.633179114342366
"E02003197",61,90,1012,971,126,10,3,2273,0.0268367795864496,0.0395952485701716,0.445226572811263,0.427188737351518,0.0554333479982402,0.0043994720633524,0.00131984161900572,1163,0.511658600967884,1110,0.488341399032116
"E02003198",2,202,906,1029,189,17,2,2347,0.000852151682999574,0.086067319982957,0.386024712398807,0.438432040903281,0.0805283340434597,0.00724328930549638,0.000852151682999574,1110,0.472944184064764,1237,0.527055815935236
"E02003199",27,267,1168,1411,293,36,8,3210,0.00841121495327103,0.0831775700934579,0.36386292834891,0.439563862928349,0.0912772585669782,0.011214953271028,0.00249221183800623,1462,0.455451713395639,1748,0.544548286604361
"E02003200",0,156,1281,1437,387,57,17,3335,0,0.0467766116941529,0.384107946026987,0.430884557721139,0.116041979010495,0.0170914542728636,0.00509745127436282,1437,0.430884557721139,1898,0.56911544227886
"E02003201",16,630,1487,1599,456,63,22,4273,0.00374444184413761,0.147437397612918,0.347999063889539,0.374210156798502,0.106716592557922,0.0147437397612918,0.00514860753568921,2133,0.499180903346595,2140,0.500819096653405
"E02003202",2,143,992,966,261,38,9,2411,0.000829531314807134,0.0593114890087101,0.411447532144338,0.400663625051846,0.108253836582331,0.0157610949813355,0.0037328909166321,1137,0.471588552467856,1274,0.528411447532144
"E02003203",15,114,812,1370,415,64,8,2798,0.00536097212294496,0.0407433881343817,0.290207290922087,0.48963545389564,0.148320228734811,0.0228734810578985,0.00285918513223731,941,0.336311651179414,1857,0.663688348820586
"E02003204",16,682,1287,1280,471,68,17,3821,0.0041873855011777,0.1784873069877,0.336822821250981,0.334990840094216,0.123266160690919,0.0177963883800052,0.00444909709500131,1985,0.519497513739859,1836,0.480502486260141
"E02003205",5,171,694,1108,349,64,15,2406,0.00207813798836243,0.071072319201995,0.288445552784705,0.460515378221114,0.145054031587697,0.0266001662510391,0.00623441396508728,870,0.361596009975062,1536,0.638403990024938
"E02003206",19,510,1338,1522,602,90,12,4093,0.00464207182995358,0.124602980698754,0.326899584656731,0.371854385536281,0.147080381138529,0.0219887612997801,0.00293183483997068,1867,0.456144637185439,2226,0.543855362814561
"E02003207",7,295,1139,900,188,33,7,2569,0.00272479564032698,0.11483067341378,0.443363176333204,0.35033086804204,0.0731802257687816,0.0128454651615415,0.00272479564032698,1441,0.56091864538731,1128,0.43908135461269
"E02003208",10,1364,2679,1692,556,68,24,6393,0.00156421085562334,0.213358360707023,0.419052088221492,0.264664476771469,0.0869701235726576,0.0106366338182387,0.00375410605349601,4053,0.633974659784139,2340,0.366025340215861
"E02003209",20,629,941,816,219,22,3,2650,0.00754716981132075,0.237358490566038,0.355094339622642,0.307924528301887,0.0826415094339623,0.00830188679245283,0.00113207547169811,1590,0.6,1060,0.4
"E02003210",23,795,1786,1584,650,113,18,4969,0.00462869792714832,0.159991950090561,0.359428456429865,0.318776413765345,0.130811028375931,0.0227409941638157,0.00362245924733347,2604,0.524049104447575,2365,0.475950895552425
"E02003211",24,1210,2358,1352,550,128,15,5637,0.00425758382118148,0.2146531843179,0.41830761043108,0.239843888593223,0.0975696292354089,0.0227071137129679,0.00266098988823842,3592,0.637218378570161,2045,0.362781621429839
"E02003212",2,303,920,1239,463,86,21,3034,0.000659195781147001,0.0998681608437706,0.30323005932762,0.408371786420567,0.152603823335531,0.028345418589321,0.00692155570204351,1225,0.403757415952538,1809,0.596242584047462
"E02003214",1,118,868,1072,180,20,10,2269,0.000440722785368004,0.0520052886734244,0.382547377699427,0.4724548259145,0.0793301013662406,0.00881445570736007,0.00440722785368004,987,0.434993389158219,1282,0.565006610841781
"E02003215",2,45,858,973,211,29,5,2123,0.000942063118228921,0.0211964201601507,0.404145077720207,0.45831370701837,0.0993876589731512,0.0136599152143194,0.0023551577955723,905,0.426283560998587,1218,0.573716439001413
"E02003216",4,450,1020,1270,306,46,10,3106,0.00128783000643915,0.144880875724404,0.328396651641983,0.40888602704443,0.098518995492595,0.0148100450740502,0.00321957501609787,1474,0.474565357372827,1632,0.525434642627173
"E02003217",1,243,1141,869,207,32,9,2502,0.000399680255795364,0.0971223021582734,0.45603517186251,0.347322142286171,0.0827338129496403,0.0127897681854516,0.00359712230215827,1385,0.553557154276579,1117,0.446442845723421
"E02003218",7,54,665,908,214,24,7,1879,0.00372538584353379,0.028738690792975,0.35391165513571,0.483235763704098,0.113890367216605,0.0127727514635444,0.00372538584353379,726,0.386375731772219,1153,0.613624268227781
"E02003219",19,3187,526,737,288,76,13,4846,0.00392075938918696,0.657655798596781,0.108543128353281,0.152084193148989,0.0594304581097813,0.0156830375567478,0.00268262484523318,3732,0.770119686339249,1114,0.229880313660751
"E02003220",22,704,1315,1300,340,46,7,3734,0.00589180503481521,0.188537761114087,0.352169255490091,0.348152115693626,0.0910551687198714,0.0123192287091591,0.00187466523835029,2041,0.546598821638993,1693,0.453401178361007
"E02003221",1,213,957,1106,335,28,14,2654,0.000376789751318764,0.0802562170308968,0.360587792012057,0.416729464958553,0.126224566691786,0.0105501130369254,0.0052750565184627,1171,0.441220798794273,1483,0.558779201205727
"E02003222",1,36,1010,861,100,10,0,2018,0.000495540138751239,0.0178394449950446,0.500495540138751,0.426660059464817,0.0495540138751239,0.00495540138751239,0,1047,0.518830525272547,971,0.481169474727453
"E02003223",5,388,2172,1637,329,43,16,4590,0.00108932461873638,0.0845315904139434,0.473202614379085,0.356644880174292,0.071677559912854,0.0093681917211329,0.00348583877995643,2565,0.558823529411765,2025,0.441176470588235
"E02003224",3,107,1036,1164,257,21,7,2595,0.00115606936416185,0.041233140655106,0.399229287090559,0.448554913294798,0.0990366088631985,0.00809248554913295,0.00269749518304432,1146,0.441618497109827,1449,0.558381502890173
"E02003225",2,211,1044,1020,187,16,1,2481,0.000806126561870214,0.0850463522773075,0.420798065296252,0.411124546553809,0.075372833534865,0.00644901249496171,0.000403063280935107,1257,0.506650544135429,1224,0.493349455864571
"E02003226",1,223,1457,1684,546,74,27,4012,0.000249252243270189,0.0555832502492522,0.363160518444666,0.419740777666999,0.136091724825523,0.018444666001994,0.00672981056829511,1681,0.418993020937188,2331,0.581006979062812
"E02003227",209,165,1148,779,125,23,9,2458,0.0850284784377543,0.0671277461350692,0.467046379170057,0.316924328722539,0.0508543531326282,0.00935720097640358,0.00366151342554923,1522,0.61920260374288,936,0.38079739625712
"E02003228",6,238,773,1011,345,35,9,2417,0.00248241621845263,0.0984691766652876,0.31981795614398,0.418287132809268,0.142738932561026,0.014480761274307,0.00372362432767894,1017,0.42076954902772,1400,0.57923045097228
"E02003229",1,100,790,832,138,12,0,1873,0.000533902829684997,0.0533902829684997,0.421783235451148,0.444207154297918,0.0736785904965296,0.00640683395621997,0,891,0.475707421249333,982,0.524292578750667
"E02003230",1,273,1537,2058,542,70,19,4500,0.000222222222222222,0.0606666666666667,0.341555555555556,0.457333333333333,0.120444444444444,0.0155555555555556,0.00422222222222222,1811,0.402444444444444,2689,0.597555555555556
"E02003231",149,129,1022,1101,186,35,6,2628,0.0566971080669711,0.0490867579908676,0.388888888888889,0.418949771689498,0.0707762557077626,0.0133181126331811,0.00228310502283105,1300,0.494672754946728,1328,0.505327245053272
"E02003232",2,552,1283,1100,329,50,11,3327,0.000601142170123234,0.165915238954013,0.385632702134055,0.330628193567779,0.098887886985272,0.0150285542530809,0.00330628193567779,1837,0.552149083258191,1490,0.447850916741809
"E02003233",1,85,1662,1027,121,7,4,2907,0.000343997248022016,0.0292397660818713,0.57172342621259,0.35328517371861,0.0416236670106639,0.00240798073615411,0.00137598899208806,1748,0.601307189542484,1159,0.398692810457516
"E02003234",3,112,1150,1029,187,24,0,2505,0.00119760479041916,0.0447105788423154,0.459081836327345,0.410778443113772,0.0746506986027944,0.00958083832335329,0,1265,0.50499001996008,1240,0.49500998003992
"E02003235",2,1152,1454,1073,299,35,6,4021,0.000497388709276299,0.286495896543148,0.36160159164387,0.266849042526735,0.0743596120368068,0.00870430241233524,0.0014921661278289,2608,0.648594876896294,1413,0.351405123103705
"E02003236",11,2115,1012,1313,426,60,17,4954,0.00222042793702059,0.426927735163504,0.204279370205894,0.265038352846185,0.0859911182882519,0.0121114251110214,0.00343157044812273,3138,0.633427533306419,1816,0.366572466693581
"E02003237",1,112,567,843,284,96,15,1918,0.000521376433785193,0.0583941605839416,0.295620437956204,0.439520333680918,0.148070907194995,0.0500521376433785,0.00782064650677789,680,0.354535974973931,1238,0.645464025026069
"E02003238",10,58,962,867,109,4,0,2010,0.00497512437810945,0.0288557213930348,0.478606965174129,0.43134328358209,0.054228855721393,0.00199004975124378,0,1030,0.512437810945274,980,0.487562189054726
"E02003239",4,322,770,1140,307,42,14,2599,0.0015390534821085,0.123893805309735,0.296267795305887,0.438630242400923,0.118122354751828,0.0161600615621393,0.00538668718737976,1096,0.42170065409773,1503,0.57829934590227
"E02003240",5,392,1017,881,350,138,37,2820,0.00177304964539007,0.139007092198582,0.36063829787234,0.31241134751773,0.124113475177305,0.048936170212766,0.0131205673758865,1414,0.501418439716312,1406,0.498581560283688
"E02003241",44,679,689,781,342,67,24,2626,0.0167555217060168,0.258568164508759,0.262376237623762,0.297410510281797,0.13023610053313,0.0255140898705255,0.00913937547600914,1412,0.537699923838538,1214,0.462300076161462
"E02003242",16,353,1003,1178,410,50,10,3020,0.00529801324503311,0.116887417218543,0.332119205298013,0.390066225165563,0.135761589403974,0.0165562913907285,0.0033112582781457,1372,0.454304635761589,1648,0.545695364238411
"E02003243",34,1312,2870,807,156,21,2,5202,0.0065359477124183,0.252210688196847,0.551710880430604,0.155132641291811,0.0299884659746251,0.00403690888119954,0.000384467512495194,4216,0.810457516339869,986,0.189542483660131
"E02003244",31,508,1782,1098,263,34,8,3724,0.00832438238453276,0.13641245972073,0.478517722878625,0.29484425349087,0.0706229860365199,0.00912996777658432,0.00214822771213749,2321,0.623254564983888,1403,0.376745435016112
"E02003245",26,245,2042,750,100,10,2,3175,0.00818897637795276,0.0771653543307087,0.643149606299213,0.236220472440945,0.031496062992126,0.0031496062992126,0.00062992125984252,2313,0.728503937007874,862,0.271496062992126
"E02003246",10,132,1052,1531,766,67,18,3576,0.00279642058165548,0.0369127516778524,0.294183445190157,0.428131991051454,0.21420581655481,0.0187360178970917,0.00503355704697987,1194,0.333892617449664,2382,0.666107382550336
"E02003247",9,279,2032,986,139,6,0,3451,0.00260793972761518,0.0808461315560707,0.588814836279339,0.285714285714286,0.0402781802376123,0.00173862648507679,0,2320,0.672268907563025,1131,0.327731092436975
"E02003248",14,144,721,1506,985,143,26,3539,0.00395591975134219,0.0406894602995196,0.203729867194123,0.42554393896581,0.278327211076575,0.0404068946029952,0.00734670810963549,879,0.248375247244984,2660,0.751624752755016
"E02003249",13,870,2325,1472,455,61,12,5208,0.00249615975422427,0.16705069124424,0.446428571428571,0.282642089093702,0.0873655913978495,0.0117127496159754,0.00230414746543779,3208,0.615975422427035,2000,0.384024577572965
"E02003250",9,657,2137,2436,1028,132,33,6432,0.00139925373134328,0.10214552238806,0.332245024875622,0.378731343283582,0.159825870646766,0.0205223880597015,0.00513059701492537,2803,0.435789800995025,3629,0.564210199004975
"E02003251",1,146,835,1142,261,34,6,2425,0.000412371134020619,0.0602061855670103,0.344329896907216,0.470927835051546,0.107628865979381,0.014020618556701,0.00247422680412371,982,0.404948453608247,1443,0.595051546391753
"E02003252",21,922,2058,1618,628,64,16,5327,0.00394218134034166,0.173080533133096,0.386333771353482,0.303735686127276,0.117889994368312,0.0120142669419936,0.0030035667354984,3001,0.563356485826919,2326,0.436643514173081
"E02003253",13,1130,1687,1542,633,67,17,5089,0.00255452937708784,0.222047553546866,0.331499312242091,0.303006484574573,0.1243859304382,0.0131656514049912,0.00334053841619179,2830,0.556101395166044,2259,0.443898604833956
"E02003254",10,422,1320,1243,363,44,9,3411,0.00293169158604515,0.123717384931105,0.38698328935796,0.364409264145412,0.106420404573439,0.0128994429785987,0.00263852242744063,1752,0.51363236587511,1659,0.48636763412489
"E02003255",8,1840,1918,1287,258,34,2,5347,0.00149616607443426,0.34411819711988,0.358705816345614,0.240695717224612,0.048251355900505,0.00635870581634561,0.000374041518608566,3766,0.704320179539929,1581,0.295679820460071
"E02003257",39,367,2400,1198,143,20,1,4168,0.00935700575815739,0.0880518234165067,0.575815738963532,0.28742802303263,0.0343090211132438,0.00479846449136276,0.000239923224568138,2806,0.673224568138196,1362,0.326775431861804
"E02003258",2,62,901,1303,257,18,4,2547,0.000785237534354142,0.0243423635649784,0.353749509226541,0.511582253631724,0.100903023164507,0.00706713780918728,0.00157047506870828,965,0.378877110325874,1582,0.621122889674127
"E02003259",1,184,839,807,306,25,13,2175,0.000459770114942529,0.0845977011494253,0.385747126436782,0.371034482758621,0.140689655172414,0.0114942528735632,0.00597701149425287,1024,0.470804597701149,1151,0.529195402298851
"E02003260",8,194,1594,987,199,29,9,3020,0.00264900662251656,0.0642384105960265,0.527814569536424,0.32682119205298,0.0658940397350993,0.00960264900662252,0.00298013245033113,1796,0.594701986754967,1224,0.405298013245033
"E02003261",0,59,642,874,222,34,1,1832,0,0.0322052401746725,0.350436681222707,0.47707423580786,0.12117903930131,0.0185589519650655,0.000545851528384279,701,0.38264192139738,1131,0.61735807860262
"E02003262",23,434,1502,1240,402,52,7,3660,0.00628415300546448,0.118579234972678,0.410382513661202,0.33879781420765,0.10983606557377,0.014207650273224,0.00191256830601093,1959,0.535245901639344,1701,0.464754098360656
"E02003263",2,200,1161,1573,630,72,16,3654,0.000547345374931582,0.0547345374931582,0.317733990147783,0.430487137383689,0.172413793103448,0.0197044334975369,0.00437876299945265,1363,0.373015873015873,2291,0.626984126984127
"E02003264",0,131,597,1275,431,76,7,2517,0,0.0520460866110449,0.237187127532777,0.506555423122765,0.171235597934048,0.0301946762018276,0.00278108859753675,728,0.289233214143822,1789,0.710766785856178
"E02003265",1,66,896,1132,362,47,5,2509,0.000398565165404544,0.0263053009166999,0.357114388202471,0.451175767237943,0.144280589876445,0.0187325627740136,0.00199282582702272,963,0.383818254284575,1546,0.616181745715425
"E02003266",4,180,1390,1185,317,14,0,3090,0.00129449838187702,0.058252427184466,0.449838187702265,0.383495145631068,0.102588996763754,0.00453074433656958,0,1574,0.509385113268608,1516,0.490614886731392
"E02003267",0,134,645,1342,721,113,25,2980,0,0.0449664429530201,0.216442953020134,0.450335570469799,0.241946308724832,0.0379194630872483,0.00838926174496644,779,0.261409395973154,2201,0.738590604026846
"E02003268",17,275,1067,1207,551,65,7,3189,0.00533082470994042,0.0862339291313892,0.33458764502979,0.37848855440577,0.172781436186892,0.0203825650674193,0.002195045468799,1359,0.426152398871119,1830,0.573847601128881
"E02003269",2,234,814,1707,690,98,13,3558,0.000562113546936481,0.0657672849915683,0.228780213603148,0.479763912310287,0.193929173693086,0.0275435637998876,0.00365373805508713,1050,0.295109612141653,2508,0.704890387858347
"E02003270",1,48,594,1206,434,48,9,2340,0.000427350427350427,0.0205128205128205,0.253846153846154,0.515384615384615,0.185470085470085,0.0205128205128205,0.00384615384615385,643,0.274786324786325,1697,0.725213675213675
"E02003271",3,64,1211,1572,267,32,5,3154,0.000951173113506658,0.020291693088142,0.383956880152188,0.498414711477489,0.0846544071020926,0.010145846544071,0.0015852885225111,1278,0.405199746353836,1876,0.594800253646164
"E02003272",0,290,464,1066,543,62,14,2439,0,0.11890118901189,0.190241902419024,0.437064370643706,0.222632226322263,0.025420254202542,0.00574005740057401,754,0.309143091430914,1685,0.690856908569086
"E02003273",24,1057,1110,1448,498,38,5,4180,0.00574162679425837,0.252870813397129,0.26555023923445,0.346411483253589,0.119138755980861,0.00909090909090909,0.00119617224880383,2191,0.524162679425837,1989,0.475837320574163
"E02003274",6,159,944,1410,697,88,18,3322,0.00180614087898856,0.0478627332931969,0.284166164960867,0.424443106562312,0.209813365442505,0.0264900662251656,0.00541842263696568,1109,0.333835039133052,2213,0.666164960866948
"E02003276",1,43,675,1375,599,45,21,2759,0.000362450163102573,0.0155853570134107,0.244653860094237,0.498368974266038,0.217107647698441,0.0163102573396158,0.00761145342515404,719,0.26060166727075,2040,0.73939833272925
"E02003277",2,616,1596,1365,396,39,7,4021,0.000497388709276299,0.1531957224571,0.396916190002487,0.339467794081074,0.0984829644367073,0.00969907983088784,0.00174086048246705,2214,0.550609301168864,1807,0.449390698831137
"E02003278",10,656,2202,2236,926,150,31,6211,0.00161004669135405,0.105619062952826,0.354532281436162,0.360006440186765,0.149090323619385,0.0241507003703107,0.00499114474319755,2868,0.461761391080341,3343,0.538238608919659
"E02003279",3,64,683,1367,583,103,9,2812,0.00106685633001422,0.0227596017069701,0.242887624466572,0.486130867709815,0.207325746799431,0.036628733997155,0.00320056899004267,750,0.266714082503556,2062,0.733285917496444
"E02003280",4,346,898,1393,630,114,13,3398,0.00117716303708064,0.101824602707475,0.264273101824603,0.409947027663331,0.1854031783402,0.0335491465567981,0.00382577987051207,1248,0.367274867569158,2150,0.632725132430842
"E02003281",4,128,833,1394,737,142,18,3256,0.00122850122850123,0.0393120393120393,0.255835380835381,0.428132678132678,0.226351351351351,0.0436117936117936,0.00552825552825553,965,0.296375921375921,2291,0.703624078624079
"E02003282",2,264,824,1646,835,155,27,3753,0.000532907007727152,0.070343725019984,0.219557687183586,0.438582467359446,0.222488675726086,0.0413002930988543,0.00719424460431655,1090,0.290434319211298,2663,0.709565680788702
"E02003283",5,258,952,1471,757,139,17,3599,0.00138927479855515,0.071686579605446,0.264517921644901,0.408724645734926,0.21033620450125,0.0386218393998333,0.00472353431508752,1215,0.337593776048902,2384,0.662406223951098
"E02003284",2,65,821,1919,946,119,20,3892,0.000513874614594039,0.0167009249743063,0.210945529290853,0.49306269270298,0.24306269270298,0.0305755395683453,0.00513874614594039,888,0.228160328879753,3004,0.771839671120247
"E02003285",4,92,824,2393,988,137,29,4467,0.000895455563017685,0.0205954779494068,0.184463845981643,0.53570629057533,0.221177524065368,0.0306693530333557,0.00649205283187822,920,0.205954779494068,3547,0.794045220505932
"E02003286",1,101,499,1320,852,157,21,2951,0.000338868180277872,0.0342256862080651,0.169095221958658,0.447305997966791,0.288715689596747,0.0532023043036259,0.00711623178583531,601,0.203659776347001,2350,0.796340223652999
"E02003287",3,218,987,1301,714,145,16,3384,0.000886524822695035,0.0644208037825059,0.291666666666667,0.384456264775414,0.210992907801418,0.0428486997635934,0.00472813238770686,1208,0.356973995271868,2176,0.643026004728132
"E02003288",4,913,2043,2354,781,125,35,6255,0.000639488409272582,0.145963229416467,0.326618705035971,0.376338928856914,0.124860111910472,0.0199840127897682,0.00559552358113509,2960,0.473221422861711,3295,0.526778577138289
"E02003289",7,251,868,2157,1119,182,39,4623,0.00151416828898983,0.054293748648064,0.187756867834739,0.466580142764439,0.242050616482803,0.0393683755137357,0.00843608046722907,1126,0.243564784771793,3497,0.756435215228207
"E02003290",2,255,1095,2057,996,198,39,4642,0.000430848772081,0.0549332184403274,0.235889702714347,0.443127962085308,0.214562688496338,0.042654028436019,0.00840155105557949,1352,0.291253769926756,3290,0.708746230073244
"E02003291",24,427,1875,1575,516,47,13,4477,0.00536073263345991,0.0953763681036408,0.418807236989055,0.351798079070806,0.115255751619388,0.0104981014071923,0.00290373017645745,2326,0.519544337726156,2151,0.480455662273844
"E02003292",4,444,1791,2401,1425,145,39,6249,0.000640102416386622,0.071051368218915,0.28660585693711,0.38422147543607,0.228036485837734,0.023203712594015,0.00624099855976956,2239,0.358297327572412,4010,0.641702672427588
"E02003293",4,339,1750,3075,1233,200,78,6679,0.00059889204970804,0.0507561012127564,0.262015271747268,0.460398263213056,0.184608474322503,0.029944602485402,0.0116783949693068,2093,0.313370265009732,4586,0.686629734990268
"E02003294",1,101,556,1354,788,192,26,3018,0.000331345261762757,0.0334658714380384,0.184227965540093,0.448641484426773,0.261100066269052,0.0636182902584493,0.00861497680583168,658,0.218025182239894,2360,0.781974817760106
"E02003295",13,86,893,1375,556,105,15,3043,0.00427209990141308,0.0282615839631942,0.293460400920145,0.451856720341768,0.182714426552744,0.0345054222806441,0.00492934604009201,992,0.325994084784752,2051,0.674005915215248
"E02003296",39,160,395,859,283,56,14,1806,0.0215946843853821,0.08859357696567,0.218715393133998,0.475636766334441,0.156699889258029,0.0310077519379845,0.00775193798449612,594,0.32890365448505,1212,0.67109634551495
"E02003297",6,76,747,1059,249,40,4,2181,0.00275103163686382,0.0348464007336084,0.342503438789546,0.485557083906465,0.114167812929849,0.0183402109124255,0.00183402109124255,829,0.380100871160018,1352,0.619899128839982
"E02003298",0,27,688,949,286,25,8,1983,0,0.0136157337367625,0.346949067070096,0.478567826525466,0.144225920322743,0.0126071608673727,0.00403429147755925,715,0.360564800806858,1268,0.639435199193142
"E02003299",43,231,548,720,231,36,10,1819,0.0236393622869709,0.126992853216053,0.301264431006047,0.395821880153931,0.126992853216053,0.0197910940076965,0.00549752611324904,822,0.451896646509071,997,0.548103353490929
"E02003300",88,658,702,1152,446,70,7,3123,0.0281780339417227,0.210694844700608,0.22478386167147,0.368876080691643,0.142811399295549,0.0224143451809158,0.00224143451809158,1448,0.463656740313801,1675,0.536343259686199
"E02003301",3,1007,1162,1487,304,75,16,4054,0.000740009866798224,0.248396645288604,0.286630488406512,0.36679822397632,0.07498766650222,0.0185002466699556,0.00394671928959053,2172,0.535767143561914,1882,0.464232856438086
"E02003302",1,33,1286,1880,378,26,9,3613,0.000276778300581234,0.00913368391918074,0.355936894547467,0.520343205092721,0.104622197619707,0.0071962358151121,0.00249100470523111,1320,0.365347356767229,2293,0.63465264323277
"E02003303",13,532,895,1186,318,38,15,2997,0.00433767100433767,0.177510844177511,0.298631965298632,0.395729062395729,0.106106106106106,0.0126793460126793,0.005005005005005,1440,0.48048048048048,1557,0.51951951951952
"E02003304",5,222,982,1232,320,55,9,2825,0.00176991150442478,0.0785840707964602,0.347610619469027,0.436106194690266,0.113274336283186,0.0194690265486726,0.0031858407079646,1209,0.427964601769912,1616,0.572035398230089
"E02003305",0,402,389,799,330,66,6,1992,0,0.201807228915663,0.195281124497992,0.401104417670683,0.16566265060241,0.0331325301204819,0.00301204819277108,791,0.397088353413655,1201,0.602911646586345
"E02003307",1,191,1424,1428,240,30,8,3322,0.000301023479831427,0.0574954846478025,0.428657435279952,0.429861529199278,0.0722456351595425,0.00903070439494281,0.00240818783865141,1616,0.486453943407586,1706,0.513546056592414
"E02003308",13,375,558,947,360,75,13,2341,0.00555318240068347,0.160187953865869,0.238359675352414,0.404527979495942,0.153780435711235,0.0320375907731739,0.00555318240068347,946,0.404100811618966,1395,0.595899188381034
"E02003309",0,82,619,1125,383,49,14,2272,0,0.0360915492957746,0.272447183098592,0.495158450704225,0.168573943661972,0.0215669014084507,0.00616197183098592,701,0.308538732394366,1571,0.691461267605634
"E02003311",11,187,842,1676,436,64,29,3245,0.00338983050847458,0.0576271186440678,0.259476117103236,0.516486902927581,0.134360554699538,0.0197226502311248,0.00893682588597843,1040,0.320493066255778,2205,0.679506933744222
"E02003312",2,673,1813,1261,466,41,12,4268,0.000468603561387067,0.157685098406748,0.424789128397376,0.295454545454545,0.109184629803187,0.00960637300843486,0.0028116213683224,2488,0.582942830365511,1780,0.417057169634489
"E02003313",5,363,1805,2354,464,38,13,5042,0.000991669972233241,0.0719952399841333,0.3579928599762,0.46687822292741,0.0920269734232447,0.00753669178897263,0.00257834192780643,2173,0.430979769932566,2869,0.569020230067434
"E02003314",3,363,651,737,262,59,27,2102,0.00142721217887726,0.172692673644148,0.309705042816365,0.350618458610847,0.124643196955281,0.0280685061845861,0.0128449096098953,1017,0.483824928639391,1085,0.516175071360609
"E02003315",5,268,506,661,258,53,14,1765,0.0028328611898017,0.151841359773371,0.286685552407932,0.374504249291785,0.146175637393768,0.030028328611898,0.00793201133144476,779,0.441359773371105,986,0.558640226628895
"E02003316",15,1287,1634,1141,277,68,16,4438,0.00337990085624155,0.289995493465525,0.36818386660658,0.257097791798107,0.062415502478594,0.0153222172149617,0.00360522757999099,2936,0.661559260928346,1502,0.338440739071654
"E02003317",1,363,874,725,226,55,17,2261,0.000442282176028306,0.160548429898275,0.38655462184874,0.320654577620522,0.0999557717823972,0.0243255196815568,0.0075187969924812,1238,0.547545333923043,1023,0.452454666076957
"E02003318",2,44,392,769,249,40,6,1502,0.00133155792276964,0.0292942743009321,0.26098535286285,0.511984021304927,0.16577896138482,0.0266311584553928,0.00399467376830892,438,0.291611185086551,1064,0.708388814913449
"E02003319",0,144,868,1489,546,79,29,3155,0,0.0456418383518225,0.275118858954041,0.471949286846276,0.173058637083994,0.0250396196513471,0.00919175911251981,1012,0.320760697305864,2143,0.679239302694136
"E02003320",1,1811,2261,1260,171,21,9,5534,0.000180701120346946,0.327249728948319,0.408565233104445,0.227683411637152,0.0308998915793278,0.00379472352728587,0.00162631008312252,4073,0.735995663173112,1461,0.264004336826888
"E02003321",3,101,1061,873,175,39,6,2258,0.00132860938883968,0.0447298494242693,0.469884853852967,0.386625332152347,0.0775022143489814,0.0172719220549159,0.00265721877767936,1165,0.515943312666076,1093,0.484056687333924
"E02003322",1,664,943,1495,349,34,18,3504,0.000285388127853881,0.189497716894977,0.26912100456621,0.426655251141553,0.0996004566210046,0.00970319634703196,0.00513698630136986,1608,0.458904109589041,1896,0.541095890410959
"E02003323",3,228,1261,945,250,30,13,2730,0.0010989010989011,0.0835164835164835,0.461904761904762,0.346153846153846,0.0915750915750916,0.010989010989011,0.00476190476190476,1492,0.546520146520147,1238,0.453479853479853
"E02003324",1,763,1241,1282,306,49,19,3661,0.000273149412728763,0.208413001912046,0.338978421196394,0.350177547118274,0.0835837202950014,0.0133843212237094,0.00518983884184649,2005,0.547664572521169,1656,0.452335427478831
"E02003325",0,189,1143,1615,594,82,43,3666,0,0.0515548281505728,0.311783960720131,0.440534642662302,0.1620294599018,0.022367703218767,0.0117294053464266,1332,0.363338788870704,2334,0.636661211129296
"E02003326",0,37,546,1358,499,81,20,2541,0,0.0145611963793782,0.214876033057851,0.534435261707989,0.19637937819756,0.0318772136953955,0.00787091696182605,583,0.229437229437229,1958,0.770562770562771
"E02003327",3,385,1692,1106,427,83,17,3713,0.000807971990304336,0.103689738755723,0.455696202531646,0.297872340425532,0.115001346619984,0.0223538917317533,0.00457850794505791,2080,0.560193913277673,1633,0.439806086722327
"E02003328",4,1476,2053,1855,548,73,43,6052,0.000660938532716457,0.243886318572373,0.339226701916722,0.306510244547257,0.0905485789821547,0.0120621282220753,0.00710508922670192,3533,0.583773959021811,2519,0.416226040978189
"E02003329",0,80,453,1491,505,62,30,2621,0,0.0305227012590614,0.172834795879435,0.568866844715757,0.192674551697825,0.0236550934757726,0.011446012972148,533,0.203357497138497,2088,0.796642502861503
"E02003330",1,142,616,1254,335,52,7,2407,0.000415454923140839,0.0589945990859992,0.255920232654757,0.520980473618612,0.139177399252181,0.0216036560033236,0.00290818446198587,759,0.315330286663897,1648,0.684669713336103
"E02003331",2,95,1483,1330,258,37,14,3219,0.000621310966138552,0.0295122708915812,0.460702081391737,0.413171792482137,0.0801491146318733,0.0114942528735632,0.00434917676296987,1580,0.490835663249456,1639,0.509164336750544
"E02003332",0,123,519,800,311,51,8,1812,0,0.0678807947019868,0.286423841059603,0.441501103752759,0.171633554083885,0.0281456953642384,0.00441501103752759,642,0.354304635761589,1170,0.645695364238411
"E02003333",0,148,1137,1518,471,73,29,3376,0,0.0438388625592417,0.336789099526066,0.449644549763033,0.139514218009479,0.0216232227488152,0.00859004739336493,1285,0.380627962085308,2091,0.619372037914692
"E02003334",2,61,596,1050,289,32,16,2046,0.000977517106549365,0.0298142717497556,0.291300097751711,0.513196480938416,0.141251221896383,0.0156402737047898,0.00782013685239492,659,0.322091886608016,1387,0.677908113391984
"E02003335",0,82,874,1426,358,43,19,2802,0,0.0292648108493933,0.31192005710207,0.508922198429693,0.127765881513205,0.0153461812990721,0.00678087080656674,956,0.341184867951463,1846,0.658815132048537
"E02003336",1,275,472,899,244,41,9,1941,0.000515198351365276,0.141679546625451,0.24317362184441,0.463163317877383,0.125708397733127,0.0211231324059763,0.00463678516228748,748,0.385368366821226,1193,0.614631633178774
"E02003337",1,111,824,935,242,27,9,2149,0.000465332712889716,0.0516519311307585,0.383434155421126,0.435086086551885,0.112610516519311,0.0125639832480223,0.00418799441600745,936,0.435551419264774,1213,0.564448580735226
"E02003338",1,597,1114,1167,297,49,16,3241,0.000308546744831842,0.18420240666461,0.343721073742672,0.36007405121876,0.0916383832150571,0.0151187904967603,0.00493674791730947,1712,0.528232027152114,1529,0.471767972847886
"E02003339",1,79,602,797,219,25,9,1732,0.000577367205542725,0.0456120092378753,0.347575057736721,0.460161662817552,0.126443418013857,0.0144341801385681,0.00519630484988453,682,0.393764434180139,1050,0.606235565819861
"E02003340",0,167,1285,1118,200,19,7,2796,0,0.0597281831187411,0.459585121602289,0.399856938483548,0.0715307582260372,0.00679542203147353,0.0025035765379113,1452,0.51931330472103,1344,0.48068669527897
"E02003341",12,424,489,728,268,52,10,1983,0.00605143721633888,0.21381744831064,0.246596066565809,0.367120524457892,0.135148764498235,0.0262228946041351,0.00504286434694907,925,0.466464952092789,1058,0.533535047907211
"E02003342",1,101,634,851,276,49,5,1917,0.000521648408972353,0.0526864893062076,0.330725091288472,0.443922796035472,0.143974960876369,0.0255607720396453,0.00260824204486176,736,0.383933229003652,1181,0.616066770996348
"E02003343",1,41,426,742,231,24,3,1468,0.000681198910081744,0.0279291553133515,0.290190735694823,0.505449591280654,0.157356948228883,0.0163487738419619,0.00204359673024523,468,0.318801089918256,1000,0.681198910081744
"E02003344",19,78,1197,881,156,24,2,2357,0.00806109461179465,0.0330929147221044,0.507848960543063,0.373780229104794,0.0661858294442087,0.010182435299109,0.000848536274925753,1294,0.549002969876962,1063,0.450997030123038
"E02003345",1,189,587,804,168,22,2,1773,0.000564015792442188,0.106598984771574,0.331077270163565,0.453468697123519,0.0947546531302876,0.0124083474337281,0.00112803158488438,777,0.43824027072758,996,0.56175972927242
"E02003346",1,388,646,873,217,33,9,2167,0.000461467466543609,0.17904937701892,0.298107983387171,0.40286109829257,0.100138440239963,0.0152284263959391,0.00415320719889248,1035,0.477618827872635,1132,0.522381172127365
"E02003347",2,32,913,951,149,11,2,2060,0.000970873786407767,0.0155339805825243,0.443203883495146,0.461650485436893,0.0723300970873786,0.00533980582524272,0.000970873786407767,947,0.459708737864078,1113,0.540291262135922
"E02003348",3,102,710,938,232,32,10,2027,0.00148001973359645,0.0503206709422792,0.350271336951159,0.462752836704489,0.114454859398125,0.0157868771583621,0.00493339911198816,815,0.402072027627035,1212,0.597927972372965
"E02003349",5,19,819,1066,237,30,3,2179,0.00229463056447912,0.00871959614502065,0.37586048646168,0.489215236346948,0.10876548875631,0.0137677833868747,0.00137677833868747,843,0.386874713171179,1336,0.613125286828821
"E02003350",8,91,797,885,212,21,8,2022,0.0039564787339268,0.0450049455984174,0.394164193867458,0.437685459940653,0.10484668644906,0.0103857566765579,0.0039564787339268,896,0.443125618199802,1126,0.556874381800198
"E02003351",1,45,1082,1084,150,13,3,2378,0.000420521446593776,0.0189234650967199,0.455004205214466,0.455845248107653,0.0630782169890664,0.00546677880571909,0.00126156433978133,1128,0.47434819175778,1250,0.52565180824222
"E02003352",25,236,356,697,217,74,20,1625,0.0153846153846154,0.145230769230769,0.219076923076923,0.428923076923077,0.133538461538462,0.0455384615384615,0.0123076923076923,617,0.379692307692308,1008,0.620307692307692
"E02003353",239,2502,1093,1296,412,71,9,5622,0.0425115617218072,0.445037353255069,0.194414799003913,0.230522945570971,0.0732835289932408,0.0126289576663109,0.0016008537886873,3834,0.68196371398079,1788,0.31803628601921
"E02003354",22,277,1348,1576,212,10,3,3448,0.00638051044083527,0.0803364269141531,0.390951276102088,0.45707656612529,0.0614849187935035,0.00290023201856148,0.000870069605568445,1647,0.477668213457077,1801,0.522331786542923
"E02003355",0,148,1355,1161,152,19,5,2840,0,0.052112676056338,0.477112676056338,0.408802816901408,0.0535211267605634,0.00669014084507042,0.00176056338028169,1503,0.529225352112676,1337,0.470774647887324
"E02003356",3,281,808,986,316,38,13,2445,0.00122699386503067,0.114928425357873,0.330470347648262,0.403271983640082,0.129243353783231,0.0155419222903885,0.00531697341513292,1092,0.446625766871166,1353,0.553374233128834
"E02003357",6,804,2156,1233,160,10,3,4372,0.00137236962488564,0.183897529734675,0.493138151875572,0.282021957913998,0.0365965233302836,0.00228728270814273,0.000686184812442818,2966,0.678408051235133,1406,0.321591948764867
"E02003358",16,1578,2627,1332,198,17,4,5772,0.00277200277200277,0.273388773388773,0.455128205128205,0.230769230769231,0.0343035343035343,0.00294525294525295,0.000693000693000693,4221,0.731288981288981,1551,0.268711018711019
"E02003359",0,26,1290,1095,187,12,3,2613,0,0.00995024875621891,0.493685419058553,0.419058553386912,0.0715652506697283,0.00459242250287026,0.00114810562571757,1316,0.503635667814772,1297,0.496364332185228
"E02003360",22,842,1705,1188,175,11,5,3948,0.00557244174265451,0.213272543059777,0.431864235055724,0.300911854103343,0.0443262411347518,0.00278622087132725,0.00126646403242148,2569,0.650709219858156,1379,0.349290780141844
"E02003361",10,47,1246,1094,172,38,6,2613,0.00382701875239189,0.0179869881362419,0.476846536548029,0.418675851511672,0.0658247225411405,0.0145426712590892,0.00229621125143513,1303,0.498660543436663,1310,0.501339456563337
"E02003362",0,23,914,1072,253,56,8,2326,0,0.00988822012037833,0.392949269131556,0.460877042132416,0.108770421324162,0.0240756663800516,0.00343938091143594,937,0.402837489251935,1389,0.597162510748065
"E02003363",39,418,894,725,249,32,5,2362,0.0165114309906859,0.17696867061812,0.378492802709568,0.306943268416596,0.105419136325148,0.0135478408128704,0.00211685012701101,1351,0.571972904318374,1011,0.428027095681626
"E02003364",157,638,743,863,169,19,3,2592,0.060570987654321,0.246141975308642,0.286651234567901,0.332947530864198,0.0652006172839506,0.00733024691358025,0.00115740740740741,1538,0.593364197530864,1054,0.406635802469136
"E02003365",20,152,743,972,240,27,6,2160,0.00925925925925926,0.0703703703703704,0.343981481481481,0.45,0.111111111111111,0.0125,0.00277777777777778,915,0.423611111111111,1245,0.576388888888889
"E02003366",2,104,957,925,181,19,4,2192,0.000912408759124088,0.0474452554744526,0.436587591240876,0.42198905109489,0.0825729927007299,0.00866788321167883,0.00182481751824818,1063,0.484945255474453,1129,0.515054744525547
"E02003367",11,79,375,764,606,201,45,2081,0.00528592023065834,0.0379625180201826,0.180201826045171,0.367131186929361,0.291206150888996,0.0965881787602114,0.0216242191254205,465,0.223450264296012,1616,0.776549735703988
"E02003368",2,91,659,799,421,135,31,2138,0.000935453695042095,0.0425631431244153,0.30823199251637,0.373713751169317,0.196913002806361,0.0631431244153414,0.0144995322731525,752,0.351730589335828,1386,0.648269410664172
"E02003369",3,164,612,831,450,128,19,2207,0.00135931128228364,0.0743090167648391,0.277299501585863,0.376529225192569,0.203896692342546,0.0579972813774354,0.00860897145446307,779,0.352967829632986,1428,0.647032170367014
"E02003370",5,225,685,835,223,50,12,2035,0.00245700245700246,0.110565110565111,0.336609336609337,0.41031941031941,0.10958230958231,0.0245700245700246,0.0058968058968059,915,0.44963144963145,1120,0.55036855036855
"E02003371",0,50,223,771,224,13,4,1285,0,0.0389105058365759,0.173540856031128,0.6,0.17431906614786,0.0101167315175097,0.00311284046692607,273,0.212451361867704,1012,0.787548638132296
"E02003372",3,135,645,1126,268,23,3,2203,0.00136177939173854,0.0612800726282342,0.292782569223786,0.511121198365865,0.121652292328643,0.0104403086699955,0.00136177939173854,783,0.355424421243759,1420,0.644575578756241
"E02003373",9,178,636,789,580,147,34,2373,0.00379266750948167,0.0750105351875263,0.268015170670038,0.332490518331226,0.244416350611041,0.0619469026548673,0.0143278550358196,823,0.346818373367046,1550,0.653181626632954
"E02003374",3,307,879,734,124,12,3,2062,0.001454898157129,0.148884578079534,0.426285160038797,0.355965082444229,0.0601357904946654,0.005819592628516,0.001454898157129,1189,0.576624636275461,873,0.423375363724539
"E02003375",8,248,794,833,320,75,18,2296,0.00348432055749129,0.10801393728223,0.34581881533101,0.36280487804878,0.139372822299652,0.0326655052264808,0.0078397212543554,1050,0.457317073170732,1246,0.542682926829268
"E02003376",11,256,838,1010,351,78,16,2560,0.004296875,0.1,0.32734375,0.39453125,0.137109375,0.03046875,0.00625,1105,0.431640625,1455,0.568359375
"E02003377",9,210,999,867,670,263,64,3082,0.00292018170019468,0.0681375730045425,0.324140168721609,0.281310837118754,0.217391304347826,0.0853341985723556,0.0207657365347177,1218,0.395197923426347,1864,0.604802076573653
"E02003378",7,614,1264,1255,383,61,19,3603,0.0019428254232584,0.170413544268665,0.350818762142659,0.348320843741327,0.106300305301138,0.0169303358312517,0.00527338329170136,1885,0.523175131834582,1718,0.476824868165418
"E02003379",2,138,1315,1079,200,21,8,2763,0.000723850886717336,0.0499457111834962,0.475931958016649,0.390517553384003,0.0723850886717336,0.00760043431053203,0.00289540354686934,1455,0.526601520086862,1308,0.473398479913138
"E02003380",11,283,914,1047,231,36,6,2528,0.00435126582278481,0.111946202531646,0.361550632911392,0.414161392405063,0.091376582278481,0.0142405063291139,0.00237341772151899,1208,0.477848101265823,1320,0.522151898734177
"E02003381",5,172,757,806,188,47,12,1987,0.00251635631605435,0.0865626572722697,0.380976346250629,0.405636638147962,0.0946149974836437,0.0236537493709109,0.00603925515853045,934,0.470055359838953,1053,0.529944640161047
"E02003382",5,218,1375,1085,189,40,11,2923,0.0017105713308245,0.074580910023948,0.470407115976736,0.371193978788916,0.0646595963051659,0.013684570646596,0.00376325692781389,1598,0.546698597331509,1325,0.453301402668491
"E02003383",0,82,826,1019,167,16,2,2112,0,0.0388257575757576,0.391098484848485,0.482481060606061,0.0790719696969697,0.00757575757575758,0.000946969696969697,908,0.429924242424242,1204,0.570075757575758
"E02003384",21,122,372,861,727,251,49,2403,0.00873907615480649,0.0507698709945901,0.154806491885144,0.358302122347066,0.30253849354973,0.104452767374116,0.0203911776945485,515,0.21431543903454,1888,0.78568456096546
"E02003385",4,2150,2815,1403,436,66,28,6902,0.000579542161692263,0.311503911909591,0.40785279629093,0.203274413213561,0.0631700956244567,0.00956244566792234,0.00405679513184584,4969,0.719936250362214,1933,0.280063749637786
"E02003386",34,321,1316,1264,429,76,9,3449,0.00985792983473471,0.0930704552044071,0.38155987242679,0.366483038561902,0.124383879385329,0.0220353725717599,0.00260945201507683,1671,0.484488257465932,1778,0.515511742534068
"E02003387",1,207,1035,1216,358,52,11,2880,0.000347222222222222,0.071875,0.359375,0.422222222222222,0.124305555555556,0.0180555555555556,0.00381944444444444,1243,0.431597222222222,1637,0.568402777777778
"E02003388",20,241,675,642,371,130,36,2115,0.00945626477541371,0.113947990543735,0.319148936170213,0.30354609929078,0.175413711583924,0.0614657210401891,0.0170212765957447,936,0.442553191489362,1179,0.557446808510638
"E02003389",35,128,872,1005,307,34,3,2384,0.0146812080536913,0.0536912751677852,0.365771812080537,0.421560402684564,0.128775167785235,0.014261744966443,0.00125838926174497,1035,0.434144295302013,1349,0.565855704697987
"E02003390",7,70,482,939,408,77,4,1987,0.00352289884247609,0.0352289884247609,0.24257674886764,0.472571716155008,0.205334675390035,0.038751887267237,0.00201308505284348,559,0.281328636134877,1428,0.718671363865123
"E02003391",1,177,890,1163,454,72,8,2765,0.000361663652802893,0.0640144665461121,0.321880650994575,0.420614828209765,0.164195298372514,0.0260397830018083,0.00289330922242315,1068,0.38625678119349,1697,0.61374321880651
"E02003392",4,223,1447,1575,415,51,24,3739,0.00106980476063118,0.0596416154051886,0.387001872158331,0.421235624498529,0.110992243915485,0.0136400106980476,0.00641882856378711,1674,0.447713292324151,2065,0.552286707675849
"E02003393",1,101,843,1112,341,41,10,2449,0.000408329930583912,0.0412413229889751,0.344222131482238,0.45406288280931,0.139240506329114,0.0167415271539404,0.00408329930583912,945,0.385871784401797,1504,0.614128215598203
"E02003394",20,581,883,1049,269,41,7,2850,0.00701754385964912,0.203859649122807,0.309824561403509,0.368070175438596,0.0943859649122807,0.0143859649122807,0.00245614035087719,1484,0.520701754385965,1366,0.479298245614035
"E02003395",2,812,1319,2117,619,93,41,5003,0.000399760143913652,0.162302618428943,0.263641814911053,0.4231461123326,0.123725764541275,0.0185888466919848,0.00819508295022986,2133,0.42634419348391,2870,0.57365580651609
"E02003396",2,256,1422,1762,692,85,32,4251,0.000470477534697718,0.0602211244413079,0.334509527170078,0.41449070806869,0.16278522700541,0.019995295224653,0.00752764055516349,1680,0.395201129146083,2571,0.604798870853917
"E02003397",1,155,922,1088,252,27,10,2455,0.000407331975560081,0.0631364562118126,0.375560081466395,0.443177189409369,0.102647657841141,0.0109979633401222,0.00407331975560081,1078,0.439103869653768,1377,0.560896130346232
"E02003398",10,577,1348,1947,477,70,22,4451,0.00224668613794653,0.129633790159515,0.302853291395192,0.437429791058189,0.107166928780049,0.0157268029656257,0.00494270950348236,1935,0.434733767692653,2516,0.565266232307347
"E02003400",2,114,847,1636,640,70,24,3333,0.0006000600060006,0.0342034203420342,0.254125412541254,0.490849084908491,0.192019201920192,0.021002100210021,0.0072007200720072,963,0.288928892889289,2370,0.711071107110711
"E02003401",13,282,1392,1481,534,76,22,3800,0.00342105263157895,0.0742105263157895,0.366315789473684,0.389736842105263,0.140526315789474,0.02,0.00578947368421053,1687,0.443947368421053,2113,0.556052631578947
"E02003402",1,342,1233,2036,768,86,34,4500,0.000222222222222222,0.076,0.274,0.452444444444444,0.170666666666667,0.0191111111111111,0.00755555555555556,1576,0.350222222222222,2924,0.649777777777778
"E02003403",1,400,1262,1136,312,52,5,3168,0.000315656565656566,0.126262626262626,0.398358585858586,0.358585858585859,0.0984848484848485,0.0164141414141414,0.00157828282828283,1663,0.524936868686869,1505,0.475063131313131
"E02003404",7,120,867,831,270,56,12,2163,0.00323624595469256,0.0554785020804438,0.400832177531207,0.384188626907074,0.124826629680999,0.0258899676375405,0.00554785020804438,994,0.459546925566343,1169,0.540453074433657
"E02003405",2,2025,1903,1161,253,28,16,5388,0.000371195248700817,0.375835189309577,0.353192279138827,0.215478841870824,0.0469561989606533,0.00519673348181143,0.00296956198960653,3930,0.729398663697105,1458,0.270601336302895
"E02003406",3,246,885,901,230,31,1,2297,0.00130605137135394,0.107096212451023,0.385285154549412,0.3922507618633,0.100130605137135,0.0134958641706574,0.00043535045711798,1134,0.493687418371789,1163,0.506312581628211
"E02003407",3,405,1329,1222,203,25,3,3190,0.000940438871473354,0.126959247648903,0.416614420062696,0.38307210031348,0.0636363636363636,0.00783699059561128,0.000940438871473354,1737,0.544514106583072,1453,0.455485893416928
"E02003408",1,122,1195,1389,271,30,7,3015,0.00033167495854063,0.0404643449419569,0.396351575456053,0.460696517412935,0.0898839137645108,0.00995024875621891,0.00232172470978441,1318,0.437147595356551,1697,0.562852404643449
"E02003409",0,212,1509,1417,337,51,7,3533,0,0.0600056609114067,0.427115765638268,0.40107557316728,0.0953863572035098,0.014435324087178,0.00198131899235777,1721,0.487121426549674,1812,0.512878573450326
"E02003410",2,165,966,1205,248,18,10,2614,0.000765110941086458,0.0631216526396327,0.369548584544759,0.460979342004591,0.0948737566947207,0.00688599846977812,0.00382555470543229,1133,0.433435348125478,1481,0.566564651874522
"E02003411",1,386,1470,1081,229,22,4,3193,0.000313185092389602,0.120889445662386,0.460382085812715,0.33855308487316,0.0717193861572189,0.00689007203257125,0.00125274036955841,1857,0.581584716567491,1336,0.418415283432509
"E02003412",6,237,1025,1441,435,51,11,3206,0.00187149095446039,0.0739238927011853,0.319713038053649,0.44946974422957,0.135683094198378,0.0159076731129133,0.00343106674984404,1268,0.395508421709295,1938,0.604491578290705
"E02003414",1,453,2370,1489,310,26,7,4656,0.000214776632302405,0.0972938144329897,0.509020618556701,0.319802405498282,0.0665807560137457,0.00558419243986254,0.00150343642611684,2824,0.606529209621993,1832,0.393470790378007
"E02003415",12,739,2158,1559,487,69,23,5047,0.00237765008916188,0.146423617990886,0.427580741034278,0.308896374083614,0.0964929661184862,0.0136714880126808,0.0045571626708936,2909,0.576382009114325,2138,0.423617990885675
"E02003416",12,493,1099,1146,307,45,10,3112,0.0038560411311054,0.158419023136247,0.353149100257069,0.368251928020566,0.0986503856041131,0.0144601542416452,0.0032133676092545,1604,0.515424164524422,1508,0.484575835475578
"E02003417",24,1325,1919,1573,542,87,29,5499,0.00436442989634479,0.240952900527369,0.348972540461902,0.286052009456265,0.0985633751591198,0.0158210583742499,0.00527368612474995,3268,0.594289870885616,2231,0.405710129114384
"E02003418",6,119,1148,1305,244,26,7,2855,0.0021015761821366,0.0416812609457093,0.402101576182137,0.457092819614711,0.0854640980735552,0.00910683012259194,0.00245183887915937,1273,0.445884413309982,1582,0.554115586690017
"E02003419",1,185,1517,752,178,30,9,2672,0.000374251497005988,0.0692365269461078,0.567739520958084,0.281437125748503,0.0666167664670659,0.0112275449101796,0.00336826347305389,1703,0.637350299401198,969,0.362649700598802
"E02003420",1,120,1015,1015,334,37,10,2532,0.000394944707740916,0.0473933649289099,0.40086887835703,0.40086887835703,0.131911532385466,0.0146129541864139,0.00394944707740916,1136,0.448657187993681,1396,0.551342812006319
"E02003421",1,39,481,747,229,27,2,1526,0.000655307994757536,0.0255570117955439,0.315203145478375,0.489515072083879,0.150065530799476,0.0176933158584535,0.00131061598951507,521,0.341415465268676,1005,0.658584534731324
"E02003422",12,210,786,1418,938,309,80,3753,0.00319744204636291,0.0559552358113509,0.209432454036771,0.37783106847855,0.249933386624034,0.0823341326938449,0.0213162803090861,1008,0.268585131894484,2745,0.731414868105516
"E02003423",2,307,912,709,181,38,6,2155,0.000928074245939675,0.14245939675174,0.423201856148492,0.329002320185615,0.0839907192575406,0.0176334106728538,0.00278422273781903,1221,0.566589327146172,934,0.433410672853828
"E02003424",4,813,1212,1116,437,72,11,3665,0.00109140518417462,0.221828103683492,0.330695770804911,0.30450204638472,0.119236016371078,0.0196452933151432,0.00300136425648022,2029,0.553615279672578,1636,0.446384720327422
"E02003425",3,1940,2612,1812,689,117,22,7195,0.000416956219596942,0.269631688672689,0.363029881862404,0.251841556636553,0.0957609451007644,0.0162612925642808,0.00305767894371091,4555,0.633078526754691,2640,0.366921473245309
"E02003426",4,156,852,1299,615,89,8,3023,0.00132318888521336,0.0516043665233212,0.281839232550447,0.42970559047304,0.203440291101555,0.0294409526959974,0.00264637777042673,1012,0.334766787958981,2011,0.665233212041019
"E02003427",7,271,1005,1173,294,46,8,2804,0.00249643366619116,0.0966476462196862,0.358416547788873,0.418330955777461,0.104850213980029,0.0164051355206847,0.00285306704707561,1283,0.45756062767475,1521,0.54243937232525
"E02003428",0,135,1072,1144,262,33,2,2648,0,0.0509818731117825,0.404833836858006,0.43202416918429,0.0989425981873112,0.0124622356495468,0.000755287009063444,1207,0.455815709969789,1441,0.544184290030212
"E02003429",12,113,663,950,395,100,19,2252,0.00532859680284192,0.0501776198934281,0.294404973357016,0.421847246891652,0.175399644760213,0.044404973357016,0.00843694493783304,788,0.349911190053286,1464,0.650088809946714
"E02003430",1,206,736,991,421,71,19,2445,0.000408997955010225,0.0842535787321063,0.301022494887526,0.405316973415133,0.172188139059305,0.029038854805726,0.00777096114519427,943,0.385685071574642,1502,0.614314928425358
"E02003431",0,100,674,1008,482,77,7,2348,0,0.0425894378194208,0.287052810902896,0.429301533219761,0.205281090289608,0.032793867120954,0.00298126064735946,774,0.329642248722317,1574,0.670357751277683
"E02003432",1,340,1052,1397,546,87,14,3437,0.000290951411114344,0.0989234797788769,0.30608088449229,0.406459121326738,0.158859470468432,0.0253127727669479,0.00407331975560081,1393,0.405295315682281,2044,0.594704684317719
"E02003433",34,143,955,739,197,23,4,2095,0.0162291169451074,0.0682577565632458,0.455847255369928,0.352744630071599,0.0940334128878282,0.0109785202863962,0.00190930787589499,1132,0.540334128878282,963,0.459665871121718
"E02003434",2,418,1359,1137,393,47,6,3362,0.000594883997620464,0.124330755502677,0.404223676383105,0.338191552647234,0.116894705532421,0.0139797739440809,0.00178465199286139,1779,0.529149315883403,1583,0.470850684116597
"E02003435",2,170,866,1102,448,61,12,2661,0.000751597143930853,0.0638857572341225,0.325441563322059,0.4141300263059,0.168357760240511,0.022923712889891,0.00450958286358512,1038,0.390078917700113,1623,0.609921082299887
"E02003436",7,154,735,1221,453,92,19,2681,0.00261096605744125,0.0574412532637076,0.274151436031332,0.455427079447967,0.168966803431555,0.0343155538977993,0.00708690787019769,896,0.33420365535248,1785,0.66579634464752
"E02003437",21,321,1026,861,315,59,16,2619,0.00801832760595647,0.122565864833906,0.391752577319588,0.328751431844215,0.120274914089347,0.0225276823214968,0.00610920198549065,1368,0.52233676975945,1251,0.47766323024055
"E02003438",14,842,1477,1410,574,97,20,4434,0.0031574199368516,0.189896256202075,0.333107803337844,0.317997293640054,0.129454217410916,0.0218764095624718,0.004510599909788,2333,0.52616147947677,2101,0.47383852052323
"E02003439",6,113,661,754,390,93,22,2039,0.00294261893084846,0.0554193231976459,0.324178518881805,0.369789112309956,0.19127023050515,0.0456105934281511,0.0107896027464443,780,0.382540461010299,1259,0.617459538989701
"E02003440",3,177,1186,1392,327,44,7,3136,0.000956632653061224,0.0564413265306122,0.378188775510204,0.443877551020408,0.104272959183673,0.014030612244898,0.00223214285714286,1366,0.435586734693878,1770,0.564413265306122
"E02003441",4,79,693,979,303,47,4,2109,0.00189663347558084,0.0374585111427217,0.328591749644381,0.464201043148412,0.143669985775249,0.0222854433380749,0.00189663347558084,776,0.367946894262684,1333,0.632053105737316
"E02003442",14,649,729,1081,170,19,1,2663,0.00525722868944799,0.24371010138941,0.273751408186256,0.405933158092377,0.063837776943297,0.00713481036425084,0.000375516334960571,1392,0.522718738265115,1271,0.477281261734885
"E02003443",4,467,984,722,181,27,11,2396,0.00166944908180301,0.194908180300501,0.410684474123539,0.301335559265442,0.075542570951586,0.0112687813021703,0.00459098497495826,1455,0.607262103505843,941,0.392737896494157
"E02003444",6,182,760,1037,370,54,5,2414,0.00248550124275062,0.0753935376967688,0.314830157415079,0.429577464788732,0.153272576636288,0.0223695111847556,0.00207125103562552,948,0.392709196354598,1466,0.607290803645402
"E02003445",3,318,578,1090,299,32,3,2323,0.0012914334911752,0.136891950064572,0.248816185966423,0.469220835126991,0.128712871287129,0.0137752905725355,0.0012914334911752,899,0.38699956952217,1424,0.61300043047783
"E02003446",1,114,619,1131,257,32,4,2158,0.00046339202965709,0.0528266913809083,0.286839666357739,0.524096385542169,0.119091751621872,0.0148285449490269,0.00185356811862836,734,0.340129749768304,1424,0.659870250231696
"E02003447",22,644,1484,1078,228,14,5,3475,0.00633093525179856,0.185323741007194,0.42705035971223,0.31021582733813,0.0656115107913669,0.00402877697841727,0.00143884892086331,2150,0.618705035971223,1325,0.381294964028777
"E02003448",28,946,714,820,284,35,10,2837,0.00986958054282693,0.333450828339796,0.251674303842087,0.289037715897074,0.100105745505816,0.0123369756785337,0.00352485019386676,1688,0.594994712724709,1149,0.405005287275291
"E02003449",0,37,1101,1336,215,13,0,2702,0,0.0136935603256847,0.407475943745374,0.494448556624722,0.0795706883789785,0.00481125092524056,0,1138,0.421169504071058,1564,0.578830495928942
"E02003450",16,1473,1818,1307,317,45,2,4978,0.00321414222579349,0.295901968662113,0.365206910405785,0.262555243069506,0.0636801928485335,0.00903977501004419,0.000401767778224186,3307,0.664323021293692,1671,0.335676978706308
"E02003451",21,1084,2192,1469,455,63,31,5315,0.00395108184383819,0.203951081843838,0.41241768579492,0.276387582314205,0.0856067732831609,0.0118532455315146,0.00583254938852305,3297,0.620319849482596,2018,0.379680150517404
"E02003452",3,1364,903,795,190,35,5,3295,0.000910470409711684,0.413960546282246,0.274051593323217,0.241274658573596,0.0576631259484067,0.0106221547799697,0.00151745068285281,2270,0.688922610015175,1025,0.311077389984825
"E02003453",7,246,584,827,161,18,2,1845,0.0037940379403794,0.133333333333333,0.316531165311653,0.448238482384824,0.0872628726287263,0.00975609756097561,0.0010840108401084,837,0.453658536585366,1008,0.546341463414634
"E02003454",6,413,1214,1169,284,32,5,3123,0.00192122958693564,0.132244636567403,0.388728786423311,0.374319564521294,0.0909382004482869,0.0102465577969901,0.0016010246557797,1633,0.52289465257765,1490,0.47710534742235
"E02003455",61,1938,1008,742,289,89,12,4139,0.0147378593863252,0.468229040831119,0.243537086252718,0.179270355158251,0.0698236288958686,0.0215027784489007,0.00289925102681807,3007,0.726503986470162,1132,0.273496013529838
"E02003456",90,1533,1321,924,185,29,11,4093,0.0219887612997801,0.374541900806255,0.322746151966773,0.225751282677742,0.045199120449548,0.00708526752992915,0.00268751526997312,2944,0.719276814072807,1149,0.280723185927193
"E02003457",6,138,805,1305,317,43,3,2617,0.0022927015666794,0.0527321360336263,0.30760412686282,0.49866259075277,0.121131066106229,0.0164310278945357,0.0011463507833397,949,0.362628964463126,1668,0.637371035536874
"E02003458",8,210,604,1107,296,42,8,2275,0.00351648351648352,0.0923076923076923,0.265494505494505,0.486593406593407,0.13010989010989,0.0184615384615385,0.00351648351648352,822,0.361318681318681,1453,0.638681318681319
"E02003459",39,664,988,1410,444,85,23,3653,0.0106761565836299,0.181768409526417,0.270462633451957,0.385984122638927,0.121543936490556,0.023268546400219,0.00629619490829455,1691,0.462907199562004,1962,0.537092800437996
"E02003460",49,1582,1169,1116,565,198,60,4739,0.0103397341211226,0.333825701624815,0.246676514032496,0.235492719983119,0.119223464866005,0.0417809664486179,0.0126608989238236,2800,0.590841949778434,1939,0.409158050221566
"E02003461",4,148,891,1026,208,29,3,2309,0.00173235166738848,0.0640970116933738,0.385881333910784,0.444348202685145,0.090082286704201,0.0125595495885665,0.00129926375054136,1043,0.451710697271546,1266,0.548289302728454
"E02003462",17,243,1124,1210,315,37,5,2951,0.00576075906472382,0.0823449678075229,0.380887834632328,0.410030498136225,0.10674347678753,0.0125381226702813,0.00169434090138936,1384,0.468993561504575,1567,0.531006438495425
"E02003463",1,45,966,900,117,2,1,2032,0.000492125984251968,0.0221456692913386,0.475393700787402,0.442913385826772,0.0575787401574803,0.000984251968503937,0.000492125984251968,1012,0.498031496062992,1020,0.501968503937008
"E02003464",0,31,982,1186,159,18,3,2379,0,0.0130306851618327,0.412778478352249,0.498528793610761,0.0668348045397226,0.00756620428751576,0.00126103404791929,1013,0.425809163514082,1366,0.574190836485919
"E02003465",5,250,899,890,83,5,0,2132,0.00234521575984991,0.117260787992495,0.421669793621013,0.417448405253283,0.0389305816135084,0.00234521575984991,0,1154,0.541275797373358,978,0.458724202626642
"E02003466",0,520,548,1253,606,75,17,3019,0,0.172242464392183,0.181517058628685,0.415038092083471,0.200728718118582,0.0248426631334879,0.00563100364359059,1068,0.353759523020868,1951,0.646240476979132
"E02003467",12,68,1371,1138,146,11,1,2747,0.00436840189297415,0.0247542773935202,0.499089916272297,0.414270112850382,0.0531488896978522,0.00400436840189297,0.000364033491081179,1451,0.528212595558791,1296,0.471787404441209
"E02003468",33,771,1255,1116,426,60,20,3681,0.00896495517522412,0.209453952730236,0.340939961966857,0.303178484107579,0.115729421352893,0.0162999185004075,0.0054333061668025,2059,0.559358869872317,1622,0.440641130127683
"E02003469",6,19,718,924,109,10,3,1789,0.00335382895472331,0.0106204583566238,0.401341531581889,0.51648965902739,0.0609278926774734,0.00558971492453885,0.00167691447736165,743,0.415315818893236,1046,0.584684181106764
"E02003470",0,54,1057,1222,246,15,1,2595,0,0.0208092485549133,0.407321772639692,0.470905587668593,0.0947976878612717,0.00578034682080925,0.000385356454720617,1111,0.428131021194605,1484,0.571868978805395
"E02003471",1,92,1146,932,100,2,1,2274,0.000439753737906772,0.040457343887423,0.503957783641161,0.409850483729112,0.0439753737906772,0.000879507475813544,0.000439753737906772,1239,0.544854881266491,1035,0.455145118733509
"E02003472",143,2865,3205,1111,221,11,0,7556,0.0189253573319217,0.379168872419269,0.424166225516146,0.147035468501853,0.0292482795129698,0.00145579671784013,0,6213,0.822260455267337,1343,0.177739544732663
"E02003473",4,34,718,976,145,8,0,1885,0.00212201591511936,0.0180371352785146,0.380901856763926,0.517771883289125,0.0769230769230769,0.00424403183023873,0,756,0.40106100795756,1129,0.59893899204244
"E02003474",7,240,1676,846,136,20,0,2925,0.00239316239316239,0.0820512820512821,0.572991452991453,0.289230769230769,0.0464957264957265,0.00683760683760684,0,1923,0.657435897435897,1002,0.342564102564103
"E02003476",1,127,1762,1217,126,7,2,3242,0.000308451573103023,0.0391733497840839,0.543491671807526,0.375385564466379,0.0388648982109809,0.00215916101172116,0.000616903146206046,1890,0.582973473164713,1352,0.417026526835287
"E02003478",0,43,1113,1001,126,17,2,2302,0,0.0186794092093831,0.483492615117289,0.434839270199826,0.054735013032146,0.00738488271068636,0.000868809730668983,1156,0.502172024326672,1146,0.497827975673328
"E02003479",5,121,1455,898,206,12,1,2698,0.00185322461082283,0.0448480355819125,0.539288361749444,0.332839140103781,0.0763528539659007,0.0044477390659748,0.000370644922164566,1581,0.585989621942179,1117,0.414010378057821
"E02003480",27,277,1478,1351,197,9,0,3339,0.00808625336927224,0.0829589697514226,0.442647499251273,0.40461215932914,0.0589997005091345,0.00269541778975741,0,1782,0.533692722371968,1557,0.466307277628032
"E02003481",81,996,1402,1351,209,16,5,4060,0.0199507389162562,0.245320197044335,0.345320197044335,0.332758620689655,0.0514778325123153,0.00394088669950739,0.00123152709359606,2479,0.610591133004926,1581,0.389408866995074
"E02003482",135,3644,870,827,326,55,14,5871,0.0229943791517629,0.620677908363141,0.148185998978028,0.140861863396355,0.055527167433146,0.00936808039516266,0.00238460228240504,4649,0.791858286492931,1222,0.208141713507069
"E02003483",7,312,2343,961,60,6,0,3689,0.00189753320683112,0.084575765790187,0.635131471943616,0.260504201680672,0.0162645703442667,0.00162645703442667,0,2662,0.721604770940634,1027,0.278395229059366
"E02003484",2,32,1334,953,123,5,0,2449,0.000816659861167824,0.0130665577786852,0.544712127398938,0.389138423846468,0.0502245814618211,0.00204164965291956,0,1368,0.558595345038791,1081,0.441404654961209
"E02003485",1,62,1115,1025,136,12,3,2354,0.000424808836023789,0.0263381478334749,0.473661852166525,0.435429056924384,0.0577740016992353,0.00509770603228547,0.00127442650807137,1178,0.500424808836024,1176,0.499575191163976
"E02003486",30,1204,1773,1033,120,6,0,4166,0.0072011521843495,0.28900624099856,0.425588094095055,0.247959673547768,0.028804608737398,0.0014402304368699,0,3007,0.721795487277964,1159,0.278204512722036
"E02003487",6,51,881,1083,140,16,1,2178,0.00275482093663912,0.0234159779614325,0.404499540863177,0.497245179063361,0.0642791551882461,0.00734618916437098,0.000459136822773186,938,0.430670339761249,1240,0.569329660238751
"E02003488",88,596,873,1199,402,69,11,3238,0.0271772699197035,0.184064237183447,0.269610870907968,0.37029030265596,0.124150710315009,0.0213094502779494,0.00339715873996294,1557,0.480852378011118,1681,0.519147621988882
"E02003489",1,437,978,993,205,28,6,2648,0.000377643504531722,0.165030211480363,0.369335347432024,0.375,0.077416918429003,0.0105740181268882,0.00226586102719033,1416,0.534743202416918,1232,0.465256797583082
"E02003490",23,1675,1807,999,122,20,6,4652,0.00494411006018917,0.36006018916595,0.388435081685297,0.214746345657782,0.0262252794496991,0.00429922613929493,0.00128976784178848,3505,0.753439380911436,1147,0.246560619088564
"E02003491",2,39,662,1183,321,37,4,2248,0.000889679715302491,0.0173487544483986,0.294483985765125,0.526245551601424,0.14279359430605,0.0164590747330961,0.00177935943060498,703,0.312722419928826,1545,0.687277580071174
"E02003492",2,267,766,713,150,20,7,1925,0.00103896103896104,0.138701298701299,0.397922077922078,0.37038961038961,0.0779220779220779,0.0103896103896104,0.00363636363636364,1035,0.537662337662338,890,0.462337662337662
"E02003493",27,190,1017,1138,413,59,6,2850,0.00947368421052632,0.0666666666666667,0.356842105263158,0.399298245614035,0.144912280701754,0.0207017543859649,0.00210526315789474,1234,0.432982456140351,1616,0.567017543859649
"E02003494",7,29,580,1001,328,29,14,1988,0.00352112676056338,0.0145875251509054,0.291750503018109,0.503521126760563,0.164989939637827,0.0145875251509054,0.00704225352112676,616,0.309859154929577,1372,0.690140845070423
"E02003495",32,122,739,973,265,18,6,2155,0.0148491879350348,0.0566125290023202,0.34292343387471,0.451508120649652,0.122969837587007,0.00835266821345708,0.00278422273781903,893,0.414385150812065,1262,0.585614849187935
"E02003496",2,68,1052,898,255,23,9,2307,0.000866926744690074,0.0294755093194625,0.456003467706979,0.389250108365843,0.110533159947984,0.00996965756393585,0.00390117035110533,1122,0.486345903771131,1185,0.513654096228869
"E02003497",20,180,673,994,366,44,8,2285,0.0087527352297593,0.0787746170678337,0.2945295404814,0.435010940919037,0.160175054704595,0.0192560175054705,0.00350109409190372,873,0.382056892778993,1412,0.617943107221007
"E02003498",5,449,1676,943,176,27,10,3286,0.00152160681679854,0.136640292148509,0.51004260499087,0.286975045648205,0.0535605599513086,0.00821667681071211,0.00304321363359708,2130,0.648204503956178,1156,0.351795496043822
"E02003499",3,88,941,886,180,22,5,2125,0.00141176470588235,0.0414117647058824,0.442823529411765,0.416941176470588,0.0847058823529412,0.0103529411764706,0.00235294117647059,1032,0.485647058823529,1093,0.514352941176471
"E02003500",4,38,616,1501,422,51,12,2644,0.00151285930408472,0.0143721633888048,0.232980332829047,0.567700453857791,0.159606656580938,0.0192889561270802,0.00453857791225416,658,0.248865355521936,1986,0.751134644478064
"E02003501",12,151,1234,1508,591,81,19,3596,0.00333704115684093,0.0419911012235818,0.343159065628476,0.419354838709677,0.164349276974416,0.0225250278086763,0.00528364849833148,1397,0.388487208008899,2199,0.611512791991101
"E02003502",4,112,1011,1083,369,57,12,2648,0.00151057401812689,0.0422960725075529,0.381797583081571,0.408987915407855,0.139350453172205,0.0215256797583082,0.00453172205438067,1127,0.425604229607251,1521,0.574395770392749
"E02003503",1,78,855,1154,335,47,8,2478,0.000403551251008878,0.0314769975786925,0.345036319612591,0.465698143664245,0.135189669087974,0.0189669087974173,0.00322841000807102,934,0.376916868442292,1544,0.623083131557708
"E02003504",4,475,1265,1909,662,76,27,4418,0.000905387052965143,0.107514712539611,0.286328655500226,0.432095971027614,0.149841557265731,0.0172023540063377,0.00611136260751471,1744,0.394748755092802,2674,0.605251244907198
"E02003505",0,152,1394,1881,481,60,23,3991,0,0.0380856928088198,0.349285893259835,0.471310448509146,0.120521172638436,0.0150338261087447,0.00576296667501879,1546,0.387371586068654,2445,0.612628413931345
"E02003506",1,683,805,1530,464,53,18,3554,0.00028137310073157,0.192177827799662,0.226505346088914,0.430500844119302,0.130557118739449,0.0149127743387732,0.00506471581316826,1489,0.418964546989308,2065,0.581035453010692
"E02003507",8,121,895,1372,341,40,7,2784,0.0028735632183908,0.0434626436781609,0.321479885057471,0.492816091954023,0.122485632183908,0.014367816091954,0.00251436781609195,1024,0.367816091954023,1760,0.632183908045977
"E02003508",3,92,1042,1753,423,49,12,3374,0.000889152341434499,0.027267338470658,0.308832246591583,0.519561351511559,0.125370480142264,0.0145228215767635,0.003556609365738,1137,0.336988737403675,2237,0.663011262596325
"E02003509",4,369,1894,2171,815,133,62,5448,0.000734214390602056,0.0677312775330396,0.347650513950073,0.398494860499266,0.149596182085169,0.0244126284875184,0.0113803230543319,2267,0.416116005873715,3181,0.583883994126285
"E02003510",4,439,1873,1670,591,95,20,4692,0.000852514919011083,0.0935635123614663,0.399190110826939,0.355924978687127,0.125959079283887,0.0202472293265132,0.00426257459505541,2316,0.493606138107417,2376,0.506393861892583
"E02003511",4,353,849,1470,565,68,26,3335,0.00119940029985007,0.105847076461769,0.254572713643178,0.440779610194903,0.169415292353823,0.0203898050974513,0.00779610194902549,1206,0.361619190404798,2129,0.638380809595202
"E02003512",1,83,1325,1815,442,59,26,3751,0.000266595574513463,0.0221274326846174,0.353239136230339,0.483870967741935,0.117835243934951,0.0157291388962943,0.00693148493735004,1409,0.375633164489469,2342,0.624366835510531
"E02003513",12,197,840,1059,408,82,15,2613,0.00459242250287026,0.0753922694221202,0.321469575200919,0.405281285878301,0.156142365097589,0.0313815537696135,0.00574052812858783,1049,0.401454267125909,1564,0.598545732874091
"E02003514",0,228,1854,2162,894,152,55,5345,0,0.0426566884939195,0.346866230121609,0.404490177736202,0.167259120673527,0.0284377923292797,0.010289990645463,2082,0.389522918615529,3263,0.610477081384472
"E02003515",5,540,1468,740,111,11,3,2878,0.00173731758165393,0.187630298818624,0.510076441973593,0.257123002084781,0.0385684503127172,0.00382209867963864,0.00104239054899236,2013,0.699444058373871,865,0.300555941626129
"E02003516",0,100,1772,2424,1023,159,42,5520,0,0.0181159420289855,0.321014492753623,0.439130434782609,0.185326086956522,0.028804347826087,0.00760869565217391,1872,0.339130434782609,3648,0.660869565217391
"E02003517",11,1257,2625,2481,1071,122,57,7624,0.00144281217208814,0.1648740818468,0.344307450157398,0.325419727177335,0.140477439664218,0.0160020986358867,0.00747639034627492,3893,0.510624344176285,3731,0.489375655823715
"E02003518",0,295,1700,1937,822,135,28,4917,0,0.059995932479154,0.345739271913769,0.393939393939394,0.167175106772422,0.0274557657107993,0.00569452918446207,1995,0.405735204392923,2922,0.594264795607077
"E02003519",0,95,2420,2225,784,118,49,5691,0,0.0166930240730979,0.425232823756809,0.39096819539624,0.137761377613776,0.0207344930592163,0.00861008610086101,2515,0.441925847829907,3176,0.558074152170093
"E02003520",0,644,2280,1655,586,108,22,5295,0,0.12162417374882,0.430594900849858,0.312559017941454,0.11067044381492,0.0203966005665722,0.00415486307837583,2924,0.552219074598678,2371,0.447780925401322
"E02003521",3,339,2175,1730,571,76,25,4919,0.000609880056922139,0.0689164464322017,0.44216304126855,0.351697499491767,0.116080504167514,0.0154502947753608,0.00508233380768449,2517,0.511689367757674,2402,0.488310632242326
"E02003522",10,485,1947,1308,433,53,13,4249,0.00235349493998588,0.114144504589315,0.458225464815251,0.307837138150153,0.101906330901389,0.0124735231819252,0.00305954342198164,2442,0.574723464344552,1807,0.425276535655448
"E02003523",24,348,1168,1806,663,117,25,4151,0.00578173933991809,0.0838352204288123,0.281377981209347,0.435075885328836,0.159720549265237,0.0281859792821007,0.00602264514574801,1540,0.370994940978078,2611,0.629005059021922
"E02003524",4,67,1010,1274,252,48,24,2679,0.00149309443822322,0.0250093318402389,0.377006345651362,0.475550578574095,0.0940649496080627,0.0179171332586786,0.00895856662933931,1081,0.403508771929825,1598,0.596491228070176
"E02003525",5,267,886,904,224,39,14,2339,0.00213766566908935,0.114151346729372,0.378794356562634,0.386489952971355,0.0957674219752031,0.016673792218897,0.00598546387345019,1158,0.495083368961095,1181,0.504916631038906
"E02003526",7,240,593,890,356,50,15,2151,0.00325430032543003,0.111576011157601,0.275685727568573,0.413761041376104,0.165504416550442,0.0232450023245002,0.00697350069735007,840,0.390516039051604,1311,0.609483960948396
"E02003527",3,222,953,975,270,99,10,2532,0.00118483412322275,0.0876777251184834,0.376382306477093,0.385071090047393,0.106635071090047,0.0390995260663507,0.00394944707740916,1178,0.465244865718799,1354,0.534755134281201
"E02003529",0,300,781,1135,292,49,18,2575,0,0.116504854368932,0.303300970873786,0.440776699029126,0.113398058252427,0.0190291262135922,0.00699029126213592,1081,0.419805825242718,1494,0.580194174757282
"E02003530",15,297,1327,1043,235,34,10,2961,0.00506585612968592,0.100303951367781,0.448159405606214,0.352245862884161,0.0793650793650794,0.0114826072272881,0.00337723741979061,1639,0.553529213103681,1322,0.446470786896319
"E02003531",1,29,760,1282,334,36,17,2459,0.000406669377795852,0.0117934119560797,0.309068727124848,0.521350142334282,0.135827572183815,0.0146400976006507,0.00691337942252948,790,0.321268808458723,1669,0.678731191541277
"E02003532",0,114,991,1557,425,69,25,3181,0,0.0358377868594782,0.311537252436341,0.489468720528136,0.133605784344546,0.0216912920465262,0.00785916378497328,1105,0.347375039295819,2076,0.652624960704181
"E02003533",1,29,696,1210,281,38,19,2274,0.000439753737906772,0.0127528583992964,0.306068601583113,0.532102022867194,0.123570800351803,0.0167106420404573,0.00835532102022867,726,0.319261213720317,1548,0.680738786279683
"E02003534",2,50,765,1823,436,42,30,3148,0.000635324015247776,0.0158831003811944,0.243011435832274,0.579097839898348,0.138500635324015,0.0133418043202033,0.00952986022871665,817,0.259529860228717,2331,0.740470139771283
"E02003535",4,77,1021,1993,444,59,25,3623,0.00110405741098537,0.0212531051614684,0.281810654154016,0.550096605023461,0.122550372619376,0.0162848468120342,0.00690035881865857,1102,0.30416781672647,2521,0.69583218327353
"E02003536",4,195,1910,1050,168,21,4,3352,0.00119331742243437,0.0581742243436754,0.56980906921241,0.313245823389021,0.0501193317422434,0.00626491646778043,0.00119331742243437,2109,0.62917661097852,1243,0.37082338902148
"E02003537",3,377,1101,1580,423,61,19,3564,0.000841750841750842,0.105780022446689,0.308922558922559,0.443322109988777,0.118686868686869,0.0171156004489338,0.005331088664422,1481,0.415544332210999,2083,0.584455667789001
"E02003538",2,165,1571,2338,478,63,29,4646,0.000430477830391735,0.0355144210073181,0.338140335772708,0.503228583727938,0.102884201463625,0.0135600516573396,0.00624192854068016,1738,0.374085234610418,2908,0.625914765389582
"E02003540",15,617,1229,1439,262,37,25,3624,0.00413907284768212,0.170253863134658,0.339128035320088,0.397075055187638,0.0722958057395143,0.0102097130242826,0.00689845474613687,1861,0.513520971302428,1763,0.486479028697572
"E02003541",2,514,2164,1607,468,83,27,4865,0.000411099691675231,0.105652620760534,0.4448098663926,0.330318602261048,0.0961973278520041,0.0170606372045221,0.00554984583761562,2680,0.55087358684481,2185,0.44912641315519
"E02003542",0,71,977,2068,447,55,16,3634,0,0.019537699504678,0.26884975233902,0.569069895432031,0.123004953219593,0.0151348376444689,0.00440286186020914,1048,0.288387451843698,2586,0.711612548156301
"E02003543",1,79,1076,2024,556,86,32,3854,0.000259470679813181,0.0204981837052413,0.279190451478983,0.525168655941879,0.144265697976129,0.0223144784639336,0.0083030617540218,1156,0.299948105864037,2698,0.700051894135963
"E02003544",0,106,826,1497,333,50,20,2832,0,0.0374293785310734,0.291666666666667,0.528601694915254,0.117584745762712,0.0176553672316384,0.00706214689265537,932,0.32909604519774,1900,0.67090395480226
"E02003545",0,170,1571,1597,608,139,31,4116,0,0.0413022351797862,0.381681243926142,0.387998056365403,0.147716229348882,0.0337706511175899,0.00753158406219631,1741,0.422983479105928,2375,0.577016520894072
"E02003546",1,79,1298,1694,468,75,23,3638,0.000274876305662452,0.0217152281473337,0.356789444749863,0.465640461792194,0.128642111050027,0.0206157229246839,0.00632215503023639,1378,0.378779549202859,2260,0.621220450797141
"E02003547",1,522,2605,1648,575,114,23,5488,0.000182215743440233,0.0951166180758018,0.474672011661808,0.300291545189504,0.104774052478134,0.0207725947521866,0.00419096209912536,3128,0.56997084548105,2360,0.43002915451895
"E02003548",1,78,849,1377,573,90,31,2999,0.000333444481493831,0.0260086695565188,0.283094364788263,0.459153051017006,0.191063687895965,0.0300100033344448,0.0103367789263088,928,0.309436478826275,2071,0.690563521173725
"E02003549",6,165,800,1049,315,86,9,2430,0.00246913580246914,0.0679012345679012,0.329218106995885,0.431687242798354,0.12962962962963,0.0353909465020576,0.0037037037037037,971,0.399588477366255,1459,0.600411522633745
"E02003550",2,235,941,1091,309,100,12,2690,0.000743494423791822,0.087360594795539,0.349814126394052,0.405576208178439,0.114869888475836,0.0371747211895911,0.00446096654275093,1178,0.437918215613383,1512,0.562081784386617
"E02003551",24,139,848,886,327,104,22,2350,0.0102127659574468,0.0591489361702128,0.360851063829787,0.377021276595745,0.139148936170213,0.0442553191489362,0.00936170212765958,1011,0.430212765957447,1339,0.569787234042553
"E02003552",1,144,935,917,377,88,18,2480,0.000403225806451613,0.0580645161290323,0.377016129032258,0.369758064516129,0.152016129032258,0.0354838709677419,0.00725806451612903,1080,0.435483870967742,1400,0.564516129032258
"E02003553",2,94,927,1021,237,28,9,2318,0.000862812769628991,0.0405522001725626,0.399913718723037,0.4404659188956,0.102243313201035,0.0120793787748059,0.00388265746333046,1023,0.441328731665229,1295,0.558671268334771
"E02003554",7,194,789,950,357,67,11,2375,0.00294736842105263,0.0816842105263158,0.332210526315789,0.4,0.150315789473684,0.0282105263157895,0.00463157894736842,990,0.416842105263158,1385,0.583157894736842
"E02003555",25,585,1177,1183,289,42,12,3313,0.00754603078780561,0.176577120434651,0.355267129489888,0.357078176878962,0.0872321159070329,0.0126773317235134,0.00362209477814669,1787,0.539390280712345,1526,0.460609719287655
"E02003556",0,95,501,929,289,46,9,1869,0,0.0508293204922418,0.268057784911718,0.497057249866239,0.154628143392188,0.0246120920278224,0.00481540930979133,596,0.318887105403959,1273,0.681112894596041
"E02003557",0,233,1223,1139,359,83,12,3049,0,0.0764184978681535,0.401115119711381,0.373565103312561,0.117743522466382,0.0272220400131191,0.00393571662840275,1456,0.477533617579534,1593,0.522466382420466
"E02003558",2,332,1043,1252,421,111,39,3200,0.000625,0.10375,0.3259375,0.39125,0.1315625,0.0346875,0.0121875,1377,0.4303125,1823,0.5696875
"E02003559",3,80,659,1168,410,66,14,2400,0.00125,0.0333333333333333,0.274583333333333,0.486666666666667,0.170833333333333,0.0275,0.00583333333333333,742,0.309166666666667,1658,0.690833333333333
"E02003560",1,104,1066,1153,217,68,12,2621,0.000381533765738268,0.0396795116367799,0.406714994276994,0.439908431896223,0.0827928271652041,0.0259442960702022,0.00457840518885921,1171,0.446776039679512,1450,0.553223960320488
"E02003561",3,345,1509,1323,483,104,28,3795,0.000790513833992095,0.0909090909090909,0.397628458498024,0.348616600790514,0.127272727272727,0.0274044795783926,0.00737812911725955,1857,0.489328063241107,1938,0.510671936758893
"E02003562",3,441,1234,1376,430,80,13,3577,0.000838691641039978,0.123287671232877,0.344981828347777,0.384679899357003,0.120212468549063,0.0223651104277327,0.00363433044450657,1678,0.469108191221694,1899,0.530891808778306
"E02003563",0,439,1356,1351,438,107,52,3743,0,0.117285599786268,0.36227624899813,0.360940422121293,0.1170184344109,0.0285866951643067,0.0138925995191023,1795,0.479561848784398,1948,0.520438151215602
"E02003564",1,201,913,1345,436,160,47,3103,0.000322268772155978,0.0647760232033516,0.294231388978408,0.433451498549791,0.140509184660006,0.0515630035449565,0.015146632291331,1115,0.359329680953916,1988,0.640670319046084
"E02003565",1,365,1373,1272,335,36,12,3394,0.000294637595757219,0.107542722451385,0.404537418974661,0.374779021803182,0.0987035945786682,0.0106069534472599,0.00353565114908662,1739,0.512374779021803,1655,0.487625220978197
"E02003566",3,226,880,821,205,38,11,2184,0.00137362637362637,0.103479853479853,0.402930402930403,0.375915750915751,0.0938644688644689,0.0173992673992674,0.00503663003663004,1109,0.507783882783883,1075,0.492216117216117
"E02003567",1,160,905,1121,229,55,16,2487,0.000402090872537193,0.0643345396059509,0.36389223964616,0.450743868114194,0.0920788098110173,0.0221149979895456,0.00643345396059509,1066,0.428628870124648,1421,0.571371129875352
"E02003568",0,464,1584,1470,597,66,25,4206,0,0.110318592486923,0.37660485021398,0.349500713266762,0.141940085592011,0.0156918687589158,0.00594388968140751,2048,0.486923442700903,2158,0.513076557299096
"E02003569",0,286,1527,1453,471,108,39,3884,0,0.0736354273944387,0.393151390319258,0.374098867147271,0.121266735324408,0.0278063851699279,0.0100411946446962,1813,0.466786817713697,2071,0.533213182286303
"E02003570",5,548,1960,1671,779,190,101,5254,0.000951655881233346,0.104301484583175,0.373049105443472,0.318043395508184,0.148267986296155,0.0361629234868672,0.0192234488009136,2513,0.47830224590788,2741,0.52169775409212
"E02003571",0,698,1835,1216,397,66,20,4232,0,0.164933837429112,0.433601134215501,0.287334593572779,0.0938090737240076,0.0155954631379962,0.00472589792060491,2533,0.598534971644612,1699,0.401465028355387
"E02003572",1,63,500,951,329,40,11,1895,0.000527704485488127,0.033245382585752,0.263852242744063,0.501846965699208,0.173614775725594,0.0211081794195251,0.00580474934036939,564,0.297625329815303,1331,0.702374670184696
"E02003573",3,259,966,1104,393,182,19,2926,0.00102529049897471,0.0885167464114833,0.330143540669856,0.377306903622693,0.134313055365687,0.062200956937799,0.00649350649350649,1228,0.419685577580314,1698,0.580314422419686
"E02003574",2,126,807,1302,408,146,27,2818,0.0007097232079489,0.0447125621007807,0.286373314407381,0.462029808374734,0.144783534421576,0.0518097941802697,0.00958126330731015,935,0.331795599716111,1883,0.668204400283889
"E02003575",3,145,1016,988,407,159,51,2769,0.00108342361863489,0.0523654749006862,0.366919465511015,0.356807511737089,0.146984470928133,0.057421451787649,0.0184182015167931,1164,0.420368364030336,1605,0.579631635969664
"E02003576",0,112,1100,1244,408,96,17,2977,0,0.0376217668794088,0.369499496137051,0.417870339267719,0.137050722203561,0.032247228753779,0.00571044675848169,1212,0.40712126301646,1765,0.59287873698354
"E02003578",4,149,773,908,246,51,20,2151,0.00185960018596002,0.0692701069270107,0.359367735936774,0.422129242212924,0.114365411436541,0.0237099023709902,0.00929800092980009,926,0.430497443049744,1225,0.569502556950256
"E02003579",13,1226,1315,1317,428,65,14,4378,0.0029693924166286,0.280036546368205,0.300365463682047,0.300822293284605,0.0977615349474646,0.014846962083143,0.00319780721790772,2554,0.58337140246688,1824,0.41662859753312
"E02003580",3,230,961,833,269,98,11,2405,0.00124740124740125,0.0956340956340956,0.3995841995842,0.346361746361746,0.111850311850312,0.0407484407484408,0.00457380457380457,1194,0.496465696465696,1211,0.503534303534304
"E02003581",3,268,1418,1623,613,139,47,4111,0.000729749452687911,0.0651909511067867,0.344928241303819,0.39479445390416,0.149112138165896,0.0338117246412065,0.0114327414254439,1689,0.410848941863294,2422,0.589151058136706
"E02003582",45,194,950,1253,493,103,34,3072,0.0146484375,0.0631510416666667,0.309244791666667,0.407877604166667,0.160481770833333,0.0335286458333333,0.0110677083333333,1189,0.387044270833333,1883,0.612955729166667
"E02003583",3,772,1308,813,287,55,22,3260,0.000920245398773006,0.23680981595092,0.401226993865031,0.249386503067485,0.0880368098159509,0.0168711656441718,0.00674846625766871,2083,0.638957055214724,1177,0.361042944785276
"E02003584",5,179,1012,1418,783,202,67,3666,0.00136388434260775,0.0488270594653573,0.276050190943808,0.386797599563557,0.213584288052373,0.055100927441353,0.0182760501909438,1196,0.326241134751773,2470,0.673758865248227
"E02003585",7,145,729,1076,382,77,32,2448,0.00285947712418301,0.0592320261437908,0.297794117647059,0.439542483660131,0.156045751633987,0.0314542483660131,0.0130718954248366,881,0.359885620915033,1567,0.640114379084967
"E02003586",11,182,1027,1243,395,96,32,2986,0.00368385800401875,0.0609511051574012,0.343938379102478,0.416275954454119,0.132283991962492,0.0321500334896182,0.0107166778298727,1220,0.408573342263898,1766,0.591426657736102
"E02003587",9,463,1264,1333,599,103,38,3809,0.00236282488842216,0.121554213704384,0.331845628773956,0.349960619585193,0.15725912312943,0.027041218167498,0.00997637175111578,1736,0.455762667366763,2073,0.544237332633237
"E02003588",4,932,1168,996,342,60,22,3524,0.00113507377979569,0.264472190692395,0.331441543700341,0.282633371169126,0.0970488081725312,0.0170261066969353,0.00624290578887628,2104,0.597048808172531,1420,0.402951191827469
"E02003589",7,377,1354,1171,503,83,36,3531,0.00198244123477768,0.106768620787312,0.38346077598414,0.331634097989238,0.142452563013311,0.0235060889266497,0.0101954120645709,1738,0.492211838006231,1793,0.507788161993769
"E02003590",24,260,1034,1447,668,183,58,3674,0.0065323897659227,0.0707675557974959,0.281437125748503,0.393848666303756,0.181818181818182,0.0498094719651606,0.0157866086009799,1318,0.358737071311922,2356,0.641262928688078
"E02003591",7,291,1322,1164,518,108,34,3444,0.00203252032520325,0.0844947735191638,0.383855981416957,0.337979094076655,0.150406504065041,0.0313588850174216,0.00987224157955865,1620,0.470383275261324,1824,0.529616724738676
"E02003592",17,560,1532,1657,682,218,70,4736,0.00358952702702703,0.118243243243243,0.32347972972973,0.349873310810811,0.144003378378378,0.0460304054054054,0.0147804054054054,2109,0.4453125,2627,0.5546875
"E02003593",10,141,351,571,593,253,67,1986,0.00503524672708963,0.0709969788519638,0.176737160120846,0.287512588116818,0.298590130916415,0.127391742195368,0.0337361530715005,502,0.252769385699899,1484,0.747230614300101
"E02003594",7,371,1336,1403,537,136,44,3834,0.00182576943140323,0.0967657798643714,0.348461137193532,0.365936358894105,0.140062597809077,0.03547209181012,0.0114762649973918,1714,0.447052686489306,2120,0.552947313510694
"E02003595",8,186,890,1361,432,79,17,2973,0.00269088462832156,0.0625630676084763,0.299360914900774,0.457786747393206,0.145307769929364,0.0265724857046754,0.00571812983518332,1084,0.364614867137572,1889,0.635385132862428
"E02003596",2,362,1606,1524,672,154,37,4357,0.00045903144365389,0.0830846913013541,0.368602249254074,0.349781960064264,0.154234565067707,0.0353454211613496,0.00849208170759697,1970,0.452145971999082,2387,0.547854028000918
"E02003597",73,108,434,683,578,263,87,2226,0.0327942497753819,0.0485175202156334,0.19496855345912,0.306828391734052,0.259658580413297,0.118149146451033,0.0390835579514825,615,0.276280323450135,1611,0.723719676549865
"E02003598",3,190,1073,1429,771,279,120,3865,0.000776196636481242,0.0491591203104787,0.277619663648124,0.369728331177232,0.199482535575679,0.0721862871927555,0.0310478654592497,1266,0.327554980595084,2599,0.672445019404916
"E02003599",2,136,1014,762,112,12,1,2039,0.000980872976949485,0.066699362432565,0.497302599313389,0.373712604217754,0.0549288867091712,0.00588523786169691,0.000490436488474743,1152,0.564982834722903,887,0.435017165277097
"E02003600",6,151,846,859,282,53,8,2205,0.00272108843537415,0.0684807256235828,0.383673469387755,0.389569160997732,0.127891156462585,0.0240362811791383,0.0036281179138322,1003,0.454875283446712,1202,0.545124716553288
"E02003601",11,615,866,999,422,112,23,3048,0.00360892388451444,0.201771653543307,0.284120734908136,0.327755905511811,0.138451443569554,0.036745406824147,0.00754593175853018,1492,0.489501312335958,1556,0.510498687664042
"E02003602",78,458,425,735,501,169,42,2408,0.0323920265780731,0.190199335548173,0.176495016611296,0.305232558139535,0.208056478405316,0.0701827242524917,0.0174418604651163,961,0.399086378737541,1447,0.600913621262459
"E02003603",5,932,1635,1525,441,64,17,4619,0.00108248538644728,0.201775276033774,0.353972721368262,0.330158042866421,0.0954752110846504,0.0138558129465252,0.00368045031392076,2572,0.556830482788482,2047,0.443169517211518
"E02003604",13,1720,1230,881,196,24,4,4068,0.00319567354965585,0.422812192723697,0.3023598820059,0.216568338249754,0.048180924287119,0.00589970501474926,0.000983284169124877,2963,0.728367748279253,1105,0.271632251720747
"E02003605",24,1013,999,1094,345,88,19,3582,0.0067001675041876,0.282802903405918,0.278894472361809,0.305415968732552,0.0963149078726968,0.0245672808486879,0.00530429927414852,2036,0.568397543271915,1546,0.431602456728085
"E02003606",67,1353,825,905,419,116,31,3716,0.0180301399354144,0.364101184068891,0.222012917115178,0.243541442411195,0.11275565123789,0.031216361679225,0.00834230355220667,2245,0.604144241119483,1471,0.395855758880517
"E02003607",8,1263,1171,1277,431,92,29,4271,0.00187309763521424,0.295715289159447,0.274174666354484,0.298993210021072,0.100913135097167,0.0215406228049637,0.0067899789276516,2442,0.571763053149145,1829,0.428236946850855
"E02003608",20,971,1620,1619,402,49,8,4689,0.00426530177010023,0.207080400938366,0.345489443378119,0.345276178289614,0.0857325655790147,0.0104499893367456,0.00170612070804009,2611,0.556835146086586,2078,0.443164853913414
"E02003609",96,1039,1473,1429,373,67,25,4502,0.0213238560639716,0.230786317192359,0.327187916481564,0.317414482452243,0.0828520657485562,0.0148822745446468,0.00555308751665926,2608,0.579298089737894,1894,0.420701910262106
"E02003610",2,734,931,979,336,59,14,3055,0.000654664484451719,0.240261865793781,0.304746317512275,0.320458265139116,0.109983633387889,0.0193126022913257,0.00458265139116203,1667,0.545662847790507,1388,0.454337152209493
"E02003611",110,1401,1123,1276,273,42,15,4240,0.0259433962264151,0.330424528301887,0.264858490566038,0.300943396226415,0.0643867924528302,0.00990566037735849,0.0035377358490566,2634,0.62122641509434,1606,0.37877358490566
"E02003612",35,1717,1936,1003,269,42,7,5009,0.00698742263924935,0.34278299061689,0.386504292273907,0.200239568776203,0.0537033339988022,0.00838490716709922,0.00139748452784987,3688,0.736274705530046,1321,0.263725294469954
"E02003613",3,109,876,884,166,15,6,2059,0.0014570179698883,0.0529383195726081,0.425449247207382,0.429334628460418,0.0806216610004857,0.00728508984944148,0.00291403593977659,988,0.479844584749879,1071,0.520155415250121
"E02003614",2,437,986,966,212,23,5,2631,0.000760167236792094,0.166096541239073,0.374762447738502,0.367160775370582,0.080577727099962,0.00874192322310908,0.00190041809198024,1425,0.541619156214367,1206,0.458380843785633
"E02003615",26,925,919,1062,331,81,22,3366,0.0077243018419489,0.274806892453951,0.273024361259655,0.315508021390374,0.0983363042186572,0.0240641711229947,0.0065359477124183,1870,0.555555555555556,1496,0.444444444444444
"E02003616",7,128,573,590,350,109,25,1782,0.00392817059483726,0.0718294051627385,0.321548821548822,0.331088664421998,0.196408529741863,0.0611672278338945,0.0140291806958474,708,0.397306397306397,1074,0.602693602693603
"E02003617",10,211,755,976,611,203,73,2839,0.00352236703064459,0.0743219443466009,0.265938710813667,0.343783022190912,0.215216625572385,0.0715040507220852,0.0257132793237055,976,0.343783022190912,1863,0.656216977809088
"E02003618",3,158,1009,1027,351,76,19,2643,0.00113507377979569,0.0597805524025728,0.381763147937949,0.388573590616723,0.132803632236095,0.0287552024214907,0.00718880060537268,1170,0.442678774120318,1473,0.557321225879682
"E02003619",16,969,1282,1004,539,208,51,4069,0.00393217006635537,0.238142049643647,0.315065126566724,0.246743671663799,0.132464979110347,0.0511182108626198,0.0125337920865077,2267,0.557139346276726,1802,0.442860653723274
"E02003620",2,80,1033,1103,265,34,4,2521,0.000793335977786593,0.0317334391114637,0.409758032526775,0.437524791749306,0.105117017056724,0.0134867116223721,0.00158667195557319,1115,0.442284807616025,1406,0.557715192383974
"E02003621",2,62,761,985,247,23,3,2083,0.000960153624579933,0.0297647623619779,0.365338454152664,0.472875660105617,0.118578972635622,0.0110417666826692,0.0014402304368699,825,0.396063370139222,1258,0.603936629860778
"E02003622",3,221,1969,1105,243,36,7,3584,0.000837053571428571,0.0616629464285714,0.549386160714286,0.308314732142857,0.0678013392857143,0.0100446428571429,0.001953125,2193,0.611886160714286,1391,0.388113839285714
"E02003623",85,2384,1075,1050,248,44,7,4893,0.0173717555691805,0.487226650316779,0.2197016145514,0.214592274678112,0.0506846515430206,0.00899243817698753,0.00143061516452074,3544,0.72430002043736,1349,0.275699979562641
"E02003624",1,124,743,1001,419,68,11,2367,0.00042247570764681,0.0523869877482045,0.31389945078158,0.422898183354457,0.177017321504014,0.0287283481199831,0.00464723278411491,868,0.366708914237431,1499,0.633291085762569
"E02003625",0,455,1732,1694,624,85,13,4603,0,0.0988485770149902,0.376276341516402,0.368020855963502,0.135563762763415,0.0184662176841191,0.00282424505757115,2187,0.475124918531393,2416,0.524875081468608
"E02003626",2,18,716,823,221,24,0,1804,0.00110864745011086,0.00997782705099778,0.39689578713969,0.456208425720621,0.122505543237251,0.0133037694013304,0,736,0.407982261640798,1068,0.592017738359202
"E02003627",6,552,1769,1928,1024,156,31,5466,0.00109769484083425,0.100987925356751,0.323637028905964,0.352725942188072,0.187339919502378,0.0285400658616905,0.00567142334431028,2327,0.425722649103549,3139,0.574277350896451
"E02003628",0,305,814,1094,520,44,9,2786,0,0.109475951184494,0.292175161521895,0.392677674084709,0.18664752333094,0.0157932519741565,0.00323043790380474,1119,0.401651112706389,1667,0.598348887293611
"E02003629",2,235,2400,1299,342,48,14,4340,0.000460829493087558,0.054147465437788,0.552995391705069,0.299308755760369,0.0788018433179724,0.0110599078341014,0.0032258064516129,2637,0.607603686635945,1703,0.392396313364055
"E02003630",3,583,2099,1527,435,55,7,4709,0.000637077935867488,0.123805478870248,0.445742195795286,0.324272669356551,0.0923763007007857,0.0116797621575706,0.0014865151836908,2685,0.570184752601402,2024,0.429815247398598
"E02003631",3,134,789,724,194,26,0,1870,0.00160427807486631,0.0716577540106952,0.42192513368984,0.38716577540107,0.103743315508021,0.013903743315508,0,926,0.495187165775401,944,0.504812834224599
"E02003632",1,68,697,904,347,48,4,2069,0.000483325277912035,0.0328661188980184,0.336877718704688,0.436926051232479,0.167713871435476,0.0231996133397777,0.00193330111164814,766,0.370227162880619,1303,0.629772837119381
"E02003633",13,1155,1225,953,217,36,10,3609,0.00360210584649487,0.320033250207814,0.339429204765863,0.264062067054586,0.0601274591299529,0.00997506234413965,0.0027708506511499,2393,0.663064560820172,1216,0.336935439179828
"E02003635",56,2038,565,673,218,60,10,3620,0.0154696132596685,0.562983425414365,0.156077348066298,0.185911602209945,0.0602209944751381,0.0165745856353591,0.00276243093922652,2659,0.734530386740332,961,0.265469613259669
"E02003636",3,69,793,1039,296,66,14,2280,0.00131578947368421,0.0302631578947368,0.34780701754386,0.455701754385965,0.129824561403509,0.0289473684210526,0.00614035087719298,865,0.379385964912281,1415,0.620614035087719
"E02003637",30,1080,921,1500,568,161,42,4302,0.00697350069735007,0.251046025104602,0.214086471408647,0.348675034867504,0.132031613203161,0.0374244537424454,0.0097629009762901,2031,0.4721059972106,2271,0.5278940027894
"E02003638",19,834,891,1060,190,24,6,3024,0.00628306878306878,0.275793650793651,0.294642857142857,0.350529100529101,0.0628306878306878,0.00793650793650794,0.00198412698412698,1744,0.576719576719577,1280,0.423280423280423
"E02003639",5,458,2116,1655,483,71,16,4804,0.00104079933388843,0.0953372189841799,0.440466278101582,0.344504579517069,0.100541215653622,0.0147793505412157,0.00333055786844296,2579,0.53684429641965,2225,0.46315570358035
"E02003640",4,128,774,966,388,49,6,2315,0.00172786177105832,0.0552915766738661,0.334341252699784,0.417278617710583,0.167602591792657,0.0211663066954644,0.00259179265658747,906,0.391360691144708,1409,0.608639308855292
"E02003641",0,12,487,790,208,34,4,1535,0,0.00781758957654723,0.317263843648208,0.514657980456026,0.135504885993485,0.0221498371335505,0.00260586319218241,499,0.325081433224756,1036,0.674918566775244
"E02003642",4,883,1937,1519,190,19,5,4557,0.000877770463023919,0.19376782971253,0.425060346719333,0.333333333333333,0.0416940969936362,0.00416940969936362,0.0010972130787799,2824,0.619705946894887,1733,0.380294053105113
"E02003643",5,1410,2575,997,202,25,3,5217,0.000958405213724363,0.27027027027027,0.493578685068047,0.191105999616638,0.0387195706344643,0.00479202606862181,0.000575043128234618,3990,0.764807360552041,1227,0.235192639447959
"E02003644",111,2319,1522,1373,370,26,11,5732,0.0193649685973482,0.40457083042568,0.265526866713189,0.239532449406839,0.0645498953244941,0.00453593859036985,0.00191905094207955,3952,0.689462665736218,1780,0.310537334263782
"E02003645",3,61,593,896,299,24,0,1876,0.00159914712153518,0.0325159914712154,0.316098081023454,0.477611940298507,0.159381663113006,0.0127931769722814,0,657,0.350213219616205,1219,0.649786780383795
"E02003646",16,741,1585,1415,317,29,0,4103,0.00389958566902267,0.180599561296612,0.386302705337558,0.344869607604192,0.0772605410675116,0.00706799902510358,0,2342,0.570801852303193,1761,0.429198147696807
"E02003647",12,1036,1710,1573,553,88,19,4991,0.00240432779002204,0.207573632538569,0.342616710078141,0.315167301142056,0.110799438990182,0.0176317371268283,0.00380685233420156,2758,0.552594670406732,2233,0.447405329593268
"E02003648",2,240,1130,847,201,30,4,2454,0.000814995925020375,0.097799511002445,0.460472697636512,0.345150774246129,0.0819070904645477,0.0122249388753056,0.00162999185004075,1372,0.559087204563977,1082,0.440912795436023
"E02003649",1,65,842,934,245,28,5,2120,0.000471698113207547,0.0306603773584906,0.397169811320755,0.440566037735849,0.115566037735849,0.0132075471698113,0.00235849056603774,908,0.428301886792453,1212,0.571698113207547
"E02003650",6,132,618,1193,337,84,19,2389,0.00251151109250733,0.0552532440351612,0.258685642528254,0.499372122226873,0.141063206362495,0.0351611552951026,0.00795311845960653,756,0.316450397655923,1633,0.683549602344077
"E02003651",3,475,529,960,289,67,12,2335,0.0012847965738758,0.203426124197002,0.226552462526767,0.411134903640257,0.123768736616702,0.0286937901498929,0.00513918629550321,1007,0.431263383297645,1328,0.568736616702356
"E02003652",16,1239,1035,1005,395,128,36,3854,0.0041515308770109,0.321484172288531,0.268552153606642,0.260768033212247,0.102490918526207,0.0332122470160872,0.00934094447327452,2290,0.594187856772185,1564,0.405812143227815
"E02003653",3,448,1118,992,283,43,15,2902,0.00103376981392143,0.154376292212267,0.385251550654721,0.341833218470021,0.0975189524465886,0.0148173673328739,0.00516884906960717,1569,0.54066161268091,1333,0.45933838731909
"E02003654",13,142,478,701,415,152,47,1948,0.0066735112936345,0.0728952772073922,0.245379876796715,0.359856262833676,0.213039014373717,0.0780287474332649,0.0241273100616016,633,0.324948665297741,1315,0.675051334702259
"E02003655",23,648,984,1140,636,263,79,3773,0.00609594487145508,0.171746620726213,0.26080042406573,0.302146832759078,0.168566127749801,0.069705804399682,0.0209382454280413,1655,0.438642989663398,2118,0.561357010336602
"E02003656",36,587,828,948,313,78,16,2806,0.0128296507483963,0.209194583036351,0.295081967213115,0.337847469707769,0.111546685673557,0.0277975766215253,0.00570206699928724,1451,0.517106200997862,1355,0.482893799002138
"E02003657",67,558,625,836,447,152,31,2716,0.0246686303387334,0.205449189985272,0.230117820324006,0.30780559646539,0.164580265095729,0.0559646539027982,0.0114138438880707,1250,0.460235640648012,1466,0.539764359351988
"E02003658",30,2175,797,967,469,108,24,4570,0.00656455142231947,0.475929978118162,0.174398249452954,0.211597374179431,0.102625820568928,0.0236323851203501,0.00525164113785558,3002,0.656892778993435,1568,0.343107221006565
"E02003659",44,703,1157,751,756,319,80,3810,0.0115485564304462,0.184514435695538,0.303674540682415,0.197112860892388,0.198425196850394,0.0837270341207349,0.020997375328084,1904,0.499737532808399,1906,0.500262467191601
"E02003660",5,635,1023,1215,572,161,33,3644,0.00137211855104281,0.174259055982437,0.280735455543359,0.333424807903403,0.156970362239297,0.0441822173435785,0.00905598243688255,1663,0.456366630076839,1981,0.543633369923161
"E02003661",3,95,264,611,561,236,56,1826,0.00164293537787514,0.052026286966046,0.144578313253012,0.33461117196057,0.307228915662651,0.129244249726177,0.0306681270536692,362,0.198247535596933,1464,0.801752464403067
"E02003662",0,73,1166,1026,119,11,2,2397,0,0.0304547350855236,0.486441385064664,0.428035043804756,0.049645390070922,0.00458906967042136,0.000834376303712975,1239,0.516896120150188,1158,0.483103879849812
"E02003663",9,2865,1817,674,111,8,5,5489,0.00163964292220805,0.521952996902897,0.331025687739115,0.122791036618692,0.0202222627072326,0.00145746037529605,0.000910912734560029,4691,0.854618327564219,798,0.145381672435781
"E02003664",23,833,1364,858,248,35,9,3370,0.00682492581602374,0.247181008902077,0.404747774480712,0.25459940652819,0.0735905044510386,0.0103857566765579,0.00267062314540059,2220,0.658753709198813,1150,0.341246290801187
"E02003665",1,299,595,823,239,34,4,1995,0.00050125313283208,0.149874686716792,0.298245614035088,0.412531328320802,0.119799498746867,0.0170426065162907,0.00200501253132832,895,0.448621553884712,1100,0.551378446115288
"E02003666",1,869,1538,1081,459,51,15,4014,0.000249128051818635,0.216492277030394,0.38315894369706,0.269307424015944,0.114349775784753,0.0127055306427504,0.00373692077727952,2408,0.599900348779273,1606,0.400099651220727
"E02003667",6,148,2589,1033,112,12,0,3900,0.00153846153846154,0.037948717948718,0.663846153846154,0.264871794871795,0.0287179487179487,0.00307692307692308,0,2743,0.703333333333333,1157,0.296666666666667
"E02003668",3,80,686,1220,369,46,10,2414,0.00124275062137531,0.0331400165700083,0.284175642087821,0.505385252692626,0.152858326429163,0.0190555095277548,0.00414250207125104,769,0.318558409279205,1645,0.681441590720795
"E02003669",0,319,1244,819,215,19,3,2619,0,0.12180221458572,0.474990454371898,0.312714776632302,0.0820924016800305,0.00725467735777014,0.0011454753722795,1563,0.596792668957617,1056,0.403207331042383
"E02003670",0,574,1172,1239,300,24,3,3312,0,0.173309178743961,0.353864734299517,0.374094202898551,0.0905797101449275,0.0072463768115942,0.000905797101449275,1746,0.527173913043478,1566,0.472826086956522
"E02003671",2,103,1143,747,132,9,1,2137,0.000935891436593355,0.0481984089845578,0.534861956013102,0.349555451567618,0.0617688348151614,0.0042115114646701,0.000467945718296678,1248,0.583996256434254,889,0.416003743565746
"E02003672",18,2086,1197,1325,424,92,21,5163,0.00348634514816967,0.404028665504552,0.231841952353283,0.256633740073601,0.0821227968235522,0.0178190974239783,0.00406740267286461,3301,0.639356963006004,1862,0.360643036993996
"E02003673",7,1024,1054,1077,376,88,21,3647,0.00191938579654511,0.280778722237455,0.289004661365506,0.295311214697011,0.103098437071566,0.0241294214422813,0.00575815738963532,2085,0.571702769399506,1562,0.428297230600494
"E02003674",4,195,609,637,414,129,30,2018,0.00198216055500496,0.0966303270564916,0.301783944499504,0.315659068384539,0.205153617443013,0.0639246778989098,0.0148662041625372,808,0.400396432111001,1210,0.599603567888999
"E02003675",3,439,1230,1388,389,72,16,3537,0.000848176420695505,0.124116482895109,0.347752332485157,0.392422957308454,0.10998020921685,0.0203562340966921,0.00452360757704269,1672,0.472716991800961,1865,0.527283008199039
"E02003676",15,110,431,842,648,280,63,2389,0.00627877773126831,0.046044370029301,0.180410213478443,0.352448723315195,0.271243197990791,0.117203850983675,0.0263708664713269,556,0.232733361239012,1833,0.767266638760988
"E02003677",13,295,1422,1130,317,63,9,3249,0.00400123114804555,0.0907971683594952,0.437673130193906,0.347799322868575,0.0975684826100339,0.0193905817174515,0.00277008310249307,1730,0.532471529701447,1519,0.467528470298553
"E02003678",7,107,562,831,298,54,10,1869,0.00374531835205993,0.0572498662386303,0.300695559122525,0.4446227929374,0.15944355270198,0.028892455858748,0.00535045478865704,676,0.361690743713216,1193,0.638309256286784
"E02003679",11,294,1123,1192,466,108,12,3206,0.00343106674984404,0.091703056768559,0.350280723643169,0.371802869619464,0.145352464129757,0.033686837180287,0.00374298190892077,1428,0.445414847161572,1778,0.554585152838428
"E02003680",23,165,990,1479,486,100,26,3269,0.00703579076170083,0.0504741511165494,0.302844906699296,0.452431936371979,0.1486693178342,0.0305903946160905,0.00795350260018354,1178,0.360354848577547,2091,0.639645151422453
"E02003681",10,364,1293,1401,532,87,15,3702,0.00270124257158293,0.0983252296056186,0.349270664505673,0.378444084278768,0.143706104808212,0.0235008103727715,0.00405186385737439,1667,0.450297136682874,2035,0.549702863317126
"E02003682",4,196,833,1042,381,74,11,2541,0.00157418339236521,0.0771349862258953,0.327823691460055,0.410074773711137,0.149940968122786,0.0291223927587564,0.00432900432900433,1033,0.406532861078316,1508,0.593467138921684
"E02003683",10,400,932,801,272,58,10,2483,0.00402738622633911,0.161095449053564,0.375352396294805,0.322593636729762,0.109544905356424,0.0233588401127668,0.00402738622633911,1342,0.540475231574708,1141,0.459524768425292
"E02003685",1,122,802,1125,438,99,15,2602,0.000384319754035357,0.0468870099923136,0.308224442736357,0.432359723289777,0.168332052267487,0.0380476556495004,0.00576479631053036,925,0.355495772482706,1677,0.644504227517294
"E02003686",19,461,568,979,424,81,14,2546,0.00746268656716418,0.181068342498036,0.223095051060487,0.384524744697565,0.166535742340927,0.0318146111547526,0.00549882168106834,1048,0.411626080125687,1498,0.588373919874313
"E02003687",1,100,575,784,309,71,7,1847,0.000541418516513265,0.0541418516513265,0.311315646995127,0.4244721169464,0.167298321602599,0.0384407146724418,0.00378992961559285,676,0.365998917162967,1171,0.634001082837033
"E02003688",34,725,1768,1809,586,100,14,5036,0.00675138999205719,0.143963463065925,0.351072279586974,0.359213661636219,0.116362192216044,0.0198570293884035,0.00277998411437649,2527,0.501787132644956,2509,0.498212867355044
"E02003689",14,600,973,1115,489,117,12,3320,0.00421686746987952,0.180722891566265,0.293072289156627,0.335843373493976,0.147289156626506,0.0352409638554217,0.0036144578313253,1587,0.478012048192771,1733,0.521987951807229
"E02003690",5,593,1151,1081,353,64,14,3261,0.00153327200245324,0.181846059490954,0.352959214964735,0.331493406930389,0.108249003373198,0.0196258816314014,0.00429316160686906,1749,0.536338546458142,1512,0.463661453541858
"E02003691",8,225,886,994,358,122,32,2625,0.00304761904761905,0.0857142857142857,0.33752380952381,0.378666666666667,0.136380952380952,0.0464761904761905,0.0121904761904762,1119,0.426285714285714,1506,0.573714285714286
"E02003692",2,186,814,1160,431,94,21,2708,0.000738552437223043,0.068685376661743,0.300590841949778,0.428360413589365,0.159158050221566,0.034711964549483,0.00775480059084195,1002,0.370014771048744,1706,0.629985228951256
"E02003693",6,671,553,775,458,155,45,2663,0.00225309800976342,0.251971460758543,0.207660533233196,0.291025159594442,0.171986481411941,0.0582050319188885,0.0168982350732257,1230,0.461885092001502,1433,0.538114907998498
"E02003694",3,245,1214,1379,383,69,11,3304,0.000907990314769976,0.0741525423728814,0.367433414043584,0.417372881355932,0.1159200968523,0.0208837772397094,0.00332929782082324,1462,0.442493946731235,1842,0.557506053268765
"E02003695",3,265,1243,1516,513,115,23,3678,0.000815660685154976,0.0720500271886895,0.337955410549212,0.412180532898314,0.139477977161501,0.0312669929309407,0.00625339858618815,1511,0.410821098423056,2167,0.589178901576944
"E02003696",16,476,1355,1374,480,57,5,3763,0.00425192665426521,0.12649481796439,0.360085038533085,0.365134201435025,0.127557799627956,0.0151474887058198,0.00132872707945788,1847,0.490831783151741,1916,0.509168216848259
"E02003697",25,412,517,789,368,134,36,2281,0.0109601052170101,0.180622533976326,0.226654975887769,0.345900920648838,0.161332748794388,0.058746163963174,0.0157825515124945,954,0.418237615081105,1327,0.581762384918895
"E02003698",7,178,850,1089,408,73,16,2621,0.00267073636016788,0.0679130103014117,0.324303700877528,0.415490270888974,0.155665776421213,0.0278519648988936,0.00610454025181229,1035,0.394887447539107,1586,0.605112552460893
"E02003699",6,253,648,792,403,121,32,2255,0.00266075388026608,0.11219512195122,0.287361419068736,0.351219512195122,0.178713968957871,0.0536585365853659,0.0141906873614191,907,0.402217294900222,1348,0.597782705099778
"E02003701",4,536,1597,1558,417,53,7,4172,0.000958772770853308,0.128475551294343,0.382790028763183,0.373441994247363,0.0999520613614573,0.0127037392138063,0.00167785234899329,2137,0.51222435282838,2035,0.48777564717162
"E02003702",4,172,488,995,871,340,94,2964,0.00134952766531714,0.058029689608637,0.164642375168691,0.335695006747638,0.293859649122807,0.114709851551957,0.0317139001349528,664,0.224021592442645,2300,0.775978407557355
"E02003703",8,486,1061,1342,507,77,14,3495,0.00228898426323319,0.139055793991416,0.303576537911302,0.383977110157368,0.145064377682403,0.0220314735336195,0.00400572246065808,1555,0.444921316165951,1940,0.555078683834049
"E02003704",2,88,539,876,281,38,6,1830,0.00109289617486339,0.0480874316939891,0.294535519125683,0.478688524590164,0.153551912568306,0.0207650273224044,0.00327868852459016,629,0.343715846994536,1201,0.656284153005464
"E02003705",4,97,933,1199,444,36,9,2722,0.0014695077149155,0.035635562086701,0.342762674504041,0.440484937545922,0.163115356355621,0.0132255694342395,0.00330639235855988,1034,0.379867744305658,1688,0.620132255694342
"E02003706",0,386,1326,1067,225,32,3,3039,0,0.127015465613689,0.436327739387957,0.351102336294834,0.0740375123395854,0.010529779532741,0.000987166831194472,1712,0.563343205001645,1327,0.436656794998355
"E02003707",25,370,856,969,402,55,11,2688,0.00930059523809524,0.13764880952381,0.318452380952381,0.360491071428571,0.149553571428571,0.0204613095238095,0.0040922619047619,1251,0.465401785714286,1437,0.534598214285714
"E02003708",3,314,1608,1440,503,60,13,3941,0.000761228114691703,0.0796752093377315,0.408018269474753,0.365389495052017,0.127632580563309,0.0152245622938341,0.00329865516366404,1925,0.488454706927176,2016,0.511545293072824
"E02003709",15,179,1073,1048,259,37,2,2613,0.00574052812858783,0.0685036356678148,0.410639112131649,0.40107156525067,0.0991197856869499,0.01415996938385,0.000765403750478377,1267,0.484883275928052,1346,0.515116724071948
"E02003710",55,1034,1792,1621,569,82,24,5177,0.0106239134633958,0.199729573111841,0.346146416843732,0.31311570407572,0.109909213830404,0.0158392891636083,0.00463588951129998,2881,0.556499903418968,2296,0.443500096581032
"E02003711",21,1242,2131,1325,415,52,18,5204,0.00403535741737125,0.238662567255957,0.409492697924673,0.254611837048424,0.0797463489623367,0.00999231360491929,0.00345887778631822,3394,0.652190622598002,1810,0.347809377401998
"E02003712",16,180,1526,1134,370,59,13,3298,0.00485142510612492,0.0545785324439054,0.462704669496665,0.343844754396604,0.112189205579139,0.0178896300788357,0.0039417828987265,1722,0.522134627046695,1576,0.477865372953305
"E02003713",1,71,574,879,292,41,9,1867,0.000535618639528656,0.0380289234065345,0.307445099089448,0.470808784145688,0.156400642742367,0.0219603642206749,0.0048205677557579,646,0.346009641135512,1221,0.653990358864489
"E02003714",2,164,1127,1127,368,49,9,2846,0.000702740688685875,0.0576247364722417,0.395994378074491,0.395994378074491,0.129304286718201,0.0172171468728039,0.00316233309908644,1293,0.454321855235418,1553,0.545678144764582
"E02003715",4,104,512,943,383,94,18,2058,0.00194363459669582,0.0505344995140913,0.248785228377065,0.45821185617104,0.186103012633625,0.0456754130223518,0.0087463556851312,620,0.301263362487852,1438,0.698736637512148
"E02003716",1,151,864,935,397,58,8,2414,0.000414250207125104,0.0625517812758906,0.357912178956089,0.387323943661972,0.164457332228666,0.024026512013256,0.00331400165700083,1016,0.420878210439105,1398,0.579121789560895
"E02003717",8,291,1368,1503,509,87,20,3786,0.00211304807184363,0.0768621236133122,0.361331220285261,0.396988906497623,0.134442683571051,0.0229793977812995,0.00528262017960909,1667,0.440306391970417,2119,0.559693608029583
"E02003718",0,145,1029,918,291,43,7,2433,0,0.0595972050965886,0.422934648581998,0.37731196054254,0.11960542540074,0.0176736539251952,0.00287710645293876,1174,0.482531853678586,1259,0.517468146321414
"E02003719",9,413,1800,1103,223,13,3,3564,0.00252525252525253,0.115881032547699,0.505050505050505,0.309483726150393,0.0625701459034792,0.00364758698092031,0.000841750841750842,2222,0.623456790123457,1342,0.376543209876543
"E02003720",46,435,1446,1330,415,51,15,3738,0.0123060460139112,0.116372391653291,0.386837881219904,0.355805243445693,0.111021936864633,0.0136436597110754,0.00401284109149278,1927,0.515516318887105,1811,0.484483681112895
"E02003721",22,567,1775,1212,291,28,9,3904,0.00563524590163934,0.145235655737705,0.454661885245902,0.310450819672131,0.0745389344262295,0.00717213114754098,0.00230532786885246,2364,0.605532786885246,1540,0.394467213114754
"E02003722",5,459,1290,1342,555,82,17,3750,0.00133333333333333,0.1224,0.344,0.357866666666667,0.148,0.0218666666666667,0.00453333333333333,1754,0.467733333333333,1996,0.532266666666667
"E02003723",398,1230,813,803,281,49,5,3579,0.111204246996368,0.343671416596815,0.227158424140821,0.224364347583124,0.0785135512713048,0.0136909751327186,0.00139703827884884,2441,0.682034087734004,1138,0.317965912265996
"E02003724",13,462,1678,1280,333,35,6,3807,0.00341476228001051,0.121355397951143,0.440767008142895,0.336222747570265,0.0874704491725768,0.00919359075387444,0.00157604412923562,2153,0.565537168374048,1654,0.434462831625952
"E02003725",18,441,1591,1381,464,83,18,3996,0.0045045045045045,0.11036036036036,0.398148148148148,0.345595595595596,0.116116116116116,0.0207707707707708,0.0045045045045045,2050,0.513013013013013,1946,0.486986986986987
"E02003726",2,526,1306,1329,508,73,25,3769,0.000530644733351021,0.139559564871319,0.346511010878217,0.352613425311754,0.134783762271159,0.0193685327673123,0.00663305916688777,1834,0.486601220482887,1935,0.513398779517113
"E02003727",17,773,1223,1841,615,65,20,4556,0.00373134328358209,0.169666374012291,0.268437225636523,0.404082528533802,0.134986830553117,0.0142669007901668,0.00438981562774363,2013,0.441834942932397,2541,0.557726075504829
"E02003728",2,646,1598,1187,418,35,10,3896,0.000513347022587269,0.165811088295688,0.410164271047228,0.304671457905544,0.107289527720739,0.00898357289527721,0.00256673511293634,2246,0.576488706365503,1650,0.423511293634497
"E02003729",11,435,1349,1276,265,19,3,3358,0.00327575938058368,0.129541393686718,0.40172721858249,0.379988088147707,0.0789160214413341,0.00565812983918999,0.000893388921977367,1795,0.534544371649792,1563,0.465455628350208
"E02003731",18,591,945,955,381,69,13,2972,0.00605652759084791,0.19885598923284,0.317967698519515,0.321332436069987,0.128196500672948,0.0232166890982503,0.00437415881561238,1554,0.522880215343203,1418,0.477119784656797
"E02003732",18,990,1295,1196,421,91,24,4035,0.00446096654275093,0.245353159851301,0.32094175960347,0.29640644361834,0.104337050805452,0.0225526641883519,0.00594795539033457,2303,0.570755885997522,1732,0.429244114002478
"E02003733",26,336,912,985,433,134,31,2857,0.00910045502275114,0.117605880294015,0.31921596079804,0.344767238361918,0.151557577878894,0.0469023451172559,0.0108505425271264,1274,0.445922296114806,1583,0.554077703885194
"E02003734",50,930,2295,1445,396,62,14,5192,0.00963020030816641,0.179121725731895,0.442026194144838,0.278312788906009,0.076271186440678,0.0119414483821263,0.00269645608628659,3275,0.6307781201849,1917,0.3692218798151
"E02003735",16,226,1622,1100,425,94,22,3505,0.00456490727532097,0.0644793152639087,0.462767475035663,0.313837375178317,0.121255349500713,0.0268188302425107,0.00627674750356633,1864,0.531811697574893,1641,0.468188302425107
"E02003736",143,756,744,1283,705,214,34,3879,0.0368651714359371,0.194895591647332,0.191802010827533,0.330755349316834,0.181747873163186,0.0551688579530807,0.00876514565609693,1643,0.423562773910802,2236,0.576437226089198
"E02003737",44,1102,1768,1585,569,102,26,5196,0.00846805234795997,0.212086220169361,0.340261739799846,0.30504234026174,0.109507313317937,0.0196304849884527,0.00500384911470362,2914,0.560816012317167,2282,0.439183987682833
"E02003738",62,706,577,838,405,121,21,2730,0.0227106227106227,0.258608058608059,0.211355311355311,0.306959706959707,0.148351648351648,0.0443223443223443,0.00769230769230769,1345,0.492673992673993,1385,0.507326007326007
"E02003739",10,241,727,887,247,39,5,2156,0.00463821892393321,0.11178107606679,0.337198515769944,0.411410018552876,0.11456400742115,0.0180890538033395,0.0023191094619666,978,0.453617810760668,1178,0.546382189239332
"E02003740",54,216,488,785,392,119,36,2090,0.0258373205741627,0.103349282296651,0.233492822966507,0.375598086124402,0.18755980861244,0.0569377990430622,0.0172248803827751,758,0.362679425837321,1332,0.637320574162679
"E02003742",37,315,600,962,478,165,59,2616,0.0141437308868502,0.120412844036697,0.229357798165138,0.367737003058104,0.182721712538226,0.0630733944954128,0.0225535168195719,952,0.363914373088685,1664,0.636085626911315
"E02003743",12,361,1729,1519,467,82,20,4190,0.00286396181384248,0.0861575178997613,0.412649164677804,0.362529832935561,0.11145584725537,0.0195704057279236,0.00477326968973747,2102,0.501670644391408,2088,0.498329355608592
"E02003744",8,572,2162,2014,820,169,49,5794,0.00138073869520193,0.0987228167069382,0.373144632378322,0.347600966517087,0.141525716258198,0.0291681049361408,0.00845702450811184,2742,0.473248187780463,3052,0.526751812219537
"E02003745",64,468,1057,1418,657,245,93,4002,0.015992003998001,0.116941529235382,0.264117941029485,0.35432283858071,0.164167916041979,0.0612193903048476,0.0232383808095952,1589,0.397051474262869,2413,0.602948525737131
"E02003746",17,246,933,1016,497,121,23,2853,0.00595864002804066,0.0862250262881178,0.327024185068349,0.356116368734665,0.174202593760953,0.0424114966701718,0.00806168944970207,1196,0.419207851384508,1657,0.580792148615492
"E02003747",111,1322,1567,1717,566,95,10,5388,0.0206013363028953,0.24536005939124,0.29083147735709,0.318671121009651,0.105048255382331,0.0176317743132888,0.00185597624350408,3000,0.556792873051225,2388,0.443207126948775
"E02003748",9,240,1304,1245,353,69,20,3240,0.00277777777777778,0.0740740740740741,0.402469135802469,0.384259259259259,0.108950617283951,0.0212962962962963,0.00617283950617284,1553,0.479320987654321,1687,0.520679012345679
"E02003749",18,262,691,938,306,105,29,2349,0.00766283524904215,0.111536824180502,0.29416773094934,0.399318859088974,0.130268199233716,0.0446998722860792,0.0123456790123457,971,0.413367390378885,1378,0.586632609621115
"E02003750",13,388,1103,1050,254,48,13,2869,0.00453119553851516,0.135238759149529,0.384454513767863,0.36598117811084,0.088532589752527,0.0167305681422098,0.00453119553851516,1504,0.524224468455908,1365,0.475775531544092
"E02003751",40,462,887,892,443,155,42,2921,0.0136939404313591,0.158165011982198,0.303663129065389,0.305374871619308,0.151660390277302,0.0530640191715166,0.0143786374529271,1389,0.475522081478946,1532,0.524477918521054
"E02003752",11,631,1717,1600,526,109,36,4630,0.00237580993520518,0.136285097192225,0.370842332613391,0.345572354211663,0.113606911447084,0.0235421166306695,0.00777537796976242,2359,0.509503239740821,2271,0.490496760259179
"E02003753",10,337,1600,1534,368,73,18,3940,0.00253807106598985,0.0855329949238579,0.406091370558376,0.389340101522843,0.0934010152284264,0.0185279187817259,0.00456852791878173,1947,0.494162436548223,1993,0.505837563451777
"E02003754",1,176,462,817,418,129,30,2033,0.000491883915395967,0.0865715691096901,0.227250368912937,0.401869158878505,0.205607476635514,0.0634530250860797,0.014756517461879,639,0.314313821938023,1394,0.685686178061977
"E02003755",17,706,1173,1348,506,113,27,3890,0.00437017994858612,0.181491002570694,0.301542416452442,0.346529562982005,0.130077120822622,0.0290488431876607,0.00694087403598972,1896,0.487403598971722,1994,0.512596401028278
"E02003756",10,601,654,1002,326,92,18,2703,0.00369959304476508,0.222345541990381,0.241953385127636,0.370699223085461,0.120606733259341,0.0340362560118387,0.00665926748057714,1265,0.467998520162782,1438,0.532001479837218
"E02003757",3,611,716,944,324,63,13,2674,0.00112191473448018,0.228496634255797,0.267763649962603,0.353029169783097,0.121166791323859,0.0235602094240838,0.00486163051608078,1330,0.49738219895288,1344,0.50261780104712
"E02003758",11,222,1019,1641,472,118,37,3520,0.003125,0.0630681818181818,0.289488636363636,0.466193181818182,0.134090909090909,0.0335227272727273,0.0105113636363636,1252,0.355681818181818,2268,0.644318181818182
"E02003759",7,235,499,867,224,36,7,1875,0.00373333333333333,0.125333333333333,0.266133333333333,0.4624,0.119466666666667,0.0192,0.00373333333333333,741,0.3952,1134,0.6048
"E02003760",5,394,1698,1002,136,24,6,3265,0.00153139356814701,0.120673813169985,0.520061255742726,0.306891271056662,0.0416539050535988,0.00735068912710567,0.00183767228177642,2097,0.642266462480858,1168,0.357733537519142
"E02003761",16,100,671,927,255,29,5,2018,0.00792864222001982,0.0495540138751239,0.332507433102081,0.459365708622398,0.126362735381566,0.0143706640237859,0.00247770069375619,787,0.389990089197225,1216,0.602576808721506
"E02003762",64,2014,1069,1355,308,68,16,4894,0.0130772374335922,0.411524315488353,0.218430731507969,0.276869636289334,0.0629342051491622,0.0138945647731917,0.00326930935839804,3147,0.643032284429914,1747,0.356967715570086
"E02003763",6,124,1515,1376,315,43,2,3381,0.00177462289263532,0.0366755397811298,0.448092280390417,0.406980183377699,0.093167701863354,0.0127181307305531,0.000591540964211772,1645,0.486542443064182,1736,0.513457556935818
"E02003764",15,698,1895,1576,456,59,19,4718,0.00317931326833404,0.147944044086477,0.401653242899534,0.334039847392963,0.0966511233573548,0.0125052988554472,0.00402713013988978,2608,0.552776600254345,2110,0.447223399745655
"E02003765",5,481,1204,1119,324,50,20,3203,0.00156103652825476,0.150171714018108,0.375897596003747,0.349359975023416,0.101155167030909,0.0156103652825476,0.00624414611301904,1690,0.527630346550109,1513,0.472369653449891
"E02003766",108,1119,954,931,301,33,7,3453,0.0312771503040834,0.324066029539531,0.276281494352737,0.269620619750941,0.0871705763104547,0.00955690703735882,0.00202722270489429,2181,0.631624674196351,1272,0.368375325803649
"E02003767",11,194,280,827,632,235,93,2272,0.00484154929577465,0.085387323943662,0.123239436619718,0.363996478873239,0.278169014084507,0.103433098591549,0.0409330985915493,485,0.213468309859155,1787,0.786531690140845
"E02003768",10,479,1094,1321,407,75,21,3407,0.00293513354857646,0.140592896976812,0.321103610214265,0.38773114176695,0.119459935427062,0.0220135016143235,0.00616378045201057,1583,0.464631640739654,1824,0.535368359260346
"E02003769",7,261,554,961,422,97,20,2322,0.00301464254952627,0.112403100775194,0.238587424633936,0.413867355727821,0.181739879414298,0.0417743324720069,0.00861326442721792,822,0.354005167958656,1500,0.645994832041344
"E02003770",24,2491,1706,775,307,89,25,5417,0.00443049658482555,0.459848624700018,0.314934465571349,0.143068118884992,0.0566734354808935,0.0164297581687281,0.00461510060919328,4221,0.779213586856193,1196,0.220786413143807
"E02003771",1,256,1174,1033,291,38,14,2807,0.000356252226576416,0.0912005700035625,0.418240114000712,0.368008550053438,0.103669397933737,0.0135375846099038,0.00498753117206983,1431,0.509796936230851,1376,0.490203063769149
"E02003772",0,115,976,976,206,29,4,2306,0,0.0498699045967042,0.423243712055507,0.423243712055507,0.0893321769297485,0.0125758889852559,0.00173460537727667,1091,0.473113616652212,1215,0.526886383347788
"E02003773",28,327,2202,1364,210,36,7,4174,0.00670819357930043,0.0783421178725443,0.527551509343555,0.326784858648778,0.0503114518447532,0.00862482031624341,0.00167704839482511,2557,0.6126018207954,1617,0.3873981792046
"E02003774",2,128,1047,754,131,18,6,2086,0.000958772770853308,0.0613614573346117,0.501917545541707,0.361457334611697,0.0627996164908917,0.00862895493767977,0.00287631831255992,1177,0.564237775647172,909,0.435762224352828
"E02003775",55,519,925,812,222,47,9,2589,0.0212437234453457,0.200463499420626,0.357280803398996,0.31363460795674,0.085747392815759,0.0181537273078409,0.00347624565469293,1499,0.578988026264967,1090,0.421011973735033
"E02003776",32,584,749,895,231,56,8,2555,0.0125244618395303,0.228571428571429,0.293150684931507,0.350293542074364,0.0904109589041096,0.0219178082191781,0.00313111545988258,1365,0.534246575342466,1190,0.465753424657534
"E02003777",250,1843,1120,821,193,32,7,4266,0.0586029067041725,0.43202062822316,0.262541022034693,0.192451945616503,0.0452414439756212,0.00750117205813408,0.00164088138771683,3213,0.753164556962025,1053,0.246835443037975
"E02003778",44,579,1046,689,222,41,6,2627,0.0167491435097069,0.220403502093643,0.398172820708032,0.26227636086791,0.0845070422535211,0.0156071564522269,0.00228397411496003,1669,0.635325466311382,958,0.364674533688618
"E02003780",93,1034,1530,1064,292,50,12,4075,0.0228220858895706,0.253742331288344,0.375460122699387,0.261104294478528,0.0716564417177914,0.0122699386503067,0.00294478527607362,2657,0.652024539877301,1418,0.347975460122699
"E02003781",93,678,687,935,239,59,14,2705,0.0343807763401109,0.250646950092421,0.253974121996303,0.345656192236599,0.0883548983364141,0.02181146025878,0.00517560073937153,1458,0.539001848428835,1247,0.460998151571164
"E02003784",57,691,875,1000,378,117,20,3138,0.0181644359464627,0.220203951561504,0.278840025493945,0.318674314850223,0.120458891013384,0.0372848948374761,0.00637348629700446,1623,0.517208413001912,1515,0.482791586998088
"E02003785",45,495,1176,1326,354,60,14,3470,0.0129682997118156,0.142651296829971,0.338904899135447,0.382132564841499,0.102017291066282,0.0172910662824208,0.00403458213256484,1716,0.494524495677233,1754,0.505475504322767
"E02003786",38,346,804,814,331,60,8,2401,0.0158267388588088,0.144106622240733,0.334860474802166,0.3390254060808,0.137859225322782,0.0249895876718034,0.00333194502290712,1188,0.494793835901708,1213,0.505206164098292
"E02003787",64,521,567,939,482,186,28,2787,0.0229637603157517,0.186939361320416,0.203444564047363,0.33692142088267,0.172945819878005,0.0667384284176534,0.0100466451381414,1152,0.413347685683531,1635,0.586652314316469
"E02003788",110,1138,593,797,315,70,13,3036,0.036231884057971,0.374835309617918,0.19532279314888,0.262516469038208,0.103754940711462,0.0230566534914361,0.00428194993412385,1841,0.606389986824769,1195,0.393610013175231
"E02003789",36,221,962,1022,232,27,8,2508,0.0143540669856459,0.0881180223285487,0.383572567783094,0.407496012759171,0.0925039872408294,0.0107655502392345,0.00318979266347687,1219,0.486044657097289,1289,0.513955342902711
"E02003790",42,435,630,1163,634,193,43,3140,0.0133757961783439,0.138535031847134,0.200636942675159,0.370382165605096,0.201910828025478,0.0614649681528662,0.0136942675159236,1107,0.352547770700637,2033,0.647452229299363
"E02003791",37,552,605,1075,567,144,38,3018,0.012259774685222,0.182902584493042,0.200463883366468,0.356196156394964,0.187872763419483,0.047713717693837,0.0125911199469848,1194,0.395626242544732,1824,0.604373757455268
"E02003792",73,719,937,1158,427,119,29,3462,0.0210860774119006,0.207683419988446,0.270652801848642,0.334488734835355,0.123339110340843,0.0343731946851531,0.00837666088965916,1729,0.499422299248989,1733,0.500577700751011
"E02003793",31,302,326,966,680,227,34,2566,0.0120810600155885,0.117692907248636,0.127045985970382,0.376461418550273,0.265003897116134,0.08846453624318,0.0132501948558067,659,0.256819953234606,1907,0.743180046765394
"E02003794",2,117,782,1038,366,95,38,2438,0.000820344544708778,0.0479901558654635,0.320754716981132,0.425758818703856,0.150123051681706,0.0389663658736669,0.0155865463494668,901,0.369565217391304,1537,0.630434782608696
"E02003795",5,164,625,708,252,110,28,1892,0.00264270613107822,0.0866807610993657,0.330338266384778,0.374207188160677,0.133192389006343,0.0581395348837209,0.0147991543340381,794,0.419661733615222,1098,0.580338266384778
"E02003796",15,236,1114,1026,236,40,4,2671,0.00561587420441782,0.0883564208161737,0.41707225758143,0.384125795582179,0.0883564208161737,0.0149756645451142,0.00149756645451142,1365,0.511044552602022,1306,0.488955447397978
"E02003797",3,360,1121,1365,467,56,14,3386,0.000886001181334908,0.106320141760189,0.331069108092144,0.403130537507383,0.137920850561134,0.0165386887182516,0.00413467217956291,1484,0.438275251033668,1902,0.561724748966332
"E02003798",1,159,1004,769,137,20,4,2094,0.000477554918815664,0.0759312320916905,0.479465138490926,0.367239732569245,0.0654250238777459,0.00955109837631328,0.00191021967526266,1164,0.555873925501433,930,0.444126074498567
"E02003799",5,326,1284,724,202,81,10,2632,0.00189969604863222,0.123860182370821,0.487841945288754,0.275075987841945,0.0767477203647416,0.0307750759878419,0.00379939209726444,1615,0.613601823708207,1017,0.386398176291793
"E02003800",16,444,488,854,306,75,18,2201,0.0072694229895502,0.201726487960018,0.221717401181281,0.388005452067242,0.139027714675148,0.0340754202635166,0.00817810086324398,948,0.43071331213085,1253,0.56928668786915
"E02003801",6,107,665,1015,277,31,6,2107,0.00284765068818225,0.0507831039392501,0.315614617940199,0.481727574750831,0.131466540104414,0.0147128618889416,0.00284765068818225,778,0.369245372567632,1329,0.630754627432368
"E02003802",2,1151,2322,1556,491,65,21,5608,0.000356633380884451,0.205242510699001,0.414051355206847,0.277460770328103,0.0875534950071327,0.0115905848787447,0.00374465049928673,3475,0.619650499286733,2133,0.380349500713267
"E02003803",3,668,2037,1882,644,114,34,5382,0.000557413600891862,0.124117428465255,0.378483835005574,0.349684132292828,0.11965811965812,0.0211817168338907,0.0063173541434411,2708,0.503158677071721,2674,0.496841322928279
"E02003804",1,109,1063,1483,439,50,17,3162,0.000316255534471853,0.034471853257432,0.33617963314358,0.469006957621758,0.138836179633144,0.0158127767235927,0.00537634408602151,1173,0.370967741935484,1989,0.629032258064516
"E02003805",4,153,546,799,236,62,10,1810,0.00220994475138122,0.0845303867403315,0.301657458563536,0.441436464088398,0.130386740331492,0.0342541436464088,0.00552486187845304,703,0.388397790055249,1107,0.611602209944751
"E02003806",34,1075,751,823,217,61,8,2969,0.0114516672280229,0.362074772650724,0.252947120242506,0.277197709666554,0.0730885820141462,0.0205456382620411,0.00269450993600539,1860,0.626473560121253,1109,0.373526439878747
"E02003807",9,143,977,1467,540,84,15,3235,0.00278207109737249,0.0442040185471406,0.302009273570325,0.453477588871716,0.166924265842349,0.0259659969088099,0.00463678516228748,1129,0.348995363214838,2106,0.651004636785162
"E02003808",1,62,944,1005,228,30,10,2280,0.00043859649122807,0.0271929824561404,0.414035087719298,0.440789473684211,0.1,0.0131578947368421,0.0043859649122807,1007,0.441666666666667,1273,0.558333333333333
"E02003809",88,1095,734,917,612,249,97,3792,0.0232067510548523,0.28876582278481,0.193565400843882,0.241824894514768,0.161392405063291,0.0656645569620253,0.0255801687763713,1917,0.505537974683544,1875,0.494462025316456
"E02003810",16,743,694,1022,585,284,95,3439,0.00465251526606572,0.216051177667927,0.2018028496656,0.297179412619948,0.170107589415528,0.0825821459726665,0.0276243093922652,1453,0.422506542599593,1986,0.577493457400407
"E02003811",91,1126,404,628,392,169,49,2859,0.0318293109478839,0.393844001399091,0.141308149702693,0.219657222805177,0.137110877929346,0.0591115774746415,0.0171388597411682,1621,0.566981462049668,1238,0.433018537950332
"E02003812",7,548,646,951,233,34,3,2422,0.00289017341040462,0.226259289843105,0.26672171758877,0.392650701899257,0.0962014863748968,0.014037985136251,0.00123864574731627,1201,0.495871180842279,1221,0.504128819157721
"E02003813",1,211,617,981,277,60,29,2176,0.000459558823529412,0.0969669117647059,0.283547794117647,0.450827205882353,0.127297794117647,0.0275735294117647,0.0133272058823529,829,0.380974264705882,1347,0.619025735294118
"E02003814",21,568,884,1216,233,34,9,2965,0.00708263069139966,0.191568296795953,0.29814502529511,0.410118043844857,0.0785834738617201,0.0114671163575042,0.003035413153457,1473,0.496795952782462,1492,0.503204047217538
"E02003815",1,592,1043,1348,245,45,6,3280,0.000304878048780488,0.180487804878049,0.317987804878049,0.410975609756098,0.0746951219512195,0.013719512195122,0.00182926829268293,1636,0.498780487804878,1644,0.501219512195122
"E02003816",17,922,1025,1332,366,72,18,3752,0.00453091684434968,0.245735607675906,0.27318763326226,0.35501066098081,0.0975479744136461,0.0191897654584222,0.00479744136460554,1964,0.523454157782516,1788,0.476545842217484
"E02003817",1,719,702,1121,186,29,12,2770,0.00036101083032491,0.25956678700361,0.253429602888087,0.404693140794224,0.0671480144404332,0.0104693140794224,0.00433212996389892,1422,0.513357400722022,1348,0.486642599277978
"E02003818",5,72,461,885,211,46,16,1696,0.00294811320754717,0.0424528301886792,0.271816037735849,0.521816037735849,0.124410377358491,0.027122641509434,0.00943396226415094,538,0.317216981132075,1158,0.682783018867925
"E02003819",1,622,500,1056,287,50,11,2527,0.000395726157499011,0.246141669964385,0.197863078749505,0.417886822318955,0.113573407202216,0.0197863078749505,0.00435298773248912,1123,0.444400474871389,1404,0.555599525128611
"E02003820",3,1212,1165,1030,263,42,18,3733,0.000803643182427002,0.324671845700509,0.312081435842486,0.275917492633271,0.0704527189927672,0.011251004553978,0.00482185909456201,2380,0.637556924725422,1353,0.362443075274578
"E02003821",2,381,788,994,240,52,8,2465,0.000811359026369168,0.154563894523327,0.319675456389452,0.403245436105477,0.0973630831643002,0.0210953346855984,0.00324543610547667,1171,0.475050709939148,1294,0.524949290060852
"E02003822",11,971,774,1472,658,208,71,4165,0.00264105642256903,0.233133253301321,0.185834333733493,0.353421368547419,0.157983193277311,0.0499399759903962,0.017046818727491,1756,0.421608643457383,2409,0.578391356542617
"E02003823",9,434,467,1287,351,60,9,2617,0.00343905235001911,0.165838746656477,0.178448605273214,0.491784486052732,0.134123041650745,0.022927015666794,0.00343905235001911,910,0.34772640427971,1707,0.65227359572029
"E02003824",11,872,485,928,219,37,7,2559,0.00429855412270418,0.340758108636186,0.189527159046503,0.362641656897225,0.0855803048065651,0.0144587729581868,0.00273544353262993,1368,0.534583821805393,1191,0.465416178194607
"E02003825",10,113,587,1051,138,24,4,1927,0.00518941359626362,0.0586403736377789,0.304618578100675,0.545407368967307,0.071613907628438,0.0124545926310327,0.00207576543850545,710,0.368448365334717,1217,0.631551634665283
"E02003826",61,1024,677,1331,432,66,24,3615,0.0168741355463347,0.283264177040111,0.187275242047026,0.368188105117566,0.119502074688797,0.0182572614107884,0.00663900414937759,1762,0.487413554633472,1853,0.512586445366528
"E02003827",1,879,1524,1704,540,99,41,4788,0.000208855472013367,0.183583959899749,0.318295739348371,0.355889724310777,0.112781954887218,0.0206766917293233,0.00856307435254804,2404,0.502088554720134,2384,0.497911445279866
"E02003828",0,50,988,1094,291,35,12,2470,0,0.0202429149797571,0.4,0.442914979757085,0.117813765182186,0.01417004048583,0.0048582995951417,1038,0.420242914979757,1432,0.579757085020243
"E02003829",34,448,518,936,239,32,6,2213,0.0153637596023498,0.202440126525079,0.234071396294623,0.42295526434704,0.10799819249887,0.0144600090375056,0.00271125169453231,1000,0.451875282422052,1213,0.548124717577949
"E02003830",1,461,1143,1450,485,76,26,3642,0.000274574409665019,0.126578802855574,0.313838550247117,0.398132894014278,0.133168588687534,0.0208676551345415,0.0071389346512905,1605,0.440691927512356,2037,0.559308072487644
"E02003831",19,1005,846,1178,416,116,38,3618,0.00525152017689331,0.277777777777778,0.233830845771144,0.325594250967385,0.114980652294085,0.0320619126589276,0.0105030403537866,1870,0.516860143725815,1748,0.483139856274185
"E02003832",1,70,645,1347,464,59,18,2604,0.000384024577572965,0.0268817204301075,0.247695852534562,0.517281105990783,0.178187403993856,0.0226574500768049,0.00691244239631336,716,0.274961597542243,1888,0.725038402457757
"E02003833",0,222,611,1006,169,39,13,2060,0,0.107766990291262,0.296601941747573,0.488349514563107,0.0820388349514563,0.0189320388349515,0.00631067961165049,833,0.404368932038835,1227,0.595631067961165
"E02003834",1,75,1049,1128,358,53,12,2676,0.000373692077727952,0.0280269058295964,0.392002989536622,0.42152466367713,0.133781763826607,0.0198056801195815,0.00448430493273543,1125,0.420403587443946,1551,0.579596412556054
"E02003835",3,591,561,1110,345,49,12,2671,0.00112317484088356,0.221265443654062,0.210033695245226,0.415574691126919,0.12916510670161,0.0183451890677649,0.00449269936353426,1155,0.432422313740172,1516,0.567577686259828
"E02003836",1,282,1153,1232,342,49,15,3074,0.000325309043591412,0.0917371502927781,0.375081327260898,0.400780741704619,0.111255692908263,0.0159401431359792,0.00487963565387118,1436,0.467143786597267,1638,0.532856213402733
"E02003838",45,1372,436,1052,367,55,12,3339,0.0134770889487871,0.410901467505241,0.13057801737047,0.315064390536089,0.109913147648997,0.0164719976040731,0.00359389038634322,1853,0.554956573824498,1486,0.445043426175502
"E02003839",4,318,1353,1002,271,48,10,3006,0.00133067198935462,0.105788423153693,0.450099800399202,0.333333333333333,0.0901530272787758,0.0159680638722555,0.00332667997338656,1675,0.557218895542249,1331,0.442781104457751
"E02003840",14,271,811,1079,1032,493,174,3874,0.00361383582860093,0.0699535363964894,0.20934434692824,0.278523489932886,0.266391326794011,0.127258647392876,0.0449148167268973,1096,0.28291171915333,2778,0.71708828084667
"E02003841",6,292,1105,1058,346,74,20,2901,0.00206825232678387,0.100654946570148,0.380903136849362,0.364701826956222,0.119269217511203,0.0255084453636677,0.00689417442261289,1403,0.483626335746294,1498,0.516373664253706
"E02003842",18,370,403,680,367,131,33,2002,0.00899100899100899,0.184815184815185,0.201298701298701,0.33966033966034,0.183316683316683,0.0654345654345654,0.0164835164835165,791,0.395104895104895,1211,0.604895104895105
"E02003843",0,136,964,792,224,40,9,2165,0,0.0628175519630485,0.44526558891455,0.365819861431871,0.103464203233256,0.0184757505773672,0.00415704387990762,1100,0.508083140877598,1065,0.491916859122402
"E02003844",4,47,514,1025,291,44,10,1935,0.0020671834625323,0.0242894056847545,0.265633074935401,0.529715762273902,0.150387596899225,0.0227390180878553,0.00516795865633075,565,0.291989664082687,1370,0.708010335917313
"E02003845",24,2000,1885,1537,333,71,28,5878,0.00408302143586254,0.340251786321878,0.32068730860837,0.261483497788363,0.0566519224225927,0.0120789384144267,0.00476352500850629,3909,0.665022116366111,1969,0.334977883633889
"E02003846",0,98,1070,898,211,36,13,2326,0,0.0421324161650903,0.460017196904557,0.386070507308684,0.090713671539123,0.0154772141014617,0.00558899398108341,1168,0.502149613069647,1158,0.497850386930353
"E02003847",32,863,694,1263,259,36,7,3154,0.010145846544071,0.273620798985415,0.22003804692454,0.400443880786303,0.0821179454660748,0.0114140773620799,0.00221940393151554,1589,0.503804692454027,1565,0.496195307545973
"E02003848",2,39,717,674,163,27,1,1623,0.00123228589032656,0.0240295748613678,0.44177449168207,0.415280345040049,0.100431300061614,0.0166358595194085,0.000616142945163278,758,0.467036352433765,865,0.532963647566235
"E02003849",2,530,1657,708,121,21,2,3041,0.000657678395264716,0.17428477474515,0.544886550476817,0.232818151923709,0.0397895429135153,0.00690562315027951,0.000657678395264716,2189,0.719829003617231,852,0.280170996382769
"E02003850",2,27,459,722,154,13,3,1380,0.00144927536231884,0.0195652173913043,0.332608695652174,0.523188405797101,0.111594202898551,0.00942028985507246,0.00217391304347826,488,0.353623188405797,892,0.646376811594203
"E02003851",22,20,356,876,218,33,2,1527,0.014407334643091,0.0130975769482646,0.233136869679109,0.573673870333988,0.142763588736084,0.0216110019646365,0.00130975769482646,398,0.260641781270465,1129,0.739358218729535
"E02003852",2,23,522,841,181,13,8,1590,0.00125786163522013,0.0144654088050314,0.328301886792453,0.528930817610063,0.113836477987421,0.00817610062893082,0.0050314465408805,547,0.344025157232704,1043,0.655974842767296
"E02003853",2,264,514,856,286,82,23,2027,0.000986679822397632,0.130241736556487,0.253576714356191,0.422298963986186,0.141095214602861,0.0404538727183029,0.0113468179575728,780,0.384805130735076,1247,0.615194869264924
"E02003854",11,270,527,1054,312,43,5,2222,0.00495049504950495,0.121512151215122,0.237173717371737,0.474347434743474,0.14041404140414,0.0193519351935194,0.00225022502250225,808,0.363636363636364,1414,0.636363636363636
"E02003855",5,225,525,972,314,30,11,2082,0.00240153698366955,0.10806916426513,0.252161383285303,0.46685878962536,0.150816522574448,0.0144092219020173,0.00528338136407301,755,0.362632084534102,1327,0.637367915465898
"E02003856",3,838,2008,1663,420,78,16,5026,0.000596896140071628,0.166732988460008,0.399522483087943,0.330879426979706,0.0835654596100279,0.0155192996418623,0.00318344608038201,2849,0.566852367688022,2177,0.433147632311978
"E02003857",13,278,980,1034,250,32,4,2591,0.00501736781165573,0.107294480895407,0.378232342724817,0.399073716711694,0.096487842531841,0.0123504438440756,0.00154380548050946,1271,0.49054419143188,1320,0.50945580856812
"E02003858",3,293,1008,1075,449,60,14,2902,0.00103376981392143,0.100964851826327,0.347346657477602,0.370434183321847,0.154720882150241,0.0206753962784287,0.00482425913163336,1304,0.44934527911785,1598,0.55065472088215
"E02003859",23,533,844,1400,1007,384,133,4324,0.00531914893617021,0.123265494912118,0.195189639222942,0.32377428307123,0.232886216466235,0.0888066604995375,0.0307585568917669,1400,0.32377428307123,2924,0.67622571692877
"E02003860",34,139,561,1048,402,67,11,2262,0.0150309460654288,0.0614500442086649,0.248010610079576,0.463306808134394,0.177718832891247,0.0296198054818744,0.00486295313881521,734,0.324491600353669,1528,0.675508399646331
"E02003861",14,283,1025,1089,311,33,7,2762,0.00506879073135409,0.102461984069515,0.371107892831282,0.394279507603186,0.112599565532223,0.0119478638667632,0.00253439536567705,1322,0.478638667632151,1440,0.521361332367849
"E02003862",14,145,463,683,327,108,27,1767,0.00792303338992643,0.0820599886813809,0.262026032823995,0.386530843237125,0.185059422750424,0.0611205432937182,0.0152801358234295,622,0.352009054895303,1145,0.647990945104697
"E02003863",9,240,776,1090,468,104,14,2701,0.00333209922251018,0.0888559792669382,0.287300999629767,0.403554239170678,0.173269159570529,0.0385042576823399,0.00518326545723806,1025,0.379489078119215,1676,0.620510921880785
"E02003864",15,577,1061,1256,579,149,23,3660,0.00409836065573771,0.157650273224044,0.289890710382514,0.343169398907104,0.158196721311475,0.0407103825136612,0.00628415300546448,1653,0.451639344262295,2007,0.548360655737705
"E02003865",0,302,873,1352,429,76,17,3049,0,0.0990488684814693,0.2863233847163,0.44342407346671,0.140701869465399,0.0249262053132174,0.0055755985569039,1175,0.38537225319777,1874,0.61462774680223
"E02003866",16,241,516,843,223,39,2,1880,0.00851063829787234,0.128191489361702,0.274468085106383,0.448404255319149,0.118617021276596,0.0207446808510638,0.00106382978723404,773,0.411170212765957,1107,0.588829787234043
"E02003867",7,204,1125,1054,202,34,6,2632,0.00265957446808511,0.0775075987841945,0.427431610942249,0.400455927051672,0.0767477203647416,0.0129179331306991,0.00227963525835866,1336,0.507598784194529,1296,0.492401215805471
"E02003868",15,397,1389,1579,399,66,13,3858,0.00388802488335925,0.102903058579575,0.360031104199067,0.409279419388284,0.103421461897356,0.0171073094867807,0.00336962156557802,1801,0.466822187662001,2057,0.533177812337999
"E02003869",18,432,706,1143,373,69,15,2756,0.00653120464441219,0.156748911465893,0.256168359941945,0.414731494920174,0.135341074020319,0.0250362844702467,0.00544267053701016,1156,0.41944847605225,1600,0.58055152394775
"E02003870",12,245,1658,2538,907,148,45,5553,0.00216099405726634,0.0441202953358545,0.298577345578966,0.457050243111831,0.163335134161714,0.0266522600396182,0.00810372771474878,1915,0.344858634972087,3638,0.655141365027913
"E02003871",7,173,928,1226,248,24,14,2620,0.00267175572519084,0.066030534351145,0.354198473282443,0.46793893129771,0.0946564885496183,0.00916030534351145,0.00534351145038168,1108,0.422900763358779,1512,0.577099236641221
"E02003872",44,533,602,1130,694,317,108,3428,0.0128354725787631,0.155484247374562,0.17561260210035,0.329638273045508,0.2024504084014,0.0924737456242707,0.0315052508751459,1179,0.343932322053676,2249,0.656067677946324
"E02003873",44,514,1151,1144,277,39,5,3174,0.0138626339004411,0.161940768746062,0.362633900441084,0.360428481411468,0.0872715816005041,0.0122873345935728,0.0015752993068683,1709,0.538437303087587,1465,0.461562696912413
"E02003874",1,245,978,1296,421,86,15,3042,0.000328731097961867,0.0805391190006575,0.321499013806706,0.42603550295858,0.138395792241946,0.0282708744247206,0.00493096646942801,1224,0.402366863905325,1818,0.597633136094674
"E02003875",3,57,286,735,444,195,70,1790,0.00167597765363128,0.0318435754189944,0.159776536312849,0.410614525139665,0.24804469273743,0.108938547486034,0.0391061452513966,346,0.193296089385475,1444,0.806703910614525
"E02003876",1,152,447,900,277,54,11,1842,0.000542888165038002,0.0825190010857763,0.242671009771987,0.488599348534202,0.150380021715527,0.0293159609120521,0.00597176981541802,600,0.325732899022801,1242,0.674267100977199
"E02003877",7,494,788,1174,453,126,23,3065,0.00228384991843393,0.161174551386623,0.257096247960848,0.383034257748777,0.147797716150082,0.0411092985318108,0.00750407830342577,1289,0.420554649265905,1776,0.579445350734095
"E02003878",23,620,596,1102,364,101,38,2844,0.00808720112517581,0.218002812939522,0.209563994374121,0.387482419127989,0.127988748241913,0.0355133614627286,0.0133614627285513,1239,0.435654008438819,1605,0.564345991561181
"E02003879",133,1344,1345,1166,394,57,20,4459,0.0298273155416013,0.301412872841444,0.301637138371832,0.261493608432384,0.0883606189728639,0.0127831352321148,0.00448531060775959,2822,0.632877326754878,1637,0.367122673245122
"E02003880",3,60,651,963,327,62,14,2080,0.00144230769230769,0.0288461538461538,0.312980769230769,0.462980769230769,0.157211538461538,0.0298076923076923,0.00673076923076923,714,0.343269230769231,1366,0.656730769230769
"E02003881",3,71,688,1108,341,45,21,2277,0.00131752305665349,0.031181379007466,0.302151954325867,0.486605182257356,0.14975845410628,0.0197628458498024,0.00922266139657444,762,0.334650856389987,1515,0.665349143610013
"E02003882",6,285,888,1579,390,53,19,3220,0.00186335403726708,0.0885093167701863,0.275776397515528,0.490372670807453,0.12111801242236,0.0164596273291925,0.00590062111801242,1179,0.366149068322981,2041,0.633850931677019
"E02003883",76,1475,1063,1391,396,53,4,4458,0.0170480035890534,0.330865859129655,0.238447734410049,0.312023328847017,0.0888290713324361,0.0118887393449978,0.000897263346792284,2614,0.586361597128757,1844,0.413638402871243
"E02003884",11,615,633,1069,406,109,27,2870,0.00383275261324042,0.214285714285714,0.220557491289199,0.372473867595819,0.141463414634146,0.0379790940766551,0.00940766550522648,1259,0.438675958188153,1611,0.561324041811847
"E02003885",1,368,346,874,336,74,13,2012,0.000497017892644135,0.182902584493042,0.171968190854871,0.434393638170974,0.166998011928429,0.036779324055666,0.00646123260437376,715,0.355367793240557,1297,0.644632206759443
"E02003886",41,231,934,731,182,23,6,2148,0.0190875232774674,0.107541899441341,0.434823091247672,0.340316573556797,0.0847299813780261,0.010707635009311,0.00279329608938547,1206,0.56145251396648,942,0.43854748603352
"E02003887",28,620,698,957,154,24,8,2489,0.0112494977902772,0.249096022498996,0.280433909200482,0.384491763760546,0.0618722378465247,0.00964242667738047,0.00321414222579349,1346,0.540779429489755,1143,0.459220570510245
"E02003888",0,562,759,890,329,62,19,2621,0,0.214421976344907,0.289584128195345,0.339565051507058,0.12552460892789,0.0236550934757726,0.00724914154902709,1321,0.504006104540252,1300,0.495993895459748
"E02003889",0,627,888,721,155,30,5,2426,0,0.258450123660346,0.36603462489695,0.29719703215169,0.0638911788953009,0.0123660346248969,0.00206100577081616,1515,0.624484748557296,911,0.375515251442704
"E02003890",0,748,676,739,251,26,14,2454,0,0.30480847595762,0.275468622656887,0.301140994295029,0.102281988590057,0.0105949470252649,0.00570497147514262,1424,0.580277098614507,1030,0.419722901385493
"E02003891",7,362,465,764,397,153,54,2202,0.00317892824704814,0.164396003633061,0.211171662125341,0.346957311534968,0.180290644868302,0.0694822888283379,0.0245231607629428,834,0.37874659400545,1368,0.62125340599455
"E02003892",19,347,442,725,536,312,120,2501,0.00759696121551379,0.13874450219912,0.176729308276689,0.289884046381447,0.214314274290284,0.124750099960016,0.0479808076769292,808,0.323070771691323,1693,0.676929228308677
"E02003893",22,124,260,757,797,391,143,2494,0.00882117080994387,0.04971932638332,0.104250200481155,0.303528468323978,0.319566960705694,0.156776263031275,0.0573376102646351,406,0.162790697674419,2088,0.837209302325581
"E02003894",17,475,1080,1085,423,134,53,3267,0.00520355065809611,0.145393327211509,0.330578512396694,0.332108968472605,0.129476584022039,0.0410162228344047,0.0162228344046526,1572,0.481175390266299,1695,0.518824609733701
"E02003895",10,1221,1156,961,490,192,73,4103,0.00243724104313917,0.297587131367292,0.281745064586888,0.234218864245674,0.119424811113819,0.046795028028272,0.0177918596149159,2387,0.581769436997319,1716,0.418230563002681
"E02003896",4,189,929,876,413,98,27,2536,0.00157728706624606,0.0745268138801262,0.366324921135647,0.345425867507886,0.162854889589905,0.0386435331230284,0.0106466876971609,1122,0.442429022082019,1414,0.557570977917981
"E02003897",11,338,559,631,254,101,36,1930,0.00569948186528497,0.175129533678756,0.289637305699482,0.326943005181347,0.13160621761658,0.0523316062176166,0.0186528497409326,908,0.470466321243523,1022,0.529533678756477
"E02003898",24,88,412,806,793,377,140,2640,0.00909090909090909,0.0333333333333333,0.156060606060606,0.30530303030303,0.300378787878788,0.14280303030303,0.053030303030303,524,0.198484848484848,2116,0.801515151515152
"E02003899",4,137,658,749,224,44,15,1831,0.00218459858001092,0.0748225013653741,0.359366466411797,0.409066084107045,0.122337520480612,0.0240305843801202,0.00819224467504096,799,0.436373566357182,1032,0.563626433642818
"E02003900",6,103,1172,895,326,71,14,2587,0.00231928875144956,0.039814456899884,0.453034402783146,0.345960572091225,0.126014688828759,0.0274449168921531,0.0054116737533823,1281,0.49516814843448,1306,0.50483185156552
"E02003901",14,304,696,940,926,582,261,3723,0.0037604082728982,0.0816545796400752,0.186946011281225,0.252484555466022,0.248724147193124,0.156325543916197,0.0701047542304593,1014,0.272360999194198,2709,0.727639000805802
"E02003902",8,42,790,783,226,56,26,1931,0.00414293112377007,0.0217503883997929,0.409114448472294,0.405489383738995,0.117037804246504,0.0290005178663905,0.0134645261522527,840,0.435007767995857,1091,0.564992232004143
"E02003903",4,65,517,929,607,313,138,2573,0.00155460551884959,0.0252623396813059,0.20093276331131,0.361057131752818,0.235911387485426,0.121647881849981,0.0536338904003109,586,0.227749708511465,1987,0.772250291488535
"E02003904",7,120,580,945,600,262,211,2725,0.00256880733944954,0.0440366972477064,0.212844036697248,0.346788990825688,0.220183486238532,0.0961467889908257,0.0774311926605505,707,0.259449541284404,2018,0.740550458715596
"E02003905",33,313,544,837,691,294,94,2806,0.0117605131860299,0.111546685673557,0.193870277975766,0.298289379900214,0.246258018531718,0.104775481111903,0.0334996436208125,890,0.317177476835353,1916,0.682822523164647
"E02003906",49,320,613,766,641,343,133,2865,0.0171029668411867,0.111692844677138,0.213961605584642,0.267364746945899,0.223734729493892,0.119720767888307,0.0464223385689354,982,0.342757417102967,1883,0.657242582897033
"E02003907",41,477,551,1061,986,478,175,3769,0.0108782170336959,0.126558768904219,0.146192624038206,0.281507031042717,0.261607853542054,0.126824091270894,0.0464314141682144,1069,0.283629609976121,2700,0.716370390023879
"E02003908",9,312,1361,901,317,70,18,2988,0.00301204819277108,0.104417670682731,0.455488621151272,0.301539491298527,0.106091030789826,0.0234270414993307,0.00602409638554217,1682,0.562918340026774,1306,0.437081659973226
"E02003909",7,743,1300,1216,359,95,19,3739,0.00187215833110457,0.198716234287243,0.347686547205135,0.32522064723188,0.0960149772666488,0.0254078630649906,0.00508157261299813,2050,0.548274939823482,1689,0.451725060176518
"E02003910",21,666,998,1052,524,99,44,3404,0.00616921269095182,0.195652173913043,0.293184488836663,0.309048178613396,0.153936545240893,0.0290834312573443,0.0129259694477086,1685,0.495005875440658,1719,0.504994124559342
"E02003911",37,392,556,1013,855,384,122,3359,0.0110151830902054,0.11670139922596,0.165525454004168,0.301577850550759,0.254540041679071,0.114319738017267,0.0363203334325692,985,0.293242036320333,2374,0.706757963679666
"E02003912",29,389,641,1143,982,445,149,3778,0.00767601905770249,0.102964531498147,0.169666490206458,0.302541026998412,0.259925886712546,0.117787188988883,0.0394388565378507,1059,0.280307040762308,2719,0.719692959237692
"E02003913",40,187,330,616,623,326,112,2234,0.017905102954342,0.0837063563115488,0.147717099373321,0.275738585496867,0.278871978513876,0.145926589077887,0.0501342882721576,557,0.249328558639212,1677,0.750671441360788
"E02003914",8,393,1186,1067,448,103,32,3237,0.00247142415817115,0.121408711770158,0.366388631448872,0.329626197096077,0.138399752857584,0.0318195860364535,0.00988569663268458,1587,0.490268767377201,1650,0.509731232622799
"E02003915",3,205,1080,1161,494,114,39,3096,0.000968992248062015,0.0662144702842377,0.348837209302326,0.375,0.159560723514212,0.0368217054263566,0.0125968992248062,1288,0.416020671834625,1808,0.583979328165375
"E02003916",18,505,806,1182,622,160,46,3339,0.00539083557951483,0.151242887091944,0.241389637616053,0.353998203054807,0.18628331835879,0.0479185384845762,0.0137765798143157,1329,0.398023360287511,2010,0.601976639712489
"E02003917",50,373,981,1012,351,87,10,2864,0.0174581005586592,0.130237430167598,0.342527932960894,0.353351955307263,0.122555865921788,0.030377094972067,0.00349162011173184,1404,0.490223463687151,1460,0.509776536312849
"E02003918",24,346,676,1060,498,222,79,2905,0.00826161790017212,0.119104991394148,0.232702237521515,0.364888123924269,0.171428571428571,0.0764199655765921,0.0271944922547332,1046,0.360068846815835,1859,0.639931153184165
"E02003919",159,469,1203,900,414,138,57,3340,0.0476047904191617,0.140419161676647,0.360179640718563,0.269461077844311,0.123952095808383,0.0413173652694611,0.0170658682634731,1831,0.548203592814371,1509,0.451796407185629
"E02003920",9,424,1048,972,475,182,90,3200,0.0028125,0.1325,0.3275,0.30375,0.1484375,0.056875,0.028125,1481,0.4628125,1719,0.5371875
"E02003921",17,110,359,654,678,354,110,2282,0.00744960560911481,0.0482033304119194,0.157318141980719,0.286590709903593,0.297107800175285,0.15512708150745,0.0482033304119194,486,0.212971078001753,1796,0.787028921998247
"E02003922",58,640,932,887,534,216,71,3338,0.0173756740563211,0.191731575793889,0.27920910724985,0.265727980826842,0.159976033553026,0.0647094068304374,0.0212702216896345,1630,0.48831635710006,1708,0.51168364289994
"E02003923",16,936,1011,942,514,141,59,3619,0.00442111080408953,0.258634982039237,0.279358938933407,0.260292898590771,0.142028184581376,0.038961038961039,0.0163028460900801,1963,0.542415031776734,1656,0.457584968223266
"E02003924",6,308,1061,880,513,199,83,3050,0.0019672131147541,0.100983606557377,0.347868852459016,0.288524590163934,0.168196721311475,0.0652459016393443,0.0272131147540984,1375,0.450819672131148,1675,0.549180327868853
"E02003925",9,183,812,831,462,152,61,2510,0.00358565737051793,0.0729083665338645,0.323505976095618,0.331075697211155,0.18406374501992,0.0605577689243028,0.0243027888446215,1004,0.4,1506,0.6
"E02003926",31,192,416,752,738,459,188,2776,0.0111671469740634,0.069164265129683,0.14985590778098,0.270893371757925,0.265850144092219,0.165345821325648,0.0677233429394813,639,0.230187319884726,2137,0.769812680115274
"E02003927",27,841,643,1206,964,367,152,4200,0.00642857142857143,0.200238095238095,0.153095238095238,0.287142857142857,0.22952380952381,0.0873809523809524,0.0361904761904762,1511,0.359761904761905,2689,0.640238095238095
"E02003928",28,633,1837,1462,530,138,60,4688,0.00597269624573379,0.135025597269625,0.391851535836177,0.311860068259386,0.113054607508532,0.0294368600682594,0.0127986348122867,2498,0.532849829351536,2190,0.467150170648464
"E02003929",32,188,513,819,867,490,213,3122,0.0102498398462524,0.0602178090967329,0.164317745035234,0.262331838565022,0.277706598334401,0.15695067264574,0.0682254964766175,733,0.234785393978219,2389,0.765214606021781
"E02003930",20,209,546,989,1118,613,319,3814,0.00524383848977452,0.0547981122181437,0.143156790770844,0.25930781331935,0.293130571578395,0.160723649711589,0.0836392239119035,775,0.203198741478762,3039,0.796801258521238
"E02003931",53,881,1506,1452,699,182,50,4823,0.010989010989011,0.18266639021356,0.312253783951897,0.301057433132905,0.144930541156956,0.0377358490566038,0.010366991499067,2440,0.505909185154468,2383,0.494090814845532
"E02003932",48,296,595,926,808,412,190,3275,0.0146564885496183,0.090381679389313,0.181679389312977,0.282748091603053,0.246717557251908,0.125801526717557,0.0580152671755725,939,0.286717557251908,2336,0.713282442748092
"E02003933",30,156,497,998,961,530,203,3375,0.00888888888888889,0.0462222222222222,0.147259259259259,0.295703703703704,0.284740740740741,0.157037037037037,0.0601481481481481,683,0.20237037037037,2692,0.79762962962963
"E02003934",29,143,719,891,677,359,170,2988,0.00970548862115127,0.0478580990629183,0.240629183400268,0.298192771084337,0.226572958500669,0.120147255689424,0.0568942436412316,891,0.298192771084337,2097,0.701807228915663
"E02003935",13,687,1807,1119,555,150,57,4388,0.00296262534184139,0.156563354603464,0.411804922515953,0.255013673655424,0.126481312670921,0.0341841385597083,0.0129899726526892,2507,0.571330902461258,1881,0.428669097538742
"E02003936",31,298,408,839,916,466,155,3113,0.00995823964021844,0.0957275939608095,0.131063283006746,0.26951493735946,0.294249919691616,0.149694828140058,0.0497911982010922,737,0.236749116607774,2376,0.763250883392226
"E02003937",69,516,579,884,963,536,217,3764,0.0183315621679065,0.137088204038257,0.153825717321998,0.234856535600425,0.255844845908608,0.14240170031881,0.0576514346439957,1164,0.309245483528162,2600,0.690754516471838
"E02003938",55,717,924,1141,757,337,131,4062,0.0135401280157558,0.176514032496307,0.227474150664697,0.280896110290497,0.186361398325948,0.0829640571147218,0.0322501230920729,1696,0.41752831117676,2366,0.58247168882324
"E02003939",18,359,784,1009,405,126,47,2748,0.00655021834061135,0.130640465793304,0.285298398835517,0.367176128093159,0.147379912663755,0.0458515283842795,0.0171033478893741,1161,0.422489082969432,1587,0.577510917030568
"E02003940",21,156,360,764,766,436,173,2676,0.007847533632287,0.0582959641255605,0.134529147982063,0.285500747384155,0.286248131539611,0.162929745889387,0.0646487294469357,537,0.20067264573991,2139,0.79932735426009
"E02003941",31,885,1346,918,401,98,30,3709,0.00835804799137234,0.238608789431113,0.36290105149636,0.247506066325155,0.108115394985171,0.02642221623079,0.00808843354003775,2262,0.609867888918846,1447,0.390132111081154
"E02003942",103,579,907,1069,432,99,37,3226,0.0319280843149411,0.179479231246125,0.281153130812151,0.331370117792932,0.133911965282083,0.0306881587104774,0.0114693118412895,1589,0.492560446373218,1637,0.507439553626782
"E02003943",44,528,1276,1367,824,313,142,4494,0.00979083222073876,0.117489986648865,0.283934134401424,0.304183355585225,0.183355585224744,0.0696484201157098,0.0315976858032933,1848,0.411214953271028,2646,0.588785046728972
"E02003944",24,755,1296,1260,722,432,170,4659,0.0051513200257566,0.162051942476926,0.278171281390856,0.270444301352222,0.154968877441511,0.0927237604636188,0.0364885168491093,2075,0.445374543893539,2584,0.554625456106461
"E02003945",23,410,846,776,496,245,90,2886,0.00796950796950797,0.142065142065142,0.293139293139293,0.268884268884269,0.171864171864172,0.0848925848925849,0.0311850311850312,1279,0.443173943173943,1607,0.556826056826057
"E02003946",27,462,787,1187,1031,556,225,4275,0.00631578947368421,0.108070175438596,0.184093567251462,0.27766081871345,0.241169590643275,0.130058479532164,0.0526315789473684,1276,0.298479532163743,2999,0.701520467836257
"E02003947",66,148,406,660,817,460,193,2750,0.024,0.0538181818181818,0.147636363636364,0.24,0.297090909090909,0.167272727272727,0.0701818181818182,620,0.225454545454545,2130,0.774545454545454
"E02003948",5,198,1025,1103,749,193,73,3346,0.00149432157800359,0.059175134488942,0.306335923490735,0.329647340107591,0.223849372384937,0.0576808129109384,0.0218170950388524,1228,0.367005379557681,2118,0.632994620442319
"E02003949",0,213,1084,1334,832,229,119,3811,0,0.0558908422986093,0.284439779585411,0.350039359748098,0.218315402781422,0.0600892154290213,0.031225400157439,1297,0.34033062188402,2514,0.65966937811598
"E02003950",32,192,338,634,749,443,247,2635,0.0121442125237192,0.072865275142315,0.128273244781784,0.240607210626186,0.284250474383302,0.168121442125237,0.0937381404174573,562,0.213282732447818,2073,0.786717267552182
"E02003951",6,73,472,872,758,378,198,2757,0.00217627856365615,0.0264780558578165,0.17120058034095,0.316285817918027,0.27493652520856,0.137105549510337,0.0718171926006529,551,0.199854914762423,2206,0.800145085237577
"E02003952",79,1963,1217,1148,581,175,46,5209,0.0151660587444807,0.376847763486274,0.233634094835861,0.220387790362834,0.111537723171434,0.0335956997504319,0.00883086964868497,3259,0.625647917066615,1950,0.374352082933385
"E02003953",38,612,1164,1372,982,421,169,4758,0.00798654897015553,0.128625472887768,0.244640605296343,0.288356452290879,0.206389239176124,0.0884825556956705,0.0355191256830601,1814,0.381252627154266,2944,0.618747372845734
"E02003954",58,1063,1618,1208,583,167,62,4759,0.0121874343349443,0.223366253414583,0.339987392309309,0.253834839251944,0.122504727884009,0.0350914057575121,0.0130279470476991,2739,0.575541080058836,2020,0.424458919941164
"E02003955",54,737,1322,1675,548,100,34,4470,0.0120805369127517,0.164876957494407,0.295749440715884,0.374720357941834,0.122595078299776,0.0223713646532438,0.00760626398210291,2113,0.472706935123043,2357,0.527293064876957
"E02003956",15,167,570,889,737,334,159,2871,0.00522466039707419,0.0581678857540927,0.198537095088819,0.30964820619993,0.256704980842912,0.116335771508185,0.0553814002089864,752,0.261929641239986,2119,0.738070358760014
"E02003957",182,304,972,1426,948,438,179,4449,0.0409080692290402,0.0683299617891661,0.218476062036413,0.320521465497865,0.213081591368847,0.0984490896830749,0.0402337603955945,1458,0.327714093054619,2991,0.672285906945381
"E02003958",15,250,487,933,791,338,114,2928,0.00512295081967213,0.0853825136612022,0.166325136612022,0.318647540983607,0.270150273224044,0.115437158469945,0.0389344262295082,752,0.256830601092896,2176,0.743169398907104
"E02003959",6,204,1068,946,384,98,41,2747,0.00218420094648708,0.0742628321805606,0.3887877684747,0.344375682562796,0.139788860575173,0.0356752821259556,0.0149253731343284,1278,0.465234801601747,1469,0.534765198398253
"E02003960",5,294,610,977,584,204,69,2743,0.001822821728035,0.107181917608458,0.22238425082027,0.356179365658039,0.212905577834488,0.0743711265038279,0.025154939846883,909,0.331388990156763,1834,0.668611009843237
"E02003961",9,816,1417,1178,403,102,38,3963,0.00227100681302044,0.205904617713853,0.357557406005551,0.297249558415342,0.101690638405249,0.0257380772142316,0.00958869543275296,2242,0.565733030532425,1721,0.434266969467575
"E02003962",10,453,1058,917,414,108,48,3008,0.00332446808510638,0.150598404255319,0.351728723404255,0.304853723404255,0.137632978723404,0.0359042553191489,0.0159574468085106,1521,0.505651595744681,1487,0.494348404255319
"E02003963",5,524,1558,1521,634,180,57,4479,0.00111632060727841,0.116990399642777,0.347845501227953,0.339584728734092,0.141549453002902,0.0401875418620228,0.0127260549229739,2087,0.465952221478008,2392,0.534047778521991
"E02003964",76,422,567,987,965,510,230,3757,0.0202289060420548,0.112323662496673,0.150918285866383,0.26270960873037,0.256853872770828,0.135746606334842,0.0612190577588501,1065,0.28347085440511,2692,0.71652914559489
"E02003965",13,519,1044,1738,654,241,123,4332,0.00300092336103416,0.119806094182825,0.240997229916898,0.401200369344414,0.150969529085873,0.0556325023084026,0.028393351800554,1576,0.363804247460757,2756,0.636195752539243
"E02003966",74,191,240,640,689,450,180,2464,0.0300324675324675,0.0775162337662338,0.0974025974025974,0.25974025974026,0.279626623376623,0.18262987012987,0.073051948051948,505,0.204951298701299,1959,0.795048701298701
"E02003967",14,192,616,1096,745,412,154,3229,0.00433570764942707,0.0594611334778569,0.190771136574791,0.339423970269433,0.230721585630226,0.127593682254568,0.0476927841436977,822,0.254567977702075,2407,0.745432022297925
"E02003968",4,349,941,1171,538,145,61,3209,0.00124649423496416,0.108756622000623,0.293237768775319,0.364911187285759,0.16765347460268,0.0451854160174509,0.0190090370832035,1294,0.403240885010907,1915,0.596759114989093
"E02003969",9,185,787,1311,375,79,34,2780,0.00323741007194245,0.0665467625899281,0.283093525179856,0.47158273381295,0.134892086330935,0.0284172661870504,0.0122302158273381,981,0.352877697841727,1799,0.647122302158273
"E02003970",11,532,921,1284,542,162,67,3519,0.00312588803637397,0.151179312304632,0.261722080136402,0.364876385336743,0.154021028701336,0.0460358056265985,0.0190394998579142,1464,0.416027280477408,2055,0.583972719522592
"E02003971",12,469,574,1160,478,208,86,2987,0.00401740877134248,0.157013726146635,0.192166052895882,0.388349514563107,0.160026782725142,0.0696350853699364,0.0287914295279545,1055,0.35319718781386,1932,0.64680281218614
"E02003972",6,217,764,1562,625,133,42,3349,0.00179157957599283,0.0647954613317408,0.228127799343087,0.466407882950134,0.186622872499253,0.0397133472678411,0.0125410570319498,987,0.294714840250821,2362,0.705285159749179
"E02003973",4,250,1518,1805,592,82,41,4292,0.000931966449207828,0.0582479030754893,0.353681267474371,0.420549860205033,0.137931034482759,0.0191053122087605,0.00955265610438024,1772,0.412861136999068,2520,0.587138863000932
"E02003974",6,200,1330,1380,263,35,10,3224,0.00186104218362283,0.0620347394540943,0.412531017369727,0.428039702233251,0.081575682382134,0.0108560794044665,0.00310173697270471,1536,0.476426799007444,1688,0.523573200992556
"E02003975",3,675,496,909,308,57,21,2469,0.00121506682867558,0.273390036452005,0.200891049007695,0.3681652490887,0.124746861077359,0.023086269744836,0.00850546780072904,1174,0.475496152288376,1295,0.524503847711624
"E02003976",12,222,914,1188,659,194,67,3256,0.00368550368550369,0.0681818181818182,0.280712530712531,0.364864864864865,0.202395577395577,0.0595823095823096,0.0205773955773956,1148,0.352579852579853,2108,0.647420147420147
"E02003977",1,109,385,1062,416,102,38,2113,0.000473260766682442,0.0515854235683862,0.18220539517274,0.502602934216753,0.196876478939896,0.0482725982016091,0.0179839091339328,495,0.234264079507809,1618,0.765735920492191
"E02003978",7,90,472,1028,339,67,24,2027,0.00345337937839171,0.0444005920078934,0.232856438085841,0.507153428712383,0.167242229896399,0.0330537740503207,0.0118401578687716,569,0.280710409472126,1458,0.719289590527874
"E02003979",13,160,301,1242,398,70,13,2197,0.00591715976331361,0.0728265817023213,0.137005006827492,0.565316340464269,0.181156121984524,0.0318616294947656,0.00591715976331361,474,0.215748748293127,1723,0.784251251706873
"E02003980",37,121,1348,1153,233,89,35,3016,0.0122679045092838,0.0401193633952255,0.446949602122016,0.382294429708223,0.0772546419098143,0.0295092838196286,0.011604774535809,1506,0.499336870026525,1510,0.500663129973475
"E02003981",19,107,465,1390,450,80,24,2535,0.00749506903353057,0.0422090729783038,0.183431952662722,0.548323471400395,0.177514792899408,0.0315581854043393,0.00946745562130178,591,0.233136094674556,1944,0.766863905325444
"E02003982",7,230,875,1027,279,56,11,2485,0.0028169014084507,0.0925553319919517,0.352112676056338,0.41327967806841,0.112273641851107,0.0225352112676056,0.00442655935613682,1112,0.44748490945674,1373,0.55251509054326
"E02003983",2,83,873,1496,343,93,25,2915,0.000686106346483705,0.0284734133790738,0.299485420240137,0.513207547169811,0.117667238421955,0.0319039451114923,0.00857632933104631,958,0.328644939965695,1957,0.671355060034305
"E02003984",1,218,1079,1827,580,159,68,3932,0.000254323499491353,0.055442522889115,0.27441505595117,0.464649033570702,0.147507629704985,0.0404374364191251,0.017293997965412,1298,0.330111902339776,2634,0.669888097660224
"E02003985",2,133,631,1166,280,51,11,2274,0.000879507475813544,0.0584872471416007,0.277484608619173,0.512752858399296,0.123131046613896,0.0224274406332454,0.00483729111697449,766,0.336851363236588,1508,0.663148636763413
"E02003986",2,5,667,1342,564,352,55,2987,0.000669568128557081,0.0016739203213927,0.223300970873786,0.449280214261801,0.188818212253097,0.117843990626046,0.0184131235353197,674,0.225644459323736,2313,0.774355540676264
"E02003987",21,95,429,717,604,352,119,2337,0.00898587933247754,0.040650406504065,0.183568677792041,0.306803594351733,0.258451005562687,0.150620453572957,0.0509199828840394,545,0.233204963628584,1792,0.766795036371416
"E02003988",9,270,650,952,515,281,97,2774,0.00324441240086518,0.0973323720259553,0.234318673395818,0.343186733958183,0.185652487382841,0.101297764960346,0.0349675558759913,929,0.334895457822639,1845,0.665104542177361
"E02003989",0,457,839,1163,242,36,7,2744,0,0.166545189504373,0.305758017492711,0.423833819241982,0.0881924198250729,0.0131195335276968,0.00255102040816327,1296,0.472303206997085,1448,0.527696793002915
"E02003990",17,1201,1072,1478,336,83,26,4213,0.00403512936150012,0.28507002136245,0.254450510325184,0.350818893899834,0.0797531450272965,0.0197009257061476,0.00617137431758842,2290,0.543555661049134,1923,0.456444338950866
"E02003991",14,203,458,944,256,68,41,1984,0.00705645161290323,0.102318548387097,0.230846774193548,0.475806451612903,0.129032258064516,0.0342741935483871,0.0206653225806452,675,0.340221774193548,1309,0.659778225806452
"E02003992",1,184,1152,1848,710,109,48,4052,0.000246791707798618,0.0454096742349457,0.284304047384008,0.456071076011846,0.175222112537019,0.0269002961500494,0.0118460019743337,1337,0.329960513326752,2715,0.670039486673248
"E02003993",41,415,647,1080,552,248,72,3055,0.0134206219312602,0.135842880523732,0.211783960720131,0.353518821603928,0.180687397708674,0.0811783960720131,0.0235679214402619,1103,0.361047463175123,1952,0.638952536824877
"E02003994",0,162,948,1587,417,62,16,3192,0,0.0507518796992481,0.296992481203008,0.49718045112782,0.130639097744361,0.0194235588972431,0.0050125313283208,1110,0.347744360902256,2082,0.652255639097744
"E02003995",0,678,1564,1651,243,42,6,4184,0,0.162045889101338,0.373804971319312,0.394598470363289,0.0580783938814532,0.010038240917782,0.001434034416826,2242,0.53585086042065,1942,0.46414913957935
"E02003996",5,382,1394,2081,676,140,41,4719,0.00105954651409197,0.0809493536766264,0.295401568128841,0.440983259165077,0.143250688705234,0.0296673023945751,0.00868828141555414,1781,0.377410468319559,2938,0.622589531680441
"E02003997",1,371,1587,1504,207,41,17,3728,0.000268240343347639,0.0995171673819742,0.425697424892704,0.40343347639485,0.0555257510729614,0.0109978540772532,0.00456008583690987,1959,0.525482832618026,1769,0.474517167381974
"E02003998",0,35,726,1098,209,49,5,2122,0,0.0164938737040528,0.342130065975495,0.517436380772856,0.0984919886899152,0.0230914231856739,0.00235626767200754,761,0.358623939679548,1361,0.641376060320452
"E02003999",15,1418,1057,1163,402,129,48,4232,0.00354442344045369,0.335066162570888,0.24976370510397,0.274810964083176,0.0949905482041588,0.0304820415879017,0.0113421550094518,2490,0.588374291115312,1742,0.411625708884688
"E02004000",0,106,380,802,315,101,54,1758,0,0.0602957906712173,0.216154721274175,0.456200227531286,0.179180887372014,0.0574516496018202,0.0307167235494881,486,0.276450511945392,1272,0.723549488054608
"E02004001",0,109,825,902,413,76,27,2352,0,0.046343537414966,0.350765306122449,0.383503401360544,0.175595238095238,0.032312925170068,0.0114795918367347,934,0.397108843537415,1418,0.602891156462585
"E02004002",2,117,825,1620,310,50,13,2937,0.000680966973101805,0.0398365679264556,0.280898876404494,0.551583248212462,0.10554988083078,0.0170241743275451,0.00442628532516173,944,0.321416411304052,1993,0.678583588695948
"E02004003",10,460,1078,1965,735,191,85,4524,0.002210433244916,0.101679929266136,0.238284703801945,0.434350132625995,0.162466843501326,0.0422192749778957,0.018788682581786,1548,0.342175066312997,2976,0.657824933687003
"E02004004",36,711,1158,1360,373,83,29,3750,0.0096,0.1896,0.3088,0.362666666666667,0.0994666666666667,0.0221333333333333,0.00773333333333333,1905,0.508,1845,0.492
"E02004005",2,130,785,1302,415,79,32,2745,0.000728597449908925,0.0473588342440801,0.285974499089253,0.47431693989071,0.151183970856102,0.0287795992714025,0.0116575591985428,917,0.334061930783242,1828,0.665938069216758
"E02004006",5,153,587,1245,660,286,98,3034,0.0016479894528675,0.0504284772577456,0.193473961766645,0.410349373764008,0.21753460777851,0.0942649967040211,0.032300593276203,745,0.245550428477258,2289,0.754449571522742
"E02004007",5,114,660,1454,719,355,148,3455,0.00144717800289436,0.0329956584659913,0.191027496382055,0.420839363241679,0.208104196816208,0.102749638205499,0.0428364688856729,779,0.225470332850941,2676,0.774529667149059
"E02004008",20,180,388,734,754,424,141,2641,0.00757288905717531,0.0681560015145778,0.146914047709201,0.277925028398334,0.285497917455509,0.160545248012117,0.053388867853086,588,0.222642938280954,2053,0.777357061719046
"E02004009",32,106,381,531,725,321,110,2206,0.014505893019039,0.0480507706255666,0.172710788757933,0.240707162284678,0.328649138712602,0.145512239347235,0.0498640072529465,519,0.235267452402539,1687,0.764732547597461
"E02004010",1,441,1469,1204,437,69,37,3658,0.000273373428102788,0.12055768179333,0.401585565882996,0.329141607435757,0.119464188080919,0.0188627665390924,0.0101148168398032,1911,0.522416621104429,1747,0.477583378895571
"E02004011",15,1296,953,1464,543,149,45,4465,0.00335946248600224,0.290257558790594,0.213437849944009,0.327883538633819,0.121612541993281,0.0333706606942889,0.0100783874580067,2264,0.507054871220605,2201,0.492945128779395
"E02004012",48,150,346,736,797,428,146,2651,0.018106374952848,0.0565824217276499,0.130516786118446,0.277631082610336,0.300641267446247,0.161448509996228,0.0550735571482459,544,0.205205582798944,2107,0.794794417201056
"E02004013",23,267,894,1341,885,394,154,3958,0.00581101566447701,0.0674583122789287,0.225871652349672,0.338807478524507,0.223597776654876,0.0995452248610409,0.0389085396664982,1184,0.299140980293077,2774,0.700859019706923
"E02004014",20,207,530,892,924,440,174,3187,0.00627549419516787,0.0649513649199874,0.166300596171949,0.279887041104487,0.289927831816756,0.138060872293693,0.0545967994979605,757,0.237527455287104,2430,0.762472544712896
"E02004015",23,201,981,1310,851,392,112,3870,0.00594315245478036,0.051937984496124,0.253488372093023,0.338501291989664,0.219896640826873,0.101291989664083,0.0289405684754522,1205,0.311369509043928,2665,0.688630490956072
"E02004016",26,227,1184,1442,775,247,72,3973,0.00654417316889001,0.0571356657437705,0.29801157815253,0.362949911905361,0.195066700226529,0.0621696451044551,0.0181223256984646,1437,0.36169141706519,2536,0.63830858293481
"E02004017",4,499,1216,1400,583,187,52,3941,0.00101497081958894,0.12661760974372,0.308551129155037,0.355239786856128,0.147931996955088,0.0474498858157828,0.0131946206546562,1719,0.436183709718346,2222,0.563816290281654
"E02004018",24,407,1539,1538,545,112,30,4195,0.00572109654350417,0.0970202622169249,0.366865315852205,0.366626936829559,0.129916567342074,0.0266984505363528,0.00715137067938021,1970,0.469606674612634,2225,0.530393325387366
"E02004019",17,55,571,1087,470,186,74,2460,0.00691056910569106,0.0223577235772358,0.232113821138211,0.441869918699187,0.191056910569106,0.075609756097561,0.0300813008130081,643,0.261382113821138,1817,0.738617886178862
"E02004020",22,510,959,1401,393,73,14,3372,0.00652431791221827,0.151245551601424,0.284400948991696,0.415480427046263,0.116548042704626,0.0216488730723606,0.00415183867141162,1491,0.442170818505338,1881,0.557829181494662
"E02004021",13,103,353,770,766,507,152,2664,0.00487987987987988,0.0386636636636637,0.132507507507508,0.289039039039039,0.287537537537538,0.190315315315315,0.0570570570570571,469,0.176051051051051,2195,0.823948948948949
"E02004022",20,148,358,759,604,382,142,2413,0.00828843762950684,0.0613344384583506,0.148363033568172,0.314546208039785,0.250310816411107,0.158309158723581,0.0588479071694986,526,0.21798590965603,1887,0.78201409034397
"E02004023",23,283,675,869,594,251,88,2783,0.00826446280991736,0.101688825008983,0.242544017247575,0.312252964426877,0.213438735177866,0.0901904419690981,0.0316205533596838,981,0.352497305066475,1802,0.647502694933525
"E02004024",25,503,467,971,563,224,58,2811,0.00889363215937389,0.178939879046603,0.166133048737104,0.345428673070082,0.2002845962291,0.07968694414799,0.0206332266097474,995,0.353966559943081,1816,0.646033440056919
"E02004025",33,134,917,1318,534,177,48,3161,0.0104397342613097,0.0423916482125909,0.29009807023094,0.416956659285036,0.168933881683012,0.0559949383106612,0.0151850680164505,1084,0.34292945270484,2077,0.65707054729516
"E02004026",10,473,1083,1632,577,110,57,3942,0.00253678335870117,0.119989852866565,0.274733637747336,0.41400304414003,0.146372399797057,0.0279046169457128,0.0144596651445967,1566,0.397260273972603,2376,0.602739726027397
"E02004027",7,369,829,1465,707,199,56,3632,0.0019273127753304,0.101596916299559,0.228248898678414,0.403359030837004,0.19465859030837,0.0547907488986784,0.0154185022026432,1205,0.331773127753304,2427,0.668226872246696
"E02004028",17,338,561,1110,479,191,67,2763,0.00615273253709736,0.12233079985523,0.203040173724213,0.401737242128122,0.173362287368802,0.0691277596815056,0.0242490047050308,916,0.33152370611654,1847,0.66847629388346
"E02004029",6,741,777,1085,421,70,13,3113,0.00192740122068744,0.238034050754899,0.249598458079023,0.348538387407645,0.135239318984902,0.0224863475746868,0.00417603597815612,1524,0.48955991005461,1589,0.51044008994539
"E02004030",15,370,506,740,395,116,47,2189,0.00685244403837369,0.169026952946551,0.231155778894472,0.338053905893102,0.180447693010507,0.0529922338967565,0.0214709913202376,891,0.407035175879397,1298,0.592964824120603
"E02004031",81,192,1151,1227,376,59,17,3103,0.0261037705446342,0.0618756042539478,0.370931356751531,0.395423783435385,0.121173058330648,0.0190138575572027,0.00547856912665163,1424,0.458910731550113,1679,0.541089268449887
"E02004032",2,418,760,1216,408,84,7,2895,0.000690846286701209,0.144386873920553,0.262521588946459,0.420034542314335,0.140932642487047,0.0290155440414508,0.00241796200345423,1180,0.407599309153713,1715,0.592400690846287
"E02004033",1,310,907,1477,623,137,32,3487,0.000286779466590192,0.0889016346429596,0.260108976197304,0.423573272153714,0.17866360768569,0.0392887869228563,0.00917694293088615,1218,0.349297390306854,2269,0.650702609693146
"E02004034",0,144,557,1056,395,74,23,2249,0,0.0640284570920409,0.247665629168519,0.469542018674967,0.175633614939973,0.0329035126722988,0.010226767452201,701,0.31169408626056,1548,0.68830591373944
"E02004035",51,305,429,866,381,116,38,2186,0.0233302836230558,0.139524245196706,0.196248856358646,0.39615736505032,0.174290942360476,0.0530649588289113,0.0173833485818847,785,0.359103385178408,1401,0.640896614821592
"E02004036",22,784,1133,1587,513,107,24,4170,0.0052757793764988,0.188009592326139,0.271702637889688,0.380575539568345,0.123021582733813,0.0256594724220623,0.00575539568345324,1939,0.464988009592326,2231,0.535011990407674
"E02004037",3,224,753,1172,340,61,15,2568,0.00116822429906542,0.0872274143302181,0.293224299065421,0.456386292834891,0.132398753894081,0.0237538940809969,0.0058411214953271,980,0.381619937694704,1588,0.618380062305296
"E02004038",126,279,1042,1334,613,170,33,3597,0.0350291909924937,0.0775646371976647,0.289685849318877,0.37086460939672,0.170419794273005,0.0472616068946344,0.00917431192660551,1447,0.402279677509035,2150,0.597720322490965
"E02004039",3,80,825,1240,352,82,12,2594,0.00115651503469545,0.030840400925212,0.318041634541249,0.478026214340786,0.135697764070933,0.0316114109483423,0.0046260601387818,908,0.350038550501157,1686,0.649961449498843
"E02004040",14,561,723,1280,549,101,31,3259,0.0042957962565204,0.172138692850568,0.221847192390304,0.392758514881866,0.16845658177355,0.0309911015648972,0.00951212028229518,1298,0.398281681497392,1961,0.601718318502608
"E02004041",13,248,768,1036,411,88,23,2587,0.0050251256281407,0.095863935059915,0.296868960185543,0.40046385775029,0.158871279474295,0.0340162350212601,0.00889060688055663,1029,0.397758020873599,1558,0.602241979126401
"E02004043",6,191,814,1057,367,84,10,2529,0.00237247924080664,0.0755239224990115,0.321866350336101,0.41795175958877,0.145116646896006,0.033214709371293,0.00395413206801107,1011,0.399762752075919,1518,0.600237247924081
"E02004044",50,1141,851,974,513,156,35,3720,0.0134408602150538,0.306720430107527,0.228763440860215,0.261827956989247,0.137903225806452,0.0419354838709677,0.00940860215053763,2042,0.548924731182796,1678,0.451075268817204
"E02004045",10,696,1049,1422,491,91,25,3784,0.00264270613107822,0.183932346723044,0.277219873150106,0.375792811839323,0.129756871035941,0.0240486257928118,0.00660676532769556,1755,0.463794926004228,2029,0.536205073995772
"E02004046",8,186,1057,1009,302,57,16,2635,0.00303605313092979,0.0705882352941176,0.401138519924099,0.38292220113852,0.1146110056926,0.0216318785578748,0.00607210626185958,1251,0.474762808349146,1384,0.525237191650854
"E02004047",16,509,1223,1101,423,67,13,3352,0.00477326968973747,0.151849642004773,0.364856801909308,0.32846062052506,0.126193317422434,0.0199880668257757,0.00387828162291169,1748,0.521479713603819,1604,0.478520286396181
"E02004048",17,648,1134,1234,476,93,33,3635,0.0046767537826685,0.178266850068776,0.311966987620358,0.339477303988996,0.130949105914718,0.0255845942228336,0.00907840440165062,1799,0.494910591471802,1836,0.505089408528198
"E02004049",4,504,1214,1206,307,59,10,3304,0.00121065375302663,0.152542372881356,0.367433414043584,0.36501210653753,0.0929176755447942,0.0178571428571429,0.00302663438256659,1722,0.521186440677966,1582,0.478813559322034
"E02004050",3,596,1439,994,239,27,7,3305,0.000907715582450832,0.180332829046899,0.435400907715582,0.300756429652042,0.0723146747352496,0.00816944024205749,0.00211800302571861,2038,0.616641452344932,1267,0.383358547655068
"E02004051",18,524,1373,1475,613,129,21,4153,0.00433421622923188,0.12617385022875,0.330604382374187,0.355164941006501,0.147604141584397,0.0310618829761618,0.00505658560077053,1915,0.46111244883217,2238,0.53888755116783
"E02004052",6,462,1158,1218,460,87,34,3425,0.00175182481751825,0.134890510948905,0.338102189781022,0.355620437956204,0.134306569343066,0.0254014598540146,0.00992700729927007,1626,0.474744525547445,1799,0.525255474452555
"E02004053",54,256,1283,1112,470,63,21,3259,0.0165694998465787,0.0785517029763731,0.39367904265112,0.341208959803621,0.144216017183185,0.0193310831543418,0.00644369438478061,1593,0.488800245474072,1666,0.511199754525928
"E02004054",11,394,1162,1324,399,93,14,3397,0.00323815130997939,0.115984692375626,0.34206652929055,0.389755666764792,0.117456579334707,0.0273770974389167,0.00412128348542832,1567,0.461289372976155,1830,0.538710627023845
"E02004055",14,115,956,1477,413,54,9,3038,0.00460829493087558,0.0378538512179065,0.314680710994075,0.486175115207373,0.135944700460829,0.0177748518762344,0.00296247531270573,1085,0.357142857142857,1953,0.642857142857143
"E02004056",25,423,1279,1187,285,46,8,3253,0.00768521364893944,0.130033814940055,0.393175530279742,0.364893944051645,0.0876114355979096,0.0141407931140486,0.00245926836766062,1727,0.530894558868737,1526,0.469105441131264
"E02004057",2,150,1046,1367,443,58,20,3086,0.000648088139987038,0.0486066104990279,0.338950097213221,0.442968243681141,0.143551523007129,0.0187945560596241,0.00648088139987038,1198,0.388204795852236,1888,0.611795204147764
"E02004058",20,519,1373,1441,260,36,10,3659,0.00546597430992074,0.141842033342443,0.375239136376059,0.39382344902979,0.0710576660289697,0.00983875375785734,0.00273298715496037,1912,0.522547144028423,1747,0.477452855971577
"E02004059",30,303,759,1272,257,13,8,2642,0.0113550340651022,0.114685844057532,0.287282361847086,0.481453444360333,0.0972747918243755,0.00492051476154429,0.00302800908402725,1092,0.41332323996972,1550,0.58667676003028
"E02004060",15,197,865,1247,204,26,6,2560,0.005859375,0.076953125,0.337890625,0.487109375,0.0796875,0.01015625,0.00234375,1077,0.420703125,1483,0.579296875
"E02004061",1,356,977,1281,354,76,11,3056,0.000327225130890052,0.116492146596859,0.319698952879581,0.419175392670157,0.115837696335079,0.024869109947644,0.00359947643979058,1334,0.43651832460733,1722,0.56348167539267
"E02004062",10,230,1406,1319,156,10,1,3132,0.00319284802043423,0.0734355044699872,0.448914431673052,0.421136653895275,0.0498084291187739,0.00319284802043423,0.000319284802043423,1646,0.525542784163474,1486,0.474457215836526
"E02004063",7,88,599,1381,498,76,10,2659,0.00263256863482512,0.0330951485520872,0.225272658894321,0.519368183527642,0.18728845430613,0.0285821737495299,0.00376081233546446,694,0.261000376081234,1965,0.738999623918767
"E02004064",24,548,1759,1888,815,102,23,5159,0.00465206435355689,0.106222136072882,0.340957549912774,0.365962395813142,0.157976352006203,0.0197712735026168,0.00445822833882535,2331,0.451831750339213,2828,0.548168249660787
"E02004065",3,214,565,1287,370,44,4,2487,0.00120627261761158,0.0860474467229594,0.227181342983514,0.517490952955368,0.148773622838762,0.0176919983916365,0.00160836349014877,782,0.314435062324085,1705,0.685564937675915
"E02004066",8,220,1336,1849,537,78,8,4036,0.00198216055500496,0.0545094152626363,0.331020812685828,0.45812685827552,0.133052527254708,0.0193260654112983,0.00198216055500496,1564,0.387512388503469,2472,0.612487611496531
"E02004067",7,155,1359,1198,190,24,6,2939,0.00238176250425315,0.0527390268798911,0.462402177611432,0.40762164001361,0.0646478394011569,0.00816604287172508,0.00204151071793127,1521,0.517522966995577,1418,0.482477033004423
"E02004068",26,91,587,1067,588,158,53,2570,0.0101167315175097,0.035408560311284,0.2284046692607,0.415175097276265,0.228793774319066,0.0614785992217899,0.0206225680933852,704,0.273929961089494,1866,0.726070038910506
"E02004069",4,107,475,1054,652,191,62,2545,0.00157170923379175,0.0420432220039293,0.18664047151277,0.414145383104126,0.256188605108055,0.075049115913556,0.0243614931237721,586,0.230255402750491,1959,0.769744597249509
"E02004072",55,805,914,1243,507,110,15,3649,0.0150726226363387,0.220608385859139,0.25047958344752,0.340641271581255,0.138942175938613,0.0301452452726774,0.00411071526445602,1774,0.486160591942998,1875,0.513839408057002
"E02004073",5,194,1198,1473,671,157,54,3752,0.00133262260127932,0.0517057569296375,0.319296375266525,0.392590618336887,0.178837953091684,0.0418443496801706,0.0143923240938166,1397,0.372334754797441,2355,0.627665245202559
"E02004074",9,279,582,902,361,103,38,2274,0.00395778364116095,0.122691292875989,0.255936675461741,0.396657871591909,0.158751099384345,0.0452946350043975,0.0167106420404573,870,0.382585751978892,1404,0.617414248021108
"E02004075",16,208,479,842,652,305,105,2607,0.0061373225930188,0.0797851937092443,0.1837360951285,0.322976601457614,0.250095895665516,0.116992711929421,0.0402761795166858,703,0.269658611430763,1904,0.730341388569237
"E02004076",43,914,1035,981,295,46,13,3327,0.0129245566576495,0.274721971746318,0.311091073038774,0.294860234445446,0.088668470093177,0.0138262699128344,0.00390742410580102,1992,0.598737601442741,1335,0.401262398557259
"E02004077",23,367,473,722,636,341,111,2673,0.00860456416011972,0.137298915076693,0.176954732510288,0.270108492330715,0.237934904601571,0.127572016460905,0.0415263748597082,863,0.322858211747101,1810,0.677141788252899
"E02004078",3,172,1350,977,354,65,11,2932,0.00102319236016371,0.0586630286493861,0.46043656207367,0.333219645293315,0.120736698499318,0.0221691678035471,0.00375170532060027,1525,0.52012278308322,1407,0.47987721691678
"E02004080",2,352,1165,1863,976,188,56,4602,0.000434593654932638,0.0764884832681443,0.253150803998262,0.404823989569752,0.212081703607127,0.040851803563668,0.0121686223381139,1519,0.330073880921339,3083,0.669926119078662
"E02004081",5,88,551,747,313,103,19,1826,0.00273822562979189,0.0481927710843374,0.301752464403067,0.409090909090909,0.171412924424973,0.056407447973713,0.0104052573932092,644,0.352683461117196,1182,0.647316538882804
"E02004082",6,62,482,795,285,83,17,1730,0.00346820809248555,0.0358381502890173,0.278612716763006,0.459537572254335,0.164739884393064,0.0479768786127168,0.00982658959537572,550,0.317919075144509,1180,0.682080924855491
"E02004083",6,447,861,1060,525,92,17,3008,0.00199468085106383,0.148603723404255,0.28623670212766,0.352393617021277,0.174534574468085,0.0305851063829787,0.00565159574468085,1314,0.436835106382979,1694,0.563164893617021
"E02004084",6,96,1002,858,182,34,13,2191,0.00273847558192606,0.043815609310817,0.457325422181652,0.391602008215427,0.0830670926517572,0.015518028297581,0.0059333637608398,1104,0.503879507074395,1087,0.496120492925605
"E02004085",11,195,922,1330,477,102,15,3052,0.00360419397116645,0.0638925294888598,0.302096985583224,0.435779816513761,0.156290956749672,0.0334207077326343,0.00491480996068152,1128,0.36959370904325,1924,0.63040629095675
"E02004086",3,101,661,1031,365,85,19,2265,0.00132450331125828,0.0445916114790287,0.291832229580574,0.455187637969095,0.161147902869757,0.0375275938189845,0.00838852097130243,765,0.337748344370861,1500,0.662251655629139
"E02004087",48,78,757,1230,590,119,15,2837,0.0169192809305604,0.0274938315121607,0.266831159675714,0.433556573845612,0.207966161438139,0.0419457173070144,0.00528727529080014,883,0.311244272118435,1954,0.688755727881565
"E02004088",2,134,673,1032,386,72,9,2308,0.000866551126516464,0.0580589254766031,0.29159445407279,0.447140381282496,0.167244367417678,0.0311958405545927,0.00389948006932409,809,0.35051993067591,1499,0.64948006932409
"E02004089",4,285,941,1445,799,147,21,3642,0.00109829763866008,0.0782537067545305,0.258374519494783,0.396760021965953,0.21938495332235,0.0403624382207578,0.0057660626029654,1230,0.337726523887974,2412,0.662273476112026
"E02004090",5,112,692,880,395,87,18,2189,0.00228414801279123,0.0511649154865235,0.316126084970306,0.402010050251256,0.180447693010507,0.0397441754225674,0.00822293284604842,809,0.369575148469621,1380,0.630424851530379
"E02004091",5,203,847,1353,593,134,25,3160,0.00158227848101266,0.0642405063291139,0.268037974683544,0.428164556962025,0.187658227848101,0.0424050632911392,0.00791139240506329,1055,0.333860759493671,2105,0.666139240506329
"E02004092",5,167,1150,1209,497,84,19,3131,0.00159693388693708,0.0533375918236985,0.367294793995529,0.386138613861386,0.158735228361546,0.026828489300543,0.00606834877036091,1322,0.422229319706164,1809,0.577770680293836
"E02004093",1,171,710,1014,306,54,13,2269,0.000440722785368004,0.0753635962979286,0.312913177611283,0.446892904363156,0.134861172322609,0.0237990304098722,0.00572939620978405,882,0.388717496694579,1387,0.611282503305421
"E02004094",1,90,776,913,181,31,9,2001,0.000499750124937531,0.0449775112443778,0.387806096951524,0.456271864067966,0.0904547726136932,0.0154922538730635,0.00449775112443778,867,0.43328335832084,1134,0.56671664167916
"E02004095",5,405,1434,1608,526,90,26,4094,0.00122129946262824,0.0989252564728871,0.350268685881778,0.392769907181241,0.12848070346849,0.0219833903273083,0.00635075720566683,1844,0.450415241817294,2250,0.549584758182706
"E02004096",13,339,738,1216,423,98,15,2842,0.00457424349049965,0.119282195636875,0.259676284306826,0.427867698803659,0.148838845883181,0.0344827586206897,0.00527797325826882,1090,0.383532723434201,1752,0.616467276565799
"E02004097",3,86,715,1156,492,92,34,2578,0.00116369278510473,0.0333591931730023,0.277346780449961,0.448409619860357,0.190845616757176,0.0356865787432118,0.013188518231187,804,0.311869666408068,1774,0.688130333591932
"E02004098",7,154,757,1188,351,70,21,2548,0.00274725274725275,0.0604395604395604,0.297095761381476,0.466248037676609,0.137755102040816,0.0274725274725275,0.00824175824175824,918,0.360282574568289,1630,0.639717425431711
"E02004100",7,504,682,960,400,108,23,2684,0.0026080476900149,0.187779433681073,0.254098360655738,0.357675111773472,0.14903129657228,0.0402384500745156,0.00856929955290611,1193,0.444485842026826,1491,0.555514157973174
"E02004102",6,303,1336,1424,574,105,29,3777,0.00158856235107228,0.0802223987291501,0.353719883505428,0.377018797987821,0.151972464919248,0.0277998411437649,0.00767805136351602,1645,0.43553084458565,2132,0.56446915541435
"E02004103",1,190,710,1078,279,27,11,2296,0.000435540069686411,0.0827526132404181,0.309233449477352,0.469512195121951,0.121515679442509,0.0117595818815331,0.00479094076655052,901,0.392421602787456,1395,0.607578397212544
"E02004104",26,760,822,866,288,67,13,2842,0.0091484869809993,0.267417311752287,0.289232934553132,0.304714989444054,0.101337086558761,0.0235749472202674,0.00457424349049965,1608,0.565798733286418,1234,0.434201266713582
"E02004105",0,230,957,1271,341,54,12,2865,0,0.0802792321116928,0.334031413612565,0.443630017452007,0.119022687609075,0.018848167539267,0.00418848167539267,1187,0.414310645724258,1678,0.585689354275742
"E02004106",5,28,505,1099,313,53,10,2013,0.00248385494287134,0.0139095876800795,0.250869349230005,0.54595131644312,0.155489319423746,0.0263288623944362,0.00496770988574267,538,0.267262791852956,1475,0.732737208147044
"E02004108",2,130,910,1198,383,65,16,2704,0.000739644970414201,0.0480769230769231,0.336538461538462,0.443047337278107,0.14164201183432,0.0240384615384615,0.00591715976331361,1042,0.385355029585799,1662,0.614644970414201
"E02004109",5,88,449,1006,286,76,21,1931,0.00258933195235629,0.0455722423614707,0.232522009321595,0.520973588814086,0.14810978767478,0.0393578456758156,0.0108751941998964,542,0.280683583635422,1389,0.719316416364578
"E02004110",5,92,604,1098,270,31,5,2105,0.00237529691211401,0.0437054631828979,0.286935866983373,0.521615201900238,0.128266033254157,0.0147268408551069,0.00237529691211401,701,0.333016627078385,1404,0.666983372921615
"E02004111",37,418,522,949,234,61,10,2231,0.0165844912595249,0.187359928283281,0.233975795607351,0.425369789332138,0.104885701479157,0.027341999103541,0.00448229493500672,977,0.437920215150157,1254,0.562079784849843
"E02004112",3,65,475,896,300,89,26,1854,0.00161812297734628,0.035059331175836,0.256202804746494,0.483279395900755,0.161812297734628,0.0480043149946063,0.0140237324703344,543,0.292880258899676,1311,0.707119741100324
"E02004113",8,1138,1063,1636,492,86,15,4438,0.00180261378999549,0.256421811626859,0.239522307345651,0.368634520054078,0.110860748084723,0.0193780982424516,0.00337990085624155,2209,0.497746732762506,2229,0.502253267237494
"E02004114",22,1077,506,1043,360,116,33,3157,0.00696864111498258,0.341146658219829,0.160278745644599,0.330376940133038,0.11403230915426,0.0367437440608172,0.0104529616724739,1605,0.508394044979411,1552,0.491605955020589
"E02004115",14,419,925,1494,401,69,17,3339,0.00419287211740042,0.125486672656484,0.277029050613956,0.44743935309973,0.120095837076969,0.0206648697214735,0.00509134471398622,1358,0.406708595387841,1981,0.593291404612159
"E02004116",41,802,1142,1455,305,50,9,3804,0.0107781282860147,0.210830704521556,0.300210304942166,0.382492113564669,0.0801787592008412,0.0131440588853838,0.00236593059936909,1985,0.521819137749737,1819,0.478180862250263
"E02004117",11,638,575,1274,377,119,22,3016,0.00364721485411141,0.211538461538462,0.190649867374005,0.422413793103448,0.125,0.0394562334217507,0.00729442970822281,1224,0.405835543766578,1792,0.594164456233422
"E02004118",31,1442,621,880,345,130,32,3481,0.00890548692904338,0.414248779086469,0.178397012352772,0.25280091927607,0.0991094513070957,0.0373455903476013,0.009192760700948,2094,0.601551278368285,1387,0.398448721631715
"E02004119",15,1254,1954,1083,258,54,14,4632,0.00323834196891192,0.270725388601036,0.421848013816926,0.23380829015544,0.055699481865285,0.0116580310880829,0.00302245250431779,3223,0.695811744386874,1409,0.304188255613126
"E02004120",6,1394,937,1003,266,40,3,3649,0.00164428610578241,0.382022471910112,0.256782680186352,0.274869827349959,0.07289668402302,0.0109619073718827,0.000822143052891203,2337,0.640449438202247,1312,0.359550561797753
"E02004121",14,1890,642,930,276,57,14,3823,0.00366204551399425,0.494376144389223,0.167930944284593,0.243264452001046,0.0721946115616008,0.014909756735548,0.00366204551399425,2546,0.665969134187811,1277,0.334030865812189
"E02004122",16,463,475,732,348,67,21,2122,0.00754005655042413,0.218190386427898,0.223845428840716,0.344957587181904,0.163996229971725,0.031573986804901,0.00989632422243167,954,0.449575871819039,1168,0.550424128180961
"E02004123",7,295,785,1012,459,119,32,2709,0.00258397932816537,0.108896271686969,0.289774824658546,0.373569582871908,0.169435215946844,0.0439276485788114,0.011812476928756,1087,0.40125507567368,1622,0.59874492432632
"E02004124",6,436,779,1177,304,48,8,2758,0.00217548948513416,0.158085569253082,0.282451051486585,0.42675852066715,0.110224800580131,0.0174039158810732,0.00290065264684554,1221,0.442712110224801,1537,0.557287889775199
"E02004125",16,679,1070,1307,469,81,28,3650,0.00438356164383562,0.186027397260274,0.293150684931507,0.358082191780822,0.128493150684932,0.0221917808219178,0.00767123287671233,1765,0.483561643835616,1885,0.516438356164384
"E02004126",3,601,1071,1052,303,37,13,3080,0.000974025974025974,0.19512987012987,0.347727272727273,0.341558441558442,0.0983766233766234,0.012012987012987,0.00422077922077922,1675,0.543831168831169,1405,0.456168831168831
"E02004128",64,1525,1015,1469,571,201,39,4884,0.0131040131040131,0.312244062244062,0.207821457821458,0.300778050778051,0.116912366912367,0.0411547911547912,0.00798525798525799,2604,0.533169533169533,2280,0.466830466830467
"E02004129",21,92,230,642,734,312,112,2143,0.00979934671021932,0.0429304713019132,0.107326178254783,0.299580027998133,0.342510499300047,0.145590293980401,0.052263182454503,343,0.160055996266916,1800,0.839944003733084
"E02004130",8,336,1255,1122,337,59,17,3134,0.00255264837268666,0.10721123165284,0.40044671346522,0.358008934269304,0.107530312699426,0.0188257817485641,0.00542437779195916,1599,0.510210593490747,1535,0.489789406509253
"E02004131",4,48,856,972,141,23,4,2048,0.001953125,0.0234375,0.41796875,0.474609375,0.06884765625,0.01123046875,0.001953125,908,0.443359375,1140,0.556640625
"E02004132",29,438,496,950,641,271,72,2897,0.010010355540214,0.151190887124612,0.17121159820504,0.327925440110459,0.22126337590611,0.093545046599931,0.0248532965136348,963,0.332412840869865,1934,0.667587159130135
"E02004133",13,835,1401,1275,539,189,65,4317,0.00301135047486681,0.193421357424137,0.324530924252953,0.295343988881167,0.124855223534862,0.0437804030576789,0.015056752374334,2249,0.520963632151957,2068,0.479036367848043
"E02004135",19,172,589,1133,746,323,113,3095,0.0061389337641357,0.0555735056542811,0.190306946688207,0.366074313408724,0.241033925686591,0.104361873990307,0.0365105008077544,780,0.252019386106624,2315,0.747980613893376
"E02004136",21,626,951,1311,399,101,27,3436,0.00611175785797439,0.182188591385332,0.276775320139697,0.381548311990687,0.116123399301513,0.0293946449359721,0.00785797438882421,1598,0.465075669383003,1838,0.534924330616997
"E02004137",18,102,455,820,572,234,94,2295,0.00784313725490196,0.0444444444444444,0.198257080610022,0.357298474945534,0.249237472766885,0.101960784313725,0.040958605664488,575,0.250544662309368,1720,0.749455337690632
"E02004138",16,464,1212,1517,575,111,29,3924,0.00407747196738022,0.118246687054027,0.308868501529052,0.386595310907238,0.146534148827727,0.0282874617737003,0.00739041794087666,1692,0.431192660550459,2232,0.568807339449541
"E02004139",4,405,962,1144,363,55,9,2942,0.00135961930659415,0.137661454792658,0.326988443235894,0.388851121685928,0.123385452073419,0.0186947654656696,0.00305914343983685,1371,0.466009517335146,1571,0.533990482664854
"E02004140",3,176,730,1169,525,114,36,2753,0.00108972030512169,0.0639302579004722,0.265165274246277,0.42462767889575,0.190701053396295,0.041409371594624,0.0130766436614602,909,0.330185252451871,1844,0.669814747548129
"E02004141",16,227,575,866,435,111,46,2276,0.0070298769771529,0.0997363796133568,0.252636203866432,0.380492091388401,0.191124780316344,0.0487697715289982,0.0202108963093146,818,0.359402460456942,1458,0.640597539543058
"E02004142",28,249,497,659,354,84,29,1900,0.0147368421052632,0.131052631578947,0.261578947368421,0.346842105263158,0.186315789473684,0.0442105263157895,0.0152631578947368,774,0.407368421052632,1126,0.592631578947368
"E02004143",11,142,798,1030,168,23,5,2177,0.00505282498851631,0.0652273771244832,0.366559485530547,0.473128158015618,0.0771704180064309,0.0105649977032614,0.00229673863114378,951,0.436839687643546,1226,0.563160312356454
"E02004144",10,108,728,1194,329,64,10,2443,0.00409332787556283,0.0442079410560786,0.297994269340974,0.488743348342202,0.134670487106017,0.0261972984036021,0.00409332787556283,846,0.346295538272616,1597,0.653704461727384
"E02004145",11,216,922,1165,425,91,17,2847,0.00386371619248332,0.0758693361433087,0.32384966631542,0.409202669476642,0.149279943800492,0.0319634703196347,0.00597119775201967,1149,0.403582718651212,1698,0.596417281348788
"E02004146",10,233,1089,1135,276,47,11,2801,0.00357015351660121,0.0831845769368083,0.388789717957872,0.405212424134238,0.0985362370581935,0.0167797215280257,0.00392716886826134,1332,0.475544448411282,1469,0.524455551588718
"E02004147",2,213,1110,1587,654,130,49,3745,0.000534045393858478,0.0568758344459279,0.296395193591455,0.423765020026702,0.174632843791722,0.0347129506008011,0.0130841121495327,1325,0.353805073431242,2420,0.646194926568758
"E02004148",14,929,1557,1079,402,79,20,4080,0.00343137254901961,0.227696078431373,0.381617647058824,0.264460784313725,0.0985294117647059,0.0193627450980392,0.00490196078431373,2500,0.612745098039216,1580,0.387254901960784
"E02004149",3,62,728,1071,246,42,8,2160,0.00138888888888889,0.0287037037037037,0.337037037037037,0.495833333333333,0.113888888888889,0.0194444444444444,0.0037037037037037,793,0.36712962962963,1367,0.63287037037037
"E02004150",14,99,1030,917,218,46,13,2337,0.00599058622165169,0.0423620025673941,0.440735986307231,0.392383397518186,0.0932819854514335,0.0196833547282841,0.00556268720581943,1143,0.489088575096277,1194,0.510911424903723
"E02004151",114,1726,964,1108,258,50,10,4230,0.0269503546099291,0.408037825059102,0.22789598108747,0.26193853427896,0.0609929078014184,0.0118203309692671,0.00236406619385343,2804,0.662884160756501,1426,0.337115839243499
"E02004152",4,195,1118,1511,507,86,26,3447,0.00116042935886278,0.0565709312445605,0.324340005802147,0.438352190310415,0.147084421235857,0.0249492312155498,0.00754279083260806,1317,0.38207136640557,2130,0.61792863359443
"E02004153",45,166,1238,1192,294,37,7,2979,0.0151057401812689,0.0557233971131252,0.415575696542464,0.400134273246056,0.0986908358509567,0.0124202752601544,0.00234978180597516,1449,0.486404833836858,1530,0.513595166163142
"E02004154",8,200,1200,1501,375,62,18,3364,0.00237812128418549,0.0594530321046373,0.356718192627824,0.446195005945303,0.111474435196195,0.0184304399524376,0.00535077288941736,1408,0.418549346016647,1956,0.581450653983353
"E02004155",44,180,1067,946,200,42,10,2489,0.0176777822418642,0.0723182000803536,0.428686219365207,0.38007231820008,0.0803535556448373,0.0168742466854158,0.00401767778224186,1291,0.518682201687425,1198,0.481317798312575
"E02004156",1,761,2728,1525,612,103,45,5775,0.000173160173160173,0.131774891774892,0.472380952380952,0.264069264069264,0.105974025974026,0.0178354978354978,0.00779220779220779,3490,0.604329004329004,2285,0.395670995670996
"E02004157",42,174,1069,1195,367,72,16,2935,0.0143100511073254,0.0592844974446337,0.364224872231687,0.407155025553663,0.125042589437819,0.0245315161839864,0.00545144804088586,1285,0.437819420783646,1650,0.562180579216354
"E02004158",2,255,972,1401,434,93,30,3187,0.000627549419516787,0.0800125509883903,0.304989017885158,0.439598368371509,0.136178224035143,0.0291810480075306,0.0094132412927518,1229,0.385629118293066,1958,0.614370881706934
"E02004159",174,1532,1655,978,269,54,20,4682,0.0371636052968817,0.327210593763349,0.353481418197352,0.208885091841094,0.0574540794532251,0.0115335326783426,0.00427167876975651,3361,0.717855617257582,1321,0.282144382742418
"E02004160",21,124,748,975,258,42,14,2182,0.00962419798350138,0.0568285976168653,0.342804766269478,0.446837763519707,0.118240146654445,0.0192483959670028,0.00641613198900092,893,0.409257561869844,1289,0.590742438130156
"E02004161",380,582,1301,1058,259,62,18,3660,0.103825136612022,0.159016393442623,0.355464480874317,0.289071038251366,0.0707650273224044,0.0169398907103825,0.00491803278688525,2263,0.618306010928962,1397,0.381693989071038
"E02004162",68,206,1300,1075,215,49,14,2927,0.0232319781346088,0.0703792278783738,0.444140758455757,0.367270242569183,0.0734540485138367,0.0167406901264093,0.00478305432183123,1574,0.537751964468739,1353,0.462248035531261
"E02004163",251,1055,980,1052,355,69,15,3777,0.0664548583531904,0.279322213396876,0.259465184008472,0.27852793222134,0.0939899391051099,0.0182684670373312,0.0039714058776807,2286,0.605242255758539,1491,0.394757744241461
"E02004164",32,153,316,646,714,371,136,2368,0.0135135135135135,0.0646114864864865,0.133445945945946,0.272804054054054,0.30152027027027,0.156672297297297,0.0574324324324324,501,0.211570945945946,1867,0.788429054054054
"E02004165",21,766,1208,1021,310,93,20,3439,0.00610642628671125,0.222739168362896,0.351264902587962,0.296888630415819,0.0901424832800233,0.027042744984007,0.00581564408258215,1995,0.580110497237569,1444,0.419889502762431
"E02004166",19,261,532,708,521,217,62,2320,0.00818965517241379,0.1125,0.229310344827586,0.305172413793103,0.224568965517241,0.0935344827586207,0.0267241379310345,812,0.35,1508,0.65
"E02004167",12,243,1194,811,312,97,24,2693,0.00445599702933531,0.0902339398440401,0.443371704418864,0.301151132565912,0.115855922762718,0.0360193093204605,0.00891199405867063,1449,0.538061641292239,1244,0.461938358707761
"E02004168",15,334,794,944,469,100,38,2694,0.00556792873051225,0.123979213066073,0.294729027468448,0.350408314773571,0.174090571640683,0.0371195248700817,0.014105419450631,1143,0.424276169265033,1551,0.575723830734967
"E02004169",49,368,660,880,415,140,37,2549,0.0192232247940369,0.144370341310318,0.258925068654374,0.345233424872499,0.16280894468419,0.0549234994115339,0.0145154962730483,1077,0.422518634758729,1472,0.577481365241271
"E02004170",32,654,1337,1103,263,44,16,3449,0.00927805160916208,0.18962017976225,0.387648593795303,0.319802841403305,0.0762539866628008,0.0127573209625979,0.00463902580458104,2023,0.586546825166715,1426,0.413453174833285
"E02004171",44,663,684,860,519,231,59,3060,0.0143790849673203,0.216666666666667,0.223529411764706,0.281045751633987,0.169607843137255,0.0754901960784314,0.019281045751634,1391,0.454575163398693,1669,0.545424836601307
"E02004172",27,148,288,713,615,301,99,2191,0.0123231401186673,0.0675490643541762,0.131446827932451,0.325422181652214,0.280693747147421,0.137380191693291,0.04518484710178,463,0.211319032405294,1728,0.788680967594706
"E02004173",22,198,543,765,578,260,109,2475,0.00888888888888889,0.08,0.219393939393939,0.309090909090909,0.233535353535354,0.105050505050505,0.044040404040404,763,0.308282828282828,1712,0.691717171717172
"E02004174",47,587,1160,1086,378,111,38,3407,0.0137951276783094,0.172292339301438,0.340475491634869,0.318755503375404,0.11094804813619,0.0325799823891987,0.0111535074845905,1794,0.526562958614617,1613,0.473437041385383
"E02004175",6,145,767,1110,516,118,58,2720,0.00220588235294118,0.0533088235294118,0.281985294117647,0.408088235294118,0.189705882352941,0.0433823529411765,0.0213235294117647,918,0.3375,1802,0.6625
"E02004176",3,72,390,876,722,366,140,2569,0.00116776956014013,0.0280264694433632,0.151810042818217,0.340988711560919,0.281043207473725,0.142467886337096,0.0544959128065395,465,0.181004281821721,2104,0.81899571817828
"E02004177",1,123,826,1025,489,107,53,2624,0.00038109756097561,0.046875,0.314786585365854,0.390625,0.186356707317073,0.0407774390243902,0.0201981707317073,950,0.362042682926829,1674,0.637957317073171
"E02004178",28,285,856,902,608,242,118,3039,0.0092135570911484,0.0937808489634748,0.281671602500823,0.296808160579138,0.20006581112208,0.0796314577163541,0.0388285620269826,1169,0.384666008555446,1870,0.615333991444554
"E02004179",45,346,1108,1395,507,104,63,3568,0.0126121076233184,0.0969730941704036,0.310538116591928,0.39097533632287,0.142096412556054,0.0291479820627803,0.0176569506726457,1499,0.42012331838565,2069,0.57987668161435
"E02004180",100,309,425,619,498,248,112,2311,0.043271311120727,0.133708351363046,0.18390307226309,0.2678494158373,0.21549112938122,0.107312851579403,0.0484638684552142,834,0.360882734746863,1477,0.639117265253137
"E02004181",24,248,759,696,297,67,21,2112,0.0113636363636364,0.117424242424242,0.359375,0.329545454545455,0.140625,0.0317234848484848,0.00994318181818182,1031,0.488162878787879,1081,0.511837121212121
"E02004182",1,239,1114,1026,461,63,43,2947,0.000339328130302002,0.0810994231421785,0.37801153715643,0.348150661689854,0.156430268069223,0.0213776722090261,0.0145911096029861,1354,0.459450288428911,1593,0.540549711571089
"E02004183",10,268,656,949,374,69,18,2344,0.00426621160409556,0.114334470989761,0.279863481228669,0.404863481228669,0.159556313993174,0.0294368600682594,0.00767918088737201,934,0.398464163822526,1410,0.601535836177474
"E02004184",19,257,1297,1189,335,58,16,3171,0.00599180069378745,0.0810469883317565,0.409019236833806,0.374960580258594,0.10564490696941,0.0182907600126143,0.00504572690003154,1573,0.49605802585935,1598,0.50394197414065
"E02004185",64,692,614,822,343,93,31,2659,0.0240691989469725,0.260248213614141,0.230913877397518,0.309138773975179,0.128995863106431,0.0349755547198195,0.0116585182399398,1370,0.515231289958631,1289,0.484768710041369
"E02004186",25,1327,1087,1133,367,127,45,4111,0.00608124543906592,0.322792507905619,0.264412551690586,0.275602043298468,0.0892726830454877,0.0308927268304549,0.0109462417903187,2439,0.593286305035271,1672,0.406713694964729
"E02004187",89,844,1091,1170,806,319,124,4443,0.0200315102408283,0.189961737564709,0.245554805311726,0.263335584064821,0.181408957911321,0.0717983344586991,0.0279090704478956,2024,0.455548053117263,2419,0.544451946882737
"E02004188",46,244,471,817,717,349,138,2782,0.0165348670021567,0.087706685837527,0.169302659956866,0.293673616103523,0.257728253055356,0.125449317038102,0.0496046010064702,761,0.273544212796549,2021,0.726455787203451
"E02004189",23,186,770,741,249,112,30,2111,0.0108953102794884,0.0881099005210801,0.364756039791568,0.351018474656561,0.117953576504027,0.0530554239696826,0.0142112742775936,979,0.463761250592136,1132,0.536238749407864
"E02004190",220,605,552,984,646,296,142,3445,0.0638606676342525,0.175616835994194,0.160232220609579,0.285631349782293,0.187518142235123,0.085921625544267,0.0412191582002903,1377,0.399709724238026,2068,0.600290275761974
"E02004191",33,602,1231,1498,640,124,30,4158,0.00793650793650794,0.144781144781145,0.296055796055796,0.36026936026936,0.153920153920154,0.0298220298220298,0.00721500721500722,1866,0.448773448773449,2292,0.551226551226551
"E02004192",26,238,535,1129,875,400,135,3338,0.00778909526662672,0.0713001797483523,0.160275614140204,0.338226482923907,0.262133013780707,0.11983223487118,0.0404433792690234,799,0.239364889155183,2539,0.760635110844817
"E02004193",11,371,1479,1650,331,54,14,3910,0.00281329923273657,0.0948849104859335,0.378260869565217,0.421994884910486,0.0846547314578005,0.0138107416879795,0.00358056265984655,1861,0.475959079283887,2049,0.524040920716113
"E02004194",83,376,498,921,668,284,98,2928,0.0283469945355191,0.128415300546448,0.170081967213115,0.314549180327869,0.228142076502732,0.0969945355191257,0.0334699453551913,957,0.326844262295082,1971,0.673155737704918
"E02004195",6,104,880,1105,634,263,88,3080,0.00194805194805195,0.0337662337662338,0.285714285714286,0.358766233766234,0.205844155844156,0.0853896103896104,0.0285714285714286,990,0.321428571428571,2090,0.678571428571429
"E02004196",31,408,574,927,719,322,112,3093,0.0100226317491109,0.131910766246363,0.185580342709344,0.299709020368574,0.232460394439056,0.10410604591012,0.0362107985774329,1013,0.327513740704817,2080,0.672486259295183
"E02004197",28,1581,658,871,466,159,57,3820,0.00732984293193717,0.413874345549738,0.172251308900524,0.228010471204188,0.121989528795812,0.0416230366492147,0.0149214659685864,2267,0.593455497382199,1553,0.406544502617801
"E02004198",11,264,1017,1105,456,112,38,3003,0.00366300366300366,0.0879120879120879,0.338661338661339,0.367965367965368,0.151848151848152,0.0372960372960373,0.0126540126540127,1292,0.43023643023643,1711,0.56976356976357
"E02004199",73,338,475,909,975,441,125,3336,0.0218824940047962,0.101318944844125,0.142386091127098,0.272482014388489,0.29226618705036,0.132194244604317,0.0374700239808154,886,0.265587529976019,2450,0.734412470023981
"E02004200",39,375,679,1094,805,326,94,3412,0.0114302461899179,0.109906213364596,0.199003516998828,0.32063305978898,0.235932004689332,0.0955451348182884,0.0275498241500586,1093,0.320339976553341,2319,0.679660023446659
"E02004201",22,64,200,598,495,231,72,1682,0.0130796670630202,0.0380499405469679,0.118906064209275,0.355529131985731,0.294292508917955,0.137336504161712,0.0428061831153389,286,0.170035671819263,1396,0.829964328180737
"E02004202",125,909,822,1190,512,132,50,3740,0.0334224598930481,0.243048128342246,0.219786096256684,0.318181818181818,0.136898395721925,0.0352941176470588,0.0133689839572193,1856,0.496256684491979,1884,0.503743315508021
"E02004203",10,260,331,685,555,320,114,2275,0.0043956043956044,0.114285714285714,0.145494505494505,0.301098901098901,0.243956043956044,0.140659340659341,0.0501098901098901,601,0.264175824175824,1674,0.735824175824176
"E02004204",23,573,1352,1338,513,177,83,4059,0.00566642030056664,0.141167775314117,0.333086967233309,0.329637841832964,0.126385809312639,0.0436067997043607,0.0204483863020448,1948,0.479921162847992,2111,0.520078837152008
"E02004205",26,1023,990,1071,441,139,32,3722,0.00698549167114455,0.27485222998388,0.265986029016658,0.287748522299839,0.118484685652875,0.0373455131649651,0.00859752821063944,2039,0.547823750671682,1683,0.452176249328318
"E02004206",24,259,1048,1249,482,106,50,3218,0.0074580484773151,0.0804847731510255,0.325668116842759,0.388129272840273,0.149782473586078,0.0329397141081417,0.0155376009944065,1331,0.4136109384711,1887,0.5863890615289
"E02004207",8,374,662,757,329,131,35,2296,0.00348432055749129,0.162891986062718,0.288327526132404,0.329703832752613,0.143292682926829,0.0570557491289199,0.0152439024390244,1044,0.454703832752613,1252,0.545296167247387
"E02004208",6,244,974,1444,437,76,17,3198,0.00187617260787992,0.0762976860537836,0.304565353345841,0.451532207629769,0.136647904940588,0.0237648530331457,0.00531582238899312,1224,0.382739212007505,1974,0.617260787992495
"E02004209",18,540,995,1312,299,65,13,3242,0.00555212831585441,0.166563849475632,0.306909315237508,0.404688463911166,0.0922270203578038,0.0200493522516965,0.0040098704503393,1553,0.479025293028994,1689,0.520974706971006
"E02004210",3,223,1113,1272,621,131,52,3415,0.000878477306002928,0.0653001464128843,0.325915080527086,0.372474377745242,0.181844802342606,0.0383601756954612,0.0152269399707174,1339,0.392093704245974,2076,0.607906295754026
"E02004211",16,124,760,1121,429,107,38,2595,0.00616570327552987,0.0477842003853565,0.292870905587669,0.431984585741811,0.165317919075145,0.041233140655106,0.0146435452793834,900,0.346820809248555,1695,0.653179190751445
"E02004212",5,420,813,791,224,41,19,2313,0.00216169476869866,0.181582360570687,0.351491569390402,0.341980112408128,0.0968439256377,0.017725897103329,0.00821444012105491,1238,0.535235624729788,1075,0.464764375270212
"E02004213",13,1382,775,775,232,80,24,3281,0.00396220664431576,0.421213044803414,0.236208473026516,0.236208473026516,0.070710149344712,0.0243828101188662,0.00731484303565986,2170,0.661383724474246,1111,0.338616275525754
"E02004214",5,179,937,1254,444,78,22,2919,0.00171291538198013,0.0613223706748887,0.321000342583076,0.429599177800617,0.152106885919836,0.02672147995889,0.00753682768071257,1121,0.384035628639945,1798,0.615964371360055
"E02004215",0,346,610,919,380,102,23,2380,0,0.145378151260504,0.256302521008403,0.386134453781513,0.159663865546218,0.0428571428571429,0.00966386554621849,956,0.401680672268908,1424,0.598319327731092
"E02004216",2,68,495,928,243,54,12,1802,0.00110987791342952,0.0377358490566038,0.274694783573807,0.514983351831299,0.134850166481687,0.0299667036625971,0.00665926748057714,565,0.31354051054384,1237,0.68645948945616
"E02004217",2,200,785,1198,528,149,63,2925,0.000683760683760684,0.0683760683760684,0.268376068376068,0.40957264957265,0.180512820512821,0.0509401709401709,0.0215384615384615,987,0.337435897435897,1938,0.662564102564102
"E02004218",12,315,433,883,383,111,27,2164,0.0055452865064695,0.145563770794824,0.200092421441774,0.408040665434381,0.176987060998152,0.0512939001848429,0.0124768946395564,760,0.351201478743068,1404,0.648798521256932
"E02004219",15,96,361,745,378,91,33,1719,0.0087260034904014,0.0558464223385689,0.21000581733566,0.433391506689936,0.219895287958115,0.0529377545084351,0.0191972076788831,472,0.274578243164631,1247,0.725421756835369
"E02004220",40,398,1022,1126,386,113,52,3137,0.0127510360216768,0.126872808415684,0.325788970353841,0.358941664010201,0.123047497609181,0.0360216767612369,0.0165763468281798,1460,0.465412814791202,1677,0.534587185208798
"E02004221",27,751,1009,975,361,95,20,3238,0.0083384805435454,0.231933292155652,0.311612106238419,0.301111797405806,0.111488573193329,0.0293390982087708,0.00617665225447807,1787,0.551883878937616,1451,0.448116121062384
"E02004222",4,210,840,1131,477,124,48,2834,0.00141143260409315,0.0741002117148906,0.296400846859562,0.399082568807339,0.168313338038109,0.0437544107268878,0.0169371912491179,1054,0.371912491178546,1780,0.628087508821454
"E02004223",30,1112,2116,1341,557,114,51,5321,0.00563803796278895,0.20898327382071,0.397669610975381,0.252020296936666,0.104679571509115,0.021424544258598,0.00958466453674121,3258,0.61229092275888,2063,0.38770907724112
"E02004224",15,160,413,828,726,436,155,2733,0.00548847420417124,0.0585437248444932,0.151115989754848,0.302963776070252,0.265642151481888,0.159531650201244,0.0567142334431028,588,0.215148188803513,2145,0.784851811196487
"E02004225",14,287,861,766,264,67,19,2278,0.00614574187884109,0.125987708516242,0.377963125548727,0.336259877085162,0.115891132572432,0.0294117647058824,0.00834064969271291,1162,0.51009657594381,1116,0.48990342405619
"E02004226",24,166,533,874,778,352,134,2861,0.00838867528836071,0.0580216707444949,0.186298497029011,0.305487591751136,0.271932890597693,0.12303390422929,0.046836770360014,723,0.252708843061866,2138,0.747291156938134
"E02004227",48,312,941,1330,1093,471,171,4366,0.01099404489235,0.0714612918002749,0.215529088410444,0.304626660558864,0.250343563902886,0.107879065506184,0.0391662849289968,1301,0.297984425103069,3065,0.702015574896931
"E02004228",32,186,386,904,718,364,156,2746,0.0116533139111435,0.0677348871085215,0.140568099053168,0.329206117989803,0.261471230881282,0.132556445739257,0.0568099053168245,604,0.219956300072833,2142,0.780043699927167
"E02004229",73,1075,873,982,655,303,141,4102,0.0177961969770843,0.262067284251585,0.21282301316431,0.23939541686982,0.159678205753291,0.0738664066309117,0.0343734763529985,2021,0.492686494392979,2081,0.507313505607021
"E02004230",6,305,1211,1037,457,146,54,3216,0.00186567164179104,0.0948383084577114,0.376554726368159,0.322450248756219,0.142101990049751,0.0453980099502488,0.0167910447761194,1522,0.473258706467662,1694,0.526741293532338
"E02004231",18,205,410,769,652,393,143,2590,0.00694980694980695,0.0791505791505791,0.158301158301158,0.296911196911197,0.251737451737452,0.151737451737452,0.0552123552123552,633,0.244401544401544,1957,0.755598455598456
"E02004232",34,102,336,680,706,403,190,2451,0.0138718890248878,0.0416156670746634,0.137086903304774,0.277437780497756,0.288045695634435,0.164422684618523,0.0775193798449612,472,0.192574459404325,1979,0.807425540595675
"E02004233",44,895,1581,1885,662,150,44,5261,0.00836342900589242,0.17011974909713,0.300513210416271,0.358296901729709,0.12583159095229,0.0285116897928151,0.00836342900589242,2520,0.478996388519293,2741,0.521003611480707
"E02004234",11,76,337,694,526,286,111,2041,0.00538951494365507,0.0372366487016169,0.165115139637433,0.340029397354238,0.257716805487506,0.140127388535032,0.0543851053405194,424,0.207741303282705,1617,0.792258696717295
"E02004235",9,241,557,881,444,168,73,2373,0.00379266750948167,0.101559207753898,0.23472397808681,0.37126000842815,0.187104930467762,0.0707964601769911,0.0307627475769069,807,0.34007585335019,1566,0.65992414664981
"E02004236",6,89,661,855,277,51,14,1953,0.00307219662058372,0.0455709165386585,0.338453661034306,0.43778801843318,0.141833077316948,0.0261136712749616,0.00716845878136201,756,0.387096774193548,1197,0.612903225806452
"E02004237",6,245,834,1173,284,49,3,2594,0.0023130300693909,0.0944487278334618,0.321511179645335,0.452197378565921,0.109483423284503,0.0188897455666924,0.00115651503469545,1085,0.418272937548188,1509,0.581727062451812
"E02004238",7,660,1187,1422,421,84,9,3790,0.00184696569920844,0.174142480211082,0.313192612137203,0.375197889182058,0.111081794195251,0.0221635883905013,0.00237467018469657,1854,0.489182058047493,1936,0.510817941952507
"E02004239",4,250,704,1065,210,22,1,2256,0.00177304964539007,0.110815602836879,0.312056737588652,0.472074468085106,0.0930851063829787,0.00975177304964539,0.000443262411347518,958,0.424645390070922,1298,0.575354609929078
"E02004240",0,204,1495,832,118,21,8,2678,0,0.0761762509335325,0.558252427184466,0.310679611650485,0.0440627333831217,0.00784167289021658,0.00298730395817774,1699,0.634428678117999,979,0.365571321882001
"E02004241",4,455,1861,1581,459,79,24,4463,0.000896258122339234,0.101949361416088,0.416984091418328,0.354246022854582,0.102845619538427,0.0177010979161999,0.0053775487340354,2320,0.519829710956756,2143,0.480170289043244
"E02004242",16,120,897,1343,346,52,7,2781,0.00575332614167566,0.0431499460625674,0.322545846817691,0.4829198130169,0.124415677813736,0.0186983099604459,0.0025170801869831,1033,0.371449119021935,1748,0.628550880978065
"E02004243",8,102,405,843,535,133,47,2073,0.00385914134105162,0.0492040520984081,0.195369030390738,0.406657018813314,0.258080077182827,0.0641582247949831,0.0226724553786782,515,0.248432223830198,1558,0.751567776169802
"E02004244",9,212,828,1391,212,23,1,2676,0.00336322869955157,0.0792227204783259,0.309417040358744,0.519805680119582,0.0792227204783259,0.0085949177877429,0.000373692077727952,1049,0.392002989536622,1627,0.607997010463378
"E02004245",20,397,968,1022,136,21,6,2570,0.00778210116731518,0.154474708171206,0.376653696498054,0.397665369649805,0.0529182879377432,0.00817120622568093,0.00233463035019455,1385,0.538910505836576,1185,0.461089494163424
"E02004246",14,461,667,1079,325,65,10,2621,0.00534147272033575,0.175887066005341,0.254483021747425,0.411674933231591,0.123998473864937,0.0247996947729874,0.00381533765738268,1142,0.435711560473102,1479,0.564288439526898
"E02004247",10,100,308,559,538,186,70,1771,0.00564652738565782,0.0564652738565782,0.173913043478261,0.315640880858272,0.303783173348391,0.105025409373235,0.0395256916996047,418,0.236024844720497,1353,0.763975155279503
"E02004248",4,204,945,1261,276,38,7,2735,0.00146252285191956,0.0745886654478976,0.345521023765996,0.461060329067642,0.10091407678245,0.0138939670932358,0.00255941499085923,1153,0.421572212065814,1582,0.578427787934186
"E02004249",65,649,450,688,205,33,9,2099,0.0309671272034302,0.309194854692711,0.214387803716055,0.327775131014769,0.097665555026203,0.0157217722725107,0.00428775607432111,1164,0.554549785612196,935,0.445450214387804
"E02004250",2,367,1285,1256,325,48,13,3296,0.000606796116504854,0.111347087378641,0.389866504854369,0.381067961165049,0.0986043689320388,0.0145631067961165,0.00394417475728155,1654,0.501820388349515,1642,0.498179611650485
"E02004251",1,97,609,1083,230,35,6,2061,0.000485201358563804,0.047064531780689,0.295487627365357,0.5254730713246,0.111596312469675,0.0169820475497331,0.00291120815138282,707,0.343037360504609,1354,0.656962639495391
"E02004252",42,1148,1223,1293,463,72,17,4258,0.00986378581493659,0.269610145608267,0.287224048849225,0.303663691874119,0.108736496007515,0.0169093471113199,0.00399248473461719,2413,0.566697980272428,1845,0.433302019727572
"E02004253",1,528,1016,1405,403,64,16,3433,0.000291290416545296,0.153801339935916,0.29595106321002,0.40926303524614,0.117390037867754,0.0186425866588989,0.00466064666472473,1545,0.450043693562482,1888,0.549956306437518
"E02004254",17,227,1056,1396,284,49,10,3039,0.00559394537676867,0.0746956235603817,0.347482724580454,0.459361632115828,0.0934517933530767,0.0161237249095097,0.00329055610398157,1300,0.427772293517604,1739,0.572227706482396
"E02004255",18,362,1318,1212,278,59,10,3257,0.00552655818237642,0.111145225667792,0.404666871354007,0.372121584280012,0.0853546208167025,0.0181148295977894,0.00307031010132023,1698,0.521338655204176,1559,0.478661344795824
"E02004256",23,193,1202,1016,518,261,77,3290,0.00699088145896657,0.0586626139817629,0.365349544072948,0.308814589665654,0.157446808510638,0.0793313069908815,0.0234042553191489,1418,0.431003039513678,1872,0.568996960486322
"E02004257",13,1109,1487,1012,343,76,24,4064,0.0031988188976378,0.272883858267717,0.365895669291339,0.249015748031496,0.0843996062992126,0.0187007874015748,0.00590551181102362,2609,0.641978346456693,1455,0.358021653543307
"E02004258",11,573,1333,1396,563,221,52,4149,0.00265124126295493,0.138105567606652,0.321282236683538,0.33646661846228,0.135695348276693,0.0532658471920945,0.0125331405157869,1917,0.462039045553145,2232,0.537960954446855
"E02004259",10,180,479,765,568,209,54,2265,0.00441501103752759,0.0794701986754967,0.211479028697572,0.337748344370861,0.250772626931567,0.0922737306843267,0.023841059602649,669,0.295364238410596,1596,0.704635761589404
"E02004260",9,702,926,1256,443,131,31,3498,0.00257289879931389,0.200686106346484,0.264722698684963,0.359062321326472,0.126643796455117,0.0374499714122356,0.00886220697541452,1637,0.46798170383076,1861,0.53201829616924
"E02004261",4,556,1858,1344,420,88,24,4294,0.000931532370749884,0.129482999534234,0.432696786213321,0.312994876571961,0.0978108989287378,0.0204937121564974,0.0055891942244993,2418,0.563111318118305,1876,0.436888681881695
"E02004262",20,242,554,961,569,197,58,2601,0.00768935024990388,0.093041138023837,0.212995001922338,0.369473279507882,0.218762014609765,0.0757400999615532,0.0222991157247213,816,0.313725490196078,1785,0.686274509803921
"E02004263",30,194,682,729,301,79,37,2052,0.0146198830409357,0.094541910331384,0.332358674463938,0.355263157894737,0.146686159844055,0.0384990253411306,0.0180311890838207,906,0.441520467836257,1146,0.558479532163743
"E02004264",4,253,944,1073,253,33,14,2574,0.00155400155400155,0.0982905982905983,0.366744366744367,0.416860916860917,0.0982905982905983,0.0128205128205128,0.00543900543900544,1201,0.466588966588967,1373,0.533411033411033
"E02004265",10,293,922,1208,357,70,17,2877,0.00347584289190129,0.101842196732708,0.320472714633299,0.419881821341675,0.124087591240876,0.024330900243309,0.00590893291623219,1225,0.425790754257908,1652,0.574209245742092
"E02004266",12,239,949,1054,570,111,36,2971,0.00403904409289801,0.0804442948502188,0.319421070346685,0.354762706159542,0.191854594412656,0.0373611578593066,0.012117132278694,1200,0.403904409289801,1771,0.596095590710199
"E02004267",11,121,375,653,454,180,51,1845,0.00596205962059621,0.0655826558265583,0.203252032520325,0.353929539295393,0.246070460704607,0.0975609756097561,0.0276422764227642,507,0.27479674796748,1338,0.72520325203252
"E02004268",13,547,1474,1808,748,177,50,4817,0.00269877517126842,0.113556155283371,0.30599958480382,0.375337346896409,0.155283371392983,0.0367448619472701,0.0103799045048786,2034,0.42225451525846,2783,0.57774548474154
"E02004269",0,777,1547,1404,508,91,28,4355,0,0.17841561423651,0.355223880597015,0.322388059701493,0.116647531572905,0.0208955223880597,0.00642939150401837,2324,0.533639494833525,2031,0.466360505166475
"E02004270",18,124,405,871,875,359,100,2752,0.0065406976744186,0.0450581395348837,0.147165697674419,0.316497093023256,0.317950581395349,0.130450581395349,0.0363372093023256,547,0.198764534883721,2205,0.801235465116279
"E02004271",46,203,940,1355,1091,391,123,4149,0.0110870089178115,0.0489274523981682,0.226560617016148,0.326584719209448,0.26295492889853,0.0942395758013979,0.029645697758496,1189,0.286575078332128,2960,0.713424921667872
"E02004272",39,469,1102,1469,1008,331,92,4510,0.00864745011086475,0.103991130820399,0.244345898004435,0.325720620842572,0.22350332594235,0.0733924611973392,0.0203991130820399,1610,0.356984478935698,2900,0.643015521064302
"E02004273",20,400,878,1131,725,279,124,3557,0.00562271577171774,0.112454315434355,0.246837222378409,0.317964576890638,0.203823446724768,0.0784368850154625,0.03486083778465,1298,0.364914253584481,2259,0.635085746415519
"E02004274",3,161,957,981,344,79,39,2564,0.00117004680187207,0.062792511700468,0.373244929797192,0.382605304212168,0.134165366614665,0.030811232449298,0.015210608424337,1121,0.437207488299532,1443,0.562792511700468
"E02004275",73,196,700,975,716,314,85,3059,0.0238640078457012,0.0640732265446224,0.22883295194508,0.31873161163779,0.23406341941811,0.102647924158222,0.027786858450474,969,0.316770186335404,2090,0.683229813664596
"E02004276",5,263,1083,998,366,94,35,2844,0.00175808720112518,0.0924753867791843,0.380801687763713,0.350914205344585,0.128691983122363,0.0330520393811533,0.0123066104078762,1351,0.475035161744022,1493,0.524964838255978
"E02004278",4,228,1225,1243,344,53,6,3103,0.00128907508862391,0.073477280051563,0.394779245891073,0.400580083789881,0.110860457621656,0.0170802449242668,0.00193361263293587,1457,0.46954560103126,1646,0.53045439896874
"E02004279",14,401,943,1012,450,127,43,2990,0.00468227424749164,0.134113712374582,0.315384615384615,0.338461538461538,0.150501672240803,0.0424749163879599,0.01438127090301,1358,0.454180602006689,1632,0.545819397993311
"E02004280",9,734,822,992,435,162,47,3201,0.0028116213683224,0.229303342705405,0.256794751640112,0.30990315526398,0.135895032802249,0.0506091846298032,0.0146829115901281,1565,0.488909715713839,1636,0.511090284286161
"E02004281",28,448,1338,950,209,44,10,3027,0.00925008259002313,0.14800132144037,0.442021803766105,0.313842087875785,0.0690452593326726,0.0145358440700363,0.00330360092500826,1814,0.599273207796498,1213,0.400726792203502
"E02004282",8,419,941,1389,376,77,13,3223,0.00248215947874651,0.130003102699348,0.291964008687558,0.430964939497363,0.116661495501086,0.0238907849829352,0.00403350915296308,1368,0.424449270865653,1855,0.575550729134347
"E02004283",27,319,931,1179,348,71,19,2894,0.00932964754664824,0.11022805805114,0.3217000691085,0.407394609536973,0.120248790601244,0.0245335176226676,0.00656530753282654,1277,0.441257774706289,1617,0.558742225293711
"E02004284",2,423,2211,2055,909,168,77,5845,0.000342172797262618,0.0723695466210436,0.378272027373824,0.35158254918734,0.15551753635586,0.0287425149700599,0.0131736526946108,2636,0.45098374679213,3209,0.54901625320787
"E02004285",18,640,1083,1211,332,49,22,3355,0.00536512667660209,0.190760059612519,0.322801788375559,0.360953800298063,0.098956780923994,0.0146050670640835,0.00655737704918033,1741,0.51892697466468,1614,0.48107302533532
"E02004286",3,101,584,716,217,32,5,1658,0.00180940892641737,0.0609167671893848,0.352231604342581,0.431845597104946,0.130880579010856,0.0193003618817853,0.00301568154402895,688,0.414957780458384,970,0.585042219541617
"E02004287",1,71,664,796,243,37,15,1827,0.000547345374931582,0.0388615216201423,0.36343732895457,0.435686918445539,0.133004926108374,0.0202517788724685,0.00821018062397373,736,0.402846195949644,1091,0.597153804050356
"E02004288",1,290,921,816,381,64,30,2503,0.000399520575309628,0.115860966839792,0.367958449860168,0.326008789452657,0.152217339192968,0.0255693168198162,0.0119856172592889,1212,0.48421893727527,1291,0.51578106272473
"E02004289",9,374,847,982,401,101,29,2743,0.003281079110463,0.136347065257018,0.308786000729129,0.358002187386074,0.146190302588407,0.036820998906307,0.010572366022603,1230,0.44841414509661,1513,0.551585854903391
"E02004290",1,154,536,832,194,33,7,1757,0.000569151963574274,0.0876494023904383,0.305065452475811,0.473534433693796,0.110415480933409,0.0187820147979511,0.00398406374501992,691,0.393284006829824,1066,0.606715993170176
"E02004291",17,242,1276,1197,202,21,6,2961,0.00574130361364404,0.0817291455589328,0.430935494765282,0.404255319148936,0.0682201958797704,0.00709219858156028,0.00202634245187437,1535,0.518405943937859,1426,0.481594056062141
"E02004292",3,441,768,1185,269,35,7,2708,0.00110782865583456,0.162850812407681,0.283604135893648,0.437592319054653,0.0993353028064993,0.0129246676514032,0.00258493353028065,1212,0.447562776957164,1496,0.552437223042836
"E02004293",15,491,1882,1638,205,19,3,4253,0.00352692217258406,0.115447919115918,0.44251116858688,0.385139901246179,0.0482012696919821,0.00446743475193981,0.000705384434516812,2388,0.561486009875382,1865,0.438513990124618
"E02004294",2,62,933,1283,250,27,1,2558,0.000781860828772478,0.0242376856919468,0.364738076622361,0.501563721657545,0.0977326035965598,0.0105551211884285,0.000390930414386239,997,0.389757623143081,1561,0.610242376856919
"E02004295",2,269,743,1135,270,37,12,2468,0.000810372771474878,0.108995137763371,0.301053484602917,0.459886547811994,0.109400324149109,0.0149918962722853,0.00486223662884927,1014,0.410858995137763,1454,0.589141004862237
"E02004296",7,463,1090,1387,266,36,13,3262,0.00214592274678112,0.141937461679951,0.334150827713059,0.425199264255058,0.0815450643776824,0.0110361741263029,0.00398528510116493,1560,0.478234212139792,1702,0.521765787860208
"E02004297",23,250,821,1226,335,51,8,2714,0.00847457627118644,0.0921149594694178,0.302505526897568,0.451731761238025,0.12343404568902,0.0187914517317612,0.00294767870302137,1094,0.403095062638172,1620,0.596904937361828
"E02004298",6,365,842,1459,482,96,22,3272,0.00183374083129584,0.111552567237164,0.257334963325183,0.445904645476773,0.147310513447433,0.0293398533007335,0.00672371638141809,1213,0.370721271393643,2059,0.629278728606357
"E02004299",7,120,1221,1376,315,41,8,3088,0.00226683937823834,0.038860103626943,0.395401554404145,0.44559585492228,0.102007772020725,0.0132772020725389,0.00259067357512953,1348,0.436528497409326,1740,0.563471502590674
"E02004300",1,77,1080,1383,329,45,15,2930,0.000341296928327645,0.0262798634812287,0.368600682593857,0.472013651877133,0.112286689419795,0.015358361774744,0.00511945392491468,1158,0.395221843003413,1772,0.604778156996587
"E02004301",1,460,1498,1409,322,31,5,3726,0.000268384326355341,0.123456790123457,0.402039720880301,0.378153515834675,0.0864197530864197,0.00831991411701557,0.0013419216317767,1959,0.525764895330113,1767,0.474235104669887
"E02004302",4,340,1054,1711,562,74,24,3769,0.00106128946670204,0.0902096046696736,0.279649774475988,0.453966569381799,0.149111170071637,0.0196338551339878,0.00636773680021226,1398,0.370920668612364,2371,0.629079331387636
"E02004303",2,280,1537,1874,640,106,21,4460,0.000448430493273543,0.062780269058296,0.344618834080717,0.420179372197309,0.143497757847534,0.0237668161434978,0.0047085201793722,1819,0.407847533632287,2641,0.592152466367713
"E02004304",39,199,1260,1273,298,59,11,3139,0.0124243389614527,0.0633959859827971,0.401401720293087,0.405543166613571,0.0949346925772539,0.0187957948391207,0.00350430073271743,1498,0.477222045237337,1641,0.522777954762663
"E02004305",25,596,1434,1440,340,59,22,3916,0.00638406537282942,0.152196118488253,0.366189989785495,0.367722165474974,0.0868232890704801,0.0150663942798774,0.00561797752808989,2055,0.524770173646578,1861,0.475229826353422
"E02004306",6,165,603,866,306,72,16,2034,0.00294985250737463,0.0811209439528024,0.29646017699115,0.425762045231072,0.150442477876106,0.0353982300884956,0.00786627335299902,774,0.380530973451327,1260,0.619469026548673
"E02004307",5,272,743,974,402,108,29,2533,0.0019739439399921,0.10738255033557,0.293328069482827,0.384524279510462,0.158705092775365,0.0426371891038295,0.0114488748519542,1020,0.402684563758389,1513,0.597315436241611
"E02004308",8,289,705,937,215,26,2,2182,0.00366636113657195,0.132447296058662,0.323098075160403,0.42942254812099,0.0985334555453712,0.0119156736938588,0.000916590284142988,1002,0.459211732355637,1180,0.540788267644363
"E02004309",8,289,1170,1106,226,35,6,2840,0.0028169014084507,0.101760563380282,0.411971830985915,0.38943661971831,0.0795774647887324,0.0123239436619718,0.00211267605633803,1467,0.516549295774648,1373,0.483450704225352
"E02004310",11,210,1374,1420,340,34,12,3401,0.00323434284034108,0.0617465451337842,0.403998823875331,0.417524257571303,0.0999705968832696,0.00999705968832696,0.00352837400764481,1595,0.468979711849456,1806,0.531020288150544
"E02004311",10,545,1264,1992,351,54,9,4225,0.00236686390532544,0.128994082840237,0.299171597633136,0.471479289940828,0.0830769230769231,0.0127810650887574,0.0021301775147929,1819,0.430532544378698,2406,0.569467455621302
"E02004312",8,303,780,1160,284,29,13,2577,0.00310438494373302,0.117578579743888,0.30267753201397,0.450135816841288,0.110205665502522,0.0112533954210322,0.00504462553356616,1091,0.423360496701591,1486,0.576639503298409
"E02004313",74,215,1583,1499,214,12,0,3597,0.020572699471782,0.0597720322490965,0.440088963024743,0.416736169029747,0.0594940227967751,0.00333611342785655,0,1872,0.520433694745621,1725,0.479566305254379
"E02004314",0,241,1231,1199,324,29,7,3031,0,0.0795117123061696,0.406136588584626,0.39557901682613,0.106895414054767,0.00956779940613659,0.0023094688221709,1472,0.485648300890795,1559,0.514351699109205
"E02004315",7,1390,1406,1393,436,64,8,4704,0.00148809523809524,0.295493197278912,0.298894557823129,0.296130952380952,0.092687074829932,0.0136054421768707,0.00170068027210884,2803,0.595875850340136,1901,0.404124149659864
"E02004316",4,546,1076,1083,309,59,14,3091,0.00129407958589453,0.176641863474604,0.348107408605629,0.350372047880945,0.0999676480103526,0.0190876738919444,0.00452927855063086,1626,0.526043351666127,1465,0.473956648333873
"E02004317",13,126,1644,1267,350,40,4,3444,0.0037746806039489,0.0365853658536585,0.477351916376307,0.367886178861789,0.101626016260163,0.0116144018583043,0.00116144018583043,1783,0.517711962833914,1661,0.482288037166086
"E02004318",9,579,1196,1092,280,50,5,3211,0.00280286515104329,0.180317658050452,0.37246963562753,0.340080971659919,0.087200249143569,0.0155714730613516,0.00155714730613516,1784,0.555590158829025,1427,0.444409841170975
"E02004319",5,804,976,1552,256,54,11,3658,0.00136686714051394,0.219792236194642,0.266812465828321,0.424275560415528,0.0699835975943138,0.0147621651175506,0.00300710770913067,1785,0.487971569163477,1873,0.512028430836523
"E02004320",9,139,1576,1173,198,25,5,3125,0.00288,0.04448,0.50432,0.37536,0.06336,0.008,0.0016,1724,0.55168,1401,0.44832
"E02004321",0,133,1497,1468,385,51,9,3543,0,0.0375388089189952,0.422523285351397,0.414338131526955,0.108664973186565,0.0143945808636749,0.00254022015241321,1630,0.460062094270392,1913,0.539937905729608
"E02004322",5,331,1793,1976,245,40,2,4392,0.0011384335154827,0.0753642987249545,0.408242258652095,0.449908925318761,0.0557832422586521,0.00910746812386157,0.000455373406193078,2129,0.484744990892532,2263,0.515255009107468
"E02004323",57,182,1265,1279,287,45,8,3123,0.0182516810758886,0.058277297470381,0.405059237912264,0.409542106948447,0.0918988152417547,0.0144092219020173,0.00256163944924752,1504,0.481588216458533,1619,0.518411783541467
"E02004324",41,528,888,1123,231,68,25,2904,0.0141184573002755,0.181818181818182,0.305785123966942,0.386707988980716,0.0795454545454545,0.0234159779614325,0.00860881542699725,1457,0.501721763085399,1447,0.498278236914601
"E02004325",3,337,2169,1895,293,40,7,4744,0.000632377740303541,0.0710370994940978,0.45720910623946,0.399451939291737,0.0617622259696459,0.00843170320404722,0.00147554806070826,2509,0.528878583473862,2235,0.471121416526138
"E02004326",38,381,1067,1273,274,46,13,3092,0.0122897800776197,0.123221216041397,0.345084087968952,0.411707632600259,0.0886157826649418,0.0148771021992238,0.00420439844760673,1486,0.480595084087969,1606,0.519404915912031
"E02004327",3,39,1171,1376,407,64,22,3082,0.000973393900064893,0.0126541207008436,0.379948085658663,0.446463335496431,0.13205710577547,0.0207657365347177,0.00713822193380921,1213,0.393575600259572,1869,0.606424399740428
"E02004328",1,159,1509,1293,178,17,6,3163,0.000316155548529877,0.0502687322162504,0.477078722731584,0.408789124249131,0.056275687638318,0.0053746443250079,0.00189693329117926,1669,0.527663610496364,1494,0.472336389503636
"E02004329",4,133,1047,1137,125,7,3,2456,0.00162866449511401,0.0541530944625407,0.426302931596091,0.462947882736156,0.0508957654723127,0.00285016286644951,0.0012214983713355,1184,0.482084690553746,1272,0.517915309446254
"E02004330",22,234,918,1327,299,36,14,2850,0.00771929824561404,0.0821052631578947,0.322105263157895,0.465614035087719,0.104912280701754,0.0126315789473684,0.00491228070175439,1174,0.411929824561403,1676,0.588070175438597
"E02004331",4,307,1150,1395,297,50,16,3219,0.0012426219322771,0.0953712333022678,0.357253805529668,0.43336439888164,0.092264678471575,0.0155327741534638,0.00497048772910842,1461,0.453867660764212,1758,0.546132339235788
"E02004332",34,443,1025,1220,339,96,37,3194,0.010644959298685,0.138697557921102,0.320914214151534,0.381966186599875,0.106136505948654,0.0300563556668754,0.0115842204132749,1502,0.470256731371321,1692,0.529743268628679
"E02004333",0,56,694,1208,284,26,7,2275,0,0.0246153846153846,0.305054945054945,0.530989010989011,0.124835164835165,0.0114285714285714,0.00307692307692308,750,0.32967032967033,1525,0.67032967032967
"E02004334",5,92,824,1628,311,41,10,2911,0.00171762281003092,0.0316042597045689,0.283064239093095,0.559257986946067,0.106836138783923,0.0140845070422535,0.00343524562006183,921,0.316386121607695,1990,0.683613878392305
"E02004335",67,837,1624,1509,413,50,15,4515,0.0148394241417497,0.185382059800664,0.35968992248062,0.33421926910299,0.0914728682170543,0.0110741971207087,0.00332225913621262,2528,0.559911406423034,1987,0.440088593576966
"E02004336",3,96,1076,1867,360,38,19,3459,0.000867302688638335,0.0277536860364267,0.311072564324949,0.539751373229257,0.1040763226366,0.0109858340560856,0.00549291702804279,1175,0.339693553050014,2284,0.660306446949986
"E02004337",16,1199,1484,1778,403,74,24,4978,0.00321414222579349,0.2408597830454,0.298111691442346,0.357171554841302,0.0809562073121736,0.0148654077942949,0.00482121333869024,2699,0.54218561671354,2279,0.45781438328646
"E02004338",23,623,997,1444,441,63,28,3619,0.0063553467808787,0.172147001934236,0.275490466979829,0.39900525006908,0.121856866537718,0.0174081237911025,0.00773694390715667,1643,0.453992815694943,1976,0.546007184305057
"E02004339",4,485,782,1094,286,71,28,2750,0.00145454545454545,0.176363636363636,0.284363636363636,0.397818181818182,0.104,0.0258181818181818,0.0101818181818182,1271,0.462181818181818,1479,0.537818181818182
"E02004340",15,273,2161,2204,631,81,30,5395,0.00278035217794254,0.0506024096385542,0.400556070435588,0.40852641334569,0.116960148285449,0.0150139017608897,0.00556070435588508,2449,0.453938832252085,2946,0.546061167747915
"E02004341",35,689,1361,1106,124,13,0,3328,0.0105168269230769,0.20703125,0.408954326923077,0.332331730769231,0.0372596153846154,0.00390625,0,2085,0.626502403846154,1243,0.373497596153846
"E02004342",1,49,1706,812,134,8,5,2715,0.000368324125230203,0.0180478821362799,0.628360957642726,0.299079189686924,0.0493554327808471,0.00294659300184162,0.00184162062615101,1756,0.646777163904236,959,0.353222836095764
"E02004343",2,122,1096,904,134,9,1,2268,0.000881834215167548,0.0537918871252205,0.483245149911817,0.398589065255732,0.0590828924162257,0.00396825396825397,0.000440917107583774,1220,0.537918871252205,1048,0.462081128747795
"E02004344",7,155,1390,1140,230,21,3,2946,0.00237610319076714,0.0526137135098439,0.471826205023761,0.386965376782077,0.0780719619823489,0.00712830957230143,0.0010183299389002,1552,0.526816021724372,1394,0.473183978275628
"E02004345",19,146,906,1895,1178,488,167,4799,0.00395915815794957,0.0304230047926651,0.188789331110648,0.394873932069181,0.245467805792874,0.101687851635757,0.0347989164409252,1071,0.223171494061263,3728,0.776828505938737
"E02004348",7,102,775,1111,740,396,168,3299,0.00212185510760837,0.0309184601394362,0.234919672628069,0.336768717793271,0.224310397090027,0.120036374658988,0.0509245225826008,884,0.267959987875114,2415,0.732040012124886
"E02004349",15,357,1620,2064,452,118,31,4657,0.0032209576980889,0.0766587932145158,0.347863431393601,0.443203779257032,0.0970581919690788,0.0253382005582993,0.00665664590938372,1992,0.427743182306206,2665,0.572256817693794
"E02004350",9,143,1409,1698,514,132,37,3942,0.00228310502283105,0.0362760020294267,0.357432775240994,0.430745814307458,0.13039066463724,0.0334855403348554,0.00938609842719432,1561,0.395991882293252,2381,0.604008117706748
"E02004351",13,184,1682,1344,380,53,25,3681,0.00353164900842162,0.049986416734583,0.45694104862809,0.365118174409128,0.103232817169247,0.0143982613420266,0.00679163270850312,1879,0.510459114371095,1802,0.489540885628905
"E02004352",105,638,1553,1529,573,96,48,4542,0.0231175693527081,0.140466754733598,0.341919859092911,0.336635843240863,0.126155878467635,0.0211360634081902,0.0105680317040951,2296,0.505504183179216,2246,0.494495816820784
"E02004353",2,54,762,1351,480,50,21,2720,0.000735294117647059,0.0198529411764706,0.280147058823529,0.496691176470588,0.176470588235294,0.0183823529411765,0.00772058823529412,818,0.300735294117647,1902,0.699264705882353
"E02004354",82,390,1874,1308,356,94,32,4136,0.019825918762089,0.0942940038684719,0.453094777562863,0.316247582205029,0.086073500967118,0.0227272727272727,0.00773694390715667,2346,0.567214700193424,1790,0.432785299806576
"E02004355",36,219,2180,1162,169,29,9,3804,0.00946372239747634,0.0575709779179811,0.573080967402734,0.30546792849632,0.0444269190325973,0.00762355415352261,0.00236593059936909,2435,0.640115667718191,1369,0.359884332281809
"E02004356",2,103,1131,945,151,7,1,2340,0.000854700854700855,0.044017094017094,0.483333333333333,0.403846153846154,0.0645299145299145,0.00299145299145299,0.000427350427350427,1236,0.528205128205128,1104,0.471794871794872
"E02004357",6,80,1245,927,150,25,5,2438,0.00246103363412633,0.0328137817883511,0.510664479081214,0.380229696472518,0.0615258408531583,0.0102543068088597,0.00205086136177194,1331,0.545939294503692,1107,0.454060705496309
"E02004358",3,222,1210,1204,233,33,5,2910,0.00103092783505155,0.0762886597938144,0.415807560137457,0.413745704467354,0.0800687285223368,0.011340206185567,0.00171821305841924,1435,0.493127147766323,1475,0.506872852233677
"E02004359",0,112,1042,1267,311,53,9,2794,0,0.0400858983536149,0.37294201861131,0.453471725125268,0.111309949892627,0.0189692197566213,0.00322118826055834,1154,0.413027916964925,1640,0.586972083035075
"E02004361",15,70,726,1273,341,48,7,2480,0.00604838709677419,0.0282258064516129,0.292741935483871,0.513306451612903,0.1375,0.0193548387096774,0.00282258064516129,811,0.327016129032258,1669,0.672983870967742
"E02004362",1,114,970,1597,462,71,17,3232,0.000309405940594059,0.0352722772277228,0.300123762376238,0.494121287128713,0.142945544554455,0.0219678217821782,0.00525990099009901,1085,0.335705445544554,2147,0.664294554455446
"E02004363",15,297,1112,1232,483,84,29,3252,0.00461254612546125,0.0913284132841328,0.341943419434194,0.378843788437884,0.148523985239852,0.025830258302583,0.00891758917589176,1424,0.437884378843788,1828,0.562115621156211
"E02004364",4,160,1350,1438,559,74,9,3594,0.00111296605453534,0.0445186421814135,0.375626043405676,0.400111296605454,0.155537006121313,0.0205898720089037,0.00250417362270451,1514,0.421257651641625,2080,0.578742348358375
"E02004365",4,226,1861,1972,680,107,56,4906,0.000815328169588259,0.0460660415817366,0.379331430900938,0.401956787607012,0.138605788830004,0.0218100285364859,0.0114145943742356,2091,0.426212800652263,2815,0.573787199347737
"E02004366",0,569,1965,1817,705,108,43,5207,0,0.10927597464951,0.377376608411753,0.348953332053006,0.135394661033225,0.0207413097753025,0.00825811407720376,2534,0.486652583061264,2673,0.513347416938736
"E02004367",2,219,1374,1310,411,87,26,3429,0.000583260425780111,0.0638670166229221,0.400699912510936,0.382035578885973,0.119860017497813,0.0253718285214348,0.00758238553514144,1595,0.465150189559638,1834,0.534849810440362
"E02004368",18,346,1201,1070,225,47,14,2921,0.00616227319411161,0.118452584731256,0.411160561451558,0.366312906538857,0.0770284149263951,0.016090380006847,0.00479287915097569,1565,0.535775419376926,1356,0.464224580623074
"E02004369",3,287,799,1636,485,57,16,3283,0.000913798355162961,0.0874200426439232,0.243374961925069,0.498324703015535,0.147730734084679,0.0173621687480963,0.00487359122753579,1089,0.331708802924155,2194,0.668291197075845
"E02004370",3,201,1703,1202,165,19,6,3299,0.0009093664746893,0.0609275538041831,0.516217035465293,0.364352834192179,0.0500151561079115,0.00575932100636557,0.0018187329493786,1907,0.578053955744165,1392,0.421946044255835
"E02004371",4,140,926,1233,341,44,17,2705,0.00147874306839187,0.0517560073937153,0.342329020332717,0.455822550831793,0.126062846580407,0.0162661737523105,0.00628465804066543,1070,0.395563770794824,1635,0.604436229205176
"E02004372",1,378,1314,1199,271,43,8,3214,0.000311138767890479,0.117610454262601,0.40883634100809,0.373055382700685,0.0843186060983199,0.0133789670192906,0.00248911014312383,1693,0.526757934038581,1521,0.473242065961419
"E02004373",1,227,1018,1384,475,67,18,3190,0.000313479623824451,0.0711598746081505,0.319122257053292,0.433855799373041,0.148902821316614,0.0210031347962382,0.00564263322884012,1246,0.390595611285266,1944,0.609404388714734
"E02004374",0,85,753,1574,642,100,46,3200,0,0.0265625,0.2353125,0.491875,0.200625,0.03125,0.014375,838,0.261875,2362,0.738125
"E02004375",0,176,1205,1779,741,127,42,4070,0,0.0432432432432432,0.296068796068796,0.437100737100737,0.182063882063882,0.0312039312039312,0.0103194103194103,1381,0.339312039312039,2689,0.660687960687961
"E02004376",5,141,1528,1802,743,166,57,4442,0.00112561909049977,0.0317424583520937,0.343989194056731,0.405673120216119,0.167266996848267,0.0373705538045925,0.0128320576316974,1674,0.376857271499325,2768,0.623142728500675
"E02004377",18,415,1400,1834,620,112,18,4417,0.00407516413855558,0.0939551731944759,0.316957210776545,0.415213946117274,0.14036676477247,0.0253565768621236,0.00407516413855558,1833,0.414987548109577,2584,0.585012451890423
"E02004378",0,320,2772,2249,916,185,62,6504,0,0.04920049200492,0.42619926199262,0.345787207872079,0.140836408364084,0.0284440344403444,0.00953259532595326,3092,0.47539975399754,3412,0.52460024600246
"E02004379",28,259,561,863,577,216,67,2571,0.0108907040062233,0.100739012057565,0.218203033838973,0.335667055620381,0.224426293271101,0.0840140023337223,0.0260598988720342,848,0.329832749902762,1723,0.670167250097238
"E02004380",27,722,642,984,629,222,55,3281,0.00822919841511734,0.220054861322767,0.195672051203901,0.299908564462054,0.191709844559585,0.0676622980798537,0.0167631819567205,1391,0.423956110941786,1890,0.576043889058214
"E02004381",9,330,1590,1445,514,92,32,4012,0.00224327018943171,0.0822532402791625,0.396311066799601,0.360169491525424,0.128115653040877,0.0229312063808574,0.00797607178464606,1929,0.480807577268195,2083,0.519192422731805
"E02004382",10,328,709,809,443,92,19,2410,0.004149377593361,0.136099585062241,0.294190871369295,0.335684647302905,0.183817427385892,0.0381742738589212,0.00788381742738589,1047,0.434439834024896,1363,0.565560165975104
"E02004383",9,83,802,1005,415,74,20,2408,0.0037375415282392,0.034468438538206,0.333056478405316,0.417358803986711,0.17234219269103,0.0307308970099668,0.00830564784053156,894,0.371262458471761,1514,0.628737541528239
"E02004384",9,139,825,1235,368,66,9,2651,0.003394945303659,0.0524330441342889,0.311203319502075,0.465861938890985,0.138815541305168,0.024896265560166,0.003394945303659,973,0.367031308940023,1678,0.632968691059977
"E02004385",5,195,1021,1372,379,52,10,3034,0.0016479894528675,0.0642715886618326,0.336519446275544,0.452208305866842,0.124917600527357,0.017139090309822,0.003295978905735,1221,0.402439024390244,1813,0.597560975609756
"E02004386",9,469,753,1111,323,58,11,2734,0.00329188002926116,0.171543525969276,0.27542062911485,0.406364301389905,0.118141916605706,0.0212143379663497,0.00402340892465252,1231,0.450256035113387,1503,0.549743964886613
"E02004387",15,166,988,933,216,23,20,2361,0.00635324015247776,0.0703091910207539,0.418466751376535,0.395171537484117,0.0914866581956798,0.0097416349004659,0.00847098686997035,1169,0.495129182549767,1192,0.504870817450233
"E02004388",18,929,1103,946,278,38,6,3318,0.0054249547920434,0.279987944544907,0.332429174201326,0.285111512959614,0.083785412899337,0.0114526823387583,0.00180831826401447,2050,0.617842073538276,1268,0.382157926461724
"E02004389",2,128,922,1634,425,60,9,3180,0.000628930817610063,0.040251572327044,0.289937106918239,0.513836477987421,0.133647798742138,0.0188679245283019,0.00283018867924528,1052,0.330817610062893,2128,0.669182389937107
"E02004390",8,338,962,1336,290,48,4,2986,0.00267916945746818,0.113194909578031,0.322170127260549,0.447421299397187,0.0971198928332217,0.0160750167448091,0.00133958472873409,1308,0.438044206296048,1678,0.561955793703952
"E02004391",1,314,1225,1209,409,67,17,3242,0.000308451573103023,0.0968537939543492,0.377853177051203,0.372917951881555,0.126156693399136,0.0206662553979025,0.00524367674275139,1540,0.475015422578655,1702,0.524984577421345
"E02004392",11,249,681,1153,612,209,67,2982,0.00368879946344735,0.0835010060362173,0.228370221327968,0.386653252850436,0.20523138832998,0.0700871898054997,0.022468142186452,941,0.315560026827632,2041,0.684439973172368
"E02004393",12,255,662,890,592,294,87,2792,0.00429799426934097,0.0913323782234957,0.237106017191977,0.318767908309456,0.212034383954155,0.105300859598854,0.0311604584527221,929,0.332736389684814,1863,0.667263610315186
"E02004394",22,241,493,872,535,217,73,2453,0.00896860986547085,0.0982470444353852,0.200978393803506,0.355483081940481,0.218100285364859,0.0884631064003261,0.0297594781899715,756,0.308194048104362,1697,0.691805951895638
"E02004395",21,297,1121,1333,742,189,66,3769,0.00557176970018573,0.0788007429026267,0.297426373043248,0.353674714778456,0.196869196073229,0.0501459273016715,0.0175112762005837,1439,0.38179888564606,2330,0.61820111435394
"E02004396",24,312,789,1200,561,181,46,3113,0.00770960488274976,0.100224863475747,0.253453260520398,0.385480244137488,0.180212014134276,0.0581432701574044,0.014776742691937,1125,0.361387728878895,1988,0.638612271121105
"E02004397",11,265,819,1152,551,160,55,3013,0.00365084633255891,0.0879522071025556,0.271822104215068,0.382343179555261,0.182874211749087,0.0531032193826751,0.0182542316627946,1095,0.363425157650183,1918,0.636574842349818
"E02004398",4,597,1482,1517,424,48,16,4088,0.000978473581213307,0.146037181996086,0.36252446183953,0.371086105675147,0.103718199608611,0.0117416829745597,0.00391389432485323,2083,0.50954011741683,2005,0.49045988258317
"E02004399",4,272,1167,1450,391,44,15,3343,0.00119653006281783,0.0813640442716123,0.349087645827101,0.433742147771463,0.116960813640443,0.0131618306909961,0.00448698773556686,1443,0.431648220161532,1900,0.568351779838468
"E02004400",7,551,924,1906,678,162,21,4249,0.00164744645799012,0.129677571193222,0.217462932454695,0.448576135561309,0.159566956931043,0.0381266180277712,0.00494233937397035,1482,0.348787950105907,2767,0.651212049894093
"E02004401",1,139,989,1640,490,82,4,3345,0.000298953662182362,0.0415545590433483,0.295665171898356,0.490284005979073,0.146487294469357,0.0245142002989537,0.00119581464872945,1129,0.337518684603886,2216,0.662481315396114
"E02004402",4,428,1830,2223,949,188,59,5681,0.000704101390600246,0.0753388487942264,0.322126386199613,0.391304347826087,0.167048054919908,0.0330927653582116,0.0103854955113536,2262,0.398169336384439,3419,0.601830663615561
"E02004403",8,132,490,768,458,157,42,2055,0.00389294403892944,0.0642335766423358,0.238442822384428,0.373722627737226,0.22287104622871,0.0763990267639903,0.0204379562043796,630,0.306569343065693,1425,0.693430656934307
"E02004404",10,134,300,786,503,157,52,1942,0.00514933058702369,0.0690010298661174,0.154479917610711,0.404737384140062,0.259011328527291,0.0808444902162719,0.0267765190525232,444,0.228630278063852,1498,0.771369721936148
"E02004405",13,432,730,760,223,28,8,2194,0.00592525068368277,0.19690063810392,0.332725615314494,0.346399270738377,0.101640838650866,0.0127620783956244,0.00364630811303555,1175,0.535551504102097,1019,0.464448495897903
"E02004406",5,191,827,1041,351,57,10,2482,0.00201450443190975,0.0769540692989525,0.333199033037873,0.41941982272361,0.141418211120064,0.0229653505237712,0.0040290088638195,1023,0.412167606768735,1459,0.587832393231265
"E02004407",12,284,691,975,572,157,41,2732,0.00439238653001464,0.103953147877013,0.252928257686676,0.35688140556369,0.209370424597365,0.0574670571010249,0.0150073206442167,987,0.361273792093704,1745,0.638726207906296
"E02004408",74,554,857,1149,301,41,4,2980,0.0248322147651007,0.185906040268456,0.28758389261745,0.385570469798658,0.101006711409396,0.013758389261745,0.00134228187919463,1485,0.498322147651007,1495,0.501677852348993
"E02004409",9,51,158,539,556,243,71,1627,0.00553165334972342,0.0313460356484327,0.0971112476951444,0.331284572833436,0.341733251382913,0.149354640442532,0.0436385986478181,218,0.133988936693301,1409,0.8660110633067
"E02004410",22,207,478,889,589,248,46,2479,0.00887454618797902,0.0835014118596208,0.192819685356999,0.358612343686971,0.237595804759984,0.100040338846309,0.018555869302138,707,0.285195643404599,1772,0.714804356595401
"E02004411",26,294,1100,1315,271,51,9,3066,0.00848010437051533,0.0958904109589041,0.358773646444879,0.428897586431833,0.0883887801696021,0.0166340508806262,0.00293542074363992,1420,0.463144161774299,1646,0.536855838225701
"E02004412",1,412,1086,1218,310,60,10,3097,0.000322893122376493,0.133031966419115,0.350661930900872,0.393283823054569,0.100096867936713,0.0193735873425896,0.00322893122376493,1499,0.484016790442364,1598,0.515983209557636
"E02004413",9,487,532,886,458,181,48,2601,0.00346020761245675,0.18723567858516,0.204536716647443,0.340638216070742,0.176086120722799,0.0695886197616301,0.0184544405997693,1028,0.39523260284506,1573,0.60476739715494
"E02004414",3,655,916,925,211,31,2,2743,0.001093693036821,0.238789646372585,0.333940940576012,0.337222019686475,0.0769230769230769,0.011301494713817,0.000729128691213999,1574,0.573824279985417,1169,0.426175720014583
"E02004415",16,343,600,585,451,213,63,2271,0.00704535446939674,0.151034786437693,0.264200792602378,0.257595772787318,0.198590929106121,0.0937912813738441,0.0277410832232497,959,0.422280933509467,1312,0.577719066490533
"E02004416",21,234,290,638,628,270,99,2180,0.00963302752293578,0.107339449541284,0.13302752293578,0.292660550458716,0.288073394495413,0.123853211009174,0.0454128440366973,545,0.25,1635,0.75
"E02004417",7,501,823,969,269,45,16,2630,0.0026615969581749,0.190494296577947,0.312927756653992,0.368441064638783,0.102281368821293,0.0171102661596958,0.00608365019011407,1331,0.506083650190114,1299,0.493916349809886
"E02004418",2,161,1074,809,135,22,7,2210,0.000904977375565611,0.0728506787330317,0.485972850678733,0.36606334841629,0.0610859728506787,0.00995475113122172,0.00316742081447964,1237,0.55972850678733,973,0.44027149321267
"E02004419",14,651,1062,855,176,23,5,2786,0.0050251256281407,0.233668341708543,0.381191672648959,0.30689160086145,0.063173007896626,0.00825556353194544,0.00179468772433597,1727,0.619885139985643,1059,0.380114860014358
"E02004420",61,1802,1239,1330,616,195,54,5297,0.0115159524259015,0.34019256182745,0.233905984519539,0.25108552010572,0.11629224089107,0.0368132905418161,0.0101944496885029,3102,0.58561449877289,2195,0.41438550122711
"E02004421",7,635,920,1476,419,57,19,3533,0.00198131899235777,0.179733937163883,0.260401924709878,0.417775261817153,0.118596093971129,0.016133597509199,0.00537786583639966,1562,0.442117180866119,1971,0.55788281913388
"E02004422",28,962,946,1575,501,89,23,4124,0.00678952473326867,0.233268671193017,0.229388942774006,0.381910766246363,0.121483996120272,0.0215809893307468,0.00557710960232784,1936,0.469447138700291,2188,0.530552861299709
"E02004423",12,428,632,1410,370,63,10,2925,0.0041025641025641,0.146324786324786,0.216068376068376,0.482051282051282,0.126495726495726,0.0215384615384615,0.00341880341880342,1072,0.366495726495726,1853,0.633504273504274
"E02004424",5,86,484,1009,252,35,3,1874,0.00266808964781217,0.0458911419423693,0.258271077908218,0.538420490928495,0.134471718249733,0.0186766275346852,0.0016008537886873,575,0.306830309498399,1299,0.693169690501601
"E02004425",2,102,981,1209,260,16,1,2571,0.000777907429015947,0.0396732788798133,0.381563593932322,0.47024504084014,0.101127965772073,0.00622325943212758,0.000388953714507974,1085,0.422014780241151,1486,0.577985219758849
"E02004426",7,237,975,1205,364,50,7,2845,0.00246045694200351,0.0833040421792619,0.342706502636204,0.423550087873462,0.127943760984183,0.0175746924428823,0.00246045694200351,1219,0.428471001757469,1626,0.571528998242531
"E02004427",2,224,904,1128,346,34,6,2644,0.00075642965204236,0.0847201210287443,0.341906202723147,0.426626323751891,0.130862329803328,0.0128593040847201,0.00226928895612708,1130,0.427382753403933,1514,0.572617246596067
"E02004428",1,403,889,827,288,38,10,2456,0.000407166123778502,0.164087947882736,0.361970684039088,0.336726384364821,0.117263843648208,0.0154723127035831,0.00407166123778502,1293,0.526465798045603,1163,0.473534201954397
"E02004429",3,188,540,969,381,54,9,2144,0.00139925373134328,0.0876865671641791,0.251865671641791,0.451958955223881,0.177705223880597,0.0251865671641791,0.00419776119402985,731,0.340951492537313,1413,0.659048507462687
"E02004430",1,93,694,1171,293,47,6,2305,0.000433839479392625,0.0403470715835141,0.301084598698482,0.508026030368764,0.127114967462039,0.0203904555314534,0.00260303687635575,788,0.341865509761388,1517,0.658134490238612
"E02004431",3,251,1583,1327,201,34,9,3408,0.000880281690140845,0.073650234741784,0.464495305164319,0.3893779342723,0.0589788732394366,0.00997652582159624,0.00264084507042254,1837,0.539025821596244,1571,0.460974178403756
"E02004432",9,151,488,817,342,48,9,1864,0.00482832618025751,0.0810085836909871,0.261802575107296,0.438304721030043,0.183476394849785,0.0257510729613734,0.00482832618025751,648,0.347639484978541,1216,0.652360515021459
"E02004433",3,183,1579,1140,257,37,11,3210,0.000934579439252336,0.0570093457943925,0.49190031152648,0.355140186915888,0.0800623052959502,0.0115264797507788,0.00342679127725857,1765,0.549844236760125,1445,0.450155763239875
"E02004434",3,138,1033,1245,366,77,12,2874,0.00104384133611691,0.0480167014613779,0.359429366736256,0.433194154488518,0.127348643006263,0.0267919276270007,0.00417536534446764,1174,0.408489909533751,1700,0.591510090466249
"E02004435",2,763,1143,1187,254,34,6,3389,0.000590144585423429,0.225140159339038,0.33726763056949,0.350250811448805,0.0749483623487754,0.0100324579521983,0.00177043375627029,1908,0.562997934493951,1481,0.437002065506049
"E02004436",2,261,1125,1013,243,93,6,2743,0.000729128691213999,0.0951512942034269,0.410134888807875,0.369303682099891,0.0885891359825009,0.033904484141451,0.002187386073642,1388,0.506015311702515,1355,0.493984688297484
"E02004437",2,830,1437,994,192,23,2,3480,0.000574712643678161,0.238505747126437,0.412931034482759,0.285632183908046,0.0551724137931034,0.00660919540229885,0.000574712643678161,2269,0.652011494252874,1211,0.347988505747126
"E02004438",34,313,1654,1118,220,23,8,3370,0.0100890207715134,0.0928783382789318,0.49080118694362,0.331750741839763,0.0652818991097923,0.00682492581602374,0.00237388724035608,2001,0.593768545994065,1369,0.406231454005935
"E02004439",3,393,1179,1087,121,20,5,2808,0.00106837606837607,0.139957264957265,0.419871794871795,0.387108262108262,0.0430911680911681,0.00712250712250712,0.00178062678062678,1575,0.560897435897436,1233,0.439102564102564
"E02004440",4,269,1328,1181,220,21,1,3024,0.00132275132275132,0.0889550264550265,0.439153439153439,0.390542328042328,0.0727513227513227,0.00694444444444444,0.000330687830687831,1601,0.529431216931217,1423,0.470568783068783
"E02004441",2,205,1211,1065,234,44,13,2774,0.000720980533525595,0.0739005046863735,0.436553713049748,0.383922134102379,0.0843547224224946,0.0158615717375631,0.00468637346791637,1418,0.511175198269647,1356,0.488824801730353
"E02004442",0,124,1180,1201,232,16,0,2753,0,0.0450417726116963,0.42862332001453,0.436251362150381,0.084271703596077,0.00581184162731566,0,1304,0.473665092626226,1449,0.526334907373774
"E02004443",9,827,1668,1117,316,56,10,4003,0.00224831376467649,0.206595053709718,0.41668748438671,0.279040719460405,0.0789407944041969,0.0139895078690982,0.0024981264051961,2504,0.625530851861104,1499,0.374469148138896
"E02004444",1,91,917,1308,263,34,13,2627,0.000380662352493338,0.0346402740768938,0.349067377236391,0.497906357061287,0.100114198705748,0.0129425199847735,0.0049486105824134,1009,0.384088313665778,1618,0.615911686334221
"E02004445",2,83,1199,1261,291,31,3,2870,0.000696864111498258,0.0289198606271777,0.417770034843206,0.439372822299652,0.101393728222997,0.010801393728223,0.00104529616724739,1284,0.447386759581882,1586,0.552613240418118
"E02004446",18,152,340,825,559,212,37,2143,0.00839944003733084,0.0709286047596827,0.158656089594027,0.38497433504433,0.260849276714886,0.0989267382174522,0.0172655156322912,510,0.237984134391041,1633,0.762015865608959
"E02004447",7,102,228,607,558,219,45,1766,0.00396375990939977,0.057757644394111,0.129105322763307,0.343714609286523,0.315968289920725,0.12400906002265,0.0254813137032843,337,0.190826727066818,1429,0.809173272933182
"E02004448",3,678,628,857,361,93,24,2644,0.00113464447806354,0.25642965204236,0.237518910741301,0.324130105900151,0.136535552193646,0.0351739788199697,0.00907715582450832,1309,0.495083207261725,1335,0.504916792738275
"E02004449",20,293,1221,1405,483,68,18,3508,0.00570125427594071,0.0835233751425314,0.34806157354618,0.400513112884835,0.137685290763968,0.0193842645381984,0.00513112884834664,1534,0.437286202964652,1974,0.562713797035348
"E02004450",4,171,257,603,543,254,49,1881,0.00212652844231792,0.0909090909090909,0.136629452418926,0.320574162679426,0.288676236044657,0.135034556087188,0.0260499734183945,432,0.229665071770335,1449,0.770334928229665
"E02004451",8,797,1092,1091,361,79,23,3451,0.00231816864676905,0.230947551434367,0.316430020283976,0.31614024920313,0.104607360185453,0.0228919153868444,0.00666473485946103,1897,0.549695740365112,1554,0.450304259634888
"E02004452",46,616,965,1184,313,67,14,3205,0.0143525741029641,0.192199687987519,0.301092043681747,0.369422776911076,0.0976599063962559,0.0209048361934477,0.00436817472698908,1627,0.507644305772231,1578,0.492355694227769
"E02004453",1,447,1292,801,218,27,6,2792,0.000358166189111748,0.160100286532951,0.462750716332378,0.28689111747851,0.078080229226361,0.00967048710601719,0.00214899713467049,1740,0.623209169054441,1052,0.376790830945559
"E02004454",3,663,1833,1400,576,83,24,4582,0.000654735923177652,0.144696639022261,0.400043649061545,0.305543430816237,0.125709297250109,0.0181143605412484,0.00523788738542121,2499,0.545395024006984,2083,0.454604975993016
"E02004455",5,466,714,882,252,46,10,2375,0.00210526315789474,0.196210526315789,0.300631578947368,0.371368421052632,0.106105263157895,0.0193684210526316,0.00421052631578947,1185,0.498947368421053,1190,0.501052631578947
"E02004456",2,525,1373,1442,396,57,15,3810,0.0005249343832021,0.137795275590551,0.360367454068241,0.378477690288714,0.103937007874016,0.0149606299212598,0.00393700787401575,1900,0.498687664041995,1910,0.501312335958005
"E02004457",5,708,1314,1119,390,91,22,3649,0.00137023842148534,0.194025760482324,0.360098657166347,0.306659358728419,0.106878596875856,0.0249383392710332,0.00602904905453549,2027,0.555494656070156,1622,0.444505343929844
"E02004458",4,180,1362,1077,156,21,3,2803,0.00142704245451302,0.064216910453086,0.485907955761684,0.384231180877631,0.0556546557260078,0.00749197288619336,0.00107028184088477,1546,0.551551908669283,1257,0.448448091330717
"E02004459",29,823,971,1454,508,99,18,3902,0.00743208610968734,0.210917478216299,0.248846745258842,0.372629420809841,0.130189646335213,0.0253716043054844,0.00461301896463352,1823,0.467196309584828,2079,0.532803690415172
"E02004460",5,933,1025,1119,298,40,8,3428,0.0014585764294049,0.272170361726954,0.299008168028005,0.326429404900817,0.0869311551925321,0.0116686114352392,0.00233372228704784,1963,0.572637106184364,1465,0.427362893815636
"E02004461",1,63,858,550,175,35,5,1687,0.000592768227622999,0.037344398340249,0.508595139300533,0.32602252519265,0.103734439834025,0.020746887966805,0.002963841138115,922,0.546532305868405,765,0.453467694131595
"E02004462",1,1098,2355,1386,347,36,21,5244,0.0001906941266209,0.209382151029748,0.44908466819222,0.264302059496567,0.0661708619374523,0.0068649885583524,0.0040045766590389,3454,0.658657513348589,1790,0.341342486651411
"E02004463",5,633,791,898,476,146,25,2974,0.00168123739071957,0.212844653665097,0.265971755211836,0.301950235373235,0.160053799596503,0.0490921318090114,0.00840618695359785,1429,0.480497646267653,1545,0.519502353732347
"E02004464",5,142,642,1178,448,106,25,2546,0.00196386488609584,0.0557737627651218,0.252160251374705,0.462686567164179,0.175962293794187,0.0416339355852317,0.00981932443047918,789,0.309897879025923,1757,0.690102120974077
"E02004465",2,241,635,933,351,67,22,2251,0.000888494002665482,0.107063527321191,0.282096845846291,0.414482452243447,0.155930697467792,0.0297645490892936,0.0097734340293203,878,0.390048867170147,1373,0.609951132829853
"E02004466",11,115,1005,1184,408,41,10,2774,0.00396539293439077,0.0414563806777217,0.362292718096611,0.426820475847152,0.147080028839221,0.0147801009372747,0.00360490266762797,1131,0.407714491708724,1643,0.592285508291276
"E02004467",1,226,1079,1107,311,46,7,2777,0.000360100828231905,0.0813827871804105,0.388548793662225,0.398631616852719,0.111991357580122,0.0165646380986676,0.00252070579762333,1306,0.470291681670868,1471,0.529708318329132
"E02004468",16,325,892,1468,622,82,6,3411,0.00469070653767224,0.0952799765464673,0.261506889475227,0.430372324831428,0.182351216652008,0.0240398710055702,0.00175901495162709,1233,0.361477572559367,2178,0.638522427440633
"E02004469",2,116,578,1048,443,100,20,2307,0.000866926744690074,0.0502817511920243,0.250541829215431,0.454269614217599,0.192024273948851,0.0433463372345037,0.00866926744690074,696,0.301690507152146,1611,0.698309492847854
"E02004470",2,1113,2563,2038,685,85,23,6509,0.000307266861269012,0.170994008296205,0.393762482716239,0.313104931633123,0.105238899984637,0.013058841603933,0.00353356890459364,3678,0.565063757873713,2831,0.434936242126287
"E02004471",17,377,1623,1326,433,100,27,3903,0.00435562387906738,0.0965923648475532,0.415833973866257,0.339738662567256,0.11094030233154,0.0256213169356905,0.00691775557263643,2017,0.516781962592877,1886,0.483218037407123
"E02004472",4,93,543,944,337,66,8,1995,0.00200501253132832,0.0466165413533835,0.27218045112782,0.473182957393484,0.168922305764411,0.0330827067669173,0.00401002506265664,640,0.320802005012531,1355,0.679197994987469
"E02004473",1,73,531,1103,395,52,7,2162,0.000462534690101758,0.0337650323774283,0.245605920444033,0.510175763182239,0.182701202590194,0.0240518038852914,0.0032377428307123,605,0.279833487511563,1557,0.720166512488437
"E02004474",21,398,359,982,497,63,16,2336,0.00898972602739726,0.170376712328767,0.153681506849315,0.420376712328767,0.212756849315068,0.0269691780821918,0.00684931506849315,778,0.333047945205479,1558,0.666952054794521
"E02004475",6,92,381,926,387,56,7,1855,0.00323450134770889,0.0495956873315364,0.205390835579515,0.499191374663073,0.208625336927224,0.030188679245283,0.00377358490566038,479,0.25822102425876,1376,0.74177897574124
"E02004476",2,241,410,1047,440,86,19,2245,0.00089086859688196,0.107349665924276,0.182628062360802,0.466369710467706,0.195991091314031,0.0383073496659243,0.00846325167037862,653,0.29086859688196,1592,0.70913140311804
"E02004477",5,47,276,884,512,79,8,1811,0.00276090557702927,0.0259525124240751,0.152401987852015,0.488128106018774,0.282716731087797,0.0436223081170624,0.00441744892324683,328,0.18111540585312,1483,0.81888459414688
"E02004478",7,261,662,1096,469,84,15,2594,0.00269853508095605,0.100616808018504,0.25520431765613,0.422513492675405,0.180801850424055,0.0323824209714726,0.00578257517347725,930,0.35851966075559,1664,0.64148033924441
"E02004479",6,173,556,1054,565,79,13,2446,0.00245298446443173,0.0707277187244481,0.227309893704007,0.43090760425184,0.230989370400654,0.0322976287816844,0.0053147996729354,735,0.300490596892886,1711,0.699509403107114
"E02004480",1,47,510,1074,340,43,5,2020,0.000495049504950495,0.0232673267326733,0.252475247524752,0.531683168316832,0.168316831683168,0.0212871287128713,0.00247524752475248,558,0.276237623762376,1462,0.723762376237624
"E02004481",4,91,339,1138,591,136,23,2322,0.00172265288544358,0.0391903531438415,0.145994832041344,0.490094745908699,0.254521963824289,0.0585701981050818,0.0099052540913006,434,0.186907838070629,1888,0.813092161929371
"E02004482",2,47,837,1360,311,48,8,2613,0.000765403750478377,0.0179869881362419,0.320321469575201,0.520474550325297,0.119020283199388,0.0183696900114811,0.00306161500191351,886,0.339073861461921,1727,0.660926138538079
"E02004483",1,105,587,1156,483,61,23,2416,0.000413907284768212,0.0434602649006623,0.24296357615894,0.478476821192053,0.199917218543046,0.0252483443708609,0.00951986754966887,693,0.286837748344371,1723,0.713162251655629
"E02004484",5,135,496,1424,476,93,12,2641,0.00189322226429383,0.0511170011359334,0.187807648617948,0.539189700870882,0.180234759560772,0.0352139341158652,0.00454373343430519,636,0.240817872018175,2005,0.759182127981825
"E02004485",76,1921,697,725,442,208,70,4139,0.0183619231698478,0.464121768543126,0.168398163807683,0.175163082870259,0.106789079487799,0.0502536844648466,0.0169122976564388,2694,0.650881855520657,1445,0.349118144479343
"E02004486",5,369,807,1127,335,68,10,2721,0.00183755972069092,0.13561190738699,0.296582138919515,0.414185961043734,0.123116501286292,0.0249908122013965,0.00367511944138184,1181,0.434031606027196,1540,0.565968393972804
"E02004487",8,244,988,941,319,87,18,2615,0.00305927342256214,0.0933078393881453,0.377820267686424,0.359847036328872,0.121988527724665,0.0332695984703633,0.00688336520076482,1240,0.474187380497132,1365,0.521988527724665
"E02004488",2,1146,973,1198,320,34,9,3682,0.000543183052688756,0.311243889190657,0.26425855513308,0.325366648560565,0.086909288430201,0.00923411189570885,0.0024443237370994,2121,0.576045627376426,1561,0.423954372623574
"E02004489",8,535,1234,906,270,90,18,3061,0.00261352499183273,0.174779483828814,0.403136229990199,0.295981705325057,0.0882064684743548,0.0294021561581183,0.00588043123162365,1777,0.580529238810846,1284,0.419470761189154
"E02004490",17,226,1590,1079,265,26,3,3206,0.00530255770430443,0.0704928259513412,0.495945102932003,0.336556456643793,0.0826575171553337,0.00810979413599501,0.000935745477230193,1833,0.571740486587648,1373,0.428259513412352
"E02004491",2,75,683,1057,341,51,6,2215,0.00090293453724605,0.0338600451467269,0.308352144469526,0.477200902934537,0.153950338600451,0.0230248306997743,0.00270880361173815,760,0.343115124153499,1455,0.656884875846501
"E02004492",0,138,1503,1519,309,33,7,3509,0,0.0393274437161584,0.428327158734682,0.432886862353947,0.0880592761470504,0.00940438871473354,0.00199487033342833,1641,0.467654602450841,1868,0.532345397549159
"E02004493",3,319,1843,1461,448,80,6,4160,0.000721153846153846,0.0766826923076923,0.443028846153846,0.351201923076923,0.107692307692308,0.0192307692307692,0.00144230769230769,2165,0.520432692307692,1995,0.479567307692308
"E02004495",4,179,724,1080,482,119,25,2613,0.00153080750095675,0.0685036356678148,0.277076157673173,0.413318025258324,0.184462303865289,0.0455415231534635,0.00956754688097972,907,0.347110600841944,1706,0.652889399158056
"E02004496",3,444,534,1051,460,72,13,2577,0.00116414435389988,0.172293364377183,0.207217694994179,0.407838571982926,0.178502134264649,0.0279394644935972,0.00504462553356616,981,0.380675203725262,1596,0.619324796274738
"E02004497",5,168,856,1002,374,72,13,2490,0.00200803212851406,0.0674698795180723,0.343775100401606,0.402409638554217,0.150200803212851,0.0289156626506024,0.00522088353413655,1029,0.413253012048193,1461,0.586746987951807
"E02004498",5,267,1980,1204,361,60,23,3900,0.00128205128205128,0.0684615384615385,0.507692307692308,0.308717948717949,0.0925641025641026,0.0153846153846154,0.0058974358974359,2252,0.577435897435897,1648,0.422564102564103
"E02004499",7,64,635,782,183,16,8,1695,0.00412979351032448,0.0377581120943953,0.374631268436578,0.461356932153392,0.107964601769912,0.00943952802359882,0.00471976401179941,706,0.416519174041298,989,0.583480825958702
"E02004500",58,258,814,1072,480,153,34,2869,0.0202161031718369,0.0899268037643778,0.283722551411642,0.373649355176019,0.167305681422098,0.0533286859532938,0.011850819100732,1130,0.393865458347856,1739,0.606134541652144
"E02004501",4,61,845,839,294,60,6,2109,0.00189663347558084,0.0289236605026079,0.400663821716453,0.397818871503082,0.139402560455192,0.0284495021337127,0.00284495021337127,910,0.431484115694642,1199,0.568515884305358
"E02004502",11,231,541,758,396,146,41,2124,0.0051789077212806,0.108757062146893,0.254708097928437,0.356873822975518,0.186440677966102,0.0687382297551789,0.0193032015065913,783,0.36864406779661,1341,0.63135593220339
"E02004503",1,140,793,1189,294,37,7,2461,0.000406338886631451,0.0568874441284031,0.32222673709874,0.483136936204795,0.119463632669646,0.0150345388053637,0.00284437220642015,934,0.379520520113775,1527,0.620479479886225
"E02004504",1,40,1006,1265,178,10,0,2500,4e-04,0.016,0.4024,0.506,0.0712,0.004,0,1047,0.4188,1453,0.5812
"E02004505",8,686,267,668,337,91,24,2081,0.00384430562229697,0.329649207111965,0.128303700144161,0.320999519461797,0.16194137433926,0.0437289764536281,0.0115329168668909,961,0.461797212878424,1120,0.538202787121576
"E02004506",19,228,436,729,501,186,54,2153,0.00882489549465862,0.105898745935903,0.202508128193219,0.338597306084533,0.23269856014863,0.0863910822108686,0.0250812819321876,683,0.317231769623781,1470,0.682768230376219
"E02004507",4,93,2009,1404,229,24,1,3764,0.00106269925611052,0.0247077577045696,0.533740701381509,0.373007438894793,0.0608395324123273,0.00637619553666312,0.00026567481402763,2106,0.559511158342189,1658,0.440488841657811
"E02004508",10,331,586,786,258,82,15,2068,0.00483558994197292,0.160058027079304,0.283365570599613,0.380077369439072,0.124758220502901,0.0396518375241779,0.00725338491295938,927,0.44825918762089,1141,0.55174081237911
"E02004512",0,953,2681,1861,661,105,32,6293,0,0.151438105831877,0.426028921023359,0.295725409184808,0.105037343079612,0.0166852057842047,0.00508501509613857,3634,0.577467026855236,2659,0.422532973144764
"E02004513",60,746,2728,1202,218,23,3,4980,0.0120481927710843,0.149799196787149,0.547791164658635,0.24136546184739,0.0437751004016064,0.00461847389558233,0.000602409638554217,3534,0.709638554216868,1446,0.290361445783133
"E02004514",12,151,567,835,337,62,7,1971,0.0060882800608828,0.0766108574327752,0.287671232876712,0.423642820903095,0.170979198376459,0.0314561136478945,0.00355149670218163,730,0.37037037037037,1241,0.62962962962963
"E02004515",23,1183,506,882,469,147,42,3252,0.00707257072570726,0.363776137761378,0.15559655596556,0.271217712177122,0.144218942189422,0.0452029520295203,0.0129151291512915,1712,0.526445264452645,1540,0.473554735547355
"E02004516",2,1019,1806,1988,880,150,30,5875,0.000340425531914894,0.173446808510638,0.307404255319149,0.338382978723404,0.149787234042553,0.025531914893617,0.0051063829787234,2827,0.481191489361702,3048,0.518808510638298
"E02004517",7,729,1234,1161,209,46,5,3391,0.00206428782070186,0.214980831613093,0.363904452963728,0.342376879976408,0.0616337363609555,0.0135653199646122,0.00147449130050133,1970,0.580949572397523,1421,0.419050427602477
"E02004518",1,816,911,1013,508,93,16,3358,0.000297796307325789,0.243001786777844,0.271292435973794,0.301667659321024,0.151280524121501,0.0276950565812984,0.00476474091721263,1728,0.514592019058964,1630,0.485407980941036
"E02004519",8,81,672,1011,315,43,3,2133,0.00375058602906704,0.0379746835443038,0.315049226441632,0.473980309423347,0.147679324894515,0.0201593999062353,0.00140646976090014,761,0.356774496015002,1372,0.643225503984998
"E02004520",9,653,1880,1198,164,19,3,3926,0.00229240957717779,0.166327050433011,0.478858889454916,0.305145185939888,0.0417727967396842,0.00483953132959756,0.00076413652572593,2542,0.647478349465104,1384,0.352521650534896
"E02004521",14,550,1540,1280,388,49,13,3834,0.00365153886280647,0.143453312467397,0.401669274908712,0.333854981742306,0.101199791340636,0.0127803860198226,0.00339071465832029,2104,0.548774126238915,1730,0.451225873761085
"E02004522",11,180,879,1188,413,81,9,2761,0.00398406374501992,0.0651937703730532,0.31836291198841,0.430278884462151,0.149583484244839,0.029337196667874,0.00325968851865266,1070,0.387540746106483,1691,0.612459253893517
"E02004523",41,584,1667,1126,270,42,12,3742,0.0109567076429717,0.156066274719401,0.445483698556921,0.300908605024051,0.0721539283805452,0.0112239444147515,0.00320684126135756,2292,0.612506680919294,1450,0.387493319080706
"E02004524",8,174,584,889,446,167,38,2306,0.00346921075455334,0.0754553339115351,0.253252385082394,0.38551604509974,0.193408499566349,0.072419774501301,0.0164787510841284,766,0.332176929748482,1540,0.667823070251518
"E02004525",24,618,861,1000,407,60,3,2973,0.00807265388496468,0.207870837537841,0.289606458123108,0.336360578540195,0.136898755465859,0.0201816347124117,0.00100908173562059,1503,0.505549949545913,1470,0.494450050454087
"E02004526",19,261,663,1033,527,167,40,2710,0.00701107011070111,0.096309963099631,0.244649446494465,0.381180811808118,0.194464944649446,0.0616236162361624,0.014760147601476,943,0.347970479704797,1767,0.652029520295203
"E02004527",1,325,1446,1132,403,86,19,3412,0.000293083235638921,0.0952520515826495,0.42379835873388,0.331770222743259,0.118112543962485,0.0252051582649472,0.00556858147713951,1772,0.519343493552169,1640,0.480656506447831
"E02004528",7,239,632,957,458,118,29,2440,0.00286885245901639,0.0979508196721312,0.259016393442623,0.392213114754098,0.187704918032787,0.0483606557377049,0.0118852459016393,878,0.359836065573771,1562,0.640163934426229
"E02004529",14,290,403,691,527,218,71,2214,0.00632339656729901,0.130984643179765,0.182023486901536,0.312104787714544,0.23803071364047,0.0984643179765131,0.0320686540198735,707,0.3193315266486,1507,0.6806684733514
"E02004530",2,313,780,908,324,35,15,2377,0.000841396718552798,0.131678586453513,0.328144720235591,0.38199411022297,0.136306268405553,0.014724442574674,0.00631047538914598,1095,0.460664703407657,1282,0.539335296592343
"E02004531",2,422,694,932,371,63,11,2495,0.000801603206412826,0.169138276553106,0.27815631262525,0.373547094188377,0.148697394789579,0.025250501002004,0.00440881763527054,1118,0.448096192384769,1377,0.55190380761523
"E02004532",10,216,840,969,368,61,12,2476,0.00403877221324717,0.0872374798061389,0.339256865912762,0.391357027463651,0.148626817447496,0.0246365105008078,0.00484652665589661,1066,0.430533117932149,1410,0.569466882067851
"E02004533",2,118,1074,905,244,27,3,2373,0.000842815002107038,0.0497260851243152,0.452591656131479,0.381373788453434,0.102823430257059,0.011378002528445,0.00126422250316056,1194,0.503160556257901,1179,0.496839443742099
"E02004534",2,144,1323,1230,297,44,12,3052,0.000655307994757536,0.0471821756225426,0.43348623853211,0.403014416775885,0.0973132372214941,0.0144167758846658,0.00393184796854522,1469,0.48132372214941,1583,0.51867627785059
"E02004535",7,338,747,750,281,80,27,2230,0.0031390134529148,0.151569506726457,0.334977578475336,0.336322869955157,0.126008968609865,0.0358744394618834,0.0121076233183857,1092,0.489686098654708,1138,0.510313901345292
"E02004536",2,116,619,735,373,60,28,1933,0.00103466114847387,0.0600103466114847,0.320227625452664,0.380237972064149,0.192964304190378,0.0310398344542162,0.0144852560786342,737,0.381272633212623,1196,0.618727366787377
"E02004537",0,234,1168,1620,312,34,11,3379,0,0.0692512577685706,0.345664397750814,0.479431784551642,0.0923350103580941,0.0100621485646641,0.00325540100621486,1402,0.414915655519384,1977,0.585084344480616
"E02004538",2,501,886,1123,607,122,16,3257,0.000614062020264047,0.153822536076144,0.272029474976973,0.344795824378262,0.186367823150138,0.0374577832361068,0.00491249616211237,1389,0.42646607307338,1868,0.57353392692662
"E02004539",1,341,680,1348,291,44,10,2715,0.000368324125230203,0.125598526703499,0.250460405156538,0.496500920810313,0.107182320441989,0.0162062615101289,0.00368324125230203,1022,0.376427255985267,1693,0.623572744014733
"E02004540",2,127,611,825,342,70,9,1986,0.00100704934541793,0.0639476334340383,0.307653575025176,0.415407854984894,0.172205438066465,0.0352467270896274,0.00453172205438067,740,0.372608257804632,1246,0.627391742195368
"E02004541",2,272,1357,1689,699,105,16,4140,0.000483091787439614,0.0657004830917874,0.327777777777778,0.407971014492754,0.168840579710145,0.0253623188405797,0.00386473429951691,1631,0.393961352657005,2509,0.606038647342995
"E02004542",3,280,517,761,385,69,16,2031,0.00147710487444609,0.137863121614968,0.254554406696209,0.374692269817824,0.189561792220581,0.03397341211226,0.00787789266371246,800,0.393894633185623,1231,0.606105366814377
"E02004543",2,290,827,911,317,70,7,2424,0.000825082508250825,0.11963696369637,0.341171617161716,0.375825082508251,0.130775577557756,0.0288778877887789,0.00288778877887789,1119,0.461633663366337,1305,0.538366336633663
"E02004544",62,2471,1546,1224,313,62,14,5692,0.0108924806746311,0.434118060435699,0.271609276177091,0.215038650737878,0.0549894588896697,0.0108924806746311,0.00245959241040056,4079,0.716619817287421,1613,0.283380182712579
"E02004545",0,76,1804,1781,254,18,0,3933,0,0.0193236714975845,0.458682939232138,0.452834986015764,0.0645817442156115,0.0045766590389016,0,1880,0.478006610729723,2053,0.521993389270277
"E02004546",4,505,1922,1836,356,20,4,4647,0.000860770389498601,0.108672261674198,0.413600172154078,0.395093608779858,0.0766085646653755,0.00430385194749301,0.000860770389498601,2431,0.523133204217775,2216,0.476866795782225
"E02004547",1,641,1697,1527,239,17,4,4126,0.000242365487154629,0.155356277266117,0.411294231701406,0.370092098885119,0.0579253514299564,0.0041202132816287,0.000969461948618517,2339,0.566892874454678,1787,0.433107125545322
"E02004548",0,22,1749,1108,82,1,0,2962,0,0.00742741390952059,0.590479405806887,0.37407157326131,0.0276839972991222,0.000337609723160027,0,1771,0.597906819716408,1191,0.402093180283592
"E02004549",35,57,1709,1711,265,25,6,3808,0.00919117647058824,0.014968487394958,0.448792016806723,0.449317226890756,0.0695903361344538,0.00656512605042017,0.00157563025210084,1801,0.472951680672269,2007,0.527048319327731
"E02004550",2,193,1602,1650,335,21,4,3807,0.00052534804307854,0.0506960861570791,0.42080378250591,0.433412135539795,0.0879957972156554,0.00551615445232467,0.00105069608615708,1797,0.472025216706068,2010,0.527974783293932
"E02004551",1,120,1684,1685,289,16,10,3805,0.00026281208935611,0.0315374507227332,0.44257555847569,0.442838370565046,0.0759526938239159,0.00420499342969777,0.0026281208935611,1805,0.474375821287779,2000,0.525624178712221
"E02004552",3,35,1256,1024,166,22,4,2510,0.00119521912350598,0.0139442231075697,0.500398406374502,0.40796812749004,0.0661354581673307,0.00876494023904383,0.00159362549800797,1294,0.515537848605578,1216,0.484462151394422
"E02004553",0,446,1239,1310,217,15,2,3229,0,0.138123257974605,0.383710126974295,0.405698358624961,0.0672034685661195,0.00464540105295757,0.00061938680706101,1685,0.521833384948901,1544,0.478166615051099
"E02004554",1,50,1379,1320,154,13,1,2918,0.000342700479780672,0.0171350239890336,0.472583961617546,0.452364633310487,0.0527758738862234,0.00445510623714873,0.000342700479780672,1430,0.490061686086361,1488,0.50993831391364
"E02004555",8,134,254,712,551,202,47,1908,0.00419287211740042,0.070230607966457,0.133123689727463,0.373165618448637,0.288784067085954,0.105870020964361,0.0246331236897275,396,0.207547169811321,1512,0.792452830188679
"E02004556",37,442,296,786,557,225,41,2384,0.0155201342281879,0.185402684563758,0.124161073825503,0.329697986577181,0.233640939597315,0.0943791946308725,0.0171979865771812,775,0.32508389261745,1609,0.67491610738255
"E02004557",4,447,1113,1037,259,55,11,2926,0.00136705399863295,0.152768284347232,0.380382775119617,0.354408749145591,0.0885167464114833,0.018796992481203,0.0037593984962406,1564,0.534518113465482,1362,0.465481886534518
"E02004558",9,303,1016,1157,438,128,35,3086,0.00291639662994167,0.0981853532080363,0.329228775113415,0.374918988982502,0.141931302657161,0.0414776409591704,0.0113415424497732,1328,0.430330524951393,1758,0.569669475048607
"E02004559",71,752,732,1062,253,35,5,2910,0.0243986254295533,0.258419243986254,0.251546391752577,0.364948453608247,0.0869415807560137,0.0120274914089347,0.00171821305841924,1555,0.534364261168385,1355,0.465635738831615
"E02004560",11,361,657,1011,558,234,90,2922,0.00376454483230664,0.123545516769336,0.224845995893224,0.345995893223819,0.190965092402464,0.080082135523614,0.0308008213552361,1029,0.352156057494867,1893,0.647843942505133
"E02004561",12,333,803,1058,571,224,46,3047,0.00393829996718083,0.109287824089268,0.263537906137184,0.347226780439777,0.187397440105021,0.0735149327207089,0.0150968165408599,1148,0.376764030193633,1899,0.623235969806367
"E02004562",19,811,839,1317,560,134,32,3712,0.00511853448275862,0.218480603448276,0.226023706896552,0.35479525862069,0.150862068965517,0.0360991379310345,0.00862068965517241,1669,0.449622844827586,2043,0.550377155172414
"E02004563",12,450,373,734,277,81,19,1946,0.00616649537512847,0.231243576567318,0.191675231243577,0.377183967112025,0.142343268242549,0.0416238437821172,0.00976361767728674,835,0.429085303186023,1111,0.570914696813977
"E02004564",28,293,581,953,331,82,16,2284,0.0122591943957968,0.128283712784588,0.254378283712785,0.417250437828371,0.14492119089317,0.0359019264448336,0.00700525394045534,902,0.39492119089317,1382,0.60507880910683
"E02004566",3,244,857,626,258,98,31,2117,0.00141709966934341,0.115257439773264,0.404818138875768,0.295701464336325,0.121870571563533,0.0462919225318847,0.0146433632498819,1104,0.521492678318375,1013,0.478507321681625
"E02004567",2,208,540,1024,434,65,5,2278,0.000877963125548727,0.0913081650570676,0.237050043898156,0.449517120280948,0.190517998244074,0.0285338015803336,0.00219490781387182,750,0.329236172080773,1528,0.670763827919227
"E02004568",51,790,1154,1029,258,39,15,3336,0.0152877697841727,0.236810551558753,0.345923261390887,0.308453237410072,0.0773381294964029,0.0116906474820144,0.00449640287769784,1995,0.598021582733813,1341,0.401978417266187
"E02004569",71,693,833,1121,441,102,14,3275,0.0216793893129771,0.211603053435115,0.254351145038168,0.342290076335878,0.134656488549618,0.0311450381679389,0.00427480916030534,1597,0.48763358778626,1678,0.51236641221374
"E02004570",4,313,899,1153,512,88,14,2983,0.00134093194770365,0.104927924907811,0.301374455246396,0.386523633925578,0.171639289306068,0.0295005028494804,0.00469326181696279,1216,0.407643312101911,1767,0.592356687898089
"E02004571",4,88,496,1042,420,59,5,2114,0.00189214758751183,0.0416272469252602,0.234626300851466,0.492904446546831,0.198675496688742,0.0279091769157994,0.00236518448438978,588,0.278145695364238,1526,0.721854304635762
"E02004572",41,532,670,930,470,94,19,2756,0.0148766328011611,0.193033381712627,0.24310595065312,0.33744557329463,0.170537010159652,0.0341074020319303,0.00689404934687954,1243,0.451015965166909,1513,0.548984034833091
"E02004573",2,243,923,1162,561,142,38,3071,0.000651253663301856,0.0791273200911755,0.300553565613807,0.378378378378378,0.182676652556171,0.0462390100944318,0.0123738196027353,1168,0.380332139368284,1903,0.619667860631716
"E02004574",7,371,827,1208,339,43,12,2807,0.00249376558603491,0.13216957605985,0.294620591378696,0.430352689704311,0.120769504809405,0.0153188457427859,0.00427502671891699,1205,0.429283933024581,1602,0.570716066975419
"E02004575",31,1165,1206,1518,570,178,36,4704,0.00659013605442177,0.24766156462585,0.256377551020408,0.322704081632653,0.121173469387755,0.0378401360544218,0.0076530612244898,2402,0.51062925170068,2302,0.48937074829932
"E02004576",39,270,816,1292,409,112,35,2973,0.0131180625630676,0.0908173562058527,0.274470232088799,0.434577867473932,0.13757147662294,0.0376723847965018,0.0117726202489068,1125,0.378405650857719,1848,0.621594349142281
"E02004577",21,841,354,573,357,93,33,2272,0.00924295774647887,0.370158450704225,0.15580985915493,0.252200704225352,0.157130281690141,0.0409330985915493,0.0145246478873239,1216,0.535211267605634,1056,0.464788732394366
"E02004578",4,611,989,1586,728,173,39,4130,0.000968523002421308,0.147941888619855,0.239467312348668,0.384019370460048,0.176271186440678,0.0418886198547216,0.00944309927360775,1604,0.388377723970944,2526,0.611622276029056
"E02004579",18,684,408,883,476,154,49,2672,0.00673652694610778,0.255988023952096,0.152694610778443,0.330464071856287,0.17814371257485,0.0576347305389222,0.0183383233532934,1110,0.415419161676647,1562,0.584580838323353
"E02004580",116,696,964,2516,856,146,23,5317,0.0218168139928531,0.130900883957119,0.181305247319917,0.473199172465676,0.16099304118864,0.0274590934737634,0.00432574760203122,1776,0.334022945269889,3541,0.665977054730111
"E02004581",65,885,555,988,451,108,25,3077,0.0211244718882028,0.287617809554761,0.180370490737732,0.321091972700682,0.146571335716607,0.0350991225219369,0.008124796880078,1505,0.489112772180695,1572,0.510887227819304
"E02004582",16,432,707,1235,386,63,18,2857,0.0056002800140007,0.151207560378019,0.247462373118656,0.432271613580679,0.135106755337767,0.0220511025551278,0.00630031501575079,1155,0.404270213510676,1702,0.595729786489325
"E02004583",13,440,675,1345,709,215,102,3499,0.00371534724206916,0.125750214346956,0.192912260645899,0.38439554158331,0.202629322663618,0.06144612746499,0.029151186053158,1128,0.322377822234924,2371,0.677622177765076
"E02004584",2,59,485,1378,596,108,12,2640,0.000757575757575758,0.0223484848484849,0.183712121212121,0.521969696969697,0.225757575757576,0.0409090909090909,0.00454545454545455,546,0.206818181818182,2094,0.793181818181818
"E02004585",8,614,988,1398,329,50,11,3398,0.00235432607416127,0.180694526191878,0.290759270158917,0.411418481459682,0.0968216597998823,0.0147145379635079,0.00323719835197175,1610,0.473808122424956,1788,0.526191877575044
"E02004586",4,365,1041,1505,736,122,20,3793,0.00105457421566043,0.096229897179014,0.274452939625626,0.396783548642236,0.194041655681519,0.032164513577643,0.00527287107830214,1410,0.371737411020301,2383,0.628262588979699
"E02004587",4,74,1202,1301,287,41,6,2915,0.00137221269296741,0.0253859348198971,0.412349914236707,0.44631217838765,0.0984562607204117,0.014065180102916,0.00205831903945111,1280,0.439108061749571,1635,0.560891938250429
"E02004588",2,252,1181,1504,859,130,45,3973,0.000503397936068462,0.0634281399446262,0.297256481248427,0.378555247923483,0.216209413541404,0.03272086584445,0.0113264535615404,1435,0.361188019129122,2538,0.638811980870878
"E02004589",3,122,705,1398,497,81,23,2829,0.00106044538706257,0.0431247790738777,0.249204665959703,0.494167550371156,0.175680452456698,0.0286320254506893,0.00813008130081301,830,0.293389890420643,1999,0.706610109579357
"E02004590",14,188,586,1624,1142,381,265,4200,0.00333333333333333,0.0447619047619048,0.13952380952381,0.386666666666667,0.271904761904762,0.0907142857142857,0.0630952380952381,788,0.187619047619048,3412,0.812380952380952
"E02004591",34,562,503,921,382,107,16,2525,0.0134653465346535,0.222574257425743,0.199207920792079,0.364752475247525,0.151287128712871,0.0423762376237624,0.00633663366336634,1099,0.435247524752475,1426,0.564752475247525
"E02004592",17,1281,1910,1703,595,81,21,5608,0.00303138373751783,0.228423680456491,0.34058487874465,0.30367332382311,0.106098430813124,0.0144436519258203,0.00374465049928673,3208,0.572039942938659,2400,0.427960057061341
"E02004593",70,658,547,893,539,190,42,2939,0.0238176250425315,0.223885675399796,0.186117727118067,0.303844845185437,0.183395712827492,0.0646478394011569,0.0142905750255189,1275,0.433821027560395,1664,0.566178972439605
"E02004594",9,414,537,908,424,177,32,2501,0.00359856057576969,0.165533786485406,0.214714114354258,0.363054778088765,0.16953218712515,0.0707716913234706,0.0127948820471811,960,0.383846461415434,1541,0.616153538584566
"E02004595",62,1571,1249,1446,669,212,37,5246,0.0118185284025925,0.299466260007625,0.238086160884483,0.275638581776592,0.12752573389249,0.0404117422798323,0.00705299275638582,2882,0.549370949294701,2364,0.450629050705299
"E02004596",17,1312,987,665,459,142,41,3623,0.00469224399668783,0.362130830803202,0.27242616616064,0.183549544576318,0.126690587910571,0.0391940380899807,0.0113165884626001,2316,0.63924924096053,1307,0.36075075903947
"E02004597",33,1221,1614,914,238,56,11,4087,0.00807438218742354,0.298752140934671,0.394910692439442,0.223635918766822,0.058233423048691,0.0137019818938096,0.00269146072914118,2868,0.701737215561537,1219,0.298262784438463
"E02004598",47,633,1202,939,493,162,24,3500,0.0134285714285714,0.180857142857143,0.343428571428571,0.268285714285714,0.140857142857143,0.0462857142857143,0.00685714285714286,1882,0.537714285714286,1618,0.462285714285714
"E02004599",12,270,591,732,429,158,49,2241,0.00535475234270415,0.120481927710843,0.263721552878179,0.326639892904953,0.191432396251673,0.070504239178938,0.0218652387327086,873,0.389558232931727,1368,0.610441767068273
"E02004600",19,102,740,834,193,30,4,1922,0.00988553590010406,0.0530697190426639,0.385015608740895,0.433922996878252,0.100416233090531,0.0156087408949011,0.00208116545265349,861,0.447970863683663,1061,0.552029136316337
"E02004601",4,362,578,762,231,52,7,1996,0.00200400801603206,0.181362725450902,0.289579158316633,0.381763527054108,0.115731462925852,0.0260521042084168,0.00350701402805611,944,0.472945891783567,1052,0.527054108216433
"E02004602",91,305,1429,846,138,17,5,2831,0.0321441186859767,0.107735782409043,0.504768632991876,0.298834334157542,0.0487460261391734,0.00600494524902861,0.00176616036736136,1825,0.644648534086895,1006,0.355351465913105
"E02004603",27,620,1319,1363,428,61,16,3834,0.00704225352112676,0.161711006781429,0.344027125717267,0.355503390714658,0.111632759520083,0.0159102764736568,0.00417318727177882,1966,0.512780386019823,1868,0.487219613980177
"E02004604",5,222,1713,1005,199,50,16,3210,0.00155763239875389,0.0691588785046729,0.533644859813084,0.313084112149533,0.061993769470405,0.0155763239875389,0.00498442367601246,1940,0.604361370716511,1270,0.395638629283489
"E02004605",0,192,990,744,191,37,10,2164,0,0.088724584103512,0.457486136783734,0.343807763401109,0.0882624768946396,0.017097966728281,0.00462107208872458,1182,0.546210720887246,982,0.453789279112754
"E02004606",3,603,1784,1619,519,62,18,4608,0.000651041666666667,0.130859375,0.387152777777778,0.351345486111111,0.112630208333333,0.0134548611111111,0.00390625,2390,0.518663194444444,2218,0.481336805555556
"E02004607",11,358,1558,2351,1028,208,59,5573,0.00197380226090077,0.0642382917638615,0.279562174771218,0.421855374125247,0.184460793109636,0.0373228063879419,0.010586757581195,1927,0.345774268795981,3646,0.654225731204019
"E02004608",2,444,2126,2530,1079,194,80,6455,0.000309837335398916,0.0687838884585593,0.329357087529047,0.391944229279628,0.167157242447715,0.0300542215336948,0.0123934934159566,2572,0.398450813323005,3883,0.601549186676995
"E02004609",4,198,963,951,255,43,4,2418,0.00165425971877585,0.0818858560794045,0.398263027295285,0.393300248138958,0.10545905707196,0.0177832919768404,0.00165425971877585,1165,0.481803143093466,1253,0.518196856906534
"E02004610",10,260,1180,1375,532,112,15,3484,0.00287026406429392,0.0746268656716418,0.338691159586682,0.394661308840413,0.152698048220436,0.0321469575200918,0.00430539609644087,1450,0.416188289322618,2034,0.583811710677382
"E02004611",9,667,1165,1556,635,100,14,4146,0.00217076700434153,0.160877954655089,0.280993728895321,0.37530149541727,0.153159671972986,0.0241196333815726,0.00337674867342016,1841,0.444042450554752,2305,0.555957549445249
"E02004612",7,125,1201,1435,240,35,5,3048,0.00229658792650919,0.041010498687664,0.394028871391076,0.470800524934383,0.078740157480315,0.0114829396325459,0.00164041994750656,1333,0.437335958005249,1715,0.562664041994751
"E02004613",14,106,614,1008,339,61,10,2152,0.00650557620817844,0.0492565055762082,0.285315985130112,0.468401486988848,0.157527881040892,0.0283457249070632,0.00464684014869888,734,0.341078066914498,1418,0.658921933085502
"E02004614",30,260,510,806,314,59,14,1993,0.0150526843953838,0.130456598093327,0.255895634721525,0.404415454089313,0.157551430005018,0.0296036126442549,0.00702458605117913,800,0.401404917210236,1193,0.598595082789764
"E02004615",2,622,675,1305,741,213,54,3612,0.000553709856035437,0.172203765227021,0.18687707641196,0.361295681063123,0.20514950166113,0.0589700996677741,0.0149501661129568,1299,0.359634551495017,2313,0.640365448504983
"E02004616",58,1159,1315,1408,817,260,67,5084,0.0114083398898505,0.227970102281668,0.258654602675059,0.276947285601888,0.160700236034618,0.0511408339889851,0.0131785995279308,2532,0.498033044846578,2552,0.501966955153422
"E02004617",7,835,737,1076,795,294,76,3820,0.00183246073298429,0.218586387434555,0.192931937172775,0.281675392670157,0.208115183246073,0.0769633507853403,0.0198952879581152,1579,0.413350785340314,2241,0.586649214659686
"E02004618",17,94,299,751,987,390,99,2637,0.00644671975729996,0.0356465680697763,0.113386423966629,0.284793325748957,0.374288964732651,0.147895335608646,0.037542662116041,410,0.155479711793705,2227,0.844520288206295
"E02004619",11,95,423,776,1010,429,124,2868,0.00383542538354254,0.0331241283124128,0.147489539748954,0.270571827057183,0.352161785216179,0.149581589958159,0.0432357043235704,529,0.184449093444909,2339,0.815550906555091
"E02004620",3,505,996,939,279,44,9,2775,0.00108108108108108,0.181981981981982,0.358918918918919,0.338378378378378,0.100540540540541,0.0158558558558559,0.00324324324324324,1504,0.541981981981982,1271,0.458018018018018
"E02004621",0,300,1153,1124,547,80,8,3212,0,0.0933997509339975,0.358966376089664,0.349937733499377,0.170298879202989,0.024906600249066,0.0024906600249066,1453,0.452366127023661,1759,0.547633872976339
"E02004622",87,606,1222,1021,225,26,4,3191,0.0272641805076778,0.189909119398308,0.382952052648073,0.319962394233783,0.0705108116577875,0.00814791601378878,0.00125352554058289,1915,0.600125352554058,1276,0.399874647445942
"E02004623",18,771,870,1144,444,98,28,3373,0.00533649570115624,0.228579899199526,0.257930625555885,0.339163949006819,0.131633560628521,0.0290542543729618,0.00830121553513193,1659,0.491847020456567,1714,0.508152979543433
"E02004624",18,517,857,988,588,137,29,3134,0.00574345883854499,0.164964901084876,0.273452456924059,0.315252074026803,0.18761965539247,0.0437141033822591,0.00925335035098915,1392,0.444160816847479,1742,0.555839183152521
"E02004625",4,758,953,1254,832,243,78,4122,0.000970402717127608,0.183891314895682,0.231198447355653,0.304221251819505,0.201843765162542,0.0589519650655022,0.0189228529839884,1715,0.416060164968462,2407,0.583939835031538
"E02004626",40,275,354,850,879,334,113,2845,0.0140597539543058,0.0966608084358524,0.124428822495606,0.298769771528998,0.30896309314587,0.117398945518453,0.0397188049209139,669,0.235149384885764,2176,0.764850615114235
"E02004627",18,927,689,770,252,87,18,2761,0.00651937703730532,0.335747917421224,0.24954726548352,0.278884462151394,0.0912712785222745,0.0315103223469757,0.00651937703730532,1634,0.59181455994205,1127,0.40818544005795
"E02004628",23,217,495,836,554,233,75,2433,0.00945334977394164,0.0891903000411015,0.203452527743527,0.3436087135224,0.227702424989725,0.0957665433621044,0.030826140567201,735,0.30209617755857,1698,0.69790382244143
"E02004629",54,382,1558,1596,709,193,68,4560,0.0118421052631579,0.0837719298245614,0.341666666666667,0.35,0.155482456140351,0.0423245614035088,0.0149122807017544,1994,0.437280701754386,2566,0.562719298245614
"E02004630",13,197,390,663,572,257,100,2192,0.00593065693430657,0.0898722627737226,0.177919708029197,0.302463503649635,0.260948905109489,0.117244525547445,0.0456204379562044,600,0.273722627737226,1592,0.726277372262774
"E02004631",7,47,269,668,532,198,66,1787,0.00391717963066592,0.0263010632344712,0.15053161723559,0.373810856183548,0.29770565193061,0.110800223838836,0.0369334079462787,323,0.180749860100727,1464,0.819250139899273
"E02004632",23,826,1417,1245,481,102,20,4114,0.00559066601847351,0.200777831793875,0.344433641225085,0.302625182304327,0.116917841516772,0.0247933884297521,0.00486144871171609,2266,0.550802139037433,1848,0.449197860962567
"E02004633",19,173,569,875,678,267,64,2645,0.00718336483931947,0.065406427221172,0.215122873345936,0.330812854442344,0.256332703213611,0.100945179584121,0.0241965973534972,761,0.287712665406427,1884,0.712287334593573
"E02004634",23,1371,1158,1382,572,162,38,4706,0.00488737781555461,0.291330216744581,0.246068848278793,0.293667658308542,0.121546961325967,0.0344241393965151,0.00807479813004675,2552,0.542286442838929,2154,0.457713557161071
"E02004635",6,338,626,901,442,171,44,2528,0.00237341772151899,0.13370253164557,0.247626582278481,0.356408227848101,0.174841772151899,0.0676424050632911,0.0174050632911392,970,0.38370253164557,1558,0.61629746835443
"E02004636",2,37,668,1091,320,44,10,2172,0.000920810313075506,0.0170349907918969,0.307550644567219,0.502302025782689,0.147329650092081,0.0202578268876611,0.00460405156537753,707,0.325506445672192,1465,0.674493554327808
"E02004637",3,428,1424,1671,729,111,28,4394,0.000682749203459263,0.0974055530268548,0.32407828857533,0.380291306326809,0.165908056440601,0.0252617205279927,0.00637232589895312,1855,0.422166590805644,2539,0.577833409194356
"E02004638",0,83,488,846,290,29,7,1743,0,0.0476190476190476,0.279977051061388,0.485370051635112,0.166379804934022,0.0166379804934022,0.00401606425702811,571,0.327596098680436,1172,0.672403901319564
"E02004639",21,1793,2876,1777,810,122,54,7453,0.00281765731920032,0.240574265396485,0.385884878572387,0.23842747886757,0.108681068026298,0.0163692472829733,0.00724540453508654,4690,0.629276801288072,2763,0.370723198711928
"E02004640",0,134,806,1463,697,104,42,3246,0,0.0412815773259396,0.248305606900801,0.450708564386938,0.214725816389402,0.0320394331484904,0.0129390018484288,940,0.289587184226741,2306,0.710412815773259
"E02004641",2,93,703,1285,331,43,7,2464,0.000811688311688312,0.0377435064935065,0.285308441558442,0.52150974025974,0.134334415584416,0.0174512987012987,0.00284090909090909,798,0.323863636363636,1666,0.676136363636364
"E02004642",2,315,1557,1578,327,37,14,3830,0.000522193211488251,0.0822454308093995,0.406527415143603,0.41201044386423,0.085378590078329,0.00966057441253264,0.00365535248041775,1874,0.489295039164491,1956,0.510704960835509
"E02004643",25,121,907,1357,542,57,17,3026,0.00826173165895572,0.0399867812293457,0.299735624586913,0.448446794448116,0.17911434236616,0.018836748182419,0.00561797752808989,1053,0.347984137475215,1973,0.652015862524785
"E02004644",3,407,924,1522,593,88,25,3562,0.000842223469960696,0.114261650758001,0.259404828747894,0.427288040426727,0.166479505895564,0.0247052217855138,0.00701852891633914,1334,0.374508702975856,2228,0.625491297024144
"E02004645",3,53,1029,1507,156,10,2,2760,0.00108695652173913,0.0192028985507246,0.372826086956522,0.546014492753623,0.0565217391304348,0.0036231884057971,0.00072463768115942,1085,0.393115942028986,1675,0.606884057971015
"E02004646",35,456,1863,1507,287,69,13,4230,0.008274231678487,0.107801418439716,0.440425531914894,0.356264775413712,0.0678486997635934,0.0163120567375887,0.00307328605200946,2354,0.556501182033097,1876,0.443498817966903
"E02004647",8,331,628,927,187,22,13,2116,0.00378071833648393,0.156427221172023,0.296786389413989,0.438090737240076,0.0883742911153119,0.0103969754253308,0.00614366729678639,967,0.456994328922495,1149,0.543005671077505
"E02004648",5,69,473,845,252,30,18,1692,0.00295508274231678,0.0407801418439716,0.279550827423168,0.499408983451537,0.148936170212766,0.0177304964539007,0.0106382978723404,547,0.323286052009456,1145,0.676713947990544
"E02004649",1,201,1427,897,93,13,2,2634,0.000379650721336371,0.0763097949886105,0.541761579347001,0.340546697038724,0.0353075170842825,0.00493545937737282,0.000759301442672741,1629,0.618451025056948,1005,0.381548974943052
"E02004650",43,1882,2704,829,162,25,5,5650,0.00761061946902655,0.333097345132743,0.47858407079646,0.146725663716814,0.0286725663716814,0.00442477876106195,0.000884955752212389,4629,0.81929203539823,1021,0.18070796460177
"E02004651",27,1776,1203,844,383,95,28,4356,0.00619834710743802,0.40771349862259,0.276170798898072,0.193755739210285,0.0879247015610652,0.0218089990817264,0.00642791551882461,3006,0.690082644628099,1350,0.309917355371901
"E02004652",18,121,375,696,599,288,73,2170,0.00829493087557604,0.0557603686635945,0.172811059907834,0.32073732718894,0.276036866359447,0.132718894009217,0.0336405529953917,514,0.236866359447005,1656,0.763133640552995
"E02004653",95,1292,465,662,410,152,41,3117,0.0304780237407764,0.414501122874559,0.149181905678537,0.212383702277831,0.13153673403914,0.0487648379852422,0.013153673403914,1852,0.594161052293872,1265,0.405838947706128
"E02004654",9,391,1440,1458,534,82,28,3942,0.00228310502283105,0.0991882293252156,0.365296803652968,0.36986301369863,0.135464231354642,0.0208016235413496,0.00710299340436327,1840,0.466768138001015,2102,0.533231861998985
"E02004655",0,344,1090,1051,338,55,13,2891,0,0.118989968868903,0.377032168799723,0.363542026980284,0.116914562435144,0.0190245589761328,0.00449671393981321,1434,0.496022137668627,1457,0.503977862331373
"E02004656",20,523,1493,1656,765,181,47,4685,0.00426894343649947,0.111632870864461,0.318676627534685,0.353468516542156,0.163287086446105,0.0386339381003202,0.0100320170757737,2036,0.434578441835646,2649,0.565421558164354
"E02004657",2,103,453,942,501,130,24,2155,0.000928074245939675,0.0477958236658933,0.210208816705336,0.437122969837587,0.232482598607889,0.0603248259860789,0.0111368909512761,558,0.258932714617169,1597,0.741067285382831
"E02004658",2,87,703,880,296,56,18,2042,0.000979431929480901,0.0426052889324192,0.344270323212537,0.430950048971596,0.144955925563173,0.0274240940254652,0.00881488736532811,792,0.387855044074437,1250,0.612144955925563
"E02004659",8,394,459,806,436,98,29,2230,0.00358744394618834,0.176681614349776,0.205829596412556,0.361434977578475,0.195515695067265,0.0439461883408072,0.0130044843049327,861,0.38609865470852,1369,0.61390134529148
"E02004660",18,225,512,927,531,112,28,2353,0.00764980875478113,0.0956226094347641,0.217594560135997,0.393965150871228,0.225669358266043,0.0475988100297493,0.0118997025074373,755,0.320866978325542,1598,0.679133021674458
"E02004661",41,740,790,1285,437,61,18,3372,0.012158956109134,0.219454329774614,0.234282325029656,0.381079478054567,0.129596678529063,0.0180901542111507,0.00533807829181495,1571,0.465895610913404,1801,0.534104389086596
"E02004662",34,446,519,833,422,133,31,2418,0.0140612076095947,0.184449958643507,0.214640198511166,0.34449958643507,0.174524400330852,0.0550041356492969,0.0128205128205128,999,0.413151364764268,1419,0.586848635235732
"E02004663",25,197,824,909,425,114,24,2518,0.00992851469420175,0.0782366957903098,0.32724384432089,0.361000794281176,0.16878474980143,0.04527402700556,0.00953137410643368,1046,0.415409054805401,1472,0.584590945194599
"E02004664",14,503,842,1037,394,65,23,2878,0.00486448922863099,0.174774148714385,0.292564280750521,0.360319666435024,0.136900625434329,0.022585128561501,0.00799166087560806,1359,0.472202918693537,1519,0.527797081306463
"E02004665",10,323,694,1066,540,156,37,2826,0.00353857041755131,0.114295824486907,0.245576786978061,0.37721160651097,0.191082802547771,0.0552016985138004,0.0130927105449398,1027,0.363411181882519,1799,0.636588818117481
"E02004666",40,751,1923,1362,273,49,9,4407,0.0090764692534604,0.170410710233719,0.436351259360109,0.309053778080327,0.0619469026548673,0.011118674835489,0.00204220558202859,2714,0.615838438847288,1693,0.384161561152712
"E02004667",6,329,1478,1523,699,154,55,4244,0.00141376060320452,0.0775212064090481,0.348256361922714,0.358859566446748,0.164703110273327,0.0362865221489161,0.0129594721960415,1813,0.427191328934967,2431,0.572808671065033
"E02004668",46,546,723,1151,629,230,72,3397,0.0135413600235502,0.160730055931704,0.212834854283191,0.338828377980571,0.185163379452458,0.067706800117751,0.0211951722107742,1315,0.387106270238446,2082,0.612893729761554
"E02004669",38,464,519,645,433,136,38,2273,0.0167179938407391,0.204135503739551,0.228332600087989,0.28376594808623,0.190497140343159,0.0598328200615926,0.0167179938407391,1021,0.44918609766828,1252,0.55081390233172
"E02004671",72,1304,431,672,333,103,28,2943,0.0244648318042813,0.443085287121984,0.146449201495073,0.228338430173293,0.113149847094801,0.0349983010533469,0.00951410125722052,1807,0.613999320421339,1136,0.386000679578661
"E02004672",21,576,1584,1978,483,55,11,4708,0.00446049277824979,0.122344944774851,0.336448598130841,0.420135938827528,0.102591333899745,0.0116822429906542,0.00233644859813084,2181,0.463254035683942,2527,0.536745964316058
"E02004673",159,1593,638,674,263,82,30,3439,0.0462343704565281,0.463216051177668,0.18551904623437,0.195987205583018,0.0764757196859552,0.0238441407385868,0.00872346612387322,2390,0.694969467868566,1049,0.305030532131434
"E02004674",40,1891,1827,1074,385,66,15,5298,0.00755001887504719,0.356927142317856,0.34484711211778,0.202718006795017,0.0726689316723292,0.0124575311438279,0.0028312570781427,3758,0.709324273310683,1540,0.290675726689317
"E02004675",4,289,934,1021,218,23,7,2496,0.0016025641025641,0.115785256410256,0.374198717948718,0.409054487179487,0.0873397435897436,0.00921474358974359,0.00280448717948718,1227,0.491586538461538,1269,0.508413461538462
"E02004676",11,128,819,1055,307,68,14,2402,0.00457951706910908,0.0532889258950874,0.340965861781848,0.439217318900916,0.127810158201499,0.0283097418817652,0.00582847626977519,958,0.398834304746045,1444,0.601165695253955
"E02004677",14,193,413,758,621,208,39,2246,0.006233303650935,0.0859305431878896,0.183882457702582,0.337488869100623,0.276491540516474,0.0926090828138914,0.0173642030276046,620,0.276046304541407,1626,0.723953695458593
"E02004678",16,173,704,1017,430,110,34,2484,0.00644122383252818,0.069645732689211,0.28341384863124,0.409420289855072,0.173107890499195,0.0442834138486312,0.0136876006441224,893,0.359500805152979,1591,0.640499194847021
"E02004679",11,1520,1026,987,361,80,30,4015,0.00273972602739726,0.378580323785803,0.255541718555417,0.245828144458281,0.0899128268991283,0.0199252801992528,0.0074719800747198,2557,0.636861768368618,1458,0.363138231631382
"E02004680",2,457,1710,868,94,6,1,3138,0.000637348629700446,0.145634161886552,0.544933078393881,0.276609305289994,0.029955385595921,0.00191204588910134,0.000318674314850223,2169,0.691204588910134,969,0.308795411089866
"E02004681",5,1871,2968,961,93,5,4,5908,0.000846310088016249,0.31668923493568,0.502369668246445,0.162660798916723,0.0157413676371022,0.000846310088016249,0.000677048070412999,4844,0.819905213270142,1063,0.179925524712255
"E02004682",1,450,1356,1026,150,8,2,2993,0.000334112930170398,0.150350818576679,0.453057133311059,0.342799866354828,0.0501169395255596,0.00267290344136318,0.000668225860340795,1807,0.603742064817908,1186,0.396257935182092
"E02004683",2,727,1270,960,154,22,6,3141,0.000636739891754218,0.231454950652658,0.404329831263929,0.305635148042025,0.0490289716650748,0.0070041388092964,0.00191021967526266,1999,0.636421521808341,1142,0.363578478191659
"E02004684",3,1587,1850,1025,164,9,4,4642,0.000646273158121499,0.341878500646273,0.398535114174925,0.220809995691512,0.035329599310642,0.0019388194743645,0.000861697544161999,3440,0.741059887979319,1202,0.258940112020681
"E02004685",0,519,2164,1264,247,27,11,4232,0,0.122637051039698,0.511342155009452,0.298676748582231,0.0583648393194707,0.00637996219281664,0.0025992438563327,2683,0.633979206049149,1549,0.366020793950851
"E02004686",3,761,1425,1214,366,61,14,3844,0.000780437044745057,0.197970863683663,0.370707596253902,0.315816857440167,0.095213319458897,0.0158688865764828,0.0036420395421436,2189,0.56945889698231,1655,0.43054110301769
"E02004687",3,214,1213,913,133,20,3,2499,0.00120048019207683,0.0856342537014806,0.485394157663065,0.365346138455382,0.0532212885154062,0.00800320128051221,0.00120048019207683,1430,0.572228891556623,1069,0.427771108443377
"E02004688",6,87,1713,1089,177,12,6,3090,0.00194174757281553,0.0281553398058252,0.554368932038835,0.352427184466019,0.0572815533980583,0.00388349514563107,0.00194174757281553,1806,0.584466019417476,1284,0.415533980582524
"E02004689",18,268,532,753,256,32,5,1864,0.00965665236051502,0.143776824034335,0.285407725321888,0.403969957081545,0.137339055793991,0.0171673819742489,0.00268240343347639,818,0.438841201716738,1046,0.561158798283262
"E02004690",3,139,1226,955,245,12,3,2583,0.00116144018583043,0.0538133952768099,0.474641889276036,0.369725125822687,0.0948509485094851,0.00464576074332172,0.00116144018583043,1368,0.529616724738676,1215,0.470383275261324
"E02004691",17,188,688,933,538,147,46,2557,0.00664841611263199,0.073523660539695,0.269065310911224,0.364880719593273,0.210402815799765,0.0574892452092296,0.0179898318341807,893,0.349237387563551,1664,0.650762612436449
"E02004692",2,65,606,962,174,27,4,1840,0.00108695652173913,0.0353260869565217,0.329347826086957,0.522826086956522,0.0945652173913043,0.0146739130434783,0.00217391304347826,673,0.365760869565217,1167,0.634239130434783
"E02004693",0,153,1695,827,58,9,1,2743,0,0.0557783448778709,0.617936565803864,0.301494713816989,0.021144732045206,0.003281079110463,0.000364564345607,1848,0.673714910681735,895,0.326285089318265
"E02004694",7,415,898,906,404,114,28,2772,0.00252525252525253,0.1497113997114,0.323953823953824,0.326839826839827,0.145743145743146,0.0411255411255411,0.0101010101010101,1320,0.476190476190476,1452,0.523809523809524
"E02004695",4,198,1463,925,85,4,0,2679,0.00149309443822322,0.0739081746920493,0.546099290780142,0.345278088839119,0.0317282568122434,0.00149309443822322,0,1665,0.621500559910414,1014,0.378499440089586
"E02004696",58,1680,708,751,334,90,30,3651,0.0158860586140783,0.460147904683648,0.19391947411668,0.205697069296083,0.0914817858121063,0.0246507806080526,0.00821692686935086,2446,0.669953437414407,1205,0.330046562585593
"E02004697",15,423,573,754,388,96,18,2267,0.00661667401852669,0.186590207322453,0.252756947507719,0.332598147331275,0.171151301279224,0.0423467137185708,0.00794000882223202,1011,0.445963828848699,1256,0.554036171151301
"E02004698",40,762,1242,845,241,38,16,3184,0.0125628140703518,0.239321608040201,0.390075376884422,0.265389447236181,0.0756909547738693,0.0119346733668342,0.0050251256281407,2044,0.641959798994975,1140,0.358040201005025
"E02004699",42,787,1407,1463,403,48,11,4161,0.0100937274693583,0.189137226628214,0.338139870223504,0.351598173515982,0.0968517183369382,0.0115356885364095,0.00264359528959385,2236,0.537370824321077,1925,0.462629175678923
"E02004700",39,801,1343,658,120,33,12,3006,0.0129740518962076,0.266467065868263,0.446773120425815,0.218895542248836,0.0399201596806387,0.0109780439121756,0.00399201596806387,2183,0.726214238190286,823,0.273785761809714
"E02004702",19,175,1222,1032,175,27,4,2654,0.00715900527505652,0.0659382064807837,0.46043707611153,0.388847023360965,0.0659382064807837,0.0101733232856066,0.00150715900527506,1416,0.53353428786737,1238,0.46646571213263
"E02004703",53,897,1048,1132,650,181,50,4011,0.0132136624283221,0.223635003739716,0.261281475941162,0.282223884318125,0.162054350536026,0.0451259037646472,0.012465719272002,1998,0.4981301421092,2013,0.5018698578908
"E02004704",95,550,495,719,316,105,44,2324,0.0408777969018933,0.236660929432014,0.212994836488812,0.309380378657487,0.135972461273666,0.0451807228915663,0.0189328743545611,1140,0.490533562822719,1184,0.509466437177281
"E02004705",8,898,1184,1166,364,95,16,3731,0.00214419726614849,0.240686143125168,0.317341195389976,0.312516751541142,0.0975609756097561,0.0254623425355133,0.00428839453229697,2090,0.560171535781292,1641,0.439828464218708
"E02004706",49,212,690,1030,417,119,30,2547,0.0192383195916765,0.0832351786415391,0.270906949352179,0.404397330192383,0.163722025912839,0.0467216332940715,0.0117785630153121,951,0.373380447585395,1596,0.626619552414605
"E02004707",26,259,1075,1302,772,253,69,3756,0.00692225772097977,0.0689563365282215,0.286208732694356,0.346645367412141,0.205537806176784,0.0673588924387646,0.018370607028754,1360,0.362087326943557,2396,0.637912673056443
"E02004708",8,635,1407,1361,411,81,10,3913,0.00204446716074623,0.162279580884232,0.359570661896243,0.347814975721952,0.105034500383338,0.0207002300025556,0.00255558395093279,2050,0.523894709941222,1863,0.476105290058778
"E02004709",46,581,749,972,229,40,23,2640,0.0174242424242424,0.220075757575758,0.283712121212121,0.368181818181818,0.0867424242424242,0.0151515151515152,0.00871212121212121,1376,0.521212121212121,1264,0.478787878787879
"E02004710",19,215,716,838,188,39,29,2044,0.00929549902152642,0.105185909980431,0.350293542074364,0.409980430528376,0.0919765166340509,0.0190802348336595,0.014187866927593,950,0.464774951076321,1094,0.535225048923679
"E02004712",15,125,761,1195,349,52,3,2500,0.006,0.05,0.3044,0.478,0.1396,0.0208,0.0012,901,0.3604,1599,0.6396
"E02004713",6,194,739,1167,256,27,2,2391,0.00250941028858218,0.0811375993308239,0.309075700543706,0.488080301129235,0.10706817231284,0.0112923462986198,0.000836470096194061,939,0.392722710163112,1452,0.607277289836888
"E02004714",2,332,1019,1053,282,33,7,2728,0.000733137829912023,0.121700879765396,0.373533724340176,0.38599706744868,0.103372434017595,0.0120967741935484,0.00256598240469208,1353,0.495967741935484,1375,0.504032258064516
"E02004715",20,828,1268,1067,258,34,4,3479,0.00574877838459327,0.237999425122162,0.364472549583214,0.306697326818051,0.0741592411612532,0.00977292325380857,0.00114975567691865,2116,0.608220753089968,1363,0.391779246910032
"E02004716",6,312,971,1213,241,33,10,2786,0.00215362526920316,0.111988513998564,0.348528356066044,0.435391241923905,0.0865039483129935,0.0118449389806174,0.00358937544867193,1289,0.462670495333812,1497,0.537329504666188
"E02004717",68,1993,2015,1269,272,38,7,5662,0.0120098904980572,0.351995761215118,0.355881314023313,0.224125750618156,0.0480395619922289,0.00671140939597315,0.00123631225715295,4076,0.719886965736489,1586,0.280113034263511
"E02004718",5,618,1741,1356,290,39,16,4065,0.001230012300123,0.152029520295203,0.428290282902829,0.333579335793358,0.0713407134071341,0.00959409594095941,0.0039360393603936,2364,0.581549815498155,1701,0.418450184501845
"E02004719",63,1103,1042,1291,266,38,8,3811,0.0165310942009971,0.289425347677775,0.273419050118079,0.338756231960115,0.0697979532930989,0.00997113618472842,0.00209918656520598,2208,0.579375491996851,1603,0.420624508003149
"E02004720",10,632,1552,1555,343,67,21,4180,0.00239234449760766,0.151196172248804,0.371291866028708,0.37200956937799,0.0820574162679426,0.0160287081339713,0.00502392344497608,2194,0.52488038277512,1986,0.47511961722488
"E02004721",104,2032,1518,1082,133,11,5,4885,0.0212896622313204,0.41596724667349,0.310747185261003,0.221494370522006,0.0272262026612078,0.0022517911975435,0.00102354145342886,3654,0.748004094165814,1231,0.251995905834186
"E02004722",4,144,1000,1063,214,30,8,2463,0.00162403572878603,0.0584652862362972,0.406008932196508,0.431587494924888,0.0868859114900528,0.0121802679658952,0.00324807145757207,1148,0.466098254161592,1315,0.533901745838408
"E02004723",12,309,1166,1285,283,15,8,3078,0.00389863547758285,0.100389863547758,0.378817413905133,0.417478882391163,0.0919428200129954,0.00487329434697856,0.00259909031838856,1487,0.483105912930474,1591,0.516894087069526
"E02004724",20,1102,1182,1011,225,35,10,3585,0.00557880055788006,0.307391910739191,0.329707112970711,0.282008368200837,0.0627615062761506,0.0097629009762901,0.00278940027894003,2304,0.642677824267782,1281,0.357322175732218
"E02004725",6,402,945,826,190,19,7,2395,0.00250521920668058,0.167849686847599,0.394572025052192,0.344885177453027,0.0793319415448852,0.00793319415448852,0.00292275574112735,1353,0.564926931106472,1042,0.435073068893528
"E02004726",53,200,944,929,236,27,2,2391,0.0221664575491426,0.0836470096194061,0.394813885403597,0.388540359682141,0.0987034713508992,0.0112923462986198,0.000836470096194061,1197,0.500627352572146,1194,0.499372647427854
"E02004727",35,652,1217,1127,201,29,10,3271,0.0107000917150718,0.199327422806481,0.372057474778355,0.344542953225313,0.0614490981351269,0.00886579027820238,0.0030571690614491,1904,0.582084989299908,1367,0.417915010700092
"E02004728",2,654,1364,1097,271,27,10,3425,0.000583941605839416,0.190948905109489,0.398248175182482,0.32029197080292,0.0791240875912409,0.00788321167883212,0.00291970802919708,2020,0.58978102189781,1405,0.41021897810219
"E02004729",1,231,1080,838,194,25,9,2378,0.000420521446593776,0.0971404541631623,0.454163162321278,0.352396972245585,0.0815811606391926,0.0105130361648444,0.00378469301934399,1312,0.551724137931034,1066,0.448275862068966
"E02004730",5,141,814,1196,359,41,10,2566,0.0019485580670304,0.0549493374902572,0.317225253312549,0.466095089633671,0.139906469212783,0.0159781761496493,0.00389711613406079,960,0.374123148869836,1606,0.625876851130164
"E02004731",5,212,964,1085,159,20,5,2450,0.00204081632653061,0.086530612244898,0.393469387755102,0.442857142857143,0.0648979591836735,0.00816326530612245,0.00204081632653061,1181,0.482040816326531,1269,0.517959183673469
"E02004732",75,624,848,1124,269,68,31,3039,0.0246791707798618,0.20533070088845,0.279039157617637,0.369858506087529,0.0885159591971043,0.0223757815070747,0.0102007239223429,1547,0.509049029285949,1492,0.490950970714051
"E02004733",9,542,982,1025,267,39,9,2873,0.0031326139923425,0.188652975983293,0.341802993386704,0.356769926905673,0.0929342151061608,0.0135746606334842,0.0031326139923425,1533,0.533588583362339,1340,0.466411416637661
"E02004734",2,302,1386,1535,430,84,25,3764,0.00053134962805526,0.0802337938363443,0.368225292242295,0.407810839532412,0.114240170031881,0.0223166843783209,0.00664187035069075,1690,0.448990435706695,2074,0.551009564293305
"E02004735",6,76,698,1092,264,39,1,2176,0.00275735294117647,0.0349264705882353,0.320772058823529,0.501838235294118,0.121323529411765,0.0179227941176471,0.000459558823529412,780,0.358455882352941,1396,0.641544117647059
"E02004736",4,272,650,1109,293,58,14,2400,0.00166666666666667,0.113333333333333,0.270833333333333,0.462083333333333,0.122083333333333,0.0241666666666667,0.00583333333333333,926,0.385833333333333,1474,0.614166666666667
"E02004737",4,451,1231,1026,300,75,11,3098,0.0012911555842479,0.145577792123951,0.397353131052292,0.331181407359587,0.0968366688185926,0.0242091672046482,0.00355067785668173,1686,0.544222078760491,1412,0.455777921239509
"E02004738",2,79,785,1027,266,52,10,2221,0.00090049527239982,0.0355695632597929,0.353444394416929,0.462404322377307,0.119765871229176,0.0234128770823953,0.0045024763619991,866,0.389914452949122,1355,0.610085547050878
"E02004739",13,156,791,908,245,41,7,2161,0.00601573345673299,0.0721888014807959,0.366034243405831,0.420175844516428,0.113373438223045,0.018972697825081,0.003239241092087,960,0.44423877834336,1201,0.55576122165664
"E02004740",7,96,899,1019,197,26,8,2252,0.00310834813499112,0.0426287744227353,0.399200710479574,0.452486678507993,0.0874777975133215,0.0115452930728242,0.00355239786856128,1002,0.4449378330373,1250,0.5550621669627
"E02004741",3,162,932,1002,195,18,3,2315,0.00129589632829374,0.0699784017278618,0.402591792656587,0.432829373650108,0.0842332613390929,0.00777537796976242,0.00129589632829374,1097,0.473866090712743,1218,0.526133909287257
"E02004742",2,106,992,1096,226,24,3,2449,0.000816659861167824,0.0432829726418947,0.40506329113924,0.447529603919967,0.0922825643119641,0.00979991833401388,0.00122498979175174,1100,0.449162923642303,1349,0.550837076357697
"E02004743",3,49,765,1133,224,37,7,2218,0.00135256988277728,0.0220919747520289,0.344905320108206,0.510820559062218,0.100991884580703,0.0166816952209197,0.00315599639314698,817,0.368349864743012,1401,0.631650135256988
"E02004744",60,772,1746,1146,406,258,42,4430,0.0135440180586907,0.174266365688488,0.394130925507901,0.258690744920993,0.091647855530474,0.0582392776523702,0.00948081264108352,2578,0.581941309255079,1852,0.418058690744921
"E02004745",1,247,1631,1405,227,31,10,3552,0.000281531531531532,0.0695382882882883,0.459177927927928,0.395551801801802,0.0639076576576577,0.00872747747747748,0.00281531531531532,1879,0.528997747747748,1673,0.471002252252252
"E02004746",6,692,2127,1209,284,44,8,4370,0.00137299771167048,0.158352402745995,0.486727688787185,0.276659038901602,0.0649885583524027,0.0100686498855835,0.00183066361556064,2825,0.646453089244851,1545,0.353546910755149
"E02004747",4,52,992,1146,217,45,6,2462,0.0016246953696182,0.0211210398050366,0.402924451665313,0.465475223395613,0.0881397238017872,0.0182778229082047,0.00243704305442729,1048,0.425670186839967,1414,0.574329813160032
"E02004748",1,544,2448,1545,410,78,34,5060,0.000197628458498024,0.107509881422925,0.483794466403162,0.305335968379447,0.0810276679841897,0.0154150197628458,0.00671936758893281,2993,0.591501976284585,2067,0.408498023715415
"E02004749",2,79,762,1135,293,48,6,2325,0.000860215053763441,0.0339784946236559,0.327741935483871,0.488172043010753,0.126021505376344,0.0206451612903226,0.00258064516129032,843,0.36258064516129,1482,0.63741935483871
"E02004750",2,64,910,1384,376,54,9,2799,0.000714540907466952,0.0228653090389425,0.325116112897463,0.494462307967131,0.134333690603787,0.0192926045016077,0.00321543408360129,976,0.348695962843873,1823,0.651304037156127
"E02004751",6,338,930,1162,267,49,9,2761,0.00217312567910177,0.122419413256067,0.336834480260775,0.420862006519377,0.096704092720029,0.0177471930459978,0.00325968851865266,1274,0.461427019195943,1487,0.538572980804056
"E02004752",4,68,715,1066,213,30,3,2099,0.00190566936636494,0.0323963792282039,0.340638399237732,0.507860886136255,0.101476893758933,0.014292520247737,0.0014292520247737,787,0.374940447832301,1312,0.625059552167699
"E02004753",26,694,1053,1263,370,60,10,3476,0.00747986191024166,0.199654775604143,0.302934407364787,0.363348676639816,0.10644418872267,0.0172612197928654,0.00287686996547756,1773,0.510069044879171,1703,0.489930955120829
"E02004754",10,564,801,853,349,94,23,2694,0.00371195248700817,0.209354120267261,0.297327394209354,0.316629547141797,0.129547141796585,0.0348923533778768,0.00853749072011878,1375,0.510393466963623,1319,0.489606533036377
"E02004755",11,841,2928,1334,294,40,9,5457,0.00201575957485798,0.154113982041415,0.536558548653106,0.244456661169141,0.0538757559098406,0.00733003481766538,0.00164925783397471,3780,0.692688290269379,1677,0.307311709730621
"E02004756",4,1040,1154,1149,212,37,6,3602,0.00111049416990561,0.288728484175458,0.320377568017768,0.318989450305386,0.0588561910049972,0.0102720710716269,0.00166574125485841,2198,0.610216546363132,1404,0.389783453636868
"E02004757",4,96,535,1082,372,55,7,2151,0.00185960018596002,0.0446304044630404,0.248721524872152,0.503021850302185,0.172942817294282,0.0255695025569503,0.00325430032543003,635,0.295211529521153,1516,0.704788470478847
"E02004758",8,719,1076,956,347,85,12,3203,0.00249765844520762,0.224477052763035,0.335935060880425,0.29847018420231,0.10833593506088,0.0265376209803309,0.00374648766781143,1803,0.562909772088667,1400,0.437090227911333
"E02004759",4,121,752,1101,306,51,22,2357,0.00169707254985151,0.0513364446330081,0.319049639372083,0.467119219346627,0.12982605006364,0.0216376750106067,0.00933389902418328,877,0.372083156554943,1480,0.627916843445057
"E02004760",80,1472,1116,1203,246,51,9,4177,0.019152501795547,0.352406033038066,0.267177400047881,0.288005745750539,0.0588939430213072,0.0122097198946612,0.00215465645199904,2668,0.638735934881494,1509,0.361264065118506
"E02004761",7,304,884,759,231,46,5,2236,0.00313059033989267,0.135957066189624,0.395348837209302,0.339445438282648,0.103309481216458,0.0205724508050089,0.00223613595706619,1195,0.534436493738819,1041,0.465563506261181
"E02004764",1,350,775,1206,340,53,6,2731,0.000366166239472721,0.128158183815452,0.283778835591358,0.441596484804101,0.124496521420725,0.0194068106920542,0.00219699743683632,1126,0.412303185646283,1605,0.587696814353717
"E02004765",1,122,723,939,275,20,4,2084,0.000479846449136276,0.0585412667946257,0.346928982725528,0.450575815738964,0.131957773512476,0.00959692898272553,0.00191938579654511,846,0.40595009596929,1238,0.59404990403071
"E02004766",4,421,1085,858,240,27,7,2642,0.00151400454201363,0.159348978046934,0.410673732021196,0.324753974261923,0.0908402725208176,0.010219530658592,0.00264950794852385,1510,0.571536714610144,1132,0.428463285389856
"E02004767",3,176,988,655,104,29,5,1960,0.00153061224489796,0.0897959183673469,0.504081632653061,0.334183673469388,0.0530612244897959,0.0147959183673469,0.00255102040816327,1167,0.595408163265306,793,0.404591836734694
"E02004768",1,51,846,755,130,15,1,1799,0.000555864369093941,0.028349082823791,0.470261256253474,0.419677598665926,0.0722623679822123,0.00833796553640912,0.000555864369093941,898,0.499166203446359,901,0.500833796553641
"E02004769",2,142,1081,816,134,26,12,2213,0.000903750564844103,0.0641662901039313,0.488477180298238,0.368730230456394,0.0605512878445549,0.0117487573429733,0.00542250338906462,1225,0.553547220967013,988,0.446452779032987
"E02004770",4,155,1183,886,174,35,9,2446,0.00163532297628782,0.0633687653311529,0.483646770237122,0.362224039247751,0.07113654946852,0.0143090760425184,0.00367947669664759,1342,0.548650858544563,1104,0.451349141455437
"E02004771",2,319,1305,1197,223,73,26,3145,0.000635930047694754,0.101430842607313,0.414944356120827,0.38060413354531,0.070906200317965,0.0232114467408585,0.0082670906200318,1626,0.517011128775835,1519,0.482988871224165
"E02004772",1,234,1086,1199,372,57,8,2957,0.000338180588434224,0.0791342576936084,0.367264119039567,0.405478525532634,0.125803178897531,0.0192762935407508,0.00270544470747379,1321,0.44673655732161,1636,0.55326344267839
"E02004774",8,673,1203,1688,469,76,18,4135,0.00193470374848851,0.162756952841596,0.29093107617896,0.408222490931076,0.113422007255139,0.0183796856106409,0.00435308343409915,1884,0.455622732769045,2251,0.544377267230955
"E02004775",12,1116,1261,1473,509,70,27,4468,0.0026857654431513,0.249776186213071,0.282229185317816,0.329677708146822,0.113921217547001,0.0156669650850492,0.00604297224709042,2389,0.534691136974038,2079,0.465308863025962
"E02004776",4,357,593,850,272,72,15,2163,0.00184928340268146,0.16504854368932,0.274156264447527,0.39297272306981,0.125751271382339,0.0332871012482663,0.00693481276005548,954,0.441054091539528,1209,0.558945908460472
"E02004777",3,189,876,963,381,92,16,2520,0.00119047619047619,0.075,0.347619047619048,0.382142857142857,0.151190476190476,0.0365079365079365,0.00634920634920635,1068,0.423809523809524,1452,0.576190476190476
"E02004778",6,261,756,1069,381,132,38,2643,0.00227014755959137,0.0987514188422247,0.286038592508513,0.404464623533863,0.144154370034052,0.0499432463110102,0.0143776012107454,1023,0.387060158910329,1620,0.612939841089671
"E02004779",16,403,1037,1422,852,224,83,4037,0.00396333911320287,0.0998266039137974,0.256873916274461,0.352241763685905,0.211047807778053,0.0554867475848402,0.0205598216497399,1456,0.360663859301461,2581,0.639336140698539
"E02004780",0,65,769,847,203,28,3,1915,0,0.0339425587467363,0.401566579634465,0.442297650130548,0.106005221932115,0.014621409921671,0.00156657963446475,834,0.435509138381201,1081,0.564490861618799
"E02004781",2,220,1004,1093,197,18,5,2539,0.000787711697518708,0.0866482867270579,0.395431272154391,0.430484442693974,0.0775896022055928,0.00708940527766837,0.00196927924379677,1226,0.482867270578968,1313,0.517132729421032
"E02004782",12,306,1078,1165,345,55,14,2975,0.00403361344537815,0.102857142857143,0.362352941176471,0.391596638655462,0.115966386554622,0.0184873949579832,0.00470588235294118,1396,0.469243697478992,1579,0.530756302521008
"E02004783",2,84,856,1031,239,38,5,2255,0.000886917960088692,0.0372505543237251,0.37960088691796,0.457206208425721,0.105986696230599,0.0168514412416851,0.00221729490022173,942,0.417738359201774,1313,0.582261640798226
"E02004784",7,56,328,642,257,62,14,1366,0.00512445095168375,0.04099560761347,0.240117130307467,0.469985358711567,0.18814055636896,0.0453879941434846,0.0102489019033675,391,0.286237188872621,975,0.713762811127379
"E02004785",6,128,400,707,475,164,41,1921,0.00312337324310255,0.0666319625195211,0.208224882873503,0.368037480478917,0.247267048412285,0.0853722019781364,0.0213430504945341,534,0.277980218636127,1387,0.722019781363873
"E02004786",4,79,1374,1042,181,34,7,2721,0.00147004777655274,0.0290334435869166,0.504961411245865,0.382947445791988,0.0665196618890114,0.0124954061006983,0.00257258360896729,1457,0.535464902609335,1264,0.464535097390665
"E02004787",3,145,1001,1236,325,39,6,2755,0.00108892921960073,0.0526315789473684,0.363339382940109,0.448638838475499,0.117967332123412,0.0141560798548094,0.00217785843920145,1149,0.417059891107078,1606,0.582940108892922
"E02004788",16,69,547,966,362,93,20,2073,0.00771828268210323,0.0332850940665702,0.263868789194404,0.465991316931983,0.174626145682586,0.044862518089725,0.00964785335262904,632,0.304872165943078,1441,0.695127834056922
"E02004789",13,252,1445,1330,281,40,9,3370,0.00385756676557863,0.0747774480712166,0.428783382789317,0.394658753709199,0.0833827893175074,0.0118694362017804,0.00267062314540059,1710,0.507418397626113,1660,0.492581602373887
"E02004790",7,449,1255,1159,419,60,18,3367,0.00207900207900208,0.133353133353133,0.372735372735373,0.344223344223344,0.124443124443124,0.0178200178200178,0.00534600534600535,1711,0.508167508167508,1656,0.491832491832492
"E02004791",3,176,711,629,132,19,6,1676,0.00178997613365155,0.105011933174224,0.424224343675418,0.375298329355609,0.0787589498806683,0.0113365155131265,0.0035799522673031,890,0.531026252983294,786,0.468973747016706
"E02004792",16,127,767,1266,326,75,19,2596,0.0061633281972265,0.0489214175654854,0.295454545454545,0.487673343605547,0.12557781201849,0.0288906009244992,0.00731895223420647,910,0.350539291217257,1686,0.649460708782743
"E02004793",3,219,762,1019,397,93,26,2519,0.00119094878920206,0.0869392616117507,0.302500992457324,0.404525605398968,0.157602223104406,0.036919412465264,0.0103215561730846,984,0.390631202858277,1535,0.609368797141723
"E02004794",14,171,532,967,435,116,33,2268,0.00617283950617284,0.0753968253968254,0.234567901234568,0.42636684303351,0.191798941798942,0.0511463844797178,0.0145502645502645,717,0.316137566137566,1551,0.683862433862434
"E02004795",12,515,1288,1348,780,262,100,4305,0.00278745644599303,0.119628339140534,0.299186991869919,0.313124274099884,0.181184668989547,0.0608594657375145,0.0232288037166086,1815,0.421602787456446,2490,0.578397212543554
"E02004796",11,160,911,1554,430,95,20,3181,0.00345803206538824,0.050298648223829,0.286387928324426,0.488525620873939,0.13517761710154,0.0298648223828985,0.00628733102797862,1082,0.340144608613643,2099,0.659855391386357
"E02004797",9,408,1532,1216,253,47,6,3471,0.00259291270527226,0.117545375972342,0.441371362719677,0.350331316623451,0.0728896571593201,0.0135407663497551,0.0017286084701815,1949,0.561509651397292,1522,0.438490348602708
"E02004798",5,254,1302,859,149,17,5,2591,0.00192975685063682,0.0980316480123504,0.502508683905828,0.331532226939406,0.0575067541489772,0.00656117329216519,0.00192975685063682,1561,0.602470088768815,1030,0.397529911231185
"E02004799",11,270,1363,1545,391,63,10,3653,0.00301122365179305,0.0739118532712839,0.373117985217629,0.422940049274569,0.107035313441007,0.0172460990966329,0.00273747604708459,1644,0.450041062140706,2009,0.549958937859294
"E02004800",9,121,916,1404,373,60,9,2892,0.00311203319502075,0.0418395573997234,0.316735822959889,0.485477178423237,0.128976486860304,0.020746887966805,0.00311203319502075,1046,0.361687413554633,1846,0.638312586445367
"E02004801",34,304,1220,1420,375,73,16,3442,0.00987797791981406,0.0883207437536316,0.354445090063916,0.412550842533411,0.108948285880302,0.0212085996513655,0.00464846019755956,1558,0.452643811737362,1884,0.547356188262638
"E02004802",2,73,975,1038,260,30,4,2382,0.000839630562552477,0.0306465155331654,0.409319899244332,0.435768261964736,0.109151973131822,0.0125944584382872,0.00167926112510495,1050,0.44080604534005,1332,0.55919395465995
"E02004803",1,40,1103,1229,230,13,4,2620,0.000381679389312977,0.0152671755725191,0.420992366412214,0.469083969465649,0.0877862595419847,0.0049618320610687,0.00152671755725191,1144,0.436641221374046,1476,0.563358778625954
"E02004804",14,57,618,1001,274,22,2,1988,0.00704225352112676,0.028672032193159,0.310865191146881,0.503521126760563,0.137826961770624,0.0110663983903421,0.00100603621730382,689,0.346579476861167,1299,0.653420523138833
"E02004805",0,611,1010,1058,369,60,6,3114,0,0.196210661528581,0.324341682723186,0.33975594091201,0.11849710982659,0.0192678227360308,0.00192678227360308,1621,0.520552344251766,1493,0.479447655748234
"E02004806",23,202,1116,1088,173,13,2,2617,0.00878868933893772,0.0771876194115399,0.426442491402369,0.415743217424532,0.0661062285059228,0.00496752006113871,0.000764233855559801,1341,0.512418800152847,1276,0.487581199847153
"E02004807",4,552,1401,1586,447,43,6,4039,0.000990344144590245,0.136667491953454,0.346868036642733,0.392671453330032,0.11067095815796,0.0106461995543451,0.00148551621688537,1957,0.484525872740777,2082,0.515474127259223
"E02004808",41,854,2111,1529,602,107,15,5259,0.00779615896558281,0.16238828674653,0.401407111618178,0.290739684350637,0.114470431640996,0.0203460733979844,0.00285225328009127,3006,0.571591557330291,2253,0.428408442669709
"E02004809",24,1971,2709,897,194,26,5,5826,0.00411946446961895,0.338311019567456,0.464984552008239,0.153964984552008,0.0332990044627532,0.00446275317542053,0.000858221764503948,4704,0.807415036045314,1122,0.192584963954686
"E02004810",16,835,1060,903,349,43,15,3221,0.00496740142812791,0.259236262030425,0.329090344613474,0.280347718099969,0.10835144365104,0.0133498913380938,0.00465693883886992,1911,0.593294008072027,1310,0.406705991927973
"E02004811",2,212,1196,1171,465,77,20,3143,0.000636334712058543,0.0674514794782055,0.380528157811009,0.372573973910277,0.147947820553611,0.0244988864142539,0.00636334712058543,1410,0.448615972001273,1733,0.551384027998727
"E02004812",3,114,543,943,344,57,10,2014,0.00148957298907646,0.0566037735849057,0.26961271102284,0.468222442899702,0.170804369414101,0.0283018867924528,0.00496524329692155,660,0.327706057596822,1354,0.672293942403178
"E02004813",1,73,1009,966,223,21,2,2295,0.000435729847494553,0.0318082788671024,0.439651416122004,0.420915032679739,0.0971677559912854,0.00915032679738562,0.000871459694989107,1083,0.471895424836601,1212,0.528104575163399
"E02004814",0,144,858,840,302,75,17,2236,0,0.0644007155635063,0.383720930232558,0.37567084078712,0.135062611806798,0.0335420393559928,0.00760286225402505,1002,0.448121645796064,1234,0.551878354203936
"E02004815",3,93,1411,932,89,7,1,2536,0.00118296529968454,0.0366719242902208,0.556388012618297,0.367507886435331,0.0350946372239748,0.0027602523659306,0.000394321766561514,1507,0.594242902208202,1029,0.405757097791798
"E02004817",3,237,1326,977,210,39,13,2805,0.00106951871657754,0.0844919786096257,0.472727272727273,0.348306595365419,0.0748663101604278,0.013903743315508,0.00463458110516934,1566,0.558288770053476,1239,0.441711229946524
"E02004818",6,120,1384,1204,395,80,20,3209,0.00186974135244624,0.0373948270489249,0.431287005297601,0.375194764724213,0.123091305702711,0.0249298846992833,0.00623247117482082,1510,0.470551573698972,1699,0.529448426301028
"E02004819",10,316,1107,1131,239,33,12,2848,0.00351123595505618,0.110955056179775,0.388693820224719,0.397120786516854,0.0839185393258427,0.0115870786516854,0.00421348314606742,1433,0.503160112359551,1415,0.496839887640449
"E02004820",13,65,644,839,683,143,32,2419,0.00537412153782555,0.0268706076891277,0.266225713104589,0.346837536171972,0.282348077718065,0.059115336916081,0.0132286068623398,722,0.298470442331542,1697,0.701529557668458
"E02004821",5,73,242,624,553,140,34,1671,0.00299222022740874,0.0436864153201676,0.144823459006583,0.37342908438061,0.330939557151406,0.0837821663674446,0.0203470975463794,320,0.191502094554159,1351,0.808497905445841
"E02004822",14,138,422,887,976,292,72,2801,0.0049982149232417,0.0492681185290968,0.150660478400571,0.316672616922528,0.348446983220278,0.104248482684755,0.0257051053195287,574,0.20492681185291,2227,0.79507318814709
"E02004823",4,182,1016,1279,216,54,15,2766,0.00144613159797542,0.0657989877078814,0.367317425885756,0.462400578452639,0.0780911062906725,0.0195227765726681,0.00542299349240781,1202,0.434562545191612,1564,0.565437454808388
"E02004824",10,323,1172,980,309,52,14,2860,0.0034965034965035,0.112937062937063,0.40979020979021,0.342657342657343,0.108041958041958,0.0181818181818182,0.0048951048951049,1505,0.526223776223776,1355,0.473776223776224
"E02004825",11,409,1220,1349,424,72,16,3501,0.00314195944015995,0.116823764638675,0.348471865181377,0.385318480434162,0.121108254784347,0.0205655526992288,0.00457012282205084,1640,0.468437589260211,1861,0.531562410739789
"E02004826",12,1676,661,680,363,153,34,3579,0.00335289186923722,0.468287231070131,0.184688460463817,0.189997205923442,0.101424979044426,0.0427493713327745,0.00949986029617212,2349,0.656328583403185,1230,0.343671416596815
"E02004827",0,30,934,1045,66,4,0,2079,0,0.0144300144300144,0.449254449254449,0.502645502645503,0.0317460317460317,0.00192400192400192,0,964,0.463684463684464,1115,0.536315536315536
"E02004828",2,811,644,833,187,41,12,2530,0.000790513833992095,0.320553359683794,0.254545454545455,0.329249011857707,0.0739130434782609,0.0162055335968379,0.00474308300395257,1457,0.575889328063241,1073,0.424110671936759
"E02004829",35,146,739,779,398,91,18,2206,0.0158658204895739,0.0661831368993654,0.334995466908432,0.35312783318223,0.180417044424297,0.0412511332728921,0.00815956482320943,920,0.417044424297371,1286,0.582955575702629
"E02004830",19,255,827,763,244,66,18,2192,0.00866788321167883,0.116332116788321,0.37728102189781,0.348083941605839,0.111313868613139,0.0301094890510949,0.00821167883211679,1101,0.50228102189781,1091,0.49771897810219
"E02004831",34,962,1037,1177,332,80,19,3641,0.00933809393023895,0.264213128261467,0.284811864872288,0.323262839879154,0.0911837407305685,0.0219719857182093,0.0052183466080747,2033,0.558363087063993,1608,0.441636912936007
"E02004832",16,309,845,1077,512,166,41,2966,0.00539447066756575,0.104180714767363,0.284895482130816,0.363115306810519,0.172623061362104,0.0559676331759946,0.0138233310856372,1170,0.394470667565745,1796,0.605529332434255
"E02004833",45,656,1376,1072,282,42,6,3479,0.0129347513653349,0.188559931014659,0.395515952860017,0.3081345214142,0.0810577752227652,0.0120724346076459,0.00172463351537798,2077,0.597010635240012,1402,0.402989364759989
"E02004834",3,347,1603,1047,238,39,8,3285,0.00091324200913242,0.105631659056317,0.487975646879756,0.318721461187215,0.0724505327245053,0.0118721461187215,0.00243531202435312,1953,0.594520547945205,1332,0.405479452054795
"E02004835",19,545,1972,1749,669,83,25,5062,0.00375345713156855,0.107664954563414,0.389569340181746,0.345515606479652,0.132161201106282,0.0163966811536942,0.00493875938364283,2536,0.500987751876729,2526,0.499012248123271
"E02004836",22,269,1100,775,140,20,4,2330,0.00944206008583691,0.115450643776824,0.472103004291845,0.332618025751073,0.0600858369098712,0.00858369098712446,0.00171673819742489,1391,0.596995708154506,939,0.403004291845494
"E02004837",16,341,891,1101,291,64,12,2716,0.00589101620029455,0.125552282768778,0.328055964653903,0.405375552282769,0.107142857142857,0.0235640648011782,0.00441826215022091,1248,0.459499263622975,1468,0.540500736377025
"E02004838",14,393,919,1083,430,133,25,2997,0.00467133800467134,0.131131131131131,0.30663997330664,0.361361361361361,0.143476810143477,0.0443777110443777,0.00834167500834167,1326,0.442442442442442,1671,0.557557557557558
"E02004839",68,300,524,869,629,287,76,2753,0.0247003269160915,0.108972030512169,0.190337813294588,0.315655648383582,0.228478023973847,0.104249909189975,0.0276062477297494,892,0.324010170722848,1861,0.675989829277152
"E02004840",10,878,1325,1191,316,64,15,3799,0.00263227165043432,0.231113450908134,0.348775993682548,0.313503553566728,0.0831797841537247,0.0168465385627797,0.00394840747565149,2213,0.582521716241116,1586,0.417478283758884
"E02004841",229,2414,1990,1234,368,121,35,6391,0.0358316382412768,0.377718666875293,0.311375371616335,0.193084024409326,0.0575809732436238,0.0189328743545611,0.00547645125958379,4633,0.724925676732906,1758,0.275074323267094
"E02004842",55,1729,1116,962,314,80,15,4271,0.0128775462420979,0.404823226410677,0.261297120112386,0.225239990634512,0.0735190821821587,0.0187309763521424,0.00351205806602669,2900,0.67899789276516,1371,0.32100210723484
"E02004843",0,74,602,694,265,45,9,1689,0,0.0438129070455891,0.356423919478982,0.410894020130255,0.156897572528123,0.0266429840142096,0.00532859680284192,676,0.400236826524571,1013,0.599763173475429
"E02004844",3,232,719,933,331,56,15,2289,0.00131061598951507,0.101354303189166,0.314110965487112,0.407601572739187,0.144604630843163,0.0244648318042813,0.00655307994757536,954,0.416775884665793,1335,0.583224115334207
"E02004845",11,655,1309,1097,463,68,14,3617,0.00304119435996682,0.181089300525297,0.361902128836052,0.303290019353055,0.128006635333149,0.0188001105888858,0.00387061100359414,1975,0.546032623721316,1642,0.453967376278684
"E02004846",10,230,572,736,293,57,8,1906,0.00524658971668416,0.120671563483736,0.300104931794334,0.386149003147954,0.153725078698846,0.0299055613850997,0.00419727177334732,812,0.426023084994753,1094,0.573976915005247
"E02004847",2,427,1962,1114,300,54,17,3876,0.000515995872033024,0.110165118679051,0.506191950464396,0.287409700722394,0.0773993808049536,0.0139318885448916,0.0043859649122807,2391,0.61687306501548,1485,0.38312693498452
"E02004848",0,176,910,819,229,35,7,2176,0,0.0808823529411765,0.418198529411765,0.376378676470588,0.105238970588235,0.0160845588235294,0.00321691176470588,1086,0.499080882352941,1090,0.500919117647059
"E02004849",27,557,697,738,204,29,4,2256,0.011968085106383,0.246897163120567,0.30895390070922,0.327127659574468,0.0904255319148936,0.012854609929078,0.00177304964539007,1281,0.56781914893617,975,0.43218085106383
"E02004850",2,110,1044,979,240,26,6,2407,0.000830909846281678,0.0457000415454923,0.433734939759036,0.406730369754882,0.0997091815538014,0.0108018280016618,0.00249272953884504,1156,0.48026589115081,1251,0.51973410884919
"E02004851",0,204,908,696,129,5,0,1942,0,0.105046343975283,0.467559217301751,0.358393408856849,0.0664263645726056,0.00257466529351184,0,1112,0.572605561277034,830,0.427394438722966
"E02004852",0,411,894,1058,356,58,8,2785,0,0.147576301615799,0.321005385996409,0.379892280071813,0.127827648114901,0.0208258527827648,0.00287253141831239,1305,0.468581687612208,1480,0.531418312387792
"E02004853",0,290,962,898,231,23,6,2410,0,0.120331950207469,0.399170124481328,0.372614107883817,0.095850622406639,0.00954356846473029,0.0024896265560166,1252,0.519502074688797,1158,0.480497925311203
"E02004854",2,233,993,1083,359,57,15,2742,0.000729394602479942,0.0849744711889132,0.362144420131291,0.394967177242888,0.13092633114515,0.0207877461706783,0.00547045951859956,1228,0.447848285922684,1514,0.552151714077316
"E02004855",4,413,1406,1099,334,33,5,3294,0.00121432908318154,0.125379477838494,0.426836672738312,0.333636915604129,0.101396478445659,0.0100182149362477,0.00151791135397693,1823,0.553430479659988,1471,0.446569520340012
"E02004856",6,209,565,742,334,100,31,1987,0.00301962757926522,0.105183694011072,0.284348263714142,0.373427277302466,0.168092601912431,0.0503271263210871,0.015601409159537,780,0.392551585304479,1207,0.607448414695521
"E02004857",36,440,676,897,356,74,16,2495,0.0144288577154309,0.176352705410822,0.270941883767535,0.359519038076152,0.142685370741483,0.0296593186372745,0.00641282565130261,1152,0.461723446893788,1343,0.538276553106212
"E02004858",2,42,800,779,189,19,5,1836,0.00108932461873638,0.0228758169934641,0.435729847494553,0.424291938997821,0.102941176470588,0.0103485838779956,0.00272331154684096,844,0.459694989106754,992,0.540305010893246
"E02004859",5,118,469,696,248,76,11,1623,0.00308071472581639,0.0727048675292668,0.288971041281577,0.428835489833641,0.152803450400493,0.0468268638324091,0.00677757239679606,592,0.36475662353666,1031,0.63524337646334
"E02004860",1,64,866,1086,297,48,7,2369,0.000422119037568594,0.02701561840439,0.365555086534403,0.458421274799493,0.125369354157873,0.0202617138032925,0.00295483326298016,931,0.392992823976361,1438,0.607007176023639
"E02004861",5,169,540,715,328,97,21,1875,0.00266666666666667,0.0901333333333333,0.288,0.381333333333333,0.174933333333333,0.0517333333333333,0.0112,714,0.3808,1161,0.6192
"E02004862",1,81,1270,1094,168,21,1,2636,0.000379362670713202,0.0307283763277693,0.481790591805766,0.415022761760243,0.0637329286798179,0.00796661608497724,0.000379362670713202,1352,0.512898330804249,1284,0.487101669195751
"E02004863",5,152,1621,1238,231,16,3,3266,0.00153092467850582,0.0465401102265769,0.496325780771586,0.37905695039804,0.0707287201469688,0.00489895897121862,0.000918554807103491,1778,0.544396815676669,1488,0.455603184323331
"E02004864",4,202,969,919,291,43,7,2435,0.00164271047227926,0.0829568788501027,0.397946611909651,0.37741273100616,0.119507186858316,0.0176591375770021,0.00287474332648871,1175,0.482546201232033,1260,0.517453798767967
"E02004865",1,110,1097,907,230,35,11,2391,0.000418235048097031,0.0460058552906734,0.458803847762442,0.379339188624007,0.096194061062317,0.0146382266833961,0.00460058552906734,1208,0.505227938101213,1183,0.494772061898787
"E02004866",0,121,1265,1090,164,11,0,2651,0,0.045643153526971,0.477178423236515,0.41116559788759,0.0618634477555639,0.004149377593361,0,1386,0.522821576763486,1265,0.477178423236515
"E02004867",4,367,990,870,193,27,4,2455,0.00162932790224033,0.14949083503055,0.403258655804481,0.354378818737271,0.0786150712830957,0.0109979633401222,0.00162932790224033,1361,0.554378818737271,1094,0.445621181262729
"E02004868",31,1095,1044,868,227,23,4,3292,0.00941676792223572,0.332624544349939,0.317132442284326,0.2636695018226,0.068955042527339,0.00698663426488457,0.00121506682867558,2170,0.659173754556501,1122,0.340826245443499
"E02004869",6,149,732,860,343,51,6,2147,0.00279459711224965,0.0693991616208663,0.340940847694457,0.40055891942245,0.159757801583605,0.023754075454122,0.00279459711224965,887,0.413134606427573,1260,0.586865393572427
"E02004870",3,1145,2398,1806,634,55,17,6058,0.000495212941564873,0.18900627269726,0.395840211290855,0.298118190822053,0.10465500165071,0.00907890392868934,0.00280620666886761,3546,0.58534169692968,2512,0.41465830307032
"E02004871",4,29,864,846,171,20,3,1937,0.00206504904491482,0.0149716055756324,0.4460505937016,0.436757872999484,0.0882808466701084,0.0103252452245741,0.00154878678368611,897,0.463087248322148,1040,0.536912751677852
"E02004872",18,238,874,1044,264,26,2,2466,0.0072992700729927,0.0965125709651257,0.354420113544201,0.423357664233577,0.10705596107056,0.0105433901054339,0.0008110300081103,1130,0.45823195458232,1336,0.541768045417681
"E02004873",1,997,1890,1393,670,82,16,5049,0.000198059021588433,0.197464844523668,0.374331550802139,0.275896217072688,0.13269954446425,0.0162408397702515,0.00316894434541493,2888,0.571994454347395,2161,0.428005545652604
"E02004874",5,55,896,883,250,35,5,2129,0.00234852043212776,0.0258337247534054,0.420854861437295,0.414748708313762,0.117426021606388,0.0164396430248943,0.00234852043212776,956,0.449037106622828,1173,0.550962893377172
"E02004875",1,302,1718,1426,284,35,5,3771,0.000265181649429859,0.0800848581278176,0.455582073720499,0.37814903208698,0.0753115884380801,0.00928135773004508,0.0013259082471493,2021,0.535932113497746,1750,0.464067886502254
"E02004876",11,404,797,1099,406,87,19,2823,0.00389656393907191,0.14311016648955,0.282323769040028,0.389302160821821,0.14381863266029,0.0308182784272051,0.0067304286220333,1212,0.42933049946865,1611,0.57066950053135
"E02004877",1,141,540,750,342,56,6,1836,0.000544662309368192,0.076797385620915,0.294117647058824,0.408496732026144,0.186274509803922,0.0305010893246187,0.00326797385620915,682,0.371459694989107,1154,0.628540305010893
"E02004878",3,1218,579,856,337,98,31,3122,0.000960922485586163,0.390134529147982,0.185458039718129,0.274183215887252,0.107943625880846,0.031390134529148,0.00992953235105701,1800,0.576553491351698,1322,0.423446508648302
"E02004880",97,1349,841,1096,381,133,22,3919,0.0247512120438887,0.344220464404185,0.21459556009186,0.279663179382496,0.0972186782342434,0.0339372288849196,0.00561367695840776,2287,0.583567236539934,1632,0.416432763460066
"E02004881",10,855,865,908,390,64,10,3102,0.00322372662798195,0.275628626692456,0.278852353320438,0.292714377820761,0.125725338491296,0.0206318504190845,0.00322372662798195,1730,0.557704706640877,1372,0.442295293359123
"E02004882",0,295,948,1110,355,36,9,2753,0,0.107155830003632,0.344351616418453,0.403196512895024,0.128950236106066,0.0130766436614602,0.00326916091536506,1243,0.451507446422085,1510,0.548492553577915
"E02004883",1,364,500,640,279,65,20,1869,0.000535045478865704,0.194756554307116,0.267522739432852,0.34242910647405,0.149277688603531,0.0347779561262707,0.0107009095773141,865,0.462814339218834,1004,0.537185660781166
"E02004884",27,705,1618,1378,395,47,9,4179,0.00646087580760948,0.168700646087581,0.387173965063412,0.329743957884661,0.0945202201483609,0.0112467097391721,0.00215362526920316,2350,0.562335486958603,1829,0.437664513041397
"E02004885",100,488,970,1127,180,25,8,2898,0.0345065562456867,0.168391994478951,0.334713595583161,0.388888888888889,0.062111801242236,0.00862663906142167,0.00276052449965493,1558,0.537612146307799,1340,0.462387853692202
"E02004886",6,365,419,603,351,123,35,1902,0.00315457413249211,0.191903259726604,0.220294426919033,0.317034700315457,0.184542586750789,0.0646687697160883,0.0184016824395373,790,0.415352260778128,1112,0.584647739221872
"E02004887",3,229,540,863,517,164,38,2354,0.00127442650807137,0.0972812234494477,0.229396771452846,0.36661002548853,0.219626168224299,0.0696686491079015,0.016142735768904,772,0.327952421410365,1582,0.672047578589635
"E02004888",13,542,1023,1183,351,66,9,3187,0.00407907122685911,0.170065892689049,0.320991528082837,0.371195481644179,0.110134923125196,0.020709130844054,0.00282397238782554,1578,0.495136491998745,1609,0.504863508001255
"E02004889",1,439,1284,1463,581,76,22,3866,0.000258665287118469,0.113554061045008,0.332126228660114,0.37842731505432,0.15028453181583,0.0196585618210036,0.00569063631660631,1724,0.44593895499224,2142,0.55406104500776
"E02004890",6,542,1167,1124,439,60,15,3353,0.00178944229048613,0.161646286907247,0.348046525499553,0.335222189084402,0.130927527587235,0.0178944229048613,0.00447360572621533,1715,0.511482254697286,1638,0.488517745302714
"E02004891",11,230,955,1065,416,61,16,2754,0.00399419026870007,0.0835148874364561,0.346768336964415,0.386710239651416,0.151053013798112,0.0221496005809731,0.00580973129992738,1196,0.434277414669572,1558,0.565722585330428
"E02004892",3,534,828,715,162,17,1,2260,0.00132743362831858,0.236283185840708,0.366371681415929,0.316371681415929,0.0716814159292035,0.00752212389380531,0.000442477876106195,1365,0.603982300884956,895,0.396017699115044
"E02004893",0,385,740,764,173,16,3,2081,0,0.185007208073042,0.35559827006247,0.367131186929361,0.083133109082172,0.00768861124459395,0.00144161460836136,1125,0.540605478135512,956,0.459394521864488
"E02004894",5,1075,1620,1341,474,69,14,4598,0.00108742931709439,0.233797303175294,0.352327098738582,0.291648542844715,0.103088299260548,0.0150065245759026,0.00304480208786429,2700,0.58721183123097,1898,0.41278816876903
"E02004895",5,162,1070,988,335,80,16,2656,0.00188253012048193,0.0609939759036145,0.402861445783133,0.371987951807229,0.126129518072289,0.0301204819277108,0.00602409638554217,1237,0.465737951807229,1419,0.534262048192771
"E02004896",4,273,837,1198,524,69,9,2914,0.00137268359643102,0.0936856554564173,0.287234042553192,0.411118737131091,0.179821551132464,0.0236787920384351,0.0030885380919698,1114,0.38229238160604,1800,0.61770761839396
"E02004897",2,47,618,879,290,31,4,1871,0.00106894708711919,0.0251202565473009,0.330304649919829,0.469802244788883,0.154997327632282,0.0165686798503474,0.00213789417423838,667,0.356493853554249,1204,0.643506146445751
"E02004898",2,159,998,1110,317,41,17,2644,0.00075642965204236,0.0601361573373676,0.377458396369138,0.41981845688351,0.119894099848714,0.0155068078668684,0.00642965204236006,1159,0.438350983358548,1485,0.561649016641452
"E02004899",2,96,589,739,228,46,15,1715,0.00116618075801749,0.0559766763848396,0.343440233236152,0.430903790087464,0.132944606413994,0.0268221574344023,0.0087463556851312,687,0.400583090379009,1028,0.599416909620991
"E02004900",3,352,885,964,457,79,15,2755,0.00108892921960073,0.127767695099819,0.321234119782214,0.349909255898367,0.165880217785844,0.0286751361161524,0.00544464609800363,1240,0.450090744101633,1515,0.549909255898367
"E02004901",0,616,1578,1171,199,12,7,3583,0,0.171922969578565,0.440413061680156,0.326821099637176,0.0555400502372314,0.003349148758024,0.00195367010884733,2194,0.612336031258722,1389,0.387663968741278
"E02004902",0,190,1100,1007,201,21,7,2526,0,0.0752177355502771,0.435471100554236,0.398653998416469,0.0795724465558195,0.00831353919239905,0.00277117973079968,1290,0.510688836104513,1236,0.489311163895487
"E02004903",2,478,943,725,278,39,7,2472,0.000809061488673139,0.19336569579288,0.381472491909385,0.293284789644013,0.112459546925566,0.0157766990291262,0.00283171521035599,1423,0.575647249190938,1049,0.424352750809061
"E02004904",0,389,997,771,158,5,2,2322,0,0.167527993109388,0.429371231696813,0.332041343669251,0.0680447889750215,0.00215331610680448,0.000861326442721792,1386,0.596899224806202,936,0.403100775193798
"E02004905",4,196,581,793,380,75,12,2041,0.00195982361587457,0.096031357177854,0.284664380205781,0.388535031847134,0.186183243508084,0.0367466927976482,0.00587947084762371,781,0.38265556099951,1260,0.61734443900049
"E02004906",13,738,1371,1110,300,33,12,3577,0.00363433044450657,0.206318143695835,0.38328207995527,0.310315907184792,0.0838691641039978,0.00922560805143975,0.00335476656415991,2122,0.593234554095611,1455,0.406765445904389
"E02004907",2,656,1296,1388,491,76,14,3923,0.000509813917919959,0.167218965077747,0.330359418812134,0.353810859036452,0.12515931684935,0.0193729288809584,0.00356869742543971,1954,0.4980881978078,1969,0.5019118021922
"E02004908",12,598,1140,1474,456,76,18,3774,0.00317965023847377,0.158452570217276,0.302066772655008,0.390567037625861,0.120826709062003,0.0201377848436672,0.00476947535771065,1750,0.463698993110758,2024,0.536301006889242
"E02004909",42,337,948,871,234,35,8,2475,0.016969696969697,0.136161616161616,0.383030303030303,0.351919191919192,0.0945454545454545,0.0141414141414141,0.00323232323232323,1327,0.536161616161616,1148,0.463838383838384
"E02004910",5,1043,1737,1483,379,78,13,4738,0.00105529759392149,0.220135078092022,0.366610384128324,0.313001266357113,0.0799915576192486,0.0164626424651752,0.00274377374419586,2785,0.587800759814268,1953,0.412199240185732
"E02004911",0,111,1348,1221,241,64,9,2994,0,0.0370741482965932,0.450233800935204,0.407815631262525,0.0804943219772879,0.021376085504342,0.0030060120240481,1459,0.487307949231797,1535,0.512692050768203
"E02004912",17,408,1591,1794,401,48,8,4267,0.00398406374501992,0.0956175298804781,0.372861495195688,0.420435903445043,0.0939770330442934,0.0112491211624092,0.0018748535270682,2016,0.472463088821186,2251,0.527536911178814
"E02004914",2,437,989,1202,405,52,8,3095,0.000646203554119548,0.141195476575121,0.319547657512116,0.388368336025848,0.130856219709208,0.0168012924071082,0.00258481421647819,1428,0.461389337641357,1667,0.538610662358643
"E02004915",1,116,974,891,213,30,2,2227,0.000449034575662326,0.0520880107768298,0.437359676695106,0.400089806915132,0.0956443646160754,0.0134710372698698,0.000898069151324652,1091,0.489896722047598,1136,0.510103277952402
"E02004916",0,180,628,1248,501,87,19,2663,0,0.0675929402929027,0.235824258355238,0.468644386030792,0.188133683815246,0.0326699211415697,0.00713481036425084,808,0.303417198648141,1855,0.696582801351859
"E02004917",1,142,1119,1060,173,29,7,2531,0.000395100750691426,0.0561043065981825,0.442117740023706,0.418806795732912,0.0683524298696167,0.0114579217700514,0.00276570525483998,1262,0.49861714737258,1269,0.50138285262742
"E02004918",3,254,1358,1380,522,69,12,3598,0.000833796553640912,0.0705947748749305,0.377431906614786,0.383546414674819,0.145080600333519,0.019177320733741,0.00333518621456365,1615,0.448860478043357,1983,0.551139521956643
"E02004919",5,417,1292,1093,271,24,1,3103,0.00161134386077989,0.134386077989043,0.416371253625524,0.352239767966484,0.0873348372542701,0.00773445053174347,0.000322268772155978,1714,0.552368675475346,1389,0.447631324524654
"E02004920",10,595,2152,1676,403,60,21,4917,0.00203376042302217,0.121008745169819,0.437665243034371,0.340858246898515,0.0819605450477934,0.012202562538133,0.00427089688834655,2757,0.560707748627212,2160,0.439292251372788
"E02004921",2,193,1043,1055,351,51,10,2705,0.000739371534195933,0.0713493530499076,0.385582255083179,0.390018484288355,0.129759704251386,0.0188539741219963,0.00369685767097967,1238,0.457670979667283,1467,0.542329020332717
"E02004922",19,691,1001,1268,677,214,49,3919,0.00484817555498852,0.176320489920898,0.255422301607553,0.323551926511865,0.172748150038275,0.0546057667772391,0.0125031895891809,1711,0.43659096708344,2208,0.56340903291656
"E02004923",37,556,1467,1562,520,97,17,4256,0.00869360902255639,0.130639097744361,0.34468984962406,0.367011278195489,0.12218045112782,0.0227913533834586,0.00399436090225564,2060,0.484022556390977,2196,0.515977443609023
"E02004924",2,301,713,978,324,34,6,2358,0.000848176420695505,0.127650551314673,0.302374893977947,0.414758269720102,0.137404580152672,0.0144189991518236,0.00254452926208651,1016,0.430873621713316,1342,0.569126378286684
"E02004925",17,211,1031,966,327,45,3,2600,0.00653846153846154,0.0811538461538462,0.396538461538462,0.371538461538462,0.125769230769231,0.0173076923076923,0.00115384615384615,1259,0.484230769230769,1341,0.515769230769231
"E02004926",8,356,1003,1137,517,77,10,3108,0.00257400257400257,0.114543114543115,0.322715572715573,0.365830115830116,0.166344916344916,0.0247747747747748,0.00321750321750322,1367,0.43983268983269,1741,0.56016731016731
"E02004927",8,167,763,923,302,55,6,2224,0.00359712230215827,0.075089928057554,0.343075539568345,0.415017985611511,0.135791366906475,0.0247302158273381,0.00269784172661871,938,0.421762589928058,1286,0.578237410071942
"E02004928",5,163,662,958,300,34,6,2128,0.00234962406015038,0.0765977443609023,0.31109022556391,0.450187969924812,0.140977443609023,0.0159774436090226,0.00281954887218045,830,0.390037593984962,1298,0.609962406015038
"E02004929",3,105,726,856,347,70,22,2129,0.00140911225927666,0.049318929074683,0.341005166744951,0.402066697980272,0.162987317989667,0.0328792860497886,0.0103334899013621,834,0.39173320807891,1295,0.60826679192109
"E02004930",20,110,970,1082,219,28,3,2432,0.00822368421052632,0.0452302631578947,0.398848684210526,0.444901315789474,0.0900493421052632,0.0115131578947368,0.00123355263157895,1100,0.452302631578947,1332,0.547697368421053
"E02004931",1,443,996,873,182,21,2,2518,0.00039714058776807,0.175933280381255,0.395552025416998,0.346703733121525,0.0722795869737887,0.00833995234312947,0.00079428117553614,1440,0.571882446386021,1078,0.428117553613979
"E02004932",5,225,1110,1002,292,30,9,2673,0.00187055742611298,0.0841750841750842,0.415263748597082,0.374859708193042,0.109240553684998,0.0112233445566779,0.00336700336700337,1340,0.501309390198279,1333,0.498690609801721
"E02004933",9,106,424,941,428,55,7,1970,0.00456852791878173,0.0538071065989848,0.215228426395939,0.477664974619289,0.217258883248731,0.0279187817258883,0.00355329949238579,539,0.273604060913706,1431,0.726395939086295
"E02004934",6,600,1418,1009,425,78,12,3548,0.00169109357384442,0.169109357384442,0.399661781285231,0.284385569334837,0.11978579481398,0.0219842164599775,0.00338218714768884,2024,0.570462232243517,1524,0.429537767756483
"E02004935",2,572,1884,1806,827,96,20,5207,0.000384098329172268,0.109852122143269,0.361820626080277,0.346840791242558,0.158824659112733,0.0184367198002689,0.00384098329172268,2458,0.472056846552718,2749,0.527943153447282
"E02004936",1,225,585,830,325,57,9,2032,0.000492125984251968,0.110728346456693,0.287893700787402,0.408464566929134,0.15994094488189,0.0280511811023622,0.00442913385826772,811,0.399114173228346,1221,0.600885826771653
"E02004937",6,300,642,1015,434,52,9,2458,0.00244100895036615,0.122050447518308,0.261187957689178,0.412937347436941,0.176566314076485,0.0211554109031733,0.00366151342554923,948,0.385679414157852,1510,0.614320585842148
"E02004939",4,237,1051,882,216,37,6,2433,0.00164406083025072,0.0974106041923551,0.431976983148377,0.362515413070284,0.0887792848335388,0.0152075626798192,0.00246609124537608,1292,0.531031648170982,1141,0.468968351829018
"E02004940",1,191,1385,1098,231,19,5,2930,0.000341296928327645,0.0651877133105802,0.472696245733788,0.374744027303754,0.078839590443686,0.00648464163822526,0.00170648464163823,1577,0.538225255972696,1353,0.461774744027304
"E02004941",2,316,1540,1223,360,31,7,3479,0.000574877838459327,0.0908306984765737,0.442655935613682,0.351537798217879,0.103478010922679,0.00891060649611957,0.00201207243460765,1858,0.534061511928715,1621,0.465938488071285
"E02004942",4,460,842,771,227,49,4,2357,0.00169707254985151,0.195163343232923,0.357233771743742,0.327110733983878,0.096308867204073,0.0207891387356809,0.00169707254985151,1306,0.554094187526517,1051,0.445905812473483
"E02004943",10,397,733,1048,339,57,9,2593,0.00385653682992673,0.153104512148091,0.282684149633629,0.404165059776321,0.130736598534516,0.0219822599305823,0.00347088314693405,1140,0.439645198611647,1453,0.560354801388353
"E02004944",48,499,1267,964,146,6,1,2931,0.0163766632548618,0.170249061753668,0.432275673831457,0.328897987035142,0.049812350733538,0.00204708290685773,0.000341180484476288,1814,0.618901398839986,1117,0.381098601160014
"E02004945",17,513,2012,1473,445,39,5,4504,0.00377442273534636,0.113898756660746,0.446714031971581,0.327042628774423,0.0988010657193606,0.00865896980461812,0.0011101243339254,2542,0.564387211367673,1962,0.435612788632327
"E02004946",1,54,1041,903,178,9,1,2187,0.000457247370827618,0.0246913580246914,0.47599451303155,0.412894375857339,0.081390032007316,0.00411522633744856,0.000457247370827618,1096,0.501143118427069,1091,0.498856881572931
"E02004948",4,250,1467,923,145,12,2,2803,0.00142704245451302,0.0891901534070639,0.523367820192651,0.32929004637888,0.051730288976097,0.00428112736353907,0.000713521227256511,1721,0.613985016054228,1082,0.386014983945772
"E02004949",0,367,1970,1287,277,26,5,3932,0,0.0933367243133266,0.501017293997965,0.327314343845371,0.0704476093591048,0.00661241098677518,0.00127161749745677,2337,0.594354018311292,1595,0.405645981688708
"E02004950",2,120,1063,908,146,6,1,2246,0.000890471950133571,0.0534283170080142,0.473285841495993,0.404274265360641,0.0650044523597507,0.00267141585040071,0.000445235975066785,1185,0.527604630454141,1061,0.472395369545859
"E02004951",6,334,1942,1378,328,28,7,4023,0.00149142431021626,0.0830226199353716,0.482724335073328,0.342530449913,0.0815311956251554,0.00695998011434253,0.00173999502858563,2282,0.567238379318916,1741,0.432761620681084
"E02004952",10,130,1217,888,107,6,0,2358,0.00424088210347752,0.0551314673452078,0.516115351993215,0.376590330788804,0.0453774385072095,0.00254452926208651,0,1357,0.5754877014419,1001,0.4245122985581
"E02004953",5,76,904,1076,202,23,3,2289,0.00218435998252512,0.0332022717343818,0.394932284840542,0.470074268239406,0.0882481432940149,0.0100480559196156,0.00131061598951507,985,0.430318916557449,1304,0.569681083442551
"E02004954",2,235,1269,983,254,18,0,2761,0.000724375226367258,0.0851140890981528,0.459616081130025,0.356030423759507,0.0919956537486418,0.00651937703730532,0,1506,0.545454545454545,1255,0.454545454545455
"E02004955",1,250,1023,754,144,11,2,2185,0.00045766590389016,0.11441647597254,0.468192219679634,0.345080091533181,0.0659038901601831,0.00503432494279176,0.00091533180778032,1274,0.583066361556064,911,0.416933638443936
"E02004956",6,336,1335,1170,427,64,12,3350,0.0017910447761194,0.100298507462687,0.398507462686567,0.349253731343284,0.127462686567164,0.0191044776119403,0.00358208955223881,1677,0.500597014925373,1673,0.499402985074627
"E02004957",15,809,1329,1086,341,21,6,3607,0.00415858053784308,0.224286110341004,0.368450235652897,0.301081230939839,0.0945383975602994,0.00582201275298032,0.00166343221513723,2153,0.596894926531744,1454,0.403105073468256
"E02004958",3,287,675,832,448,89,17,2351,0.0012760527435134,0.122075712462782,0.287111867290515,0.353891960867716,0.190557209698001,0.0378562313908975,0.00723096554657592,965,0.41046363249681,1386,0.58953636750319
"E02004959",6,380,839,653,280,75,11,2244,0.00267379679144385,0.169340463458111,0.373885918003565,0.290998217468806,0.124777183600713,0.0334224598930481,0.00490196078431373,1225,0.545900178253119,1019,0.454099821746881
"E02004960",15,121,519,699,342,75,12,1783,0.00841278743690409,0.0678631519910264,0.291082445316882,0.392035894559731,0.191811553561413,0.0420639371845205,0.00673022994952328,655,0.367358384744812,1128,0.632641615255188
"E02004961",0,127,877,1248,464,63,15,2794,0,0.0454545454545455,0.313886900501074,0.446671438797423,0.166070150322119,0.0225483178239084,0.00536864710093057,1004,0.359341445955619,1790,0.640658554044381
"E02004962",4,173,1158,1156,426,63,6,2986,0.00133958472873409,0.0579370395177495,0.38780977896852,0.387139986604153,0.142665773610181,0.021098459477562,0.00200937709310114,1335,0.447086403215003,1651,0.552913596784997
"E02004963",1,69,751,1000,355,43,5,2224,0.000449640287769784,0.0310251798561151,0.337679856115108,0.449640287769784,0.159622302158273,0.0193345323741007,0.00224820143884892,821,0.369154676258993,1403,0.630845323741007
"E02004964",2,70,799,710,296,38,11,1926,0.00103842159916926,0.0363447559709242,0.41484942886812,0.368639667705088,0.153686396677051,0.019730010384216,0.00571131879543095,871,0.452232606438214,1055,0.547767393561786
"E02004965",1,33,624,967,365,53,10,2053,0.000487092060399416,0.0160740379931807,0.303945445689235,0.471018022406235,0.177788602045787,0.025815879201169,0.00487092060399415,658,0.320506575742815,1395,0.679493424257185
"E02004966",2,265,570,762,371,76,13,2059,0.000971345313258863,0.128703254006799,0.276833414278776,0.370082564351627,0.180184555609519,0.0369111219038368,0.00631374453618261,837,0.406508013598834,1222,0.593491986401166
"E02004967",0,718,1245,1063,252,26,6,3310,0,0.216918429003021,0.376132930513595,0.321148036253776,0.0761329305135952,0.00785498489425982,0.00181268882175227,1963,0.593051359516616,1347,0.406948640483384
"E02004968",0,236,968,917,205,16,4,2346,0,0.100596760443308,0.412617220801364,0.390878090366581,0.087382779198636,0.00682011935208866,0.00170502983802217,1204,0.513213981244672,1142,0.486786018755328
"E02004969",6,135,685,873,269,27,4,1999,0.00300150075037519,0.0675337668834417,0.342671335667834,0.43671835917959,0.134567283641821,0.0135067533766883,0.00200100050025012,826,0.413206603301651,1173,0.586793396698349
"E02004970",3,580,1020,1026,224,24,5,2882,0.00104094378903539,0.201249132546842,0.353920888272033,0.356002775850104,0.0777238029146426,0.00832755031228314,0.00173490631505899,1603,0.556210964607911,1279,0.443789035392089
"E02004971",11,373,1037,1205,411,38,4,3079,0.00357258850276064,0.121143228320883,0.336797661578435,0.391360831438779,0.133484897694057,0.0123416693731731,0.00129912309191296,1421,0.461513478402079,1658,0.538486521597921
"E02004972",1,48,517,860,321,37,7,1791,0.000558347292015634,0.0268006700167504,0.288665549972083,0.480178671133445,0.179229480737018,0.0206588498045784,0.00390843104410944,566,0.316024567280849,1225,0.683975432719151
"E02004973",0,415,793,1822,541,73,19,3663,0,0.113295113295113,0.216489216489216,0.497406497406497,0.147693147693148,0.0199290199290199,0.00518700518700519,1208,0.32978432978433,2455,0.67021567021567
"E02004974",2,603,1350,1071,366,58,10,3460,0.000578034682080925,0.174277456647399,0.390173410404624,0.309537572254335,0.105780346820809,0.0167630057803468,0.00289017341040462,1955,0.565028901734104,1505,0.434971098265896
"E02004975",3,434,625,747,368,86,9,2272,0.00132042253521127,0.191021126760563,0.275088028169014,0.328785211267606,0.161971830985915,0.0378521126760563,0.0039612676056338,1062,0.467429577464789,1210,0.532570422535211
"E02004976",0,1486,2057,1700,506,82,23,5854,0,0.253843525794329,0.351383669285958,0.29039972668261,0.0864366245302357,0.01400751622822,0.00392893747864708,3543,0.605227195080287,2311,0.394772804919713
"E02004977",0,627,592,1409,449,45,17,3139,0,0.199745141764893,0.188595093978974,0.448869066581714,0.143039184453648,0.0143357757247531,0.00541573749601784,1219,0.388340235743867,1920,0.611659764256133
"E02004978",3,1612,1783,954,216,26,13,4607,0.000651182982418059,0.349902322552637,0.387019752550467,0.207076188408943,0.0468851747341003,0.00564358584762318,0.00282179292381159,3398,0.737573258085522,1209,0.262426741914478
"E02004979",6,301,709,1051,421,71,12,2571,0.00233372228704784,0.1170750680669,0.275768183586153,0.40879035394788,0.163749513807857,0.0276157137300661,0.00466744457409568,1016,0.395176973940101,1555,0.604823026059899
"E02004980",9,214,589,814,224,51,6,1907,0.00471945464079706,0.112218143681175,0.308862087047719,0.426848453067646,0.117461982170949,0.02674357629785,0.00314630309386471,812,0.425799685369691,1095,0.574200314630309
"E02004981",2,431,1329,855,253,59,11,2940,0.000680272108843537,0.146598639455782,0.452040816326531,0.290816326530612,0.0860544217687075,0.0200680272108844,0.00374149659863946,1762,0.599319727891156,1178,0.400680272108844
"E02004982",1,31,899,870,141,20,2,1964,0.000509164969450102,0.0157841140529532,0.457739307535642,0.442973523421589,0.0717922606924644,0.010183299389002,0.0010183299389002,931,0.474032586558045,1033,0.525967413441955
"E02004983",13,186,1199,954,185,12,1,2550,0.00509803921568627,0.0729411764705882,0.470196078431373,0.374117647058824,0.0725490196078431,0.00470588235294118,0.000392156862745098,1398,0.548235294117647,1152,0.451764705882353
"E02004984",0,199,1495,893,167,47,0,2801,0,0.0710460549803642,0.533737950731881,0.318814709032488,0.0596215637272403,0.0167797215280257,0,1694,0.604784005712246,1107,0.395215994287754
"E02004985",0,139,1150,1150,325,52,4,2820,0,0.049290780141844,0.407801418439716,0.407801418439716,0.115248226950355,0.0184397163120567,0.00141843971631206,1289,0.45709219858156,1531,0.54290780141844
"E02004986",4,1048,2268,1203,121,12,1,4657,0.000858922052823706,0.225037577839811,0.487008803951041,0.25832080738673,0.0259823920979171,0.00257676615847112,0.000214730513205927,3320,0.712905303843676,1337,0.287094696156324
"E02004987",5,337,1616,781,89,7,2,2837,0.00176242509693338,0.11878745153331,0.569615791328869,0.275290800140994,0.0313711667254142,0.00246739513570673,0.000704970038773352,1958,0.690165667959112,879,0.309834332040888
"E02004988",3,391,1901,848,87,9,0,3239,0.000926211793763507,0.120716270453844,0.586909539981476,0.261809200370485,0.0268601420191417,0.00277863538129052,0,2295,0.708552022229083,944,0.291447977770917
"E02004989",3,711,2808,927,192,24,2,4667,0.000642811227769445,0.152346260981358,0.601671309192201,0.198628669380759,0.0411399185772445,0.00514248982215556,0.000428540818512963,3522,0.754660381401329,1145,0.245339618598672
"E02004990",5,540,1353,964,288,47,10,3207,0.00155908949173683,0.168381665107577,0.421889616463985,0.30059245400686,0.0898035547240412,0.0146554412223262,0.00311817898347365,1898,0.591830371063299,1309,0.408169628936701
"E02004991",7,457,1844,1277,171,17,3,3776,0.00185381355932203,0.121027542372881,0.488347457627119,0.338188559322034,0.0452860169491525,0.0045021186440678,0.000794491525423729,2308,0.611228813559322,1468,0.388771186440678
"E02004992",11,388,1178,1432,274,32,6,3321,0.00331225534477567,0.116832279433905,0.354712436013249,0.431195423065342,0.0825052694971394,0.00963565191207468,0.001806684733514,1577,0.47485697079193,1744,0.52514302920807
"E02004994",6,208,432,747,329,83,18,1823,0.00329127811300055,0.114097641250686,0.236972024136039,0.409764125068568,0.180471749862863,0.0455293472298409,0.00987383433900165,646,0.354360943499726,1177,0.645639056500274
"E02004995",35,168,509,696,326,52,9,1795,0.0194986072423398,0.0935933147632312,0.283565459610028,0.387743732590529,0.181615598885794,0.0289693593314763,0.00501392757660167,712,0.396657381615599,1083,0.603342618384401
"E02004996",6,255,1193,1098,442,85,31,3110,0.00192926045016077,0.0819935691318328,0.383601286173633,0.353054662379421,0.142122186495177,0.0273311897106109,0.00996784565916399,1454,0.467524115755627,1656,0.532475884244373
"E02004997",14,374,636,998,576,160,46,2804,0.00499286733238231,0.133380884450785,0.226818830242511,0.355920114122682,0.205420827389444,0.0570613409415121,0.0164051355206847,1024,0.365192582025678,1780,0.634807417974322
"E02004998",2,143,861,925,184,32,9,2156,0.000927643784786642,0.0663265306122449,0.399350649350649,0.429035250463822,0.0853432282003711,0.0148423005565863,0.00417439703153989,1006,0.466604823747681,1150,0.533395176252319
"E02005000",49,1525,1978,1725,472,60,24,5833,0.00840048002743014,0.261443511057775,0.339105091719527,0.295731184639122,0.0809189096519801,0.0102863020744043,0.0041145208297617,3552,0.608949082804732,2281,0.391050917195268
"E02005001",13,622,1123,1229,299,48,8,3342,0.00388988629563136,0.186116098144823,0.336026331538001,0.367743865948534,0.0894673847995212,0.0143626570915619,0.00239377618192699,1758,0.526032315978456,1584,0.473967684021544
"E02005002",4,407,1726,1384,200,16,2,3739,0.00106980476063118,0.108852634394223,0.461620754212356,0.37015244717839,0.0534902380315592,0.00427921904252474,0.000534902380315592,2137,0.57154319336721,1602,0.42845680663279
"E02005003",1,771,1562,925,115,7,5,3386,0.000295333727111636,0.227702303603071,0.461311281748376,0.273183697578263,0.0339633786178382,0.00206733608978145,0.00147666863555818,2334,0.689308919078559,1052,0.310691080921441
"E02005004",3,307,2340,1246,183,16,3,4098,0.000732064421669107,0.0749145924841386,0.571010248901903,0.304050756466569,0.0446559297218155,0.00390434358223524,0.000732064421669107,2650,0.646656905807711,1448,0.353343094192289
"E02005005",13,1633,793,849,528,156,58,4030,0.0032258064516129,0.405210918114144,0.196774193548387,0.210669975186104,0.131017369727047,0.0387096774193548,0.0143920595533499,2439,0.605210918114144,1591,0.394789081885856
"E02005006",12,311,470,651,349,117,42,1952,0.00614754098360656,0.159323770491803,0.24077868852459,0.333504098360656,0.178790983606557,0.0599385245901639,0.021516393442623,793,0.40625,1159,0.59375
"E02005007",20,592,1313,829,399,146,45,3345,0.00597907324364723,0.176980568011958,0.392526158445441,0.247832585949178,0.119282511210762,0.0436472346786248,0.0134529147982063,1925,0.575485799701046,1419,0.424215246636771
"E02005008",23,603,1026,1243,540,125,33,3593,0.0064013359309769,0.167826328973003,0.285555246312274,0.345950459226273,0.150292234901197,0.0347898691900918,0.00918452546618425,1652,0.459782911216254,1941,0.540217088783746
"E02005009",9,290,426,754,590,209,52,2330,0.00386266094420601,0.124463519313305,0.182832618025751,0.323605150214592,0.253218884120172,0.0896995708154506,0.0223175965665236,725,0.311158798283262,1605,0.688841201716738
"E02005010",2,422,1144,1518,776,143,45,4050,0.000493827160493827,0.104197530864198,0.282469135802469,0.374814814814815,0.191604938271605,0.0353086419753086,0.0111111111111111,1568,0.387160493827161,2482,0.61283950617284
"E02005011",47,285,756,1000,341,58,14,2501,0.0187924830067973,0.113954418232707,0.302279088364654,0.39984006397441,0.136345461815274,0.0231907237105158,0.00559776089564174,1088,0.435025989604158,1413,0.564974010395842
"E02005012",27,484,906,1399,509,76,20,3421,0.00789242911429407,0.141479099678457,0.264834843612979,0.4089447529962,0.148786904413914,0.0222157263957907,0.00584624378836598,1417,0.414206372405729,2004,0.585793627594271
"E02005013",24,307,989,1302,395,88,28,3133,0.00766038940312799,0.0979891477816789,0.315671879987233,0.415576125119694,0.126077242259815,0.028088094478136,0.00893712097031599,1320,0.42132141717204,1813,0.57867858282796
"E02005014",63,176,742,1436,407,53,12,2889,0.0218068535825545,0.0609207338179301,0.256836275527864,0.49705780546902,0.140879196953963,0.0183454482519903,0.00415368639667705,981,0.339563862928349,1908,0.660436137071651
"E02005015",19,595,1087,1164,253,38,14,3170,0.00599369085173502,0.187697160883281,0.342902208201893,0.367192429022082,0.0798107255520505,0.01198738170347,0.00441640378548896,1701,0.536593059936909,1469,0.463406940063092
"E02005016",20,577,893,1259,413,63,12,3237,0.00617856039542787,0.178251467408094,0.275872721655854,0.388940376892184,0.127587272165585,0.0194624652455978,0.00370713623725672,1490,0.460302749459376,1747,0.539697250540624
"E02005017",9,265,966,1625,633,89,29,3616,0.00248893805309735,0.0732853982300885,0.267146017699115,0.449391592920354,0.175055309734513,0.0246128318584071,0.00801991150442478,1240,0.342920353982301,2376,0.657079646017699
"E02005018",52,426,1150,1128,237,45,23,3061,0.0169879124469128,0.139170205815093,0.375694217575956,0.368507023848416,0.0774256778830448,0.0147010780790591,0.00751388435151911,1628,0.531852335837961,1433,0.468147664162039
"E02005019",9,447,619,612,364,116,39,2206,0.00407978241160471,0.202629193109701,0.280598368087035,0.277425203989121,0.165004533091568,0.0525838621940163,0.0176790571169538,1075,0.487307343608341,1131,0.512692656391659
"E02005020",6,556,810,952,283,48,10,2665,0.00225140712945591,0.208630393996248,0.303939962476548,0.357223264540338,0.106191369606004,0.0180112570356473,0.00375234521575985,1372,0.514821763602251,1293,0.485178236397749
"E02005021",14,101,566,885,307,46,13,1932,0.0072463768115942,0.0522774327122153,0.29296066252588,0.458074534161491,0.158902691511387,0.0238095238095238,0.0067287784679089,681,0.352484472049689,1251,0.647515527950311
"E02005022",3,91,1322,1202,224,33,5,2880,0.00104166666666667,0.0315972222222222,0.459027777777778,0.417361111111111,0.0777777777777778,0.0114583333333333,0.00173611111111111,1416,0.491666666666667,1464,0.508333333333333
"E02005023",19,1110,1941,1290,260,35,8,4663,0.00407463006648081,0.238044177568089,0.416255629423118,0.276645936092644,0.0557580956465795,0.0075058974908857,0.00171563371220244,3070,0.658374437057688,1593,0.341625562942312
"E02005025",5,427,1246,1486,461,65,16,3706,0.00134916351861846,0.115218564490016,0.336211548839719,0.400971397733405,0.124392876416622,0.0175391257420399,0.00431732325957906,1678,0.452779276848354,2028,0.547220723151646
"E02005026",12,467,978,848,386,114,48,2853,0.00420609884332282,0.163687346652646,0.34279705573081,0.297230984928146,0.135296179460217,0.0399579390115668,0.0168243953732913,1457,0.510690501226779,1396,0.489309498773221
"E02005027",6,99,398,750,329,78,19,1679,0.00357355568790947,0.0589636688505063,0.237045860631328,0.446694460988684,0.195949970220369,0.0464562239428231,0.01131625967838,503,0.299583085169744,1176,0.700416914830256
"E02005028",19,2463,1884,568,106,17,5,5062,0.00375345713156855,0.486566574476491,0.372184907151324,0.112208613196365,0.0209403397866456,0.00335835638087712,0.000987751876728566,4366,0.862504938759384,696,0.137495061240616
"E02005029",70,4339,1852,1164,236,29,4,7694,0.00909799844034312,0.563945931894983,0.240707044450221,0.151286716922277,0.0306732518845854,0.00376917078242787,0.000519885625162464,6261,0.813750974785547,1433,0.186249025214453
"E02005030",5,1528,1441,1575,491,55,13,5108,0.000978856695379796,0.299138606108066,0.282106499608457,0.308339859044636,0.096123727486296,0.0107674236491778,0.00254502740798747,2974,0.582223962411903,2134,0.417776037588097
"E02005031",2,636,1497,1009,200,23,6,3373,0.000592943966795138,0.188556181440854,0.443818559146161,0.299140231248147,0.0592943966795138,0.00681885561814409,0.00177883190038541,2135,0.63296768455381,1238,0.36703231544619
"E02005032",0,284,1133,1784,535,59,14,3809,0,0.0745602520346548,0.297453399842478,0.468364400105014,0.140456812811762,0.0154896298241008,0.00367550538199002,1417,0.372013651877133,2392,0.627986348122867
"E02005033",2,832,1190,1038,274,33,9,3378,0.00059206631142688,0.246299585553582,0.352279455298993,0.307282415630551,0.0811130846654825,0.00976909413854352,0.00266429840142096,2024,0.599171107164002,1354,0.400828892835998
"E02005034",1,30,289,986,393,62,11,1772,0.000564334085778781,0.0169300225733634,0.163092550790068,0.556433408577878,0.221783295711061,0.0349887133182844,0.00620767494356659,320,0.18058690744921,1452,0.81941309255079
"E02005035",1,218,772,983,300,46,18,2338,0.000427715996578272,0.0932420872540633,0.330196749358426,0.420444824636441,0.128314798973482,0.0196749358426005,0.0076988879384089,991,0.423866552609068,1347,0.576133447390932
"E02005036",1,223,921,1045,261,26,8,2485,0.000402414486921529,0.089738430583501,0.370623742454728,0.420523138832998,0.105030181086519,0.0104627766599598,0.00321931589537223,1145,0.460764587525151,1340,0.539235412474849
"E02005037",5,69,630,816,263,44,2,1829,0.00273373428102788,0.0377255330781848,0.344450519409513,0.446145434663751,0.143794423182067,0.0240568616730454,0.00109349371241115,704,0.384909786768726,1125,0.615090213231274
"E02005038",1,123,411,740,280,55,4,1614,0.000619578686493185,0.0762081784386617,0.254646840148699,0.458488228004957,0.173482032218092,0.0340768277571252,0.00247831474597274,535,0.331474597273854,1079,0.668525402726146
"E02005039",1,58,654,926,281,23,7,1950,0.000512820512820513,0.0297435897435897,0.335384615384615,0.474871794871795,0.144102564102564,0.0117948717948718,0.00358974358974359,713,0.365641025641026,1237,0.634358974358974
"E02005040",0,233,527,762,284,56,15,1877,0,0.124134256792754,0.280767181672882,0.405966968566862,0.151305274374001,0.0298348428343101,0.0079914757591902,760,0.404901438465637,1117,0.595098561534363
"E02005041",5,376,645,836,413,141,44,2460,0.00203252032520325,0.152845528455285,0.26219512195122,0.339837398373984,0.167886178861789,0.0573170731707317,0.0178861788617886,1026,0.417073170731707,1434,0.582926829268293
"E02005042",10,430,1133,1436,502,101,32,3644,0.00274423710208562,0.118002195389682,0.310922063666301,0.394072447859495,0.137760702524698,0.0277167947310648,0.00878155872667398,1573,0.431668496158068,2071,0.568331503841932
"E02005043",1,263,1052,1141,372,54,13,2896,0.000345303867403315,0.0908149171270718,0.363259668508287,0.393991712707182,0.128453038674033,0.018646408839779,0.00448895027624309,1316,0.454419889502762,1580,0.545580110497238
"E02005044",1,309,1010,1419,685,141,43,3608,0.000277161862527716,0.0856430155210643,0.279933481152993,0.393292682926829,0.189855875831486,0.039079822616408,0.0119179600886918,1320,0.365853658536585,2288,0.634146341463415
"E02005045",6,762,1038,994,254,58,30,3142,0.00190961171228517,0.242520687460216,0.330362826225334,0.31635900700191,0.0808402291534055,0.0184595798854233,0.00954805856142584,1806,0.574793125397836,1336,0.425206874602164
"E02005046",23,1312,793,1050,209,46,10,3443,0.00668022073772873,0.381063026430439,0.23032239326169,0.304966598896311,0.060702875399361,0.0133604414754575,0.00290444379901249,2128,0.618065640429858,1315,0.381934359570142
"E02005047",17,293,1288,1185,295,57,8,3143,0.00540884505249761,0.0932230353165765,0.409799554565702,0.377028316894687,0.0938593700286351,0.0181355392936685,0.00254533884823417,1598,0.508431434934776,1545,0.491568565065224
"E02005048",7,209,470,849,374,104,41,2054,0.00340798442064265,0.101752677702045,0.228821811100292,0.41333982473223,0.182083739045764,0.0506329113924051,0.0199610516066212,686,0.33398247322298,1368,0.66601752677702
"E02005049",11,296,686,1093,502,228,59,2875,0.00382608695652174,0.10295652173913,0.238608695652174,0.380173913043478,0.174608695652174,0.079304347826087,0.0205217391304348,993,0.345391304347826,1882,0.654608695652174
"E02005050",11,823,971,1132,339,59,19,3354,0.00327966607036374,0.245378652355397,0.289505068574836,0.337507453786524,0.101073345259392,0.0175909361955874,0.00566487775790101,1805,0.538163387000596,1549,0.461836612999404
"E02005051",19,329,2474,2387,484,49,25,5767,0.00329460724813595,0.0570487255071961,0.428992543783596,0.413906710594763,0.0839257846367262,0.00849661869256112,0.00433500953702098,2822,0.489335876538928,2945,0.510664123461072
"E02005052",6,390,1736,1580,547,116,53,4428,0.0013550135501355,0.0880758807588076,0.392050587172538,0.356820234869015,0.12353206865402,0.026196928635953,0.0119692863595303,2132,0.481481481481481,2296,0.518518518518519
"E02005053",3,207,1458,1829,539,78,26,4140,0.00072463768115942,0.05,0.352173913043478,0.441787439613527,0.130193236714976,0.0188405797101449,0.00628019323671498,1668,0.402898550724638,2472,0.597101449275362
"E02005054",9,118,523,947,302,91,15,2005,0.00448877805486284,0.0588528678304239,0.260847880299252,0.472319201995012,0.150623441396509,0.0453865336658354,0.00748129675810474,650,0.324189526184539,1355,0.675810473815461
"E02005055",12,689,1638,1121,307,42,8,3817,0.00314383023316741,0.180508252554362,0.429132826827351,0.293686140948389,0.0804296567985329,0.0110034058160859,0.00209588682211161,2339,0.612784909614881,1478,0.387215090385119
"E02005056",0,628,2216,1799,803,152,49,5647,0,0.111209491765539,0.392420754382858,0.318576235169116,0.142199397910395,0.0269169470515318,0.00867717372055959,2844,0.503630246148397,2803,0.496369753851603
"E02005057",2,572,1293,1591,446,47,20,3971,0.000503651473180559,0.14404432132964,0.325610677411231,0.400654746915135,0.112314278519265,0.0118358096197431,0.00503651473180559,1867,0.470158650214052,2104,0.529841349785948
"E02005058",2,118,807,1327,409,46,22,2731,0.000732332478945441,0.043207616257781,0.295496155254486,0.4859025997803,0.149761991944343,0.0168436470157451,0.00805565726839985,927,0.339436103991212,1804,0.660563896008788
"E02005059",1,148,603,1362,714,139,31,2998,0.000333555703802535,0.0493662441627752,0.201134089392929,0.454302868579053,0.23815877251501,0.0463642428285524,0.0103402268178786,752,0.250833889259506,2246,0.749166110740494
"E02005060",28,705,951,941,242,28,5,2900,0.0096551724137931,0.243103448275862,0.327931034482759,0.32448275862069,0.083448275862069,0.0096551724137931,0.00172413793103448,1684,0.580689655172414,1216,0.419310344827586
"E02005061",5,194,1148,997,199,31,8,2582,0.00193648334624322,0.075135553834237,0.444616576297444,0.386134779240899,0.0770720371804803,0.012006196746708,0.00309837335398916,1347,0.521688613477924,1235,0.478311386522076
"E02005062",1,33,622,815,201,19,4,1695,0.000589970501474926,0.0194690265486726,0.366961651917404,0.480825958702065,0.11858407079646,0.0112094395280236,0.0023598820058997,656,0.387020648967552,1039,0.612979351032448
"E02005063",17,594,806,703,229,33,6,2388,0.00711892797319933,0.248743718592965,0.337520938023451,0.294388609715243,0.0958961474036851,0.0138190954773869,0.00251256281407035,1417,0.593383584589615,971,0.406616415410385
"E02005064",5,58,459,839,372,91,15,1839,0.00271886895051659,0.0315388798259924,0.249592169657423,0.456226209896683,0.202283849918434,0.0494834148994018,0.00815660685154975,522,0.283849918433931,1317,0.716150081566069
"E02005065",2,572,1524,1047,149,20,4,3318,0.000602772754671489,0.172393007836046,0.459312839059675,0.315551537070524,0.0449065702230259,0.00602772754671489,0.00120554550934298,2098,0.632308619650392,1220,0.367691380349608
"E02005066",5,72,511,994,404,73,14,2073,0.00241196333815726,0.0347322720694645,0.246502653159672,0.479498311625663,0.194886637723107,0.035214664737096,0.00675349734684033,588,0.283646888567294,1485,0.716353111432706
"E02005067",4,69,367,661,304,107,36,1548,0.00258397932816537,0.0445736434108527,0.237080103359173,0.427002583979328,0.196382428940568,0.0691214470284238,0.0232558139534884,440,0.284237726098191,1108,0.715762273901809
"E02005068",14,229,667,967,236,54,11,2178,0.00642791551882461,0.10514233241506,0.306244260789715,0.443985307621671,0.108356290174472,0.0247933884297521,0.00505050505050505,910,0.4178145087236,1268,0.5821854912764
"E02005069",8,167,891,1241,420,52,3,2782,0.00287562904385334,0.0600287562904385,0.320273184759166,0.44608195542775,0.1509705248023,0.0186915887850467,0.001078360891445,1066,0.383177570093458,1716,0.616822429906542
"E02005070",1,759,748,1320,300,36,7,3171,0.000315357931251971,0.239356669820246,0.235887732576474,0.416272469252602,0.0946073793755913,0.011352885525071,0.0022075055187638,1508,0.475559760327972,1663,0.524440239672028
"E02005071",16,1552,2804,2372,644,71,28,7487,0.00213703753172165,0.207292640577,0.374515827434219,0.316815814077735,0.0860157606517964,0.00948310404701483,0.00373981568051289,4372,0.583945505542941,3115,0.416054494457059
"E02005072",2,200,753,1058,200,23,5,2241,0.000892458723784025,0.0892458723784025,0.336010709504685,0.472110664881749,0.0892458723784025,0.0102632753235163,0.00223114680946006,955,0.426149040606872,1286,0.573850959393128
"E02005073",1,1157,2029,1563,669,107,31,5557,0.000179953212164837,0.208205866474717,0.365125067482455,0.28126687061364,0.120388698938276,0.0192549937016376,0.00557854957710995,3187,0.573510887169336,2370,0.426489112830664
"E02005074",0,132,806,1268,322,51,7,2586,0,0.0510440835266821,0.311678267594741,0.490332559938128,0.124516627996906,0.0197215777262181,0.00270688321732405,938,0.362722351121423,1648,0.637277648878577
"E02005075",4,631,1513,1322,346,42,9,3867,0.00103439358675976,0.163175588311352,0.39125937419188,0.341867080424101,0.0894750452547194,0.0108611326609775,0.00232738557020946,2148,0.555469356089992,1719,0.444530643910008
"E02005076",8,641,1612,1396,347,41,4,4049,0.00197579649296122,0.158310693998518,0.398122993331687,0.344776488021734,0.0857001728821931,0.0101259570264263,0.000987898246480612,2261,0.558409483823166,1788,0.441590516176834
"E02005077",3,142,1392,1036,261,39,10,2883,0.00104058272632674,0.0492542490461325,0.482830385015609,0.359347901491502,0.0905306971904266,0.0135275754422477,0.00346860908775581,1537,0.533125216788068,1346,0.466874783211932
"E02005078",87,808,720,997,519,161,57,3349,0.0259779038518961,0.241266049567035,0.21498954911914,0.297700806210809,0.15497163332338,0.0480740519558077,0.0170200059719319,1615,0.482233502538071,1734,0.517766497461929
"E02005079",5,613,881,1003,373,59,10,2944,0.00169836956521739,0.208220108695652,0.299252717391304,0.340692934782609,0.126698369565217,0.0200407608695652,0.00339673913043478,1499,0.509171195652174,1445,0.490828804347826
"E02005080",17,916,3061,1406,218,31,9,5658,0.00300459526334394,0.161894662424885,0.541003888299753,0.248497702368328,0.0385295157299399,0.00547896783315659,0.00159066808059385,3994,0.705903145987982,1664,0.294096854012018
"E02005081",22,296,629,871,344,101,30,2293,0.00959441779328391,0.129088530309638,0.274313126907981,0.379851722634104,0.150021805494985,0.044047099869167,0.0130832969908417,947,0.412996075010903,1346,0.587003924989097
"E02005082",58,1959,1386,1076,352,84,21,4936,0.0117504051863857,0.396880064829822,0.280794165316045,0.217990275526742,0.0713128038897893,0.0170178282009724,0.00425445705024311,3403,0.689424635332253,1533,0.310575364667747
"E02005083",7,730,877,874,309,54,8,2859,0.00244840853445261,0.255334032878629,0.306750612102134,0.305701294158797,0.108079748163694,0.018887722980063,0.00279818118223155,1614,0.564533053515215,1245,0.435466946484785
"E02005084",17,777,682,775,406,121,35,2813,0.00604337006754355,0.276217561322432,0.242445787415571,0.275506576608603,0.144329896907216,0.0430145751866335,0.0124422324920014,1476,0.524706718805546,1337,0.475293281194454
"E02005085",8,711,594,775,439,150,33,2710,0.0029520295202952,0.262361623616236,0.219188191881919,0.285977859778598,0.161992619926199,0.0553505535055351,0.0121771217712177,1313,0.48450184501845,1397,0.51549815498155
"E02005086",8,770,560,846,253,50,23,2510,0.00318725099601594,0.306772908366534,0.223107569721116,0.337051792828685,0.100796812749004,0.0199203187250996,0.00916334661354582,1338,0.533067729083665,1172,0.466932270916335
"E02005087",22,170,528,911,279,59,8,1977,0.0111279716742539,0.0859888720283258,0.267071320182094,0.460799190692969,0.141122913505311,0.0298431967627719,0.00404653515427415,720,0.364188163884674,1257,0.635811836115326
"E02005088",3,281,1238,1254,330,29,5,3140,0.000955414012738854,0.0894904458598726,0.394267515923567,0.399363057324841,0.105095541401274,0.00923566878980892,0.00159235668789809,1522,0.484713375796178,1618,0.515286624203822
"E02005089",6,246,575,853,251,50,16,1997,0.00300450676014021,0.123184777165749,0.28793189784677,0.4271407110666,0.125688532799199,0.0250375563345018,0.00801201802704056,827,0.414121181772659,1170,0.585878818227341
"E02005090",2,85,433,651,238,51,8,1468,0.00136239782016349,0.0579019073569482,0.294959128065395,0.443460490463215,0.162125340599455,0.0347411444141689,0.00544959128065395,520,0.354223433242507,948,0.645776566757493
"E02005091",2,139,644,842,379,71,16,2093,0.000955566172957477,0.0664118490205447,0.307692307692308,0.402293358815098,0.181079789775442,0.0339225991399904,0.00764452938365982,785,0.37505972288581,1308,0.62494027711419
"E02005093",4,116,362,661,332,112,29,1616,0.00247524752475248,0.0717821782178218,0.224009900990099,0.409034653465347,0.205445544554455,0.0693069306930693,0.0179455445544554,482,0.298267326732673,1134,0.701732673267327
"E02005094",8,729,866,1090,569,161,39,3462,0.00231080300404391,0.210571923743501,0.250144425187753,0.314846909300982,0.164355863662623,0.0465049104563836,0.011265164644714,1603,0.463027151935298,1859,0.536972848064702
"E02005095",4,142,546,973,318,68,5,2056,0.00194552529182879,0.0690661478599222,0.26556420233463,0.473249027237354,0.154669260700389,0.0330739299610895,0.00243190661478599,692,0.336575875486381,1364,0.663424124513619
"E02005096",5,229,1176,1434,438,62,13,3357,0.00148942508191838,0.0682156687518618,0.350312779267203,0.427167113494191,0.13047363717605,0.0184688710157879,0.00387250521298779,1410,0.420017873100983,1947,0.579982126899017
"E02005097",8,193,736,1142,434,72,14,2599,0.00307810696421701,0.0742593305117353,0.283185840707965,0.439399769141978,0.166987302808773,0.0277029626779531,0.00538668718737976,937,0.360523278183917,1662,0.639476721816083
"E02005098",9,572,1155,1297,673,156,36,3898,0.00230887634684454,0.146741918932786,0.296305797845049,0.332734735761929,0.172652642380708,0.0400205233453053,0.00923550538737814,1736,0.445356593124679,2162,0.554643406875321
"E02005099",7,171,561,1003,535,211,49,2537,0.00275916436736303,0.0674024438312968,0.221127315727237,0.395348837209302,0.210878990934174,0.0831690973590855,0.0193141505715412,739,0.291288923925897,1798,0.708711076074103
"E02005100",6,668,1143,1129,361,82,23,3412,0.00175849941383353,0.1957796014068,0.334994138335287,0.330890973036342,0.105803048065651,0.0240328253223916,0.00674091441969519,1817,0.53253223915592,1595,0.46746776084408
"E02005101",12,174,315,637,695,285,86,2204,0.00544464609800363,0.0789473684210526,0.142921960072595,0.289019963702359,0.315335753176044,0.129310344827586,0.0390199637023593,501,0.227313974591652,1703,0.772686025408348
"E02005102",21,66,461,799,437,171,50,2005,0.0104738154613466,0.0329177057356609,0.229925187032419,0.398503740648379,0.217955112219451,0.085286783042394,0.0249376558603491,548,0.273316708229426,1457,0.726683291770574
"E02005103",37,702,1888,895,129,28,6,3685,0.0100407055630936,0.190502035278155,0.512347354138399,0.242876526458616,0.0350067842605156,0.00759837177747625,0.00162822252374491,2627,0.712890094979647,1058,0.287109905020353
"E02005104",2,92,1379,1226,286,58,19,3062,0.000653167864141084,0.0300457217504899,0.450359242325278,0.400391900718485,0.0934030045721751,0.0189418680600914,0.0062050947093403,1473,0.481058131939909,1589,0.518941868060091
"E02005105",9,143,966,1526,563,76,34,3317,0.00271329514621646,0.0431112451009949,0.291227012360567,0.460054265902924,0.169731685257763,0.0229122701236057,0.0102502261079289,1118,0.337051552607778,2199,0.662948447392222
"E02005106",3,692,1362,1401,319,34,7,3818,0.000785751702462022,0.181246726034573,0.356731272917758,0.366946045049764,0.0835515976951283,0.00890518596123625,0.00183342063907805,2057,0.538763750654793,1761,0.461236249345207
"E02005107",24,898,1490,1868,774,127,30,5211,0.00460564191134139,0.17232776818269,0.285933601995778,0.358472462099405,0.14853195164076,0.0243715217808482,0.00575705238917674,2412,0.46286701208981,2799,0.53713298791019
"E02005109",4,291,591,994,505,126,36,2547,0.00157047506870828,0.114252061248528,0.232037691401649,0.390263054574009,0.198272477424421,0.049469964664311,0.0141342756183746,886,0.347860227718885,1661,0.652139772281115
"E02005110",47,561,509,873,469,128,53,2640,0.0178030303030303,0.2125,0.19280303030303,0.330681818181818,0.177651515151515,0.0484848484848485,0.0200757575757576,1117,0.423106060606061,1523,0.576893939393939
"E02005111",3,359,1436,1307,469,76,24,3674,0.000816548720740337,0.0977136635819271,0.390854654327708,0.355743059335874,0.127653783342406,0.0206859009254219,0.0065323897659227,1798,0.489384866630376,1876,0.510615133369624
"E02005112",12,202,758,957,481,147,61,2618,0.00458365164247517,0.0771581359816654,0.289533995416348,0.365546218487395,0.183728036669213,0.0561497326203209,0.0233002291825821,972,0.371275783040489,1646,0.628724216959511
"E02005113",1,568,838,1165,364,55,14,3005,0.000332778702163062,0.189018302828619,0.278868552412646,0.387687188019967,0.121131447587354,0.0183028286189684,0.00465890183028286,1407,0.468219633943428,1598,0.531780366056572
"E02005114",7,108,668,988,463,170,66,2470,0.00283400809716599,0.0437246963562753,0.270445344129555,0.4,0.187449392712551,0.0688259109311741,0.0267206477732794,783,0.317004048582996,1687,0.682995951417004
"E02005115",0,102,507,1416,552,102,28,2707,0,0.0376800886590321,0.187292205393424,0.523088289619505,0.203915773919468,0.0376800886590321,0.0103435537495382,609,0.224972294052457,2098,0.775027705947543
"E02005116",1,88,1203,981,243,66,23,2605,0.000383877159309021,0.0337811900191939,0.461804222648752,0.37658349328215,0.0932821497120921,0.0253358925143954,0.00882917466410749,1292,0.495969289827255,1313,0.504030710172745
"E02005117",17,360,601,850,284,92,27,2231,0.00761990138951143,0.161362617660242,0.269385925593904,0.380995069475571,0.127297176154191,0.0412371134020619,0.0121021963245182,978,0.438368444643658,1253,0.561631555356342
"E02005118",13,779,1349,1201,300,59,11,3712,0.00350215517241379,0.209859913793103,0.363415948275862,0.32354525862069,0.0808189655172414,0.0158943965517241,0.00296336206896552,2141,0.576778017241379,1571,0.423221982758621
"E02005119",65,387,679,946,269,53,25,2424,0.0268151815181518,0.159653465346535,0.280115511551155,0.39026402640264,0.110973597359736,0.0218646864686469,0.0103135313531353,1131,0.466584158415842,1293,0.533415841584158
"E02005120",15,169,842,918,416,118,57,2535,0.00591715976331361,0.0666666666666667,0.332149901380671,0.362130177514793,0.164102564102564,0.0465483234714004,0.0224852071005917,1026,0.404733727810651,1509,0.595266272189349
"E02005121",13,686,2099,1556,193,25,6,4578,0.00283966797728266,0.149847094801223,0.458497160332023,0.339886413280909,0.0421581476627348,0.0054608999563128,0.00131061598951507,2798,0.611183923110529,1780,0.388816076889471
"E02005122",4,315,588,945,349,80,15,2296,0.00174216027874564,0.13719512195122,0.25609756097561,0.411585365853659,0.152003484320557,0.0348432055749129,0.00653310104529617,907,0.395034843205575,1389,0.604965156794425
"E02005123",38,1001,1782,1355,367,74,18,4635,0.00819848975188781,0.21596548004315,0.384466019417476,0.292340884573894,0.0791801510248112,0.0159654800431499,0.00388349514563107,2821,0.608629989212513,1814,0.391370010787487
"E02005124",2,591,1600,1539,513,76,21,4342,0.000460617227084293,0.136112390603409,0.368493781667434,0.354444956241363,0.118148318747121,0.0175034546292031,0.00483648088438508,2193,0.505066789497927,2149,0.494933210502073
"E02005125",7,382,1298,1079,213,25,8,3012,0.00232403718459495,0.126826029216467,0.430942895086321,0.358233731739708,0.0707171314741036,0.00830013280212483,0.00265604249667995,1687,0.560092961487384,1325,0.439907038512616
"E02005126",8,174,688,1198,452,67,9,2596,0.00308166409861325,0.0670261941448382,0.26502311248074,0.461479198767334,0.174114021571649,0.025808936825886,0.00346687211093991,870,0.335130970724191,1726,0.664869029275809
"E02005127",86,549,839,907,416,106,21,2924,0.0294117647058824,0.187756497948016,0.286935704514364,0.310191518467852,0.142270861833105,0.0362517099863201,0.00718194254445964,1474,0.504103967168263,1450,0.495896032831737
"E02005128",22,1032,882,1293,366,58,12,3665,0.00600272851296044,0.281582537517053,0.240654843110505,0.352796725784447,0.0998635743519782,0.0158253751705321,0.00327421555252387,1936,0.528240109140518,1729,0.471759890859482
"E02005129",12,593,1558,1748,626,102,28,4667,0.00257124491107778,0.127062352689094,0.333833297621598,0.37454467538033,0.134133276194558,0.0218555817441611,0.00599957145918149,2163,0.46346689522177,2504,0.53653310477823
"E02005130",5,647,782,1092,509,199,68,3302,0.00151423379769836,0.195941853422168,0.236826165960024,0.330708661417323,0.154149000605694,0.0602665051483949,0.0205935796486978,1434,0.434282253179891,1868,0.565717746820109
"E02005131",10,163,500,685,351,91,49,1849,0.00540832882639264,0.0881557598702001,0.270416441319632,0.370470524607896,0.189832341806382,0.0492157923201731,0.026500811249324,673,0.363980530016225,1176,0.636019469983775
"E02005132",11,424,2509,2386,1103,194,90,6717,0.0016376358493375,0.0631234181926455,0.373529849635254,0.355218103319934,0.16421021289266,0.0288819413428614,0.0133988387673068,2944,0.438290903677237,3773,0.561709096322763
"E02005133",12,293,1002,1583,517,92,18,3517,0.00341199886266705,0.083309638896787,0.284901905032698,0.450099516633494,0.147000284333239,0.026158657947114,0.00511799829400057,1307,0.371623542792152,2210,0.628376457207848
"E02005134",2,283,1346,1834,683,116,39,4303,0.000464792005577504,0.0657680687892168,0.31280501975366,0.426214269114571,0.158726469904718,0.0269579363234952,0.00906344410876133,1631,0.379037880548455,2672,0.620962119451545
"E02005135",3,314,967,1311,392,74,15,3076,0.000975292587776333,0.102080624187256,0.314369310793238,0.426202860858257,0.127438231469441,0.0240572171651495,0.00487646293888166,1284,0.41742522756827,1792,0.58257477243173
"E02005136",2,130,799,1238,397,56,17,2639,0.000757862826828344,0.0492610837438424,0.302766199317923,0.469117089806745,0.150435771125426,0.0212201591511936,0.00644183402804092,931,0.352785145888594,1708,0.647214854111406
"E02005137",2,51,1615,1216,224,39,9,3156,0.000633713561470215,0.0161596958174905,0.511723700887199,0.385297845373891,0.0709759188846641,0.0123574144486692,0.00285171102661597,1668,0.52851711026616,1488,0.47148288973384
"E02005138",14,248,1581,1668,527,94,36,4168,0.00335892514395393,0.0595009596928983,0.379318618042226,0.400191938579655,0.126439539347409,0.022552783109405,0.00863723608445298,1843,0.442178502879079,2325,0.557821497120921
"E02005139",6,168,1028,1717,501,100,25,3545,0.00169252468265162,0.0473906911142454,0.289985895627645,0.484344146685472,0.14132581100141,0.0282087447108604,0.00705218617771509,1202,0.339069111424542,2343,0.660930888575458
"E02005140",3,170,867,1389,527,90,13,3059,0.0009807126511932,0.055573716900948,0.283425956194835,0.454069957502452,0.172278522392939,0.029421379535796,0.0042497548218372,1040,0.339980385746976,2019,0.660019614253024
"E02005141",44,317,857,1397,656,143,43,3457,0.0127277986693665,0.0916980040497541,0.24790280590107,0.404107607752386,0.189759907434191,0.0413653456754411,0.01243853051779,1218,0.352328608620191,2239,0.647671391379809
"E02005142",171,377,808,1247,360,53,10,3026,0.0565102445472571,0.124586913417052,0.267019167217449,0.412095175148711,0.118968935888962,0.0175148711169861,0.00330469266358229,1356,0.448116325181758,1670,0.551883674818242
"E02005143",0,103,933,1501,496,57,15,3105,0,0.0331723027375201,0.30048309178744,0.48341384863124,0.159742351046699,0.0183574879227053,0.00483091787439614,1036,0.33365539452496,2069,0.66634460547504
"E02005144",2,400,1691,1284,270,41,14,3702,0.000540248514316586,0.108049702863317,0.456780118854673,0.346839546191248,0.0729335494327391,0.01107509454349,0.0037817396002161,2093,0.565370070232307,1609,0.434629929767693
"E02005145",13,1219,864,980,344,78,29,3527,0.00368585199886589,0.345619506662886,0.244967394386164,0.277856535299121,0.0975333144315282,0.0221151119931953,0.0082222852282393,2096,0.594272753047916,1431,0.405727246952084
"E02005146",3,160,790,1491,564,96,36,3140,0.000955414012738854,0.0509554140127389,0.251592356687898,0.47484076433121,0.179617834394904,0.0305732484076433,0.0114649681528662,953,0.303503184713376,2187,0.696496815286624
"E02005147",10,549,2143,2040,999,203,86,6030,0.00165837479270315,0.091044776119403,0.355389718076285,0.338308457711443,0.165671641791045,0.033665008291874,0.0142620232172471,2702,0.448092868988391,3328,0.551907131011609
"E02005148",3,353,939,1216,359,64,10,2944,0.00101902173913043,0.119904891304348,0.318953804347826,0.41304347826087,0.121942934782609,0.0217391304347826,0.00339673913043478,1295,0.439877717391304,1649,0.560122282608696
"E02005149",90,1252,1007,1380,432,97,30,4288,0.0209888059701493,0.291977611940299,0.234841417910448,0.321828358208955,0.100746268656716,0.0226212686567164,0.00699626865671642,2349,0.547807835820896,1939,0.452192164179105
"E02005150",3,770,1707,1555,439,60,23,4557,0.000658327847267939,0.168970814132104,0.374588545095458,0.341233267500549,0.0963353083168751,0.0131665569453588,0.00504718016238754,2480,0.54421768707483,2077,0.45578231292517
"E02005151",4,264,1618,1519,271,34,14,3724,0.00107411385606874,0.0708915145005371,0.434479054779807,0.407894736842105,0.0727712137486574,0.00912996777658432,0.0037593984962406,1886,0.506444683136412,1838,0.493555316863588
"E02005153",86,622,1064,1037,345,45,8,3207,0.0268163392578734,0.193950732772061,0.331774243841596,0.323355160586218,0.107577174929841,0.0140318054256314,0.00249454318677892,1772,0.552541315871531,1435,0.447458684128469
"E02005154",11,429,926,1326,615,181,45,3533,0.00311350127370507,0.121426549674498,0.262100198131899,0.375318426266629,0.174073025757147,0.0512312482309652,0.0127370506651571,1366,0.386640249080102,2167,0.613359750919898
"E02005155",5,1518,1970,845,259,69,28,4694,0.00106518960374947,0.323391563698338,0.41968470387729,0.18001704303366,0.0551768214742224,0.0146996165317427,0.00596506178099702,3493,0.744141457179378,1201,0.255858542820622
"E02005156",13,162,575,832,345,76,22,2025,0.00641975308641975,0.08,0.283950617283951,0.410864197530864,0.17037037037037,0.0375308641975309,0.0108641975308642,750,0.37037037037037,1275,0.62962962962963
"E02005157",3,115,535,857,211,22,3,1746,0.00171821305841924,0.065864833906071,0.306414662084765,0.490836197021764,0.120847651775487,0.0126002290950745,0.00171821305841924,653,0.373997709049255,1093,0.626002290950744
"E02005158",3,123,602,853,282,61,10,1934,0.0015511892450879,0.0635987590486039,0.311271975180972,0.44105480868666,0.145811789038263,0.031540847983454,0.00517063081695967,728,0.376421923474664,1206,0.623578076525336
"E02005159",6,94,685,1039,308,33,6,2171,0.00276370336250576,0.0432980193459235,0.315522800552741,0.47858129894058,0.141870105941962,0.0152003684937817,0.00276370336250576,785,0.36158452326117,1386,0.63841547673883
"E02005160",3,1297,1591,1592,585,79,32,5179,0.000579262405869859,0.250434446804402,0.307202162579649,0.307395250048272,0.112956169144623,0.0152539100212396,0.00617879899594516,2891,0.558215871789921,2288,0.441784128210079
"E02005161",1,277,892,1247,464,68,18,2967,0.000337040781934614,0.0933602965958881,0.300640377485676,0.420289855072464,0.156386922817661,0.0229187731715538,0.00606673407482305,1170,0.394337714863499,1797,0.605662285136502
"E02005162",102,1050,1173,1234,418,89,26,4092,0.0249266862170088,0.256598240469208,0.286656891495601,0.301564027370479,0.102150537634409,0.0217497556207234,0.00635386119257087,2325,0.568181818181818,1767,0.431818181818182
"E02005163",5,129,777,1131,475,65,15,2597,0.00192529842125529,0.0496726992683866,0.299191374663073,0.435502502887948,0.182903350019253,0.0250288794763188,0.00577589526376588,911,0.350789372352715,1686,0.649210627647285
"E02005164",5,715,1115,1250,430,69,8,3592,0.00139198218262806,0.199053452115813,0.310412026726058,0.347995545657016,0.119710467706013,0.0192093541202673,0.0022271714922049,1835,0.510857461024499,1757,0.489142538975501
"E02005165",7,197,577,1044,444,116,28,2413,0.00290095317032739,0.0816411106506423,0.239121425611272,0.432656444260257,0.184003315375052,0.0480729382511397,0.0116038126813096,781,0.323663489432242,1632,0.676336510567758
"E02005166",6,333,1152,842,189,35,5,2562,0.00234192037470726,0.129976580796253,0.449648711943794,0.328649492583919,0.0737704918032787,0.0136612021857923,0.00195160031225605,1491,0.581967213114754,1071,0.418032786885246
"E02005167",2,130,532,999,454,106,18,2241,0.000892458723784025,0.0580098170459616,0.237394020526551,0.44578313253012,0.202588130298974,0.0473003123605533,0.00803212851405622,664,0.296296296296296,1577,0.703703703703704
"E02005168",10,361,774,1228,591,114,17,3095,0.00323101777059774,0.116639741518578,0.250080775444265,0.396768982229402,0.190953150242326,0.0368336025848142,0.00549273021001615,1145,0.369951534733441,1950,0.630048465266559
"E02005169",7,985,1872,1862,862,149,31,5768,0.00121359223300971,0.170769764216366,0.324549237170596,0.322815533980583,0.149445214979196,0.0258321775312067,0.005374479889043,2864,0.496532593619972,2904,0.503467406380028
"E02005170",8,471,1289,1575,596,79,21,4039,0.00198068828918049,0.116613023025501,0.319138400594207,0.389948006932409,0.147561277543947,0.0195592968556573,0.00519930675909879,1768,0.437732111908888,2271,0.562267888091112
"E02005171",4,261,965,893,245,64,11,2443,0.00163733115022513,0.10683585755219,0.395006139991813,0.365534179287761,0.100286532951289,0.0261972984036021,0.00450266066311912,1230,0.503479328694228,1213,0.496520671305772
"E02005172",14,105,335,802,851,346,113,2566,0.00545596258768511,0.0409197194076383,0.130553390491037,0.312548713951676,0.331644583008574,0.134840218238504,0.044037412314887,454,0.17692907248636,2112,0.82307092751364
"E02005173",2,398,1059,1415,664,105,22,3665,0.000545702592087312,0.108594815825375,0.288949522510232,0.386084583901774,0.181173260572988,0.0286493860845839,0.00600272851296044,1459,0.398090040927694,2206,0.601909959072306
"E02005174",17,328,714,867,437,95,34,2492,0.00682182985553772,0.131621187800963,0.286516853932584,0.347913322632424,0.175361155698234,0.0381219903691814,0.0136436597110754,1059,0.424959871589085,1433,0.575040128410915
"E02005175",8,417,721,936,510,177,43,2813,0.00284393885531461,0.148240312833274,0.256309989335229,0.332740846071809,0.181301102026306,0.0629221471738358,0.015286171347316,1146,0.407394241023818,1666,0.592250266619268
"E02005176",1,91,753,1479,458,71,19,2872,0.000348189415041783,0.0316852367688022,0.262186629526462,0.514972144846797,0.159470752089136,0.0247214484679666,0.00661559888579387,845,0.294220055710306,2027,0.705779944289694
"E02005177",1,173,406,1232,563,99,35,2509,0.000398565165404544,0.0689517736149861,0.161817457154245,0.491032283778398,0.224392188122758,0.0394579513750498,0.013949780789159,580,0.231167795934635,1929,0.768832204065365
"E02005178",2,349,749,1893,967,212,83,4255,0.000470035252643948,0.082021151586369,0.176028202115159,0.444888366627497,0.227262044653349,0.0498237367802585,0.0195064629847239,1100,0.258519388954172,3155,0.741480611045828
"E02005179",2,329,1106,1923,726,121,34,4241,0.000471586889884461,0.0775760433859939,0.260787550106107,0.453430794623909,0.171186041028059,0.0285310068380099,0.00801697712803584,1437,0.338835180381985,2804,0.661164819618015
"E02005180",5,309,599,991,295,44,8,2251,0.0022212350066637,0.137272323411817,0.266103953798312,0.440248778320746,0.131052865393159,0.0195468680586406,0.00355397601066193,913,0.405597512216793,1338,0.594402487783207
"E02005181",0,209,940,1433,535,101,27,3245,0,0.0644067796610169,0.289676425269646,0.441602465331279,0.164869029275809,0.0311248073959938,0.00832049306625578,1149,0.354083204930663,2096,0.645916795069338
"E02005182",0,31,887,1435,680,130,53,3216,0,0.00963930348258706,0.275808457711443,0.446206467661692,0.211442786069652,0.0404228855721393,0.0164800995024876,918,0.28544776119403,2298,0.71455223880597
"E02005183",3,72,1006,1010,246,40,8,2385,0.00125786163522013,0.030188679245283,0.421802935010482,0.423480083857442,0.10314465408805,0.0167714884696017,0.00335429769392034,1081,0.453249475890985,1304,0.546750524109015
"E02005184",12,237,288,711,273,69,23,1613,0.00743955362678239,0.146931184128952,0.178549287042777,0.440793552386857,0.169249845009299,0.0427774333539988,0.0142591444513329,537,0.332920024798512,1076,0.667079975201488
"E02005185",63,328,1424,2142,774,153,71,4955,0.0127144298688194,0.0661957618567104,0.287386478304743,0.432290615539859,0.156205852674067,0.0308779011099899,0.0143289606458123,1815,0.366296670030272,3140,0.633703329969728
"E02005186",2,342,642,803,247,52,23,2111,0.000947418285172904,0.162008526764567,0.304121269540502,0.380388441496921,0.117006158218854,0.0246328754144955,0.0108953102794884,986,0.467077214590242,1125,0.532922785409758
"E02005189",9,166,1345,824,101,13,4,2462,0.00365556458164094,0.0674248578391552,0.546303818034119,0.334687246141348,0.0410235580828595,0.00528025995125914,0.0016246953696182,1520,0.617384240454915,942,0.382615759545085
"E02005190",10,72,361,891,351,87,20,1792,0.00558035714285714,0.0401785714285714,0.201450892857143,0.497209821428571,0.195870535714286,0.0485491071428571,0.0111607142857143,443,0.247209821428571,1349,0.752790178571429
"E02005191",67,806,779,1124,227,31,5,3039,0.0220467258966765,0.265218821980915,0.256334320500165,0.369858506087529,0.0746956235603817,0.0102007239223429,0.00164527805199079,1652,0.543599868377756,1387,0.456400131622244
"E02005192",19,709,1032,970,244,50,20,3044,0.00624178712220762,0.232917214191853,0.339027595269382,0.318659658344284,0.0801576872536137,0.0164257555847569,0.00657030223390276,1760,0.578186596583443,1284,0.421813403416557
"E02005193",27,383,765,1128,258,45,9,2615,0.0103250478011472,0.146462715105163,0.292543021032505,0.431357552581262,0.0986615678776291,0.017208413001912,0.00344168260038241,1175,0.449330783938815,1440,0.550669216061185
"E02005194",0,329,981,1321,356,69,22,3078,0,0.10688758934373,0.318713450292398,0.429174788823912,0.115659519168291,0.0224171539961014,0.00714749837556855,1310,0.425601039636127,1768,0.574398960363873
"E02005195",15,230,511,759,281,86,27,1909,0.00785751702462022,0.120481927710843,0.267679413305396,0.397590361445783,0.147197485594552,0.0450497642744893,0.0141435306443164,756,0.396018858040859,1153,0.603981141959141
"E02005196",92,1604,1536,925,269,45,11,4482,0.0205265506470326,0.357875948237394,0.342704149933066,0.206381079875056,0.0600178491744757,0.0100401606425703,0.00245426149040607,3232,0.721106648817492,1250,0.278893351182508
"E02005197",2,182,1209,1252,283,53,14,2995,0.000667779632721202,0.0607679465776294,0.403672787979967,0.418030050083472,0.0944908180300501,0.0176961602671119,0.00467445742904841,1393,0.465108514190317,1602,0.534891485809683
"E02005198",0,595,1434,1481,498,92,28,4128,0,0.144137596899225,0.347383720930233,0.358769379844961,0.120639534883721,0.0222868217054264,0.00678294573643411,2029,0.491521317829457,2099,0.508478682170543
"E02005199",26,305,556,954,316,82,26,2265,0.0114790286975717,0.134657836644592,0.245474613686534,0.421192052980132,0.139514348785872,0.0362030905077263,0.0114790286975717,887,0.391611479028698,1378,0.608388520971302
"E02005200",2,424,1664,1153,191,27,8,3469,0.000576535024502739,0.122225425194581,0.479677140386278,0.332372441625829,0.0550590948400115,0.00778322283078697,0.00230614009801095,2090,0.602479100605362,1379,0.397520899394638
"E02005201",4,384,869,1092,260,61,15,2685,0.00148975791433892,0.143016759776536,0.32364990689013,0.406703910614525,0.0968342644320298,0.0227188081936685,0.00558659217877095,1257,0.468156424581006,1428,0.531843575418995
"E02005202",6,361,846,1381,472,97,20,3183,0.00188501413760603,0.113415017279296,0.265786993402451,0.433867420672322,0.148287778825008,0.0304743952246308,0.00628338045868677,1213,0.381087024819353,1970,0.618912975180647
"E02005203",8,707,776,935,336,127,39,2928,0.00273224043715847,0.24146174863388,0.265027322404372,0.319330601092896,0.114754098360656,0.0433743169398907,0.0133196721311475,1491,0.50922131147541,1437,0.49077868852459
"E02005204",14,1178,1294,1647,473,80,25,4711,0.00297176820208024,0.250053067289323,0.274676289535131,0.349607302059011,0.100403311398854,0.0169815325833156,0.00530672893228614,2486,0.527701125026534,2225,0.472298874973466
"E02005205",21,473,507,754,247,62,19,2083,0.0100816130580893,0.227076332213154,0.243398943831013,0.361977916466635,0.118578972635622,0.0297647623619779,0.00912145943350936,1001,0.480556889102256,1082,0.519443110897744
"E02005206",1,629,732,1252,470,65,16,3165,0.000315955766192733,0.198736176935229,0.231279620853081,0.395576619273302,0.148499210110585,0.0205371248025276,0.00505529225908373,1362,0.430331753554502,1803,0.569668246445498
"E02005207",21,702,779,1441,530,96,25,3594,0.00584307178631052,0.195325542570952,0.216750139120757,0.400946021146355,0.147468002225932,0.0267111853088481,0.00695603784084585,1502,0.417918753478019,2092,0.582081246521981
"E02005208",2,404,1551,2503,1410,280,94,6244,0.000320307495195388,0.0647021140294683,0.248398462524023,0.400864830237028,0.225816784112748,0.0448430493273543,0.0150544522741832,1957,0.313420884048687,4287,0.686579115951313
"E02005209",20,1138,737,1274,390,73,23,3655,0.00547195622435021,0.311354309165527,0.201641586867305,0.348563611491108,0.106703146374829,0.0199726402188782,0.00629274965800274,1895,0.518467852257182,1760,0.481532147742818
"E02005210",2,140,1009,2025,896,154,27,4253,0.000470256289677874,0.0329179402774512,0.237244298142488,0.476134493298848,0.210674817775688,0.0362097343051963,0.00634845991065131,1151,0.270632494709617,3102,0.729367505290383
"E02005211",4,403,1103,1650,692,117,34,4003,0.000999250562078441,0.100674494129403,0.27554334249313,0.412190856857357,0.17287034723957,0.0292280789407944,0.00849362977766675,1510,0.377217087184612,2493,0.622782912815388
"E02005212",2,395,856,1954,777,161,49,4194,0.000476871721506915,0.0941821649976156,0.204101096804959,0.465903671912256,0.185264663805436,0.0383881735813066,0.0116833571769194,1253,0.298760133524082,2941,0.701239866475918
"E02005213",3,159,1250,1919,602,112,32,4077,0.000735835172921266,0.0389992641648271,0.306597988717194,0.470689232278636,0.147657591366201,0.0274711797890606,0.00784890851116017,1412,0.346333088054942,2665,0.653666911945058
"E02005214",5,156,482,1322,483,82,32,2562,0.00195160031225605,0.0608899297423888,0.188134270101483,0.5160031225605,0.188524590163934,0.0320062451209992,0.0124902419984387,643,0.250975800156128,1919,0.749024199843872
"E02005215",1,282,1277,2386,927,163,72,5108,0.000195771339075959,0.0552075176194205,0.25,0.467110415035239,0.181480031323414,0.0319107282693814,0.0140955364134691,1560,0.305403288958496,3548,0.694596711041504
"E02005216",0,124,597,1000,335,65,25,2146,0,0.0577819198508854,0.278191985088537,0.465983224603914,0.156104380242311,0.0302889095992544,0.0116495806150979,721,0.335973904939422,1425,0.664026095060578
"E02005217",0,326,1146,1896,1038,172,108,4686,0,0.0695689287238583,0.244558258642766,0.40460947503201,0.221510883482714,0.0367050789586001,0.0230473751600512,1472,0.314127187366624,3214,0.685872812633376
"E02005218",8,192,824,1439,502,82,28,3075,0.00260162601626016,0.0624390243902439,0.267967479674797,0.467967479674797,0.163252032520325,0.0266666666666667,0.00910569105691057,1024,0.333008130081301,2051,0.666991869918699
"E02005219",3,58,859,1568,564,101,69,3222,0.000931098696461825,0.0180012414649286,0.266604593420236,0.48665425201738,0.175046554934823,0.0313469894475481,0.021415270018622,920,0.285536933581626,2302,0.714463066418374
"E02005220",2,104,473,935,304,50,18,1886,0.00106044538706257,0.0551431601272534,0.250795334040297,0.49575821845175,0.16118769883351,0.0265111346765642,0.0095440084835631,579,0.306998939554613,1307,0.693001060445387
"E02005221",10,360,928,1589,539,166,48,3640,0.00274725274725275,0.0989010989010989,0.254945054945055,0.436538461538462,0.148076923076923,0.0456043956043956,0.0131868131868132,1298,0.356593406593407,2342,0.643406593406593
"E02005222",31,179,437,711,434,201,76,2069,0.0149830836152731,0.0865152247462542,0.211213146447559,0.343644272595457,0.209763170613823,0.097148380860319,0.0367327211213146,647,0.312711454809087,1422,0.687288545190914
"E02005223",5,132,424,1165,425,78,17,2246,0.00222617987533393,0.0587711487088157,0.188780053428317,0.518699910952805,0.189225289403384,0.0347284060552093,0.00756901157613535,561,0.249777382012467,1685,0.750222617987533
"E02005224",0,87,621,1111,387,60,21,2287,0,0.0380411018801924,0.271534761696546,0.485789243550503,0.169217315260166,0.0262352426759948,0.00918233493659816,708,0.309575863576738,1579,0.690424136423262
"E02005225",24,384,512,704,324,94,19,2061,0.0116448326055313,0.186317321688501,0.248423095584668,0.341581756428918,0.157205240174672,0.0456089277049976,0.00921882581271228,920,0.4463852498787,1141,0.5536147501213
"E02005226",1,129,1099,1534,757,155,90,3765,0.000265604249667995,0.0342629482071713,0.291899070385126,0.407436918990704,0.201062416998672,0.0411686586985392,0.0239043824701195,1229,0.326427622841965,2536,0.673572377158034
"E02005228",7,9,332,1046,377,77,31,1879,0.00372538584353379,0.00478978179882916,0.176689728579031,0.556679084619478,0.200638637573177,0.0409792442788717,0.0164981373070782,348,0.185204896221394,1531,0.814795103778606
"E02005229",0,199,949,1247,778,145,100,3418,0,0.0582211819777648,0.277647747220597,0.364833235810415,0.227618490345231,0.0424224692802809,0.0292568753657109,1148,0.335868929198362,2270,0.664131070801638
"E02005230",1,164,1033,1145,260,43,11,2657,0.000376364320662401,0.0617237485886338,0.38878434324426,0.430937147158449,0.0978547233722243,0.0161836657884833,0.00414000752728641,1198,0.450884456153557,1459,0.549115543846443
"E02005231",21,120,1316,1586,427,84,23,3577,0.00587084148727984,0.0335476656415991,0.367906066536204,0.443388314229802,0.119373776908023,0.0234833659491194,0.00642996924797316,1457,0.407324573665082,2120,0.592675426334918
"E02005233",5,645,1123,991,265,50,7,3086,0.0016202203499676,0.20900842514582,0.363901490602722,0.321127673363577,0.0858716785482826,0.016202203499676,0.00226830848995463,1773,0.574530136098509,1313,0.425469863901491
"E02005234",23,524,1451,1347,570,87,26,4028,0.00571002979145978,0.130089374379345,0.360228401191658,0.334409136047666,0.141509433962264,0.0215988083416087,0.00645481628599801,1998,0.496027805362463,2030,0.503972194637537
"E02005235",2,55,449,1290,428,47,12,2283,0.000876040297853701,0.0240911081909768,0.196671046868156,0.565045992115637,0.187472623740692,0.020586946999562,0.00525624178712221,506,0.221638195356986,1777,0.778361804643014
"E02005236",5,392,1562,1916,658,126,49,4708,0.00106202209005947,0.0832625318606627,0.331775700934579,0.40696686491079,0.139762107051827,0.0267629566694987,0.0104078164825828,1959,0.416100254885302,2749,0.583899745114698
"E02005237",35,607,1234,1523,480,68,21,3968,0.00882056451612903,0.152973790322581,0.310987903225806,0.383820564516129,0.120967741935484,0.0171370967741935,0.00529233870967742,1876,0.472782258064516,2092,0.527217741935484
"E02005238",6,51,611,944,278,35,8,1933,0.00310398344542162,0.0263838592860838,0.316088980858769,0.488360062079669,0.143817899637869,0.0181065700982928,0.0041386445938955,668,0.345576823590274,1265,0.654423176409726
"E02005239",14,582,452,821,443,175,53,2540,0.00551181102362205,0.229133858267717,0.177952755905512,0.323228346456693,0.174409448818898,0.0688976377952756,0.0208661417322835,1048,0.41259842519685,1492,0.58740157480315
"E02005240",24,162,452,929,428,69,20,2084,0.0115163147792706,0.0777351247600768,0.216890595009597,0.445777351247601,0.205374280230326,0.0331094049904031,0.00959692898272553,638,0.306142034548944,1446,0.693857965451056
"E02005241",0,77,407,1055,469,99,31,2138,0,0.0360149672591207,0.190364826941066,0.493451824134705,0.219363891487371,0.0463049579045837,0.0144995322731525,484,0.226379794200187,1654,0.773620205799813
"E02005242",6,119,598,920,516,111,19,2289,0.00262123197903014,0.0519877675840979,0.261249453910004,0.401922236784622,0.225425950196592,0.0484927916120577,0.00830056793359546,723,0.315858453473132,1566,0.684141546526868
"E02005245",17,116,565,985,491,110,34,2318,0.00733390854184642,0.0500431406384814,0.24374460742019,0.424935289042278,0.211820534943917,0.0474547023295945,0.0146678170836928,698,0.301121656600518,1620,0.698878343399482
"E02005246",18,317,601,963,486,86,33,2504,0.00718849840255591,0.126597444089457,0.240015974440895,0.384584664536741,0.19408945686901,0.0343450479233227,0.0131789137380192,936,0.373801916932907,1568,0.626198083067093
"E02005247",31,236,882,1543,687,171,37,3587,0.00864231948703652,0.0657931419013103,0.245887928631168,0.430164482854753,0.191524951212713,0.0476721494284918,0.0103150264845275,1149,0.320323390019515,2438,0.679676609980485
"E02005248",31,73,627,1234,599,145,67,2776,0.0111671469740634,0.0262968299711816,0.225864553314121,0.444524495677233,0.215778097982709,0.0522334293948127,0.024135446685879,731,0.263328530259366,2045,0.736671469740634
"E02005249",14,48,945,2022,978,216,98,4321,0.00323999074288359,0.0111085396898866,0.218699375144642,0.467947234436473,0.226336496181439,0.0499884286044897,0.0226799352001851,1007,0.233047905577413,3314,0.766952094422587
"E02005250",0,56,457,1267,759,154,82,2775,0,0.0201801801801802,0.164684684684685,0.456576576576577,0.273513513513513,0.0554954954954955,0.0295495495495495,513,0.184864864864865,2262,0.815135135135135
"E02005251",9,244,515,1039,383,82,15,2287,0.00393528640139921,0.106689986882379,0.225185832968955,0.454306952339309,0.167468299081766,0.0358548316571928,0.00655881066899869,768,0.335811106252733,1519,0.664188893747267
"E02005252",13,158,636,1607,763,180,60,3417,0.00380450687737782,0.0462393912788996,0.18612818261633,0.470295580918935,0.22329528826456,0.0526777875329236,0.0175592625109745,807,0.236172080772608,2610,0.763827919227392
"E02005253",156,1450,425,663,288,95,28,3105,0.0502415458937198,0.466988727858293,0.136876006441224,0.213526570048309,0.0927536231884058,0.0305958132045089,0.00901771336553945,2031,0.654106280193237,1074,0.345893719806763
"E02005254",271,3064,445,803,315,126,39,5063,0.0535255777207189,0.605174797550859,0.0878925538218448,0.158601619593127,0.0622160774244519,0.0248864309697808,0.00770294291921786,3780,0.746592929093423,1283,0.253407070906577
"E02005255",1,288,642,1386,416,55,11,2799,0.000357270453733476,0.102893890675241,0.229367631296892,0.495176848874598,0.148624508753126,0.0196498749553412,0.00392997499106824,931,0.332618792425866,1868,0.667381207574134
"E02005256",21,114,970,870,146,20,1,2142,0.00980392156862745,0.0532212885154062,0.452847805788982,0.406162464985994,0.0681605975723623,0.00933706816059757,0.000466853408029879,1105,0.515873015873016,1037,0.484126984126984
"E02005257",0,384,1645,725,121,16,6,2897,0,0.132550914739386,0.567828788401795,0.25025888850535,0.0417673455298585,0.00552295478080773,0.0020711080428029,2029,0.70037970314118,868,0.29962029685882
"E02005258",9,69,692,1189,535,96,22,2612,0.00344563552833078,0.026416539050536,0.264931087289433,0.4552067381317,0.204823889739663,0.0367534456355283,0.00842266462480858,770,0.2947932618683,1842,0.7052067381317
"E02005259",0,182,1636,1338,298,71,12,3537,0,0.0514560361888606,0.462538874752615,0.378286683630195,0.0842521911224201,0.0200735086231269,0.00339270568278202,1818,0.513994910941476,1719,0.486005089058524
"E02005260",2,52,496,1025,293,53,10,1931,0.00103573278094252,0.0269290523045054,0.256861729673744,0.53081305023304,0.151734852408079,0.0274469186949767,0.00517866390471258,550,0.284826514759192,1381,0.715173485240808
"E02005261",1,222,1948,1384,339,46,15,3955,0.000252844500632111,0.0561314791403287,0.492541087231353,0.349936788874842,0.0857142857142857,0.0116308470290771,0.00379266750948167,2171,0.548925410872314,1784,0.451074589127686
"E02005262",70,1356,1118,828,133,25,9,3539,0.0197795987567109,0.383159084487143,0.315908448714326,0.233964396722238,0.0375812376377508,0.00706414241311105,0.00254309126871998,2544,0.71884713195818,995,0.28115286804182
"E02005263",0,29,625,1434,586,99,38,2811,0,0.0103166133048737,0.222340803984347,0.510138740661686,0.208466737815724,0.0352187833511206,0.0135183208822483,654,0.232657417289221,2157,0.767342582710779
"E02005264",0,155,1949,2536,730,129,40,5539,0,0.027983390503701,0.351868568333634,0.457844376241199,0.131792742372269,0.0232894024192092,0.00722152012998736,2104,0.379851958837335,3435,0.620148041162665
"E02005265",2,170,1703,1778,528,112,36,4329,0.000462000462000462,0.0392700392700393,0.393393393393393,0.410718410718411,0.121968121968122,0.0258720258720259,0.00831600831600832,1875,0.433125433125433,2454,0.566874566874567
"E02005266",12,378,1456,1341,489,85,57,3818,0.00314300680984809,0.0990047145102148,0.381351492928235,0.351231011000524,0.12807752750131,0.0222629649030906,0.0149292823467784,1846,0.483499214248298,1972,0.516500785751702
"E02005267",0,750,1180,816,282,43,15,3086,0,0.243033052495139,0.382372002592353,0.264419961114712,0.0913804277381724,0.0139338950097213,0.00486066104990279,1930,0.625405055087492,1156,0.374594944912508
"E02005268",1,88,1207,1283,436,88,24,3127,0.000319795330988168,0.0281419891269587,0.385992964502718,0.410297409657819,0.139430764310841,0.0281419891269587,0.00767508794371602,1296,0.414454748960665,1831,0.585545251039335
"E02005269",0,643,2510,1949,680,143,56,5981,0,0.107507105835145,0.419662263835479,0.325865239926434,0.113693362313994,0.0239090453101488,0.00936298277879953,3153,0.527169369670624,2828,0.472830630329376
"E02005270",9,72,359,687,675,255,88,2145,0.0041958041958042,0.0335664335664336,0.167365967365967,0.32027972027972,0.314685314685315,0.118881118881119,0.041025641025641,440,0.205128205128205,1705,0.794871794871795
"E02005271",16,890,792,1228,386,79,21,3412,0.00468933177022274,0.26084407971864,0.232121922626026,0.359906213364596,0.113130128956624,0.0231535756154748,0.00615474794841735,1698,0.497655334114889,1714,0.502344665885111
"E02005272",4,956,851,1205,347,57,13,3433,0.00116516166618118,0.278473638217303,0.247888144480047,0.351004951937081,0.101077774541218,0.0166035537430819,0.00378677541508884,1811,0.52752694436353,1622,0.47247305563647
"E02005273",5,477,396,790,350,155,40,2213,0.00225937641211026,0.215544509715319,0.178942611839132,0.356981473113421,0.158156348847718,0.070040668775418,0.0180750112968821,878,0.396746497966561,1335,0.603253502033439
"E02005274",4,740,522,959,411,109,28,2773,0.00144248106743599,0.266858997475658,0.188243779300397,0.345834835917779,0.148214929679048,0.0393076090876307,0.0100973674720519,1266,0.456545257843491,1507,0.543454742156509
"E02005275",42,538,489,847,323,59,16,2314,0.0181503889369058,0.232497839239412,0.211322385479689,0.366032843560933,0.139585133967156,0.0254969749351772,0.00691443388072602,1069,0.461970613656007,1245,0.538029386343993
"E02005276",13,1039,896,1029,373,72,15,3437,0.00378236834448647,0.302298516147803,0.260692464358452,0.29938900203666,0.10852487634565,0.0209485016002328,0.00436427116671516,1948,0.566773348850742,1489,0.433226651149258
"E02005277",9,88,511,1288,480,114,23,2513,0.00358137684042977,0.0350179068842022,0.203342618384401,0.512534818941504,0.191006764822921,0.0453641066454437,0.00915240748109829,608,0.241941902109033,1905,0.758058097890967
"E02005278",6,181,800,1118,440,109,26,2680,0.00223880597014925,0.0675373134328358,0.298507462686567,0.417164179104478,0.164179104477612,0.0406716417910448,0.00970149253731343,987,0.368283582089552,1693,0.631716417910448
"E02005279",6,117,1253,1685,734,138,42,3975,0.00150943396226415,0.0294339622641509,0.315220125786164,0.423899371069182,0.184654088050314,0.0347169811320755,0.0105660377358491,1376,0.346163522012579,2599,0.653836477987421
"E02005280",10,275,1560,1684,688,111,36,4364,0.00229147571035747,0.0630155820348304,0.357470210815765,0.385884509624198,0.157653528872594,0.0254353803849679,0.00824931255728689,1845,0.422777268560953,2519,0.577222731439047
"E02005281",24,430,828,1447,727,140,30,3626,0.0066188637617209,0.118587975730833,0.228350799779371,0.399062327633756,0.200496414782129,0.0386100386100386,0.00827357970215113,1282,0.353557639271925,2344,0.646442360728075
"E02005284",4,123,588,909,246,39,15,1924,0.00207900207900208,0.0639293139293139,0.305613305613306,0.472453222453222,0.127858627858628,0.0202702702702703,0.0077962577962578,715,0.371621621621622,1209,0.628378378378378
"E02005285",3,74,566,1071,389,66,19,2188,0.00137111517367459,0.0338208409506399,0.258683729433272,0.489488117001828,0.177787934186472,0.030164533820841,0.00868372943327239,643,0.293875685557587,1545,0.706124314442413
"E02005286",4,374,947,1120,405,72,24,2946,0.00135777325186694,0.126951799049559,0.321452817379498,0.380176510522743,0.137474541751527,0.0244399185336049,0.00814663951120163,1325,0.449762389680923,1621,0.550237610319077
"E02005287",0,59,306,770,249,54,9,1447,0,0.0407740152038701,0.21147201105736,0.532135452660677,0.172080165860401,0.0373185901865929,0.00621976503109883,365,0.25224602626123,1082,0.74775397373877
"E02005288",4,176,464,894,295,79,27,1939,0.00206291903042806,0.0907684373388345,0.239298607529654,0.46106240330067,0.152140278494069,0.0407426508509541,0.0139247034553894,644,0.332129963898917,1295,0.667870036101083
"E02005289",2,45,496,910,257,35,5,1750,0.00114285714285714,0.0257142857142857,0.283428571428571,0.52,0.146857142857143,0.02,0.00285714285714286,543,0.310285714285714,1207,0.689714285714286
"E02005290",26,178,630,1081,299,70,22,2306,0.0112749349522984,0.0771899392888118,0.273200346921075,0.46877710320902,0.129661751951431,0.0303555941023417,0.00954032957502168,834,0.361665221162186,1472,0.638334778837814
"E02005291",9,183,571,863,236,62,11,1935,0.00465116279069767,0.0945736434108527,0.295090439276486,0.445994832041344,0.121963824289406,0.0320413436692506,0.00568475452196382,763,0.394315245478036,1172,0.605684754521964
"E02005292",1,101,962,896,164,17,3,2144,0.000466417910447761,0.0471082089552239,0.448694029850746,0.417910447761194,0.0764925373134328,0.00792910447761194,0.00139925373134328,1064,0.496268656716418,1080,0.503731343283582
"E02005293",2,96,759,866,223,35,10,1991,0.00100452034153692,0.048216976393772,0.38121546961326,0.434957307885485,0.112004018081366,0.017579105976896,0.00502260170768458,857,0.430436966348569,1134,0.569563033651431
"E02005294",42,870,781,893,196,37,14,2833,0.0148252735615955,0.307094952347335,0.275679491704906,0.315213554535828,0.0691846099541122,0.0130603600423579,0.00494175785386516,1693,0.597599717613837,1140,0.402400282386163
"E02005295",17,455,681,1052,285,47,15,2552,0.00666144200626959,0.178291536050157,0.266849529780564,0.412225705329154,0.111677115987461,0.0184169278996865,0.00587774294670846,1153,0.451802507836991,1399,0.548197492163009
"E02005296",38,204,424,759,280,56,16,1777,0.0213843556555993,0.114800225098481,0.238604389420371,0.427124366910523,0.157568936409679,0.0315137872819358,0.00900393922341024,666,0.374788970174451,1111,0.625211029825549
"E02005297",25,250,638,1051,402,87,19,2472,0.0101132686084142,0.101132686084142,0.258090614886731,0.425161812297735,0.162621359223301,0.0351941747572816,0.00768608414239482,913,0.369336569579288,1559,0.630663430420712
"E02005298",65,1114,652,996,266,54,11,3158,0.0205826472450918,0.352754908169728,0.206459784673844,0.315389487017099,0.084230525649145,0.0170994300189994,0.00348321722609246,1831,0.579797340088664,1327,0.420202659911336
"E02005299",1,418,1236,1116,273,50,16,3110,0.000321543408360129,0.134405144694534,0.397427652733119,0.358842443729904,0.0877813504823151,0.0160771704180064,0.00514469453376206,1655,0.532154340836013,1455,0.467845659163987
"E02005300",7,352,674,614,135,17,5,1804,0.00388026607538803,0.195121951219512,0.373614190687361,0.340354767184035,0.0748337028824834,0.00942350332594235,0.00277161862527716,1033,0.572616407982262,771,0.427383592017738
"E02005301",5,152,856,950,228,40,13,2244,0.00222816399286988,0.0677361853832442,0.381461675579323,0.423351158645276,0.101604278074866,0.017825311942959,0.00579322638146168,1013,0.451426024955437,1231,0.548573975044563
"E02005302",5,374,1192,923,217,42,7,2760,0.00181159420289855,0.135507246376812,0.431884057971014,0.334420289855072,0.0786231884057971,0.0152173913043478,0.00253623188405797,1571,0.569202898550725,1189,0.430797101449275
"E02005303",21,495,1009,914,190,24,13,2666,0.00787696924231058,0.185671417854464,0.378469617404351,0.342835708927232,0.0712678169542386,0.00900225056264066,0.00487621905476369,1525,0.572018004501125,1141,0.427981995498875
"E02005304",6,550,757,1209,348,76,29,2975,0.00201680672268908,0.184873949579832,0.254453781512605,0.406386554621849,0.116974789915966,0.025546218487395,0.00974789915966387,1313,0.441344537815126,1662,0.558655462184874
"E02005305",4,596,628,901,321,88,36,2574,0.00155400155400155,0.231546231546232,0.243978243978244,0.35003885003885,0.124708624708625,0.0341880341880342,0.013986013986014,1228,0.477078477078477,1346,0.522921522921523
"E02005306",2,268,623,824,426,203,62,2408,0.000830564784053156,0.111295681063123,0.258720930232558,0.3421926910299,0.176910299003322,0.0843023255813953,0.0257475083056478,893,0.370847176079734,1515,0.629152823920266
"E02005307",18,821,1228,1192,368,74,37,3738,0.00481540930979133,0.219636169074371,0.328517924023542,0.318887105403959,0.0984483681112895,0.019796682718031,0.00989834135901552,2067,0.552969502407705,1671,0.447030497592295
"E02005308",5,55,500,811,407,109,32,1919,0.00260552371026576,0.0286607608129234,0.260552371026576,0.422615945805107,0.212089630015633,0.0568004168837936,0.0166753517457009,560,0.291818655549765,1359,0.708181344450235
"E02005309",3,418,816,1306,298,43,19,2903,0.00103341370995522,0.143988976920427,0.28108852910782,0.449879435067172,0.102652428522218,0.0148122631760248,0.00654495349638305,1237,0.426110919738202,1666,0.573889080261798
"E02005310",0,451,1376,1278,351,47,12,3515,0,0.128307254623044,0.391465149359886,0.363584637268848,0.0998577524893314,0.0133712660028449,0.00341394025604552,1827,0.51977240398293,1688,0.48022759601707
"E02005311",33,231,317,605,392,182,70,1830,0.0180327868852459,0.126229508196721,0.173224043715847,0.330601092896175,0.214207650273224,0.0994535519125683,0.0382513661202186,581,0.317486338797814,1249,0.682513661202186
"E02005312",3,594,1007,741,91,19,5,2460,0.00121951219512195,0.241463414634146,0.409349593495935,0.301219512195122,0.0369918699186992,0.00772357723577236,0.00203252032520325,1604,0.652032520325203,856,0.347967479674797
"E02005313",2,259,1711,1576,361,69,20,3998,0.000500250125062531,0.0647823911955978,0.427963981990996,0.394197098549275,0.0902951475737869,0.0172586293146573,0.00500250125062531,1972,0.493246623311656,2026,0.506753376688344
"E02005314",1,151,1282,1131,277,64,11,2917,0.000342817963661296,0.0517655125128557,0.439492629413781,0.387727116900926,0.0949605759341789,0.0219403496743229,0.00377099760027425,1434,0.491600959890298,1483,0.508399040109702
"E02005315",5,188,685,1061,364,89,28,2420,0.00206611570247934,0.0776859504132231,0.283057851239669,0.438429752066116,0.150413223140496,0.0367768595041322,0.0115702479338843,878,0.362809917355372,1542,0.637190082644628
"E02005316",12,230,1358,1027,172,40,11,2850,0.00421052631578947,0.0807017543859649,0.476491228070175,0.360350877192982,0.0603508771929825,0.0140350877192982,0.00385964912280702,1600,0.56140350877193,1250,0.43859649122807
"E02005317",0,185,1359,1445,397,91,41,3518,0,0.0525866969869244,0.386299033541785,0.410744741330301,0.112848209209778,0.0258669698692439,0.011654349061967,1544,0.438885730528709,1974,0.561114269471291
"E02005318",3,276,845,1097,299,61,21,2602,0.00115295926210607,0.106072252113759,0.324750192159877,0.421598770176787,0.114911606456572,0.0234435049961568,0.00807071483474251,1124,0.431975403535742,1478,0.568024596464258
"E02005319",1,107,1321,2029,875,206,79,4618,0.00021654395842356,0.0231702035513209,0.286054569077523,0.439367691641403,0.189475963620615,0.0446080554352534,0.0171069727154612,1429,0.309441316587267,3189,0.690558683412733
"E02005320",0,81,410,864,309,48,17,1729,0,0.0468478889531521,0.237131289762869,0.499710815500289,0.178716020821284,0.0277617119722383,0.00983227299016773,491,0.283979178716021,1238,0.716020821283979
"E02005321",3,125,793,864,271,36,14,2106,0.00142450142450142,0.0593542260208927,0.376543209876543,0.41025641025641,0.128679962013295,0.0170940170940171,0.00664767331433998,921,0.437321937321937,1185,0.562678062678063
"E02005322",42,562,732,1623,640,147,46,3792,0.0110759493670886,0.148206751054852,0.193037974683544,0.428006329113924,0.168776371308017,0.0387658227848101,0.0121308016877637,1336,0.352320675105485,2456,0.647679324894515
"E02005323",0,237,1197,1097,252,47,13,2843,0,0.0833626450932114,0.421034118888498,0.385860007034822,0.0886387618712628,0.0165318325712276,0.00457263454097784,1434,0.50439676398171,1409,0.495603236018291
"E02005324",14,904,509,639,329,149,35,2579,0.00542846064366033,0.350523458704924,0.197363319115936,0.247770453664211,0.127568825126018,0.0577743311360993,0.0135711516091508,1427,0.553315238464521,1152,0.446684761535479
"E02005325",11,816,944,1210,393,130,26,3530,0.00311614730878187,0.231161473087819,0.26742209631728,0.342776203966006,0.111331444759207,0.0368271954674221,0.00736543909348442,1771,0.501699716713881,1759,0.498300283286119
"E02005326",1,52,826,1775,722,130,40,3546,0.000282007896221094,0.0146644106034969,0.232938522278624,0.500564015792442,0.20360970107163,0.0366610265087422,0.0112803158488438,879,0.247884940778342,2667,0.752115059221658
"E02005327",12,500,388,610,322,130,52,2014,0.00595829195630586,0.248262164846077,0.192651439920556,0.302879841112214,0.159880834160874,0.0645481628599801,0.0258192651439921,900,0.446871896722939,1114,0.553128103277061
"E02005328",4,440,662,1408,417,63,8,3002,0.00133244503664224,0.146568954030646,0.22051965356429,0.469020652898068,0.138907395069953,0.0209860093271153,0.00266489007328448,1106,0.368421052631579,1896,0.631578947368421
"E02005329",16,543,1185,1568,493,79,17,3901,0.00410151243270956,0.139195078185081,0.303768264547552,0.401948218405537,0.126377851832863,0.0202512176365035,0.00435785695975391,1744,0.447064855165342,2157,0.552935144834658
"E02005330",4,241,591,1398,462,68,17,2781,0.00143833153541891,0.0866594750089896,0.212513484358145,0.50269687162891,0.166127292340885,0.0244516361021215,0.00611290902553038,836,0.300611290902553,1945,0.699388709097447
"E02005331",20,1102,972,1364,469,72,19,4018,0.00497760079641613,0.274265803882529,0.241911398705824,0.33947237431558,0.116724738675958,0.0179193628670981,0.00472872075659532,2094,0.521154803384769,1924,0.478845196615231
"E02005332",4,259,541,1383,474,78,17,2756,0.00145137880986938,0.0939767779390421,0.196298984034833,0.501814223512337,0.171988388969521,0.0283018867924528,0.00616835994194485,804,0.291727140783745,1952,0.708272859216255
"E02005334",3,231,386,749,223,42,4,1638,0.00183150183150183,0.141025641025641,0.235653235653236,0.457264957264957,0.136141636141636,0.0256410256410256,0.00244200244200244,620,0.378510378510378,1018,0.621489621489622
"E02005335",0,353,511,978,368,59,20,2289,0,0.154215814766273,0.223241590214067,0.427260812581914,0.160768894713849,0.0257754477937964,0.00873743993010048,864,0.377457404980341,1425,0.622542595019659
"E02005336",7,130,1016,1230,196,28,2,2609,0.00268302031429667,0.0498275201226524,0.389421234189345,0.471444998083557,0.0751245688003066,0.0107320812571867,0.00076657723265619,1153,0.441931774626294,1456,0.558068225373706
"E02005337",1,72,733,1374,579,88,15,2862,0.000349406009783368,0.0251572327044025,0.256114605171209,0.480083857442348,0.20230607966457,0.0307477288609364,0.00524109014675052,806,0.281621243885395,2056,0.718378756114605
"E02005338",15,1463,1021,1355,546,84,14,4498,0.0033348154735438,0.325255669186305,0.226989773232548,0.30124499777679,0.121387283236994,0.0186749666518453,0.00311249444197421,2499,0.555580257892397,1999,0.444419742107603
"E02005339",4,305,796,1300,301,63,10,2779,0.00143936667866139,0.109751709247931,0.286433969053616,0.467794170564951,0.10831234256927,0.0226700251889169,0.00359841669665347,1105,0.397625044980209,1674,0.602374955019791
"E02005340",1,467,751,1297,460,71,11,3058,0.000327011118378025,0.152714192282538,0.245585349901897,0.424133420536298,0.150425114453891,0.0232177894048398,0.00359712230215827,1219,0.398626553302812,1839,0.601373446697188
"E02005341",3,601,733,963,201,28,6,2535,0.00118343195266272,0.237080867850099,0.289151873767258,0.379881656804734,0.0792899408284024,0.0110453648915187,0.00236686390532544,1337,0.52741617357002,1198,0.47258382642998
"E02005342",10,381,539,888,288,66,13,2185,0.0045766590389016,0.174370709382151,0.246681922196796,0.406407322654462,0.131807780320366,0.0302059496567506,0.00594965675057208,930,0.425629290617849,1255,0.574370709382151
"E02005343",6,444,713,930,308,45,15,2461,0.0024380333197887,0.180414465664364,0.289719626168224,0.377895164567249,0.125152377082487,0.0182852498984153,0.00609508329947176,1163,0.472572125152377,1298,0.527427874847623
"E02005344",12,772,897,1006,334,89,21,3131,0.00383264132864899,0.246566592143085,0.286489939316512,0.321303098051741,0.106675183647397,0.02842542318748,0.00670712232513574,1681,0.536889172788247,1450,0.463110827211753
"E02005345",10,407,1005,732,225,30,4,2413,0.00414421881475342,0.168669705760464,0.416493990882719,0.30335681723995,0.0932449233319519,0.0124326564442603,0.00165768752590137,1422,0.589307915457936,991,0.410692084542064
"E02005346",4,956,2444,1839,926,129,40,6338,0.000631113916061849,0.150836225938782,0.38561060271379,0.290154622909435,0.146102871568318,0.0203534237929946,0.00631113916061849,3404,0.537077942568634,2934,0.462922057431366
"E02005347",1,326,1787,1694,602,70,23,4503,0.000222074172773706,0.0723961803242283,0.396846546746613,0.376193648678659,0.133688652009771,0.0155451920941594,0.00510770597379525,2114,0.469464801243615,2389,0.530535198756385
"E02005348",6,78,771,979,176,14,3,2027,0.0029600394671929,0.0384805130735076,0.380365071534287,0.482979773063641,0.0868278243709916,0.00690675875678342,0.00148001973359645,855,0.421805624074988,1172,0.578194375925012
"E02005349",7,816,899,945,373,65,14,3119,0.00224430907342097,0.261622314844501,0.288233408143636,0.302981724911831,0.119589612055146,0.0208400128246233,0.00448861814684194,1722,0.552100032061558,1397,0.447899967938442
"E02005350",1,404,778,932,331,58,16,2520,0.000396825396825397,0.16031746031746,0.308730158730159,0.36984126984127,0.131349206349206,0.023015873015873,0.00634920634920635,1183,0.469444444444444,1337,0.530555555555556
"E02005351",0,64,817,865,244,36,4,2030,0,0.0315270935960591,0.402463054187192,0.426108374384236,0.120197044334975,0.0177339901477833,0.00197044334975369,881,0.433990147783251,1149,0.566009852216749
"E02005352",22,258,450,694,378,121,34,1957,0.0112416964741952,0.131834440470107,0.229943791517629,0.354624425140521,0.193152784874808,0.0618293306080736,0.0173735309146653,730,0.373019928461932,1227,0.626980071538069
"E02005353",5,598,1264,1389,496,75,14,3841,0.00130174433741213,0.155688622754491,0.329080968497787,0.36162457693309,0.129133038271284,0.019526165061182,0.00364488414475397,1867,0.48607133558969,1974,0.51392866441031
"E02005354",5,437,990,1274,374,59,7,3146,0.00158931977113795,0.138906547997457,0.314685314685315,0.40495867768595,0.118881118881119,0.0187539732994278,0.00222504767959313,1432,0.45518118245391,1714,0.54481881754609
"E02005355",2,661,814,848,332,79,7,2743,0.000729128691213999,0.240977032446227,0.296755377324098,0.309150565074736,0.121035362741524,0.028800583302953,0.002551950419249,1477,0.538461538461538,1266,0.461538461538462
"E02005356",5,559,763,964,429,82,15,2817,0.0017749378771743,0.198438054668087,0.270855520056798,0.342208022719205,0.152289669861555,0.0291089811856585,0.0053248136315229,1327,0.471068512602059,1490,0.528931487397941
"E02005357",60,940,1004,1005,372,74,21,3476,0.0172612197928654,0.270425776754891,0.288837744533947,0.289125431530495,0.107019562715765,0.0212888377445339,0.00604142692750288,2004,0.576524741081703,1472,0.423475258918297
"E02005358",12,1173,1298,1453,454,75,13,4478,0.00267976775346137,0.261947297900849,0.289861545332738,0.32447521214828,0.101384546672622,0.0167485484591335,0.00290308173291648,2483,0.554488610987048,1995,0.445511389012952
"E02005359",11,1005,435,778,275,59,19,2582,0.00426026336173509,0.389233152594888,0.16847405112316,0.301316808675445,0.106506584043377,0.02285050348567,0.00735863671572424,1451,0.561967467079783,1131,0.438032532920217
"E02005360",2,141,368,775,443,128,22,1879,0.00106439595529537,0.0750399148483236,0.195848855774348,0.412453432676956,0.235763704097924,0.0681213411389037,0.0117083555082491,511,0.271953166577967,1368,0.728046833422033
"E02005361",1,108,843,950,269,46,11,2228,0.000448833034111311,0.0484739676840215,0.378366247755835,0.426391382405745,0.120736086175943,0.0206463195691203,0.00493716337522442,952,0.427289048473968,1276,0.572710951526032
"E02005362",4,419,719,826,297,63,6,2334,0.00171379605826907,0.179520137103685,0.308054841473865,0.353898886032562,0.127249357326478,0.0269922879177378,0.0025706940874036,1142,0.489288774635818,1192,0.510711225364182
"E02005363",24,657,890,973,340,72,5,2961,0.00810536980749747,0.221884498480243,0.300574130361364,0.328605200945626,0.114826072272881,0.0243161094224924,0.00168861870989531,1571,0.530563998649105,1390,0.469436001350895
"E02005364",0,48,261,668,381,75,7,1440,0,0.0333333333333333,0.18125,0.463888888888889,0.264583333333333,0.0520833333333333,0.00486111111111111,309,0.214583333333333,1131,0.785416666666667
"E02005365",10,417,853,1277,475,88,16,3136,0.00318877551020408,0.13297193877551,0.272002551020408,0.407206632653061,0.151466836734694,0.0280612244897959,0.00510204081632653,1280,0.408163265306122,1856,0.591836734693877
"E02005366",1,669,855,888,334,48,6,2801,0.000357015351660121,0.238843270260621,0.305248125669404,0.317029632274188,0.119243127454481,0.0171367368796858,0.00214209210996073,1525,0.544448411281685,1276,0.455551588718315
"E02005368",17,257,474,659,503,232,71,2213,0.00768187980117488,0.116131947582467,0.214188883868052,0.297785811116132,0.227293267058292,0.104835065521916,0.0320831450519657,748,0.338002711251695,1465,0.661997288748305
"E02005369",9,1309,1577,1429,472,98,21,4915,0.00183112919633774,0.266327568667345,0.320854526958291,0.290742624618515,0.0960325534079349,0.0199389623601221,0.00427263479145473,2895,0.589013224821973,2020,0.410986775178026
"E02005370",7,673,916,1214,243,35,1,3089,0.00226610553577209,0.217869860796374,0.296536095823891,0.393007445775332,0.078666235027517,0.0113305276788605,0.000323729362253156,1596,0.516672062156038,1493,0.483327937843962
"E02005371",13,883,851,1378,607,206,55,3993,0.0032556974705735,0.221136989732031,0.213122965189081,0.345103931880791,0.152016028049086,0.0515902829952417,0.0137741046831956,1747,0.437515652391685,2246,0.562484347608315
"E02005372",33,536,719,1052,559,189,50,3138,0.0105162523900574,0.17080943275972,0.22912683237731,0.335245379222435,0.178138942001275,0.0602294455066922,0.0159337157425112,1288,0.410452517527087,1850,0.589547482472913
"E02005373",38,2178,1098,1260,388,64,11,5037,0.00754417311891999,0.432400238237046,0.217986896962478,0.250148898153663,0.0770299781616041,0.0127059757792337,0.00218383958705579,3314,0.657931308318443,1723,0.342068691681556
"E02005374",3,261,1349,1171,374,52,10,3220,0.00093167701863354,0.081055900621118,0.418944099378882,0.363664596273292,0.116149068322981,0.0161490683229814,0.0031055900621118,1613,0.500931677018634,1607,0.499068322981366
"E02005375",20,835,1384,1336,430,59,10,4074,0.00490918016691213,0.204958271968581,0.339715267550319,0.32793323514973,0.105547373588611,0.0144820814923908,0.00245459008345606,2239,0.549582719685813,1835,0.450417280314188
"E02005376",16,832,1273,1444,344,59,12,3980,0.00402010050251256,0.209045226130653,0.319849246231156,0.362814070351759,0.0864321608040201,0.0148241206030151,0.00301507537688442,2121,0.532914572864322,1859,0.467085427135678
"E02005377",26,502,997,1225,385,81,16,3232,0.00804455445544554,0.155321782178218,0.308477722772277,0.379022277227723,0.119121287128713,0.0250618811881188,0.00495049504950495,1525,0.471844059405941,1707,0.528155940594059
"E02005378",2,99,530,706,190,39,6,1572,0.00127226463104326,0.0629770992366412,0.337150127226463,0.44910941475827,0.120865139949109,0.0248091603053435,0.00381679389312977,631,0.401399491094148,941,0.598600508905852
"E02005379",5,493,650,803,233,35,7,2226,0.00224618149146451,0.221473495058401,0.292003593890386,0.3607367475292,0.104672057502246,0.0157232704402516,0.00314465408805031,1148,0.515723270440252,1078,0.484276729559748
"E02005380",38,381,851,1091,514,182,52,3109,0.0122225796075909,0.122547442907687,0.27372145384368,0.350916693470569,0.165326471534255,0.0585397233837247,0.0167256352524928,1270,0.408491476358958,1839,0.591508523641042
"E02005381",10,741,794,1052,446,126,27,3196,0.00312891113892365,0.231852315394243,0.248435544430538,0.329161451814768,0.139549436795995,0.039424280350438,0.00844806007509387,1545,0.483416770963705,1651,0.516583229036295
"E02005382",9,756,1387,1469,601,83,15,4320,0.00208333333333333,0.175,0.321064814814815,0.340046296296296,0.13912037037037,0.019212962962963,0.00347222222222222,2152,0.498148148148148,2168,0.501851851851852
"E02005383",10,274,1239,1442,488,69,9,3531,0.00283205890682526,0.0775984140470122,0.35089209855565,0.408382894364203,0.138204474653073,0.0195412064570943,0.00254885301614274,1523,0.431322571509487,2008,0.568677428490513
"E02005384",11,496,673,787,328,94,24,2413,0.00455864069622876,0.20555325321177,0.278905926232905,0.326150020721094,0.135930377123912,0.0389556568586821,0.00994612515540821,1180,0.489017820140903,1233,0.510982179859097
"E02005385",8,297,493,846,281,51,12,1988,0.00402414486921529,0.149396378269618,0.247987927565392,0.425553319919517,0.141348088531187,0.0256539235412475,0.00603621730382294,798,0.401408450704225,1190,0.598591549295775
"E02005386",2,465,993,1659,909,149,33,4210,0.000475059382422803,0.110451306413302,0.235866983372922,0.394061757719715,0.215914489311164,0.0353919239904988,0.00783847980997625,1460,0.346793349168646,2750,0.653206650831354
"E02005387",7,546,1731,1299,307,37,4,3931,0.00178071737471381,0.138895955227677,0.440345967947087,0.330450267107606,0.0780971762910201,0.00941236326634444,0.00101755278555075,2284,0.581022640549478,1647,0.418977359450522
"E02005388",4,421,667,960,431,74,16,2573,0.00155460551884959,0.16362223085892,0.259230470268169,0.373105324523902,0.167508744656044,0.0287602020987174,0.00621842207539837,1092,0.424407306645939,1481,0.575592693354061
"E02005389",4,116,1011,833,254,46,2,2266,0.00176522506619594,0.0511915269196823,0.446160635481024,0.367608120035305,0.112091791703442,0.0203000882612533,0.00088261253309797,1131,0.499117387466902,1135,0.500882612533098
"E02005390",34,893,864,1327,404,60,11,3593,0.00946284441970498,0.248538825494016,0.240467575841915,0.369329251322015,0.112440857222377,0.0166991372112441,0.00306150848872808,1791,0.498469245755636,1802,0.501530754244364
"E02005391",19,479,727,1265,768,233,65,3556,0.00534308211473566,0.134701912260967,0.204443194600675,0.355736782902137,0.215973003374578,0.0655230596175478,0.0182789651293588,1225,0.344488188976378,2331,0.655511811023622
"E02005392",28,802,783,1456,483,64,16,3632,0.00770925110132159,0.220814977973568,0.215583700440529,0.400881057268722,0.132984581497797,0.0176211453744493,0.00440528634361234,1613,0.444107929515418,2019,0.555892070484582
"E02005393",16,664,691,974,506,147,40,3038,0.00526662277814352,0.218564845292956,0.227452271231073,0.320605661619487,0.166556945358789,0.0483870967741935,0.0131665569453588,1371,0.451283739302172,1667,0.548716260697828
"E02005394",11,742,1403,1293,456,59,12,3976,0.00276659959758551,0.186619718309859,0.352867203219316,0.325201207243461,0.114688128772636,0.0148390342052314,0.00301810865191147,2156,0.542253521126761,1820,0.457746478873239
"E02005395",10,246,893,1447,568,84,26,3274,0.0030543677458766,0.0751374465485644,0.272755039706781,0.441967012828345,0.173488087965791,0.0256566890653635,0.00794135613927917,1149,0.350946854001222,2125,0.649053145998778
"E02005396",12,254,449,732,758,290,99,2594,0.0046260601387818,0.0979182729375482,0.173091750192752,0.28218966846569,0.292212798766384,0.111796453353894,0.0381649961449499,715,0.275636083269083,1879,0.724363916730917
"E02005397",5,962,1077,1346,543,128,28,4089,0.0012227928588897,0.235265346050379,0.263389581804842,0.329175837613108,0.132795304475422,0.0313034971875764,0.00684764000978234,2044,0.499877720714111,2045,0.500122279285889
"E02005398",6,416,836,1005,407,88,34,2792,0.00214899713467049,0.148997134670487,0.299426934097421,0.359957020057307,0.145773638968481,0.0315186246418338,0.0121776504297994,1258,0.450573065902579,1534,0.549426934097421
"E02005399",34,1375,1085,1027,286,48,14,3869,0.0087878004652365,0.355388989402946,0.280434220728871,0.265443266994055,0.0739209097958129,0.0124063065391574,0.00361850607392091,2494,0.644611010597054,1375,0.355388989402946
"E02005400",4,220,562,795,283,68,13,1945,0.00205655526992288,0.113110539845758,0.288946015424165,0.408740359897172,0.145501285347044,0.0349614395886889,0.00668380462724936,786,0.404113110539846,1159,0.595886889460154
"E02005401",13,427,420,704,414,161,58,2197,0.00591715976331361,0.19435593991807,0.191169776968594,0.320436959490214,0.188438780154756,0.0732817478379609,0.0263996358670915,860,0.391442876649977,1337,0.608557123350023
"E02005402",3,478,699,1042,237,46,3,2508,0.00119617224880383,0.190590111642743,0.278708133971292,0.415470494417863,0.0944976076555024,0.018341307814992,0.00119617224880383,1180,0.470494417862839,1328,0.529505582137161
"E02005403",1,89,752,1056,338,51,16,2303,0.000434216239687364,0.0386452453321754,0.326530612244898,0.458532349109857,0.146765089014329,0.0221450282240556,0.00694745983499783,842,0.365610073816761,1461,0.634389926183239
"E02005404",12,635,752,1290,571,185,72,3517,0.00341199886266705,0.180551606482798,0.213818595393802,0.366789877736707,0.16235427921524,0.0526016491327836,0.0204719931760023,1399,0.397782200739266,2118,0.602217799260734
"E02005405",11,375,1048,1184,225,40,9,2892,0.00380359612724758,0.129668049792531,0.36237897648686,0.409405255878285,0.0778008298755187,0.0138312586445367,0.00311203319502075,1434,0.495850622406639,1458,0.504149377593361
"E02005406",2,361,958,1302,560,89,18,3290,0.00060790273556231,0.109726443768997,0.291185410334347,0.395744680851064,0.170212765957447,0.0270516717325228,0.00547112462006079,1321,0.401519756838906,1969,0.598480243161094
"E02005407",48,2023,945,1201,373,55,14,4659,0.0103026400515132,0.4342133505044,0.202833226014166,0.257780639622237,0.0800600987336338,0.0118051083923589,0.00300493668169135,3016,0.647349216570079,1643,0.352650783429921
"E02005408",9,382,927,1189,400,101,30,3038,0.00296247531270573,0.125740618828176,0.30513495720869,0.39137590520079,0.131665569453588,0.0332455562870309,0.00987491770901909,1318,0.433838051349572,1720,0.566161948650428
"E02005409",14,1080,1181,1697,565,132,24,4693,0.00298316641806947,0.230129980822502,0.251651395695717,0.361602386533134,0.120392073300661,0.0281269976560835,0.00511399957383337,2275,0.484764542936288,2418,0.515235457063712
"E02005412",17,439,803,1357,472,71,13,3172,0.005359394703657,0.138398486759142,0.253152585119798,0.42780580075662,0.148802017654477,0.0223833543505675,0.00409836065573771,1259,0.396910466582598,1913,0.603089533417402
"E02005414",47,330,1042,1300,405,52,6,3182,0.0147705845380264,0.103708359522313,0.327467001885607,0.408548082966688,0.12727844123193,0.0163419233186675,0.00188560653676933,1419,0.445945945945946,1763,0.554054054054054
"E02005415",16,267,752,1562,641,78,16,3332,0.00480192076830732,0.0801320528211285,0.225690276110444,0.468787515006002,0.192376950780312,0.0234093637454982,0.00480192076830732,1035,0.31062424969988,2297,0.68937575030012
"E02005416",5,766,641,1275,310,41,6,3044,0.00164257555847569,0.251642575558476,0.210578186596583,0.418856767411301,0.101839684625493,0.0134691195795007,0.00197109067017083,1412,0.463863337713535,1632,0.536136662286465
"E02005417",25,193,493,999,558,230,72,2570,0.00972762645914397,0.0750972762645914,0.191828793774319,0.388715953307393,0.217120622568093,0.0894941634241245,0.0280155642023346,711,0.276653696498054,1859,0.723346303501946
"E02005418",7,509,1955,1739,613,102,25,4950,0.00141414141414141,0.102828282828283,0.394949494949495,0.351313131313131,0.123838383838384,0.0206060606060606,0.00505050505050505,2471,0.499191919191919,2479,0.500808080808081
"E02005419",10,407,1310,1655,776,153,53,4364,0.00229147571035747,0.093263061411549,0.300183318056829,0.379239230064161,0.17781851512374,0.0350595783684693,0.0121448212648946,1727,0.395737855178735,2637,0.604262144821265
"E02005420",4,453,1308,1444,320,46,10,3585,0.00111576011157601,0.126359832635983,0.364853556485356,0.40278940027894,0.0892608089260809,0.0128312412831241,0.00278940027894003,1765,0.492329149232915,1820,0.507670850767085
"E02005422",10,476,554,873,499,212,66,2690,0.00371747211895911,0.176951672862454,0.205947955390335,0.32453531598513,0.185501858736059,0.0788104089219331,0.0245353159851301,1040,0.386617100371747,1650,0.613382899628253
"E02005423",80,698,1407,1327,592,190,43,4337,0.0184459303666129,0.160940742448697,0.324417800322804,0.305971869956191,0.136499884712935,0.0438090846207056,0.00991468757205442,2185,0.503804473138114,2152,0.496195526861886
"E02005424",13,368,742,1469,751,230,51,3624,0.00358719646799117,0.101545253863135,0.204746136865342,0.405353200883002,0.207229580573951,0.0634657836644592,0.0140728476821192,1123,0.309878587196468,2501,0.690121412803532
"E02005425",15,230,379,848,584,244,71,2371,0.00632644453816955,0.0970054829185997,0.159848165331084,0.357654997891185,0.246309574019401,0.102910164487558,0.0299451708140025,624,0.263180092787853,1747,0.736819907212147
"E02005426",27,1083,1940,1502,301,34,12,4899,0.00551132884262094,0.22106552357624,0.395999183506838,0.306593182282098,0.0614411104307001,0.00694019187589304,0.00244947948560931,3050,0.622576035925699,1849,0.377423964074301
"E02005427",27,272,969,1422,604,96,16,3406,0.00792718731650029,0.0798590722254844,0.284497944803288,0.417498532002349,0.177334116265414,0.0281855549031122,0.00469759248385203,1268,0.372284204345273,2138,0.627715795654727
"E02005428",10,196,1150,1590,653,208,76,3883,0.00257532835436518,0.0504764357455576,0.296162760751996,0.409477208344064,0.168168941540046,0.0535668297707958,0.0195724954931754,1356,0.349214524851919,2527,0.650785475148081
"E02005429",21,169,937,1413,369,94,61,3064,0.00685378590078329,0.0551566579634465,0.305809399477807,0.461161879895561,0.120430809399478,0.0306788511749347,0.0199086161879896,1127,0.367819843342037,1937,0.632180156657963
"E02005430",16,150,433,928,769,273,82,2652,0.00603318250377074,0.0565610859728507,0.163273001508296,0.349924585218703,0.289969834087481,0.102941176470588,0.030920060331825,599,0.225867269984917,2052,0.773755656108597
"E02005431",20,379,675,1396,751,278,95,3594,0.00556483027267668,0.105453533667223,0.187813021702838,0.388425153032832,0.208959376739009,0.0773511407902059,0.0264329437952142,1074,0.298831385642738,2520,0.701168614357262
"E02005432",20,360,365,895,895,343,106,2984,0.00670241286863271,0.120643431635389,0.122319034852547,0.299932975871314,0.299932975871314,0.114946380697051,0.0355227882037534,745,0.249664879356568,2239,0.750335120643432
"E02005433",18,218,515,1097,904,432,133,3317,0.00542659029243292,0.065722037986132,0.155260777811275,0.33072053059994,0.27253542357552,0.13023816701839,0.0400964727163099,751,0.22640940608984,2566,0.77359059391016
"E02005434",21,652,1149,1361,350,86,21,3640,0.00576923076923077,0.179120879120879,0.315659340659341,0.373901098901099,0.0961538461538462,0.0236263736263736,0.00576923076923077,1822,0.500549450549451,1818,0.499450549450549
"E02005435",7,412,1206,1404,401,68,30,3528,0.00198412698412698,0.116780045351474,0.341836734693878,0.397959183673469,0.113662131519274,0.0192743764172336,0.00850340136054422,1625,0.460600907029478,1903,0.539399092970521
"E02005436",23,269,1122,1204,550,160,64,3392,0.00678066037735849,0.0793042452830189,0.330778301886792,0.354952830188679,0.162146226415094,0.0471698113207547,0.0188679245283019,1414,0.41686320754717,1978,0.58313679245283
"E02005437",0,67,919,1459,842,173,69,3529,0,0.01898554831397,0.260413714933409,0.413431567016152,0.238594502691981,0.0490223859450269,0.0195522810994616,986,0.279399263247379,2543,0.720600736752621
"E02005438",34,422,1250,1253,337,40,6,3342,0.0101735487731897,0.126271693596649,0.374027528426092,0.374925194494315,0.100837821663674,0.0119688809096349,0.00179533213644524,1706,0.510472770795931,1636,0.489527229204069
"E02005439",25,792,1438,1850,532,127,36,4800,0.00520833333333333,0.165,0.299583333333333,0.385416666666667,0.110833333333333,0.0264583333333333,0.0075,2255,0.469791666666667,2545,0.530208333333333
"E02005440",8,87,282,805,663,263,88,2196,0.00364298724954463,0.0396174863387978,0.128415300546448,0.366575591985428,0.301912568306011,0.11976320582878,0.0400728597449909,377,0.171675774134791,1819,0.828324225865209
"E02005441",16,218,477,1025,834,347,136,3053,0.00524074680641991,0.0714051752374713,0.156239764166394,0.335735342286276,0.273173927284638,0.113658696364232,0.0445463478545693,711,0.232885686210285,2342,0.767114313789715
"E02005442",0,331,1316,772,81,8,4,2512,0,0.131767515923567,0.523885350318471,0.307324840764331,0.0322452229299363,0.00318471337579618,0.00159235668789809,1647,0.655652866242038,865,0.344347133757962
"E02005443",6,311,1402,1131,174,19,2,3045,0.00197044334975369,0.102134646962233,0.460426929392447,0.371428571428571,0.0571428571428571,0.00623973727422003,0.000656814449917898,1719,0.564532019704433,1326,0.435467980295567
"E02005444",23,538,1874,2300,917,109,17,5778,0.00398061613014884,0.0931118033921772,0.324333679473866,0.398061613014884,0.158705434406369,0.0188646590515749,0.00294219453097958,2435,0.421426098996192,3343,0.578573901003807
"E02005445",8,445,1825,2111,701,95,23,5208,0.00153609831029186,0.0854454685099846,0.35042242703533,0.405337941628264,0.134600614439324,0.0182411674347158,0.00441628264208909,2278,0.437403993855607,2930,0.562596006144393
"E02005446",3,301,1446,1338,500,76,14,3678,0.000815660685154976,0.0818379554105492,0.393148450244698,0.363784665579119,0.135943447525829,0.020663404023926,0.00380641653072322,1750,0.475802066340402,1928,0.524197933659598
"E02005447",3,255,1061,1898,727,109,29,4082,0.000734933855952964,0.062469377756002,0.259921607055365,0.464968152866242,0.178098971092602,0.026702596766291,0.00710436060754532,1319,0.32312591866732,2763,0.67687408133268
"E02005448",2,175,1534,934,119,6,0,2770,0.000722021660649819,0.0631768953068592,0.553790613718412,0.337184115523466,0.0429602888086643,0.00216606498194946,0,1711,0.617689530685921,1059,0.382310469314079
"E02005449",3,368,970,1359,491,55,10,3256,0.000921375921375921,0.113022113022113,0.297911547911548,0.417383292383292,0.150798525798526,0.0168918918918919,0.00307125307125307,1341,0.411855036855037,1915,0.588144963144963
"E02005450",9,127,937,1603,219,16,1,2912,0.00309065934065934,0.0436126373626374,0.321771978021978,0.550480769230769,0.075206043956044,0.00549450549450549,0.000343406593406593,1073,0.368475274725275,1839,0.631524725274725
"E02005451",3,229,1381,1121,245,36,10,3025,0.000991735537190083,0.075702479338843,0.456528925619835,0.370578512396694,0.0809917355371901,0.011900826446281,0.00330578512396694,1613,0.533223140495868,1412,0.466776859504132
"E02005452",7,200,1238,1732,290,32,8,3507,0.00199600798403194,0.0570287995437696,0.353008269175934,0.493869404049045,0.0826917593384659,0.00912460792700314,0.00228115198175078,1445,0.412033076703735,2062,0.587966923296265
"E02005453",12,399,1097,1665,349,76,19,3617,0.00331766657450926,0.110312413602433,0.303290019353055,0.46032623721316,0.096488802875311,0.0210118883052253,0.00525297207630633,1508,0.416920099529997,2109,0.583079900470003
"E02005455",101,1142,1865,1506,695,214,68,5591,0.0180647469146843,0.204256841352173,0.333571811840458,0.269361473797174,0.124306921838669,0.0382758003934895,0.0121624038633518,3108,0.555893400107315,2483,0.444106599892685
"E02005456",8,1145,1330,1829,321,48,8,4689,0.00170612070804009,0.244188526338238,0.283642567711666,0.390061846875666,0.0684580934101088,0.0102367242482406,0.00170612070804009,2483,0.529537214757944,2206,0.470462785242056
"E02005457",23,448,815,1287,466,96,28,3163,0.00727157761618716,0.141637685741385,0.25766677205185,0.406892190957951,0.147328485614923,0.0303509326588682,0.00885235535883655,1286,0.406576035409421,1877,0.593423964590579
"E02005458",11,420,545,857,439,170,54,2496,0.00440705128205128,0.168269230769231,0.218349358974359,0.343349358974359,0.17588141025641,0.0681089743589744,0.0216346153846154,976,0.391025641025641,1520,0.608974358974359
"E02005459",28,367,678,1197,783,270,68,3391,0.00825715128280743,0.108227661456797,0.19994102034798,0.352993217340018,0.230905337658508,0.0796225302270717,0.020053081686818,1073,0.316425833087585,2318,0.683574166912415
"E02005460",19,206,834,1237,224,54,15,2589,0.00733874082657397,0.0795674005407493,0.322132097334878,0.477790652761684,0.0865198918501352,0.0208574739281576,0.00579374275782155,1059,0.409038238702202,1530,0.590961761297798
"E02005461",16,195,481,871,471,165,52,2251,0.00710795202132386,0.0866281652598845,0.213682807641048,0.386939138160817,0.209240337627721,0.0733007552199023,0.0231008440693025,692,0.307418924922257,1559,0.692581075077743
"E02005462",42,976,1389,1755,441,67,13,4683,0.00896860986547085,0.208413410207132,0.296604740550929,0.374759769378603,0.0941704035874439,0.0143070681187273,0.00277599829169336,2407,0.513986760623532,2276,0.486013239376468
"E02005463",5,715,1354,1220,192,32,5,3523,0.00141924496168039,0.202952029520295,0.384331535623049,0.346295770650014,0.0544990065285268,0.00908316775475447,0.00141924496168039,2074,0.588702810105024,1449,0.411297189894976
"E02005464",10,457,753,1274,560,193,48,3295,0.00303490136570561,0.138694992412747,0.228528072837633,0.386646433990895,0.169954476479514,0.0585735963581184,0.014567526555387,1220,0.370257966616085,2075,0.629742033383915
"E02005465",47,700,583,1363,602,219,66,3580,0.0131284916201117,0.195530726256983,0.162849162011173,0.38072625698324,0.168156424581006,0.0611731843575419,0.0184357541899441,1330,0.371508379888268,2250,0.628491620111732
"E02005466",7,226,433,1013,487,191,80,2437,0.00287238407878539,0.0927369716864998,0.177677472302011,0.415675010258515,0.199835863766927,0.0783750512925728,0.0328272466146902,666,0.273286828067296,1771,0.726713171932704
"E02005467",11,562,911,1553,348,54,14,3453,0.00318563567911961,0.162757022878656,0.263828554879815,0.449753837242977,0.100781928757602,0.0156385751520417,0.00405444540978859,1484,0.429771213437591,1969,0.570228786562409
"E02005468",17,544,494,1235,496,175,46,3007,0.00565347522447622,0.180911207183239,0.164283338875956,0.41070834718989,0.164948453608247,0.0581975390754905,0.0152976388427004,1055,0.350848021283671,1952,0.649151978716329
"E02005469",2,588,613,1222,477,152,41,3095,0.000646203554119548,0.189983844911147,0.198061389337641,0.394830371567044,0.154119547657512,0.0491114701130856,0.0132471728594507,1203,0.388691437802908,1892,0.611308562197092
"E02005470",7,1004,1775,1831,581,110,22,5330,0.00131332082551595,0.188367729831144,0.333020637898687,0.343527204502814,0.109005628517824,0.0206378986866792,0.00412757973733583,2786,0.522701688555347,2544,0.477298311444653
"E02005471",3,186,1348,1666,430,71,17,3721,0.000806234883095942,0.0499865627519484,0.36226820747111,0.44772910507928,0.115560333243752,0.0190808922332706,0.00456866433754367,1537,0.413061005106154,2184,0.586938994893846
"E02005472",23,160,1165,1966,647,169,51,4181,0.00550107629753647,0.0382683568524276,0.278641473331739,0.470222434824205,0.154747668022004,0.0404209519253767,0.0121980387467113,1348,0.322410906481703,2833,0.677589093518297
"E02005473",138,563,1190,1421,324,54,16,3706,0.0372369131138694,0.151915812196438,0.321100917431193,0.383432271991365,0.087425796006476,0.0145709660010793,0.00431732325957906,1891,0.5102536427415,1815,0.4897463572585
"E02005474",62,479,429,1020,563,229,65,2847,0.0217773094485423,0.168247277836319,0.150684931506849,0.35827186512118,0.197752019669828,0.0804355461889708,0.0228310502283105,970,0.340709518791711,1877,0.659290481208289
"E02005475",36,925,684,960,351,83,22,3061,0.0117608624632473,0.30218882718066,0.223456386801699,0.313622999019928,0.114668409016661,0.0271153217902646,0.00718719372754002,1645,0.537406076445606,1416,0.462593923554394
"E02005476",16,211,432,880,830,272,57,2698,0.00593031875463306,0.0782060785767235,0.160118606375093,0.326167531504818,0.30763528539659,0.100815418828762,0.0211267605633803,659,0.244255003706449,2039,0.755744996293551
"E02005477",15,701,965,1339,488,123,24,3655,0.00410396716826265,0.191792065663475,0.264021887824897,0.366347469220246,0.133515731874145,0.0336525307797538,0.00656634746922025,1681,0.459917920656635,1974,0.540082079343365
"E02005478",12,226,1564,2085,574,81,13,4555,0.0026344676180022,0.049615806805708,0.343358946212953,0.457738748627881,0.126015367727772,0.0177826564215148,0.00285400658616904,1802,0.395609220636663,2753,0.604390779363337
"E02005479",17,833,1274,1430,366,49,13,3982,0.00426921145153189,0.209191361125063,0.319939728779508,0.359116022099448,0.0919136112506278,0.0123053741838272,0.00326469110999498,2124,0.533400301356102,1858,0.466599698643898
"E02005480",12,177,1539,1446,237,23,5,3439,0.00348938644954929,0.051468450130852,0.447513812154696,0.420471067170689,0.0689153823785984,0.00668799069496947,0.00145391102064554,1728,0.502471648735097,1711,0.497528351264903
"E02005481",7,599,2129,2014,968,152,41,5910,0.0011844331641286,0.101353637901861,0.360236886632826,0.34077834179357,0.163790186125212,0.0257191201353638,0.00693739424703892,2735,0.462774957698816,3175,0.537225042301184
"E02005482",38,239,972,1331,725,315,69,3689,0.0103008945513689,0.0647872052046625,0.263486039577121,0.360802385470317,0.196530224993223,0.0853889943074004,0.0187042558959068,1249,0.338574139333153,2440,0.661425860666847
"E02005483",12,182,656,1145,836,277,65,3173,0.00378190986448156,0.0573589662779704,0.206744405924992,0.360857232902616,0.263473053892216,0.0872990860384494,0.0204853450992751,850,0.267885282067444,2323,0.732114717932556
"E02005484",16,197,753,934,846,244,59,3049,0.00524762217120367,0.0646113479829452,0.246966218432273,0.306329944244014,0.277468022302394,0.080026238110856,0.0193506067563135,966,0.316825188586422,2083,0.683174811413578
"E02005485",67,1555,950,1093,207,35,10,3917,0.0171049272402349,0.396987490426347,0.242532550421241,0.279040081695175,0.0528465662496809,0.0089354097523615,0.00255297421496043,2572,0.656624968087822,1345,0.343375031912178
"E02005486",8,697,2154,1244,317,44,13,4477,0.00178691087781997,0.155684610230065,0.481125753853027,0.277864641501005,0.0708063435336163,0.00982800982800983,0.00290373017645745,2859,0.638597274960911,1618,0.361402725039089
"E02005487",18,233,798,1242,480,151,46,2968,0.00606469002695418,0.0785040431266846,0.268867924528302,0.418463611859838,0.161725067385445,0.0508760107816712,0.0154986522911051,1049,0.353436657681941,1919,0.646563342318059
"E02005488",4,369,1024,1066,247,44,6,2760,0.00144927536231884,0.133695652173913,0.371014492753623,0.386231884057971,0.0894927536231884,0.0159420289855072,0.00217391304347826,1397,0.506159420289855,1363,0.493840579710145
"E02005489",12,382,947,1028,260,45,8,2682,0.00447427293064877,0.142431021625652,0.353094705443699,0.383296047725578,0.0969425801640567,0.0167785234899329,0.00298284862043251,1341,0.5,1341,0.5
"E02005490",9,255,2136,1603,439,56,9,4507,0.00199689372087863,0.0565786554248946,0.473929443088529,0.355668959396494,0.0974040381628578,0.0124251164854671,0.00199689372087863,2400,0.532504992234302,2107,0.467495007765698
"E02005491",5,929,1826,1950,715,120,32,5577,0.00089653935807782,0.166577012730859,0.32741617357002,0.34965034965035,0.128205128205128,0.0215169445938677,0.00573785189169805,2760,0.494889725658956,2817,0.505110274341043
"E02005492",28,297,1058,1332,743,223,57,3738,0.00749063670411985,0.079454253611557,0.283039058319957,0.356340288924559,0.198769395398609,0.0596575708935259,0.0152487961476726,1383,0.369983948635634,2355,0.630016051364366
"E02005493",13,451,1311,1232,488,169,31,3695,0.00351826792963464,0.122056833558863,0.354803788903924,0.333423545331529,0.132070365358593,0.0457374830852503,0.00838971583220568,1775,0.480378890392422,1920,0.519621109607578
"E02005494",41,474,1458,1400,683,163,52,4271,0.00959962538047296,0.110981034886443,0.341372044017794,0.327792086162491,0.159915710606415,0.03816436431749,0.0121751346288925,1973,0.461952704284711,2298,0.538047295715289
"E02005495",62,815,1424,2301,1154,185,70,6011,0.0103144235568125,0.135584761271003,0.236899018466145,0.382798203293961,0.19198136749293,0.0307769090001664,0.0116453169189819,2301,0.382798203293961,3710,0.617201796706039
"E02005496",17,202,518,902,563,181,46,2429,0.00699876492383697,0.0831617949773569,0.213256484149856,0.371346233017703,0.231782626595307,0.0745162618361466,0.0189378344997942,737,0.30341704405105,1692,0.69658295594895
"E02005497",4,218,2242,999,148,19,3,3633,0.0011010184420589,0.0600055050922103,0.617120836774016,0.274979355904211,0.0407376823561795,0.0052298375997798,0.000825763831544178,2464,0.678227360308285,1169,0.321772639691715
"E02005498",10,242,558,965,458,152,40,2425,0.00412371134020619,0.0997938144329897,0.230103092783505,0.397938144329897,0.188865979381443,0.062680412371134,0.0164948453608247,810,0.334020618556701,1615,0.665979381443299
"E02005499",25,723,885,1133,339,89,26,3220,0.0077639751552795,0.224534161490683,0.274844720496894,0.351863354037267,0.10527950310559,0.027639751552795,0.00807453416149068,1633,0.507142857142857,1587,0.492857142857143
"E02005500",49,636,939,1121,320,75,25,3165,0.0154818325434439,0.200947867298578,0.296682464454976,0.354186413902054,0.101105845181675,0.023696682464455,0.00789889415481832,1624,0.513112164296998,1541,0.486887835703002
"E02005501",19,963,865,1145,282,55,18,3347,0.00567672542575441,0.287720346579026,0.25844039438303,0.342097400657305,0.0842545563190917,0.016432626232447,0.00537795040334628,1847,0.55183746638781,1500,0.44816253361219
"E02005502",23,559,1159,1240,450,103,33,3567,0.0064479955144379,0.156714325763947,0.324922904401458,0.347631062517522,0.126156433978133,0.0288758059994393,0.00925147182506308,1741,0.488085225679843,1826,0.511914774320157
"E02005503",39,345,375,1095,777,233,48,2912,0.0133928571428571,0.118475274725275,0.128777472527473,0.37603021978022,0.266826923076923,0.0800137362637363,0.0164835164835165,759,0.260645604395604,2153,0.739354395604396
"E02005504",26,273,443,1330,953,266,48,3339,0.00778676250374364,0.0817610062893082,0.13267445342917,0.39832285115304,0.285414794848757,0.079664570230608,0.0143755615453729,742,0.222222222222222,2597,0.777777777777778
"E02005505",14,461,938,965,323,52,17,2770,0.00505415162454874,0.166425992779783,0.338628158844765,0.348375451263538,0.116606498194946,0.0187725631768953,0.00613718411552347,1413,0.510108303249097,1357,0.489891696750902
"E02005506",15,256,572,1127,422,105,21,2518,0.00595710881652105,0.101667990468626,0.227164416203336,0.447577442414615,0.167593328038125,0.0416997617156473,0.00833995234312947,843,0.334789515488483,1675,0.665210484511517
"E02005507",11,559,2118,1738,406,80,18,4930,0.00223123732251521,0.113387423935091,0.429614604462475,0.352535496957404,0.0823529411764706,0.0162271805273834,0.00365111561866126,2688,0.545233265720081,2242,0.454766734279919
"E02005508",34,299,431,983,557,165,32,2501,0.0135945621751299,0.119552179128349,0.172331067572971,0.393042782886845,0.222710915633747,0.0659736105557777,0.0127948820471811,764,0.305477808876449,1737,0.694522191123551
"E02005509",366,915,1190,1263,416,71,14,4235,0.0864226682408501,0.216056670602125,0.28099173553719,0.298229043683589,0.0982290436835891,0.0167650531286895,0.00330578512396694,2471,0.583471074380165,1764,0.416528925619835
"E02005510",15,323,540,1146,499,128,26,2677,0.00560328726186029,0.120657452372058,0.20171834142697,0.428091146806126,0.186402689577886,0.0478147179678745,0.0097123645872245,878,0.327979081060889,1799,0.672020918939111
"E02005511",127,812,1134,1325,417,63,16,3894,0.0326142783769902,0.208525937339497,0.291217257318952,0.340267077555213,0.10708782742681,0.0161787365177196,0.00410888546481767,2073,0.532357473035439,1821,0.467642526964561
"E02005512",73,850,793,876,597,170,61,3420,0.0213450292397661,0.248538011695906,0.23187134502924,0.256140350877193,0.174561403508772,0.0497076023391813,0.0178362573099415,1716,0.501754385964912,1704,0.498245614035088
"E02005513",25,1209,1436,1551,381,70,9,4681,0.00534073915829951,0.258278145695364,0.306772057252724,0.331339457380902,0.0813928647724845,0.0149540696432386,0.00192266609698782,2670,0.570390942106388,2011,0.429609057893613
"E02005514",38,474,361,981,719,205,42,2820,0.0134751773049645,0.168085106382979,0.128014184397163,0.347872340425532,0.254964539007092,0.0726950354609929,0.0148936170212766,873,0.309574468085106,1947,0.690425531914894
"E02005515",17,259,513,725,457,144,34,2149,0.00791065611912518,0.120521172638436,0.238715681712424,0.337366216845044,0.2126570497906,0.0670079106561191,0.0158213122382504,789,0.367147510469986,1360,0.632852489530014
"E02005516",98,232,547,871,594,198,40,2580,0.037984496124031,0.089922480620155,0.212015503875969,0.337596899224806,0.230232558139535,0.0767441860465116,0.0155038759689922,877,0.339922480620155,1703,0.660077519379845
"E02005517",0,91,1335,631,94,17,0,2168,0,0.0419741697416974,0.615774907749078,0.291051660516605,0.0433579335793358,0.00784132841328413,0,1426,0.657749077490775,742,0.342250922509225
"E02005518",4,210,1920,1486,379,48,18,4065,0.000984009840098401,0.0516605166051661,0.472324723247232,0.365559655596556,0.0932349323493235,0.0118081180811808,0.0044280442804428,2134,0.524969249692497,1931,0.475030750307503
"E02005519",3,286,1439,1054,255,21,7,3065,0.000978792822185971,0.0933115823817292,0.469494290375204,0.343882544861338,0.0831973898858075,0.00685154975530179,0.00228384991843393,1728,0.563784665579119,1337,0.436215334420881
"E02005520",89,703,994,1025,355,101,33,3300,0.026969696969697,0.213030303030303,0.301212121212121,0.310606060606061,0.107575757575758,0.0306060606060606,0.01,1786,0.541212121212121,1514,0.458787878787879
"E02005521",12,144,454,1202,947,277,57,3093,0.00387972841901067,0.046556741028128,0.146783058519237,0.388619463304235,0.306175234400259,0.0895570643388296,0.0184287099903007,610,0.197219527966376,2483,0.802780472033624
"E02005522",8,101,425,745,369,103,32,1783,0.00448681996634885,0.0566461020751542,0.238362310712283,0.417835109366237,0.206954570947841,0.0577678070667415,0.0179472798653954,534,0.299495232753786,1249,0.700504767246214
"E02005523",75,664,652,929,332,97,20,2769,0.0270855904658722,0.239797760924521,0.235464066449982,0.335500180570603,0.119898880462261,0.035030697002528,0.00722282412423257,1391,0.502347417840376,1378,0.497652582159624
"E02005524",22,272,498,765,174,24,5,1760,0.0125,0.154545454545455,0.282954545454545,0.434659090909091,0.0988636363636364,0.0136363636363636,0.00284090909090909,792,0.45,968,0.55
"E02005525",65,99,1003,1639,199,29,3,3037,0.0214027000329272,0.0325979585116892,0.330260125123477,0.539677313137965,0.0655251893315772,0.00954889693776753,0.000987816924596642,1167,0.384260783668094,1870,0.615739216331906
"E02005526",27,216,696,865,139,18,2,1963,0.0137544574630667,0.110035659704534,0.354559347936831,0.440652063168619,0.0708099847172695,0.00916963830871116,0.00101884870096791,939,0.478349465104432,1024,0.521650534895568
"E02005527",149,882,976,1165,426,92,21,3711,0.0401509027216384,0.237671786580437,0.26300188628402,0.313931554836971,0.114793856103476,0.0247911614120183,0.00565885206143896,2007,0.540824575586095,1704,0.459175424413905
"E02005528",62,339,1081,1309,259,46,6,3102,0.0199871050934881,0.109284332688588,0.348484848484849,0.421985815602837,0.0834945196647324,0.014829142488717,0.00193423597678917,1482,0.477756286266925,1620,0.522243713733075
"E02005529",2,73,525,883,218,29,4,1734,0.00115340253748558,0.0420991926182238,0.302768166089965,0.509227220299885,0.125720876585928,0.0167243367935409,0.00230680507497117,600,0.346020761245675,1134,0.653979238754325
"E02005530",6,368,393,869,283,47,9,1975,0.0030379746835443,0.186329113924051,0.198987341772152,0.44,0.143291139240506,0.0237974683544304,0.00455696202531646,767,0.388354430379747,1208,0.611645569620253
"E02005531",2,41,554,817,176,25,7,1622,0.00123304562268804,0.0252774352651048,0.341553637484587,0.503699136868064,0.108508014796547,0.0154130702836005,0.00431565967940814,597,0.36806411837238,1025,0.63193588162762
"E02005532",48,1936,629,1029,251,49,10,3952,0.0121457489878543,0.489878542510121,0.15915991902834,0.260374493927126,0.0635121457489878,0.0123987854251012,0.00253036437246964,2613,0.661184210526316,1339,0.338815789473684
"E02005533",14,614,633,1168,518,140,19,3106,0.00450740502253703,0.19768190598841,0.203799098518995,0.376046361880232,0.16677398583387,0.0450740502253702,0.00611719253058596,1261,0.405988409529942,1845,0.594011590470058
"E02005534",2,81,760,1183,315,38,7,2386,0.000838222967309304,0.0339480301760268,0.318524727577536,0.495808885163454,0.132020117351215,0.0159262363788768,0.00293378038558256,843,0.353310980720872,1543,0.646689019279128
"E02005535",9,126,950,1124,206,40,8,2463,0.00365408038976857,0.0511571254567601,0.385708485586683,0.456354039788875,0.0836378400324807,0.0162403572878603,0.00324807145757207,1085,0.440519691433212,1378,0.559480308566789
"E02005536",86,550,489,862,372,87,20,2466,0.0348742903487429,0.223033252230333,0.198296836982968,0.349553933495539,0.150851581508516,0.0352798053527981,0.008110300081103,1125,0.456204379562044,1341,0.543795620437956
"E02005537",68,348,492,918,441,126,25,2418,0.0281224152191894,0.143920595533499,0.203473945409429,0.379652605459057,0.182382133995037,0.0521091811414392,0.010339123242349,908,0.375516956162117,1510,0.624483043837883
"E02005538",17,455,614,1295,1196,919,377,4873,0.00348861071208701,0.0933716396470347,0.12600041042479,0.265750051303099,0.245434024215063,0.188590190847527,0.0773650728504002,1086,0.222860660783911,3787,0.777139339216089
"E02005539",22,341,568,1041,700,249,58,2979,0.00738502853306479,0.114467942262504,0.190668009399127,0.34944612286002,0.234978180597516,0.0835850956696878,0.0194696206780799,931,0.312520980194696,2048,0.687479019805304
"E02005540",10,181,1038,1485,440,86,20,3260,0.00306748466257669,0.055521472392638,0.31840490797546,0.455521472392638,0.134969325153374,0.0263803680981595,0.00613496932515337,1229,0.376993865030675,2031,0.623006134969325
"E02005541",2,46,704,945,339,52,12,2100,0.000952380952380952,0.0219047619047619,0.335238095238095,0.45,0.161428571428571,0.0247619047619048,0.00571428571428571,752,0.358095238095238,1348,0.641904761904762
"E02005542",9,266,1355,1292,535,126,61,3644,0.00246981339187706,0.0729967069154775,0.371844127332602,0.354555433589462,0.146816684961581,0.0345773874862788,0.0167398463227223,1630,0.447310647639956,2014,0.552689352360044
"E02005543",1,165,1963,1612,723,129,77,4670,0.000214132762312634,0.0353319057815846,0.4203426124197,0.345182012847966,0.154817987152034,0.0276231263383298,0.0164882226980728,2129,0.455888650963597,2541,0.544111349036403
"E02005544",0,169,1206,1054,288,69,32,2818,0,0.059971611071682,0.427963094393187,0.37402413058907,0.102200141944642,0.024485450674237,0.0113555713271824,1375,0.487934705464869,1443,0.512065294535131
"E02005545",9,67,799,819,133,30,6,1863,0.00483091787439614,0.0359634997316157,0.428878153515835,0.439613526570048,0.0713902308105207,0.0161030595813204,0.00322061191626409,875,0.469672571121847,988,0.530327428878154
"E02005546",1,273,1291,1093,377,86,17,3138,0.000318674314850223,0.0869980879541109,0.411408540471638,0.348311026131294,0.120140216698534,0.0274059910771192,0.00541746335245379,1565,0.498725302740599,1573,0.501274697259401
"E02005547",7,110,1159,1393,512,80,27,3288,0.00212895377128954,0.0334549878345499,0.352493917274939,0.423661800486618,0.155717761557178,0.024330900243309,0.00821167883211679,1276,0.388077858880779,2012,0.611922141119221
"E02005548",2,112,1149,724,158,35,5,2185,0.00091533180778032,0.0512585812356979,0.525858123569794,0.331350114416476,0.0723112128146453,0.0160183066361556,0.0022883295194508,1263,0.578032036613272,922,0.421967963386728
"E02005549",15,47,429,677,294,120,32,1614,0.00929368029739777,0.0291201982651797,0.265799256505576,0.419454770755886,0.182156133828996,0.0743494423791822,0.0198265179677819,491,0.304213135068154,1123,0.695786864931846
"E02005550",16,1143,1017,924,172,37,8,3317,0.00482363581549593,0.344588483569491,0.30660235152246,0.27856496834489,0.0518540850165813,0.0111546578233343,0.00241181790774797,2176,0.656014470907446,1141,0.343985529092554
"E02005551",6,522,1059,1284,627,170,43,3711,0.00161681487469685,0.140662894098626,0.285367825383994,0.345998383185125,0.168957154405821,0.0458097547830773,0.0115871732686607,1587,0.427647534357316,2124,0.572352465642684
"E02005552",27,436,610,1426,1256,474,106,4335,0.00622837370242215,0.100576701268743,0.140715109573241,0.328950403690888,0.289734717416378,0.109342560553633,0.0244521337946943,1073,0.247520184544406,3262,0.752479815455594
"E02005553",19,331,1110,1733,638,211,69,4111,0.0046217465336901,0.0805156896132328,0.270007297494527,0.42155193383605,0.155193383604962,0.0513257115057164,0.0167842374118219,1460,0.35514473364145,2651,0.64485526635855
"E02005554",6,75,705,1240,702,196,55,2979,0.00201409869083585,0.0251762336354481,0.236656596173212,0.416247062772743,0.235649546827795,0.0657938905673045,0.018462571332662,786,0.263846928499496,2193,0.736153071500503
"E02005555",31,198,632,930,239,39,6,2075,0.0149397590361446,0.0954216867469879,0.304578313253012,0.448192771084337,0.115180722891566,0.0187951807228916,0.00289156626506024,861,0.414939759036145,1214,0.585060240963855
"E02005556",3,233,834,1066,239,28,3,2406,0.00124688279301746,0.0968412302576891,0.346633416458853,0.443059019118869,0.099334995843724,0.0116375727348296,0.00124688279301746,1070,0.444721529509559,1336,0.55527847049044
"E02005557",12,341,1600,963,238,45,13,3212,0.0037359900373599,0.106164383561644,0.49813200498132,0.299813200498132,0.0740971357409714,0.0140099626400996,0.00404732254047323,1953,0.608032378580324,1259,0.391967621419676
"E02005558",17,206,374,894,777,230,69,2567,0.00662251655629139,0.0802493182703545,0.145695364238411,0.348266458901441,0.302687962602259,0.0895987534086482,0.0268796260225945,597,0.232567199065056,1970,0.767432800934943
"E02005559",24,121,925,1179,418,76,18,2761,0.0086925027164071,0.0438247011952191,0.335023542194857,0.427019195943499,0.151394422310757,0.0275262586019558,0.00651937703730532,1070,0.387540746106483,1691,0.612459253893517
"E02005560",1,254,2019,1190,234,26,6,3730,0.000268096514745308,0.0680965147453083,0.541286863270777,0.319034852546917,0.0627345844504021,0.00697050938337802,0.00160857908847185,2274,0.609651474530831,1456,0.390348525469169
"E02005561",4,906,2239,1848,831,124,59,6011,0.000665446681084678,0.15072367326568,0.372483779737149,0.307436366661121,0.138246547995342,0.020628847113625,0.009815338545999,3149,0.523872899683913,2862,0.476127100316087
"E02005562",8,212,423,988,842,286,50,2809,0.00284798860804557,0.0754716981132075,0.150587397650409,0.351726593093628,0.299750800996796,0.101815592737629,0.0177999288002848,643,0.228907084371663,2166,0.771092915628338
"E02005563",6,343,458,987,621,245,67,2727,0.0022002200220022,0.125779244591126,0.167950128346168,0.361936193619362,0.227722772277228,0.0898423175650898,0.0245691235790246,807,0.295929592959296,1920,0.704070407040704
"E02005564",10,140,957,1440,692,196,42,3477,0.00287604256542997,0.0402645959160196,0.275237273511648,0.414150129421915,0.199022145527754,0.0563704342824274,0.0120793787748059,1107,0.318377911993098,2370,0.681622088006903
"E02005565",13,178,573,1053,645,219,63,2744,0.00473760932944606,0.064868804664723,0.208819241982507,0.383746355685131,0.235058309037901,0.0798104956268222,0.0229591836734694,764,0.278425655976676,1980,0.721574344023324
"E02005566",28,390,721,1273,950,401,110,3873,0.0072295378259747,0.100697134004648,0.186160599018848,0.32868577330235,0.245287890524141,0.103537309579138,0.0284017557449006,1139,0.294087270849471,2734,0.705912729150529
"E02005567",15,606,2194,1715,454,87,25,5096,0.00294348508634223,0.118916797488226,0.430533751962323,0.336538461538462,0.0890894819466248,0.0170722135007849,0.00490580847723705,2815,0.552394034536892,2281,0.447605965463108
"E02005568",11,208,369,1058,853,317,81,2897,0.00379703141180532,0.0717984121505005,0.127373144632378,0.365205384880911,0.294442526751812,0.109423541594753,0.0279599585778391,588,0.202968588194684,2309,0.797031411805316
"E02005569",29,305,392,1085,972,347,75,3205,0.00904836193447738,0.0951638065522621,0.122308892355694,0.338533541341654,0.303276131045242,0.108268330733229,0.0234009360374415,726,0.226521060842434,2479,0.773478939157566
"E02005570",4,276,1104,1436,507,144,29,3500,0.00114285714285714,0.0788571428571429,0.315428571428571,0.410285714285714,0.144857142857143,0.0411428571428571,0.00828571428571429,1384,0.395428571428571,2116,0.604571428571429
"E02005571",25,293,670,993,886,342,143,3352,0.0074582338902148,0.0874105011933174,0.199880668257757,0.296241050119332,0.264319809069212,0.102028639618138,0.0426610978520286,988,0.294749403341289,2364,0.705250596658711
"E02005572",2,373,1353,1569,647,173,49,4166,0.000480076812289966,0.0895343254920787,0.324771963514162,0.376620259241479,0.155304848775804,0.0415266442630821,0.0117618819011042,1728,0.414786365818531,2438,0.585213634181469
"E02005573",19,578,859,1121,513,203,82,3375,0.00562962962962963,0.171259259259259,0.254518518518519,0.332148148148148,0.152,0.0601481481481481,0.0242962962962963,1456,0.431407407407407,1919,0.568592592592593
"E02005574",34,213,507,1096,708,254,84,2896,0.0117403314917127,0.0735497237569061,0.175069060773481,0.378453038674033,0.244475138121547,0.087707182320442,0.0290055248618785,754,0.260359116022099,2142,0.739640883977901
"E02005575",8,141,400,991,698,296,106,2640,0.00303030303030303,0.0534090909090909,0.151515151515152,0.375378787878788,0.264393939393939,0.112121212121212,0.0401515151515152,549,0.207954545454545,2091,0.792045454545455
"E02005576",11,212,744,1215,534,197,83,2996,0.00367156208277704,0.0707610146862483,0.248331108144192,0.405540720961282,0.178237650200267,0.0657543391188251,0.0277036048064085,967,0.322763684913218,2029,0.677236315086782
"E02005577",13,131,424,958,720,224,60,2530,0.00513833992094862,0.0517786561264822,0.167588932806324,0.378656126482213,0.284584980237154,0.0885375494071146,0.0237154150197628,568,0.224505928853755,1962,0.775494071146245
"E02005578",9,67,338,1024,792,293,52,2575,0.00349514563106796,0.0260194174757282,0.13126213592233,0.397669902912621,0.307572815533981,0.11378640776699,0.0201941747572816,414,0.160776699029126,2161,0.839223300970874
"E02005580",34,401,1123,1352,386,74,19,3389,0.0100324579521983,0.118323989377397,0.331366184715255,0.398937739746238,0.113897904986722,0.0218353496606669,0.00560637356152257,1558,0.459722632044851,1831,0.540277367955149
"E02005581",5,81,453,1076,730,301,77,2723,0.00183621006243114,0.0297466030113845,0.166360631656261,0.395152405435182,0.268086669114947,0.110539845758355,0.0282776349614396,539,0.197943444730077,2184,0.802056555269923
"E02005582",10,249,563,1104,748,306,111,3091,0.00323519896473633,0.0805564542219347,0.182141701714655,0.357165965706891,0.241992882562278,0.0989970883209317,0.0359107085085733,822,0.265933354901326,2269,0.734066645098673
"E02005583",32,247,646,1467,815,290,84,3581,0.00893605138229545,0.068975146607093,0.180396537280089,0.409662105557107,0.227590058642837,0.0809829656520525,0.0234571348785256,925,0.258307735269478,2656,0.741692264730522
"E02005584",3,235,2390,1543,336,51,15,4573,0.000656024491581019,0.0513885851738465,0.522632844959545,0.337415263503171,0.0734747430570741,0.0111524163568773,0.0032801224579051,2628,0.574677454624973,1945,0.425322545375027
"E02005585",15,241,1937,1890,420,52,12,4567,0.00328443179329976,0.0527698708123495,0.424129625574776,0.41383840595577,0.0919640902123933,0.0113860302167725,0.00262754543463981,2193,0.480183928180425,2374,0.519816071819575
"E02005586",5,239,1612,2478,719,67,21,5141,0.000972573429293912,0.046489009920249,0.313557673604357,0.482007391558063,0.139856059132464,0.0130324839525384,0.00408480840303443,1856,0.3610192569539,3285,0.6389807430461
"E02005587",2,183,1402,1347,304,36,4,3278,0.00061012812690665,0.0558267236119585,0.427699816961562,0.410921293471629,0.0927394752898109,0.0109823062843197,0.0012202562538133,1587,0.484136668700427,1691,0.515863331299573
"E02005588",4,509,2700,1443,216,18,2,4892,0.000817661488143908,0.104047424366312,0.551921504497138,0.294971381847915,0.0441537203597711,0.00367947669664759,0.000408830744071954,3213,0.656786590351594,1679,0.343213409648406
"E02005589",6,280,2227,1675,387,51,8,4634,0.00129477772982305,0.0604229607250755,0.480578334052654,0.361458782908934,0.0835131635735865,0.0110056107034959,0.00172637030643073,2513,0.542296072507553,2121,0.457703927492447
"E02005592",0,59,815,2187,961,92,34,4148,0,0.0142237222757956,0.196480231436837,0.527242044358727,0.231677917068467,0.0221793635486982,0.00819672131147541,874,0.210703953712633,3274,0.789296046287367
"E02005593",1,81,1296,1000,200,28,9,2615,0.000382409177820268,0.0309751434034417,0.495602294455067,0.382409177820268,0.0764818355640535,0.0107074569789675,0.00344168260038241,1378,0.526959847036329,1237,0.473040152963671
"E02005594",3,311,2146,2260,745,99,18,5582,0.00053744177714081,0.0557147975635973,0.384450017914726,0.404872805446077,0.133464707989968,0.0177355786456467,0.00322465066284486,2460,0.440702257255464,3122,0.559297742744536
"E02005595",6,297,1025,1531,424,72,7,3362,0.00178465199286139,0.0883402736466389,0.304878048780488,0.455383700178465,0.126115407495538,0.0214158239143367,0.00208209399167162,1328,0.395002974419988,2034,0.604997025580012
"E02005596",3,166,1683,1662,383,46,7,3950,0.000759493670886076,0.0420253164556962,0.426075949367089,0.420759493670886,0.0969620253164557,0.0116455696202532,0.00177215189873418,1852,0.468860759493671,2098,0.531139240506329
"E02005598",226,2076,1120,999,435,116,22,4994,0.0452543051661994,0.415698838606328,0.224269122947537,0.200040048057669,0.0871045254305166,0.0232278734481378,0.00440528634361234,3422,0.685222266720064,1572,0.314777733279936
"E02005599",25,1055,809,900,206,23,6,3024,0.00826719576719577,0.348875661375661,0.267526455026455,0.297619047619048,0.0681216931216931,0.00760582010582011,0.00198412698412698,1889,0.624669312169312,1135,0.375330687830688
"E02005600",81,135,310,686,552,186,33,1983,0.0408472012102874,0.0680786686838124,0.156328794755421,0.345940494200706,0.278366111951589,0.0937972768532526,0.0166414523449319,526,0.265254664649521,1457,0.734745335350479
"E02005601",32,128,785,999,280,41,8,2273,0.0140783106027277,0.0563132424109107,0.345358556973163,0.439507259128905,0.123185217773867,0.0180378354597448,0.00351957765068192,945,0.415750109986802,1328,0.584249890013198
"E02005602",116,1347,1105,1457,635,146,41,4847,0.0239323292758407,0.27790385805653,0.227976067670724,0.300598308231896,0.131008871466887,0.0301217247782133,0.00845884051990922,2568,0.529812255003095,2279,0.470187744996905
"E02005603",117,2597,1400,1076,310,82,8,5590,0.0209302325581395,0.464579606440072,0.250447227191413,0.192486583184258,0.0554561717352415,0.0146690518783542,0.00143112701252236,4114,0.735957066189624,1476,0.264042933810376
"E02005604",28,475,668,1171,513,142,27,3024,0.00925925925925926,0.15707671957672,0.220899470899471,0.38723544973545,0.169642857142857,0.046957671957672,0.00892857142857143,1171,0.38723544973545,1853,0.61276455026455
"E02005605",44,442,1006,1173,576,192,37,3470,0.0126801152737752,0.127377521613833,0.289913544668588,0.338040345821326,0.165994236311239,0.0553314121037464,0.0106628242074928,1492,0.429971181556196,1978,0.570028818443804
"E02005606",14,181,203,671,638,210,50,1967,0.00711743772241993,0.0920183019827148,0.103202846975089,0.341128622267412,0.324351804778851,0.106761565836299,0.025419420437214,398,0.202338586680224,1569,0.797661413319776
"E02005607",24,312,885,1365,887,252,63,3788,0.00633579725448786,0.0823653643083421,0.23363252375924,0.360348468848997,0.23416050686378,0.0665258711721225,0.0166314677930306,1221,0.32233368532207,2567,0.67766631467793
"E02005608",26,328,357,975,709,222,47,2664,0.00975975975975976,0.123123123123123,0.134009009009009,0.365990990990991,0.266141141141141,0.0833333333333333,0.0176426426426426,711,0.266891891891892,1953,0.733108108108108
"E02005609",69,467,818,1091,545,139,38,3167,0.0217871802968109,0.147458162298705,0.258288601199874,0.34449005367856,0.172087148721187,0.0438901168298074,0.0119987369750553,1354,0.42753394379539,1813,0.57246605620461
"E02005610",23,194,420,1029,658,190,62,2576,0.00892857142857143,0.0753105590062112,0.16304347826087,0.39945652173913,0.255434782608696,0.0737577639751553,0.0240683229813665,637,0.247282608695652,1939,0.752717391304348
"E02005611",33,641,1704,1705,465,95,37,4680,0.00705128205128205,0.136965811965812,0.364102564102564,0.364316239316239,0.0993589743589744,0.0202991452991453,0.00790598290598291,2378,0.508119658119658,2302,0.491880341880342
"E02005612",5,335,934,879,310,57,19,2539,0.00196927924379677,0.131941709334384,0.367861362741237,0.346199291059472,0.1220953131154,0.0224497833792832,0.00748326112642773,1274,0.501772351319417,1265,0.498227648680583
"E02005613",4,160,913,1465,422,26,0,2990,0.00133779264214047,0.0535117056856187,0.305351170568562,0.489966555183946,0.141137123745819,0.00869565217391304,0,1077,0.360200668896321,1913,0.639799331103679
"E02005614",243,3592,1247,1029,347,43,16,6517,0.0372870952892435,0.551173852999847,0.191345711216818,0.157894736842105,0.0532453582936934,0.00659812797299371,0.00245511738529998,5082,0.779806659505908,1435,0.220193340494092
"E02005615",4,394,1026,1305,244,14,4,2991,0.00133734536944166,0.131728518890003,0.343029087261785,0.436308926780341,0.0815780675359412,0.0046807087930458,0.00133734536944166,1424,0.47609495152123,1567,0.52390504847877
"E02005616",10,207,791,826,199,27,4,2064,0.00484496124031008,0.100290697674419,0.383236434108527,0.400193798449612,0.0964147286821705,0.0130813953488372,0.00193798449612403,1008,0.488372093023256,1056,0.511627906976744
"E02005617",9,326,1607,1536,279,15,5,3777,0.00238284352660842,0.0863118877415939,0.425469949695526,0.406671961874504,0.073868149324861,0.0039714058776807,0.0013238019592269,1942,0.514164680963728,1835,0.485835319036272
"E02005619",16,165,306,745,601,260,61,2154,0.0074280408542247,0.0766016713091922,0.142061281337047,0.345868152274838,0.279015784586815,0.120705663881151,0.0283194057567317,487,0.226090993500464,1667,0.773909006499536
"E02005620",5,386,619,1029,368,105,18,2530,0.00197628458498024,0.152569169960474,0.244664031620553,0.406719367588933,0.145454545454545,0.041501976284585,0.00711462450592885,1010,0.399209486166008,1520,0.600790513833992
"E02005621",40,495,342,910,657,263,57,2764,0.0144717800289436,0.179088277858177,0.123733719247467,0.329232995658466,0.237698986975398,0.0951519536903039,0.0206222865412446,877,0.317293777134588,1887,0.682706222865412
"E02005622",14,545,668,1200,620,205,69,3321,0.00421559771153267,0.164107196627522,0.201144233664559,0.3613369467028,0.186690755796447,0.0617283950617284,0.020776874435411,1227,0.369467028003613,2094,0.630532971996387
"E02005623",65,2868,748,1270,402,96,19,5468,0.0118873445501097,0.524506217995611,0.136795903438186,0.232260424286759,0.0735186539868325,0.0175566934893928,0.003474762253109,3681,0.673189465983906,1787,0.326810534016094
"E02005624",6,1433,1705,1176,192,17,1,4530,0.00132450331125828,0.316335540838852,0.376379690949227,0.259602649006622,0.0423841059602649,0.00375275938189845,0.00022075055187638,3144,0.694039735099338,1386,0.305960264900662
"E02005625",5,211,1551,1304,379,58,7,3515,0.00142247510668563,0.0600284495021337,0.441251778093883,0.370981507823613,0.107823613086771,0.0165007112375533,0.00199146514935989,1767,0.502702702702703,1748,0.497297297297297
"E02005626",60,312,1245,792,136,12,2,2559,0.0234466588511137,0.121922626025791,0.48651817116061,0.309495896834701,0.0531457600625244,0.00468933177022274,0.000781555295037124,1617,0.631887456037515,942,0.368112543962485
"E02005627",5,484,867,1004,364,139,31,2894,0.00172771250863856,0.167242570836213,0.299585348997927,0.346924671734623,0.125777470628887,0.048030407740152,0.0107118175535591,1356,0.468555632342778,1538,0.531444367657222
"E02005628",4,369,778,1109,469,147,24,2900,0.00137931034482759,0.127241379310345,0.268275862068966,0.382413793103448,0.161724137931034,0.0506896551724138,0.00827586206896552,1151,0.396896551724138,1749,0.603103448275862
"E02005629",8,179,678,734,497,169,64,2329,0.0034349506225848,0.0768570201803349,0.291112065264062,0.315156719622155,0.213396307428081,0.0725633319021039,0.0274796049806784,865,0.371404036066982,1464,0.628595963933018
"E02005630",16,527,1155,1230,711,215,50,3904,0.00409836065573771,0.134989754098361,0.295850409836066,0.315061475409836,0.182120901639344,0.0550717213114754,0.0128073770491803,1698,0.434938524590164,2206,0.565061475409836
"E02005631",29,852,1269,1308,589,166,46,4259,0.00680911011974642,0.200046959380136,0.297957266964076,0.307114346090632,0.138295374501057,0.0389762855130312,0.0108006574313219,2150,0.504813336463959,2109,0.495186663536041
"E02005632",7,307,630,818,355,113,21,2251,0.00310972900932919,0.136383829409151,0.279875610839627,0.363394047090182,0.157707685473123,0.0501999111505997,0.00932918702798756,944,0.419369169258107,1307,0.580630830741892
"E02005633",61,976,1086,1326,347,62,7,3865,0.0157826649417853,0.252522639068564,0.28098318240621,0.343078913324709,0.0897800776196637,0.0160413971539457,0.0018111254851229,2123,0.549288486416559,1742,0.450711513583441
"E02005634",8,665,1436,1266,323,58,22,3778,0.00211752249867655,0.176019057702488,0.38009528851244,0.335097935415564,0.0854949708840656,0.015352038115405,0.00582318687136051,2109,0.558231868713605,1669,0.441768131286395
"E02005635",22,430,1249,1192,335,51,14,3293,0.0066808381415123,0.130580018220468,0.379289401761312,0.361979957485575,0.101730944427574,0.0154873975098694,0.00425144245368965,1701,0.516550258123292,1592,0.483449741876708
"E02005636",8,582,1724,1708,439,70,14,4545,0.00176017601760176,0.128052805280528,0.379317931793179,0.375797579757976,0.0965896589658966,0.0154015401540154,0.00308030803080308,2314,0.509130913091309,2231,0.490869086908691
"E02005637",2,549,1640,1722,664,119,30,4726,0.000423190859077444,0.116165890816758,0.347016504443504,0.364367329665679,0.140499365213711,0.0251798561151079,0.00634786288616166,2191,0.46360558611934,2535,0.53639441388066
"E02005638",22,262,1037,1289,229,26,5,2870,0.00766550522648084,0.0912891986062718,0.361324041811847,0.449128919860627,0.0797909407665505,0.00905923344947735,0.00174216027874564,1321,0.460278745644599,1549,0.539721254355401
"E02005639",41,416,303,639,463,179,55,2096,0.0195610687022901,0.198473282442748,0.14456106870229,0.30486641221374,0.220896946564885,0.0854007633587786,0.0262404580152672,760,0.362595419847328,1336,0.637404580152672
"E02005640",80,703,1730,1337,387,70,10,4317,0.0185313875376419,0.162844567987028,0.400741255501506,0.30970581422284,0.0896455872133426,0.0162149640954366,0.00231642344220524,2513,0.582117211026176,1804,0.417882788973824
"E02005641",37,769,1201,1130,393,84,14,3628,0.0101984564498346,0.211962513781698,0.33103638368247,0.311466372657111,0.10832414553473,0.0231532524807056,0.00385887541345094,2007,0.553197353914002,1621,0.446802646085998
"E02005642",3,214,764,1233,431,55,6,2706,0.00110864745011086,0.0790835181079084,0.282335550628234,0.455654101995565,0.159275683665928,0.0203252032520325,0.00221729490022173,981,0.362527716186253,1725,0.637472283813747
"E02005643",0,181,1126,1271,371,57,24,3030,0,0.0597359735973597,0.371617161716172,0.419471947194719,0.122442244224422,0.0188118811881188,0.00792079207920792,1307,0.431353135313531,1723,0.568646864686469
"E02005644",19,291,1023,2104,936,115,32,4520,0.00420353982300885,0.0643805309734513,0.226327433628319,0.465486725663717,0.207079646017699,0.0254424778761062,0.00707964601769911,1333,0.294911504424779,3187,0.705088495575221
"E02005645",4,893,2188,1945,726,115,13,5884,0.000679809653297077,0.151767505098572,0.371855880353501,0.330557443915704,0.123385452073419,0.019544527532291,0.0022093813732155,3085,0.52430319510537,2799,0.47569680489463
"E02005646",7,84,545,954,246,44,4,1884,0.00371549893842887,0.0445859872611465,0.28927813163482,0.506369426751592,0.130573248407643,0.0233545647558386,0.00212314225053079,636,0.337579617834395,1248,0.662420382165605
"E02005647",21,213,1134,1033,317,42,10,2770,0.0075812274368231,0.0768953068592058,0.409386281588448,0.372924187725632,0.114440433212996,0.0151624548736462,0.0036101083032491,1368,0.493862815884477,1402,0.506137184115524
"E02005648",53,1719,685,962,217,48,0,3684,0.0143865363735071,0.466612377850163,0.185939196525516,0.261129207383279,0.0589033659066232,0.0130293159609121,0,2457,0.666938110749186,1227,0.333061889250814
"E02005650",8,743,645,864,236,36,3,2535,0.00315581854043392,0.293096646942801,0.254437869822485,0.340828402366864,0.0930966469428008,0.0142011834319527,0.00118343195266272,1396,0.55069033530572,1139,0.44930966469428
"E02005651",5,241,536,996,281,42,4,2105,0.00237529691211401,0.114489311163895,0.254631828978622,0.473159144893112,0.133491686460808,0.0199524940617577,0.00190023752969121,782,0.371496437054632,1323,0.628503562945368
"E02005652",3,323,613,949,264,38,8,2198,0.00136487716105551,0.146951774340309,0.278889899909008,0.431756141947225,0.120109190172884,0.0172884440400364,0.00363967242948135,939,0.427206551410373,1259,0.572793448589627
"E02005653",37,127,1724,1009,174,15,2,3088,0.0119818652849741,0.0411269430051813,0.558290155440414,0.326748704663212,0.0563471502590674,0.00485751295336788,0.000647668393782383,1888,0.61139896373057,1200,0.38860103626943
"E02005654",6,340,1634,942,137,10,3,3072,0.001953125,0.110677083333333,0.531901041666667,0.306640625,0.0445963541666667,0.00325520833333333,0.0009765625,1980,0.64453125,1092,0.35546875
"E02005655",1,212,655,927,276,33,6,2110,0.0004739336492891,0.100473933649289,0.31042654028436,0.439336492890995,0.130805687203791,0.0156398104265403,0.0028436018957346,868,0.411374407582938,1242,0.588625592417062
"E02005656",0,190,1223,665,82,14,1,2175,0,0.0873563218390805,0.562298850574713,0.305747126436782,0.0377011494252874,0.0064367816091954,0.000459770114942529,1413,0.649655172413793,762,0.350344827586207
"E02005657",2,328,592,979,369,53,15,2338,0.000855431993156544,0.140290846877673,0.253207869974337,0.418733960650128,0.157827202737382,0.0226689478186484,0.00641573994867408,922,0.394354148845167,1416,0.605645851154833
"E02005658",0,147,1092,1285,387,44,19,2974,0,0.0494283792871553,0.367182246133154,0.432078009414929,0.130127774041695,0.0147948890383322,0.00638870208473436,1239,0.416610625420309,1735,0.583389374579691
"E02005659",0,242,527,827,312,45,9,1962,0,0.123343527013252,0.268603465851172,0.421508664627931,0.159021406727829,0.0229357798165138,0.00458715596330275,769,0.391946992864424,1193,0.608053007135576
"E02005660",2,211,1092,721,88,8,3,2125,0.000941176470588235,0.0992941176470588,0.513882352941176,0.339294117647059,0.0414117647058824,0.00376470588235294,0.00141176470588235,1305,0.614117647058824,820,0.385882352941176
"E02005661",1,125,1069,901,312,42,11,2461,0.000406338886631451,0.0507923608289313,0.434376269809021,0.366111336854937,0.126777732629013,0.0170662332385209,0.00446972775294596,1195,0.485574969524584,1266,0.514425030475417
"E02005662",6,77,470,1157,445,82,8,2245,0.00267260579064588,0.0342984409799555,0.209354120267261,0.515367483296214,0.198218262806236,0.0365256124721604,0.00356347438752784,553,0.246325167037862,1692,0.753674832962138
"E02005663",3,109,600,848,177,15,1,1753,0.00171135196805476,0.0621791215059897,0.342270393610953,0.48374215630348,0.100969766115231,0.00855675984027382,0.000570450656018254,712,0.406160867084997,1041,0.593839132915003
"E02005664",55,118,746,1182,523,76,24,2724,0.0201908957415565,0.0433186490455213,0.273861967694567,0.433920704845815,0.191997063142438,0.0279001468428781,0.00881057268722467,919,0.337371512481645,1805,0.662628487518355
"E02005665",9,284,1171,1028,225,21,2,2740,0.00328467153284672,0.103649635036496,0.427372262773723,0.375182481751825,0.0821167883211679,0.00766423357664234,0.00072992700729927,1464,0.534306569343066,1276,0.465693430656934
"E02005666",11,271,1664,1231,242,21,5,3445,0.00319303338171263,0.0786647314949202,0.483018867924528,0.35732946298984,0.0702467343976778,0.00609579100145138,0.00145137880986938,1946,0.564876632801161,1499,0.435123367198839
"E02005667",6,379,1052,894,177,22,5,2535,0.00236686390532544,0.149506903353057,0.414990138067061,0.352662721893491,0.0698224852071006,0.00867850098619329,0.0019723865877712,1437,0.566863905325444,1098,0.433136094674556
"E02005668",5,367,553,860,276,55,6,2122,0.00235626767200754,0.172950047125353,0.260603204524034,0.405278039585297,0.130065975494816,0.0259189443920829,0.00282752120640905,925,0.435909519321395,1197,0.564090480678605
"E02005669",4,173,424,784,254,39,2,1680,0.00238095238095238,0.10297619047619,0.252380952380952,0.466666666666667,0.151190476190476,0.0232142857142857,0.00119047619047619,601,0.357738095238095,1079,0.642261904761905
"E02005670",0,775,2449,1909,511,70,20,5734,0,0.135158702476456,0.427101499825602,0.332926403906523,0.0891175444715731,0.0122078828043251,0.00348796651552145,3224,0.562260202302058,2510,0.437739797697942
"E02005671",0,138,746,1694,709,92,18,3397,0,0.0406240800706506,0.219605534294966,0.498675301736827,0.208713570797763,0.0270827200471004,0.00529879305269355,884,0.260229614365617,2513,0.739770385634383
"E02005672",0,236,1283,2082,693,94,31,4419,0,0.0534057479067662,0.290337180357547,0.471147318397828,0.156822810590631,0.0212717809459154,0.00701516180131251,1519,0.343742928264313,2900,0.656257071735687
"E02005673",8,263,1197,1414,466,57,16,3421,0.00233849751534639,0.0768781058170126,0.349897690733704,0.413329435837474,0.136217480268927,0.016661794796843,0.00467699503069278,1468,0.429114294066063,1953,0.570885705933938
"E02005674",2,571,2039,1436,497,70,18,4633,0.000431685732786531,0.123246276710555,0.440103604575869,0.30995035614073,0.107273904597453,0.0151090006475286,0.00388517159507878,2612,0.56378156701921,2021,0.43621843298079
"E02005675",5,346,1183,786,98,7,3,2428,0.00205930807248764,0.142504118616145,0.487232289950577,0.323723228995058,0.0403624382207578,0.0028830313014827,0.00123558484349259,1534,0.631795716639209,894,0.368204283360791
"E02005676",1,212,739,919,242,35,7,2155,0.000464037122969838,0.0983758700696056,0.34292343387471,0.426450116009281,0.112296983758701,0.0162412993039443,0.00324825986078886,952,0.441763341067285,1203,0.558236658932715
"E02005677",27,786,1523,1257,406,53,11,4063,0.00664533595865124,0.193453113462958,0.374846172778735,0.309377307408319,0.0999261629337928,0.0130445483632784,0.00270735909426532,2336,0.574944622200345,1727,0.425055377799655
"E02005679",9,98,1147,1534,174,11,0,2973,0.00302724520686176,0.0329633366969391,0.385805583585604,0.515977127480659,0.0585267406659939,0.00369996636394215,0,1254,0.421796165489405,1719,0.578203834510595
"E02005680",25,429,1145,969,143,26,5,2742,0.00911743253099927,0.156455142231947,0.417578409919767,0.353391684901532,0.0521517140773158,0.00948212983223924,0.00182348650619985,1599,0.583150984682713,1143,0.416849015317287
"E02005681",80,729,672,1003,379,84,15,2962,0.0270087778528022,0.24611748818366,0.226873733963538,0.338622552329507,0.12795408507765,0.0283592167454423,0.0050641458474004,1481,0.5,1481,0.5
"E02005682",3,503,529,855,400,112,30,2432,0.00123355263157895,0.206825657894737,0.217516447368421,0.3515625,0.164473684210526,0.0460526315789474,0.0123355263157895,1035,0.425575657894737,1397,0.574424342105263
"E02005683",5,803,1972,1504,413,86,12,4795,0.00104275286757039,0.167466110531804,0.41126173096976,0.313660062565172,0.0861313868613139,0.0179353493222106,0.00250260688216893,2780,0.579770594369134,2015,0.420229405630865
"E02005684",12,347,678,1059,561,222,62,2941,0.00408024481468888,0.117987079224753,0.230533832029922,0.360081604896294,0.190751445086705,0.0754845290717443,0.0210812648758926,1037,0.352601156069364,1904,0.647398843930636
"E02005685",47,1923,1360,1111,292,78,18,4829,0.00973286394698695,0.398219092979913,0.281631807827708,0.230068337129841,0.0604680057983019,0.0161524125077656,0.00372747980948437,3330,0.689583764754608,1499,0.310416235245392
"E02005686",15,295,491,991,593,190,44,2619,0.00572737686139748,0.112638411607484,0.187476135929744,0.378388697976327,0.226422298587247,0.0725467735777014,0.0168003054600993,801,0.305841924398625,1818,0.694158075601375
"E02005687",8,468,480,685,464,201,43,2349,0.00340570455512984,0.199233716475096,0.204342273307791,0.291613452532993,0.197530864197531,0.0855683269476373,0.0183056619838229,956,0.406981694338016,1393,0.593018305661984
"E02005688",4,521,1025,1058,375,98,33,3114,0.00128452151573539,0.167308927424534,0.329158638407193,0.33975594091201,0.120423892100193,0.031470777135517,0.010597302504817,1550,0.497752087347463,1564,0.502247912652537
"E02005689",2,1404,1012,951,163,16,6,3554,0.00056274620146314,0.395047833427124,0.284749577940349,0.267585818795723,0.0458638154192459,0.00450196961170512,0.00168823860438942,2418,0.680360157568936,1136,0.319639842431064
"E02005690",1,336,1021,814,254,43,11,2480,0.000403225806451613,0.135483870967742,0.411693548387097,0.328225806451613,0.10241935483871,0.0173387096774194,0.00443548387096774,1358,0.54758064516129,1122,0.45241935483871
"E02005691",8,153,570,926,452,123,34,2266,0.00353045013239188,0.0675198587819947,0.251544571932921,0.40864960282436,0.199470432480141,0.0542806707855252,0.0150044130626655,731,0.322594880847308,1535,0.677405119152692
"E02005692",78,1480,782,927,381,89,28,3765,0.0207171314741036,0.393094289508632,0.207702523240372,0.246215139442231,0.101195219123506,0.0236387782204515,0.00743691899070385,2340,0.621513944223108,1425,0.378486055776892
"E02005693",8,152,1467,832,163,19,4,2645,0.00302457466918715,0.0574669187145558,0.554631379962193,0.314555765595463,0.0616257088846881,0.00718336483931947,0.00151228733459357,1627,0.615122873345936,1018,0.384877126654064
"E02005694",8,342,736,1046,185,23,0,2340,0.00341880341880342,0.146153846153846,0.314529914529915,0.447008547008547,0.0790598290598291,0.00982905982905983,0,1086,0.464102564102564,1254,0.535897435897436
"E02005695",30,1514,1211,1486,494,60,20,4815,0.00623052959501558,0.314434060228453,0.251505711318795,0.308618899273105,0.102596053997923,0.0124610591900312,0.00415368639667705,2755,0.572170301142264,2060,0.427829698857736
"E02005696",5,252,1214,757,91,13,2,2334,0.00214224507283633,0.107969151670951,0.520137103684661,0.324335904027421,0.0389888603256213,0.00556983718937446,0.000856898029134533,1471,0.630248500428449,863,0.369751499571551
"E02005697",3,451,1425,1141,458,83,27,3588,0.000836120401337793,0.125696767001115,0.397157190635452,0.318004459308807,0.127647714604236,0.0231326644370123,0.00752508361204013,1879,0.523690078037904,1709,0.476309921962096
"E02005698",1,113,809,713,169,25,1,1831,0.000546149645002731,0.0617149098853086,0.441835062807209,0.389404696886947,0.0922992900054615,0.0136537411250683,0.000546149645002731,923,0.50409612233752,908,0.49590387766248
"E02005699",4,256,1367,1039,139,18,3,2826,0.00141542816702052,0.0905874026893135,0.483722576079264,0.367657466383581,0.0491861288039632,0.00636942675159236,0.00106157112526539,1627,0.575725406935598,1199,0.424274593064402
"E02005700",31,984,803,1216,465,69,11,3579,0.00866163732886281,0.274937133277452,0.224364347583124,0.339759709416038,0.129924559932942,0.019279128248114,0.00307348421346745,1818,0.507963118189438,1761,0.492036881810562
"E02005701",32,324,1187,1569,509,132,38,3791,0.00844104457926668,0.0854655763650752,0.313109997362174,0.41387496702717,0.134265365338961,0.0348193088894751,0.0100237404378792,1543,0.407016618306515,2248,0.592983381693485
"E02005702",24,705,699,976,569,223,61,3257,0.00736874424316856,0.216456862143076,0.214614676082284,0.299662265888855,0.174700644765121,0.0684679152594412,0.0187288916180534,1428,0.438440282468529,1829,0.561559717531471
"E02005703",4,302,1307,1073,312,70,19,3087,0.00129575639779721,0.0978296080336897,0.42338840298024,0.347586653709103,0.101068999028183,0.0226757369614512,0.00615484288953677,1613,0.522513767411727,1474,0.477486232588273
"E02005704",53,867,1876,1728,678,216,59,5477,0.00967683038159576,0.158298338506482,0.342523279167427,0.315501186781085,0.123790396202301,0.0394376483476356,0.0107723206134745,2796,0.510498448055505,2681,0.489501551944495
"E02005705",24,258,669,930,857,425,140,3303,0.0072661217075386,0.07811080835604,0.202543142597639,0.281562216167121,0.259461095973358,0.128670905237663,0.0423857099606418,951,0.287920072661217,2352,0.712079927338783
"E02005706",25,157,1560,1642,519,158,44,4105,0.00609013398294762,0.0382460414129111,0.380024360535932,0.4,0.126431181485993,0.038489646772229,0.0107186358099878,1742,0.424360535931791,2363,0.57563946406821
"E02005707",69,154,516,971,682,280,89,2761,0.0249909453096704,0.0557768924302789,0.186888808402753,0.351684172401304,0.247011952191235,0.101412531691416,0.032234697573343,739,0.267656646142702,2022,0.732343353857298
"E02005708",8,392,1065,1879,1619,682,272,5917,0.00135203650498563,0.0662497887442961,0.179989859726213,0.317559574108501,0.273618387696468,0.115261112050025,0.0459692411695116,1465,0.247591684975494,4452,0.752408315024506
"E02005709",0,465,1211,976,197,19,4,2872,0,0.161908077994429,0.421657381615599,0.33983286908078,0.0685933147632312,0.00661559888579387,0.00139275766016713,1676,0.583565459610028,1196,0.416434540389972
"E02005710",24,276,1869,1586,654,95,18,4522,0.00530738611233967,0.0610349402919062,0.413312693498452,0.350729765590447,0.144626271561256,0.0210084033613445,0.00398053958425475,2169,0.479655019902698,2353,0.520344980097302
"E02005711",4,65,1300,1145,246,18,3,2781,0.00143833153541891,0.0233728874505574,0.467457749011147,0.411722402013664,0.0884573894282632,0.00647249190938511,0.00107874865156419,1369,0.492268967997123,1412,0.507731032002877
"E02005712",39,1229,1617,944,165,26,3,4023,0.00969425801640567,0.305493412875963,0.401938851603281,0.234650758140691,0.0410141685309471,0.00646283867760378,0.000745712155108128,2885,0.71712652249565,1138,0.28287347750435
"E02005713",5,130,673,799,93,9,0,1709,0.00292568753657109,0.0760678759508484,0.393797542422469,0.467524868344061,0.0544177881802224,0.00526623756582797,0,808,0.472791105909889,901,0.527208894090111
"E02005715",85,1250,1545,1210,273,23,4,4390,0.0193621867881549,0.284738041002278,0.351936218678815,0.275626423690205,0.0621867881548975,0.00523917995444191,0.000911161731207289,2880,0.656036446469248,1510,0.343963553530752
"E02005717",3,255,1044,1135,222,25,3,2687,0.00111648678823967,0.0949013770003722,0.388537402307406,0.422404168217343,0.0826200223297358,0.00930405656866394,0.00111648678823967,1302,0.484555266096018,1385,0.515444733903982
"E02005718",0,92,756,1020,206,24,4,2102,0,0.043767840152236,0.359657469077069,0.485252140818268,0.0980019029495718,0.0114176974310181,0.00190294957183635,848,0.403425309229305,1254,0.596574690770695
"E02005719",46,507,1299,1197,219,25,3,3296,0.0139563106796117,0.153822815533981,0.394114077669903,0.363167475728155,0.0664441747572816,0.00758495145631068,0.000910194174757282,1852,0.561893203883495,1444,0.438106796116505
"E02005720",22,602,1679,1463,399,88,23,4276,0.00514499532273152,0.140785781103835,0.39265668849392,0.342142188961646,0.093311506080449,0.0205799812909261,0.00537885874649205,2303,0.538587464920486,1973,0.461412535079514
"E02005721",14,550,783,758,227,53,13,2398,0.00583819849874896,0.229357798165138,0.32652210175146,0.316096747289408,0.0946622185154295,0.0221017514595496,0.00542118432026689,1347,0.561718098415346,1051,0.438281901584654
"E02005722",23,1347,696,809,710,302,95,3982,0.00577599196383727,0.338272225012556,0.174786539427423,0.203164239075841,0.178302360622803,0.0758412857860372,0.0238573581115018,2066,0.518834756403817,1916,0.481165243596183
"E02005723",0,131,1174,1043,239,27,7,2621,0,0.0499809233117131,0.447920640976726,0.397939717665013,0.091186570011446,0.0103014116749332,0.00267073636016788,1305,0.49790156428844,1316,0.502098435711561
"E02005724",1,328,553,813,169,23,4,1891,0.000528820729772607,0.173453199365415,0.292437863564252,0.42993125330513,0.0893707033315706,0.01216287678477,0.00211528291909043,882,0.466419883659439,1009,0.533580116340561
"E02005725",5,583,854,858,268,71,20,2659,0.00188040616773223,0.219255359157578,0.321173373448665,0.322677698382851,0.100789770590448,0.0267017675817977,0.00752162467092892,1442,0.542309138773975,1217,0.457690861226025
"E02005726",6,131,685,957,432,135,25,2371,0.00253057781526782,0.0552509489666807,0.288907633909743,0.403627161535217,0.182201602699283,0.0569380008435259,0.0105440742302826,822,0.346689160691691,1549,0.653310839308309
"E02005727",8,95,307,727,816,435,171,2559,0.0031262211801485,0.0371238765142634,0.119968737788199,0.284095349745995,0.318874560375147,0.169988276670574,0.0668229777256741,410,0.16021883548261,2149,0.83978116451739
"E02005728",4,67,487,844,607,306,110,2425,0.00164948453608247,0.0276288659793814,0.200824742268041,0.348041237113402,0.250309278350515,0.126185567010309,0.045360824742268,558,0.230103092783505,1867,0.769896907216495
"E02005729",2,114,459,754,383,125,35,1872,0.00106837606837607,0.0608974358974359,0.245192307692308,0.402777777777778,0.204594017094017,0.0667735042735043,0.0186965811965812,575,0.30715811965812,1297,0.69284188034188
"E02005730",32,592,1657,1984,630,117,35,5047,0.00634040023776501,0.117297404398653,0.328313849811769,0.393104814741431,0.124826629680999,0.0231820883693283,0.00693481276005548,2281,0.451951654448187,2766,0.548048345551813
"E02005731",6,428,1129,1418,309,33,11,3334,0.0017996400719856,0.128374325134973,0.338632273545291,0.425314937012597,0.0926814637072585,0.00989802039592082,0.00329934013197361,1563,0.46880623875225,1771,0.531193761247751
"E02005733",27,119,490,909,1014,481,152,3192,0.00845864661654135,0.037280701754386,0.153508771929825,0.284774436090226,0.317669172932331,0.150689223057644,0.0476190476190476,636,0.199248120300752,2556,0.800751879699248
"E02005734",2,119,807,1046,300,57,9,2340,0.000854700854700855,0.0508547008547009,0.344871794871795,0.447008547008547,0.128205128205128,0.0243589743589744,0.00384615384615385,928,0.396581196581197,1412,0.603418803418803
"E02005735",1,150,1281,1673,473,46,7,3631,0.000275406224180667,0.0413109336271,0.352795373175434,0.460754613054255,0.130267144037455,0.0126686863123107,0.00192784356926467,1432,0.394381713026714,2199,0.605618286973286
"E02005736",3,700,1849,1126,218,16,6,3918,0.000765696784073507,0.178662582950485,0.471924451250638,0.287391526288923,0.0556406329760082,0.00408371618172537,0.00153139356814701,2552,0.651352730985197,1366,0.348647269014803
"E02005739",25,190,1081,1467,399,41,9,3212,0.00778331257783313,0.0591531755915318,0.336550435865504,0.456724782067248,0.124221668742217,0.0127646326276463,0.00280199252801993,1296,0.403486924034869,1916,0.596513075965131
"E02005740",9,219,1527,1702,446,91,24,4018,0.00223992035838726,0.0545047287207566,0.380039820806371,0.423593827775012,0.11100049776008,0.0226480836236934,0.00597312095569935,1755,0.436784469885515,2263,0.563215530114485
"E02005741",56,566,1113,1101,180,27,6,3049,0.0183666775992129,0.18563463430633,0.365037717284356,0.361102000655953,0.0590357494260413,0.0088553624139062,0.00196785831420138,1735,0.569039029189898,1314,0.430960970810102
"E02005742",16,313,710,1053,606,241,69,3008,0.00531914893617021,0.10405585106383,0.236037234042553,0.350066489361702,0.201462765957447,0.0801196808510638,0.022938829787234,1039,0.345412234042553,1969,0.654587765957447
"E02005744",10,308,871,1130,539,222,59,3139,0.00318572793883402,0.0981204205160879,0.277476903472443,0.359987257088245,0.171710735903154,0.0707231602421153,0.0187957948391207,1189,0.378783051927365,1950,0.621216948072635
"E02005746",6,511,707,1267,379,80,19,2969,0.00202088245200404,0.172111822162344,0.238127315594476,0.426743011114853,0.127652408218255,0.0269450993600539,0.0063994610980128,1224,0.412260020208825,1745,0.587739979791175
"E02005747",12,375,873,1386,412,82,14,3154,0.00380469245402663,0.118896639188332,0.276791376030438,0.439441978440076,0.130627774254914,0.025998731769182,0.00443880786303107,1260,0.399492707672796,1894,0.600507292327204
"E02005748",21,245,792,1150,497,156,57,2918,0.00719671007539411,0.0839616175462646,0.271418779986292,0.394105551747772,0.170322138450994,0.0534612748457848,0.0195339273474983,1058,0.362577107607951,1860,0.637422892392049
"E02005749",4,348,971,1583,517,92,29,3544,0.00112866817155756,0.0981941309255079,0.273984198645598,0.446670428893905,0.145880361173815,0.0259593679458239,0.00818284424379232,1323,0.373306997742664,2221,0.626693002257336
"E02005750",8,327,929,1222,576,153,40,3255,0.00245775729646697,0.100460829493088,0.285407066052227,0.37542242703533,0.176958525345622,0.0470046082949309,0.0122887864823349,1264,0.388325652841782,1991,0.611674347158218
"E02005751",22,343,578,1235,608,237,53,3076,0.00715214564369311,0.111508452535761,0.187906371911573,0.40149544863459,0.197659297789337,0.0770481144343303,0.0172301690507152,943,0.306566970091027,2133,0.693433029908973
"E02005752",23,755,417,864,675,259,84,3077,0.00747481312967176,0.245368865778356,0.135521611959701,0.280792980175496,0.219369515762106,0.0841728956776081,0.0272993175170621,1195,0.388365290867728,1882,0.611634709132272
"E02005754",35,275,493,1174,454,141,32,2604,0.0134408602150538,0.105606758832565,0.189324116743472,0.45084485407066,0.174347158218126,0.054147465437788,0.0122887864823349,803,0.308371735791091,1801,0.691628264208909
"E02005755",24,696,785,970,383,115,35,3008,0.00797872340425532,0.231382978723404,0.260970744680851,0.322473404255319,0.127327127659574,0.0382313829787234,0.0116356382978723,1505,0.500332446808511,1503,0.499667553191489
"E02005756",24,194,741,707,549,218,70,2503,0.00958849380743108,0.0775069916100679,0.296044746304435,0.282461046743907,0.219336795844986,0.087095485417499,0.027966440271674,959,0.383140231721934,1544,0.616859768278066
"E02005757",16,523,1116,1299,591,176,70,3791,0.00422052228963334,0.13795832234239,0.294381429701926,0.342653653389607,0.155895542073332,0.0464257451859668,0.0184647850171459,1655,0.436560274333949,2136,0.563439725666051
"E02005758",73,1222,982,1239,507,187,62,4272,0.0170880149812734,0.286048689138577,0.229868913857678,0.29002808988764,0.118679775280899,0.0437734082397004,0.0145131086142322,2277,0.533005617977528,1995,0.466994382022472
"E02005759",71,992,936,1371,668,203,62,4303,0.0165001161980014,0.230536834766442,0.217522658610272,0.318614919823379,0.155240529862886,0.0471763885661167,0.0144085521729026,1999,0.464559609574715,2304,0.535440390425285
"E02005760",37,289,458,993,418,151,38,2384,0.0155201342281879,0.121224832214765,0.192114093959732,0.416526845637584,0.175335570469799,0.0633389261744966,0.0159395973154362,784,0.328859060402685,1600,0.671140939597315
"E02005761",6,144,304,716,508,258,93,2029,0.00295712173484475,0.070970921636274,0.149827501232134,0.352883193691474,0.250369640216856,0.127156234598324,0.0458353868900936,454,0.223755544603253,1575,0.776244455396747
"E02005762",3,366,797,1022,315,67,19,2589,0.00115874855156431,0.141367323290846,0.307840865198919,0.394747006566242,0.121668597914253,0.0258787176516029,0.00733874082657397,1166,0.450366937041329,1423,0.549633062958671
"E02005763",21,353,555,814,489,175,54,2461,0.00853311661926046,0.143437626980902,0.225518082080455,0.330759853718001,0.198699715562779,0.0711093051605039,0.0219422998780983,929,0.377488825680618,1532,0.622511174319382
"E02005764",7,382,1450,1602,463,84,20,4008,0.00174650698602794,0.095309381237525,0.361776447105788,0.399700598802395,0.115518962075848,0.0209580838323353,0.00499001996007984,1839,0.458832335329341,2169,0.541167664670659
"E02005765",31,1199,692,932,320,116,30,3320,0.00933734939759036,0.361144578313253,0.208433734939759,0.280722891566265,0.0963855421686747,0.0349397590361446,0.00903614457831325,1922,0.578915662650602,1398,0.421084337349398
"E02005766",9,134,511,896,556,173,55,2334,0.0038560411311054,0.0574121679520137,0.218937446443873,0.383890317052271,0.2382176520994,0.0741216795201371,0.0235646958011997,654,0.280205655526992,1680,0.719794344473008
"E02005767",12,692,558,918,381,102,14,2677,0.00448262980948823,0.258498319013821,0.208442286141203,0.34292118042585,0.142323496451251,0.03810235338065,0.00522973477773627,1262,0.471423234964512,1415,0.528576765035487
"E02005768",4,1108,558,961,225,44,12,2912,0.00137362637362637,0.380494505494505,0.191620879120879,0.330013736263736,0.0772664835164835,0.0151098901098901,0.00412087912087912,1670,0.573489010989011,1242,0.426510989010989
"E02005769",5,259,910,1249,388,59,21,2891,0.00172950536146662,0.0895883777239709,0.314769975786925,0.432030439294362,0.13420961604981,0.0204081632653061,0.00726392251815981,1174,0.406087858872363,1717,0.593912141127637
"E02005770",2,43,657,1730,530,53,18,3033,0.000659413122321134,0.0141773821299044,0.216617210682493,0.570392350807781,0.174744477415101,0.0174744477415101,0.00593471810089021,702,0.231454005934718,2331,0.768545994065282
"E02005771",3,243,1257,1220,228,22,3,2976,0.00100806451612903,0.0816532258064516,0.422379032258065,0.40994623655914,0.0766129032258065,0.00739247311827957,0.00100806451612903,1503,0.505040322580645,1473,0.494959677419355
"E02005772",19,493,426,817,245,70,18,2088,0.00909961685823755,0.236111111111111,0.204022988505747,0.391283524904215,0.117337164750958,0.0335249042145594,0.00862068965517241,938,0.449233716475096,1150,0.550766283524904
"E02005773",10,561,1358,1861,571,84,14,4459,0.00224265530387979,0.125812962547656,0.304552590266876,0.41735815205203,0.128055617851536,0.0188383045525903,0.00313971742543171,1929,0.432608208118412,2530,0.567391791881588
"E02005774",7,298,1007,1578,437,58,19,3404,0.00205640423031727,0.0875440658049354,0.295828437132785,0.463572267920094,0.128378378378378,0.0170387779083431,0.00558166862514689,1312,0.385428907168038,2092,0.614571092831962
"E02005775",0,439,1994,2380,998,162,32,6005,0,0.0731057452123231,0.332056619483764,0.396336386344713,0.166194837635304,0.026977518734388,0.00532889258950874,2433,0.405162364696087,3572,0.594837635303913
"E02005776",33,534,732,1028,731,268,81,3407,0.00968594071030232,0.156736131493983,0.214851775755797,0.30173172879366,0.214558262400939,0.0786615791018491,0.0237745817434693,1299,0.381273847960082,2108,0.618726152039918
"E02005777",4,110,708,1276,346,57,11,2512,0.00159235668789809,0.0437898089171974,0.281847133757962,0.50796178343949,0.137738853503185,0.0226910828025478,0.00437898089171975,822,0.327229299363057,1690,0.672770700636943
"E02005778",18,283,351,695,556,207,80,2190,0.00821917808219178,0.129223744292237,0.16027397260274,0.317351598173516,0.253881278538813,0.0945205479452055,0.0365296803652968,652,0.297716894977169,1538,0.702283105022831
"E02005779",17,213,1267,1637,746,126,20,4026,0.00422255340288127,0.0529061102831595,0.314704421261798,0.406607054148038,0.185295578738202,0.0312965722801788,0.00496770988574267,1497,0.371833084947839,2529,0.628166915052161
"E02005780",4,554,1106,1721,501,69,14,3969,0.00100781053162006,0.139581758629378,0.278659611992945,0.433610481229529,0.126228269085412,0.017384731670446,0.00352733686067019,1664,0.419249181153943,2305,0.580750818846057
"E02005781",16,282,400,774,412,157,41,2082,0.00768491834774256,0.135446685878963,0.192122958693564,0.371757925072046,0.197886647454371,0.0754082612872238,0.0196926032660903,698,0.335254562920269,1384,0.664745437079731
"E02005782",19,102,405,1014,743,330,88,2701,0.00703443169196594,0.0377637911884487,0.149944465012958,0.375416512402814,0.275083302480563,0.12217697149204,0.0325805257312107,526,0.194742687893373,2175,0.805257312106627
"E02005783",7,212,1021,1457,438,100,22,3257,0.00214921707092416,0.065090574147989,0.313478661344796,0.447344181762358,0.134479582437826,0.0307031010132023,0.00675468222290451,1240,0.380718452563709,2017,0.619281547436291
"E02005784",4,96,660,916,227,68,29,2000,0.002,0.048,0.33,0.458,0.1135,0.034,0.0145,760,0.38,1240,0.62
"E02005785",10,600,1810,2129,348,42,9,4948,0.00202101859337106,0.121261115602264,0.365804365400162,0.430274858528698,0.0703314470493129,0.00848827809215845,0.00181891673403395,2420,0.489086499595796,2528,0.510913500404204
"E02005786",5,95,311,607,956,677,223,2874,0.00173973556019485,0.0330549756437022,0.10821155184412,0.211203897007655,0.332637439109255,0.235560194850383,0.0775922059846903,411,0.143006263048017,2463,0.856993736951983
"E02005787",24,363,732,1121,873,395,126,3634,0.0066042927903137,0.0998899284534948,0.201430930104568,0.308475509080903,0.240231150247661,0.108695652173913,0.0346725371491469,1119,0.307925151348376,2515,0.692074848651624
"E02005788",15,359,614,965,532,309,120,2914,0.00514756348661633,0.123198352779684,0.210706932052162,0.331159917638984,0.182566918325326,0.106039807824297,0.0411805078929307,988,0.339052848318463,1926,0.660947151681537
"E02005789",37,772,1056,1780,715,259,92,4711,0.00785395881978349,0.163871789428996,0.224156230099767,0.377839099978773,0.151772447463384,0.0549777117384844,0.019528762470813,1865,0.395881978348546,2846,0.604118021651454
"E02005790",12,348,471,934,680,292,115,2852,0.00420757363253857,0.122019635343619,0.165147265077139,0.327489481065919,0.238429172510519,0.102384291725105,0.0403225806451613,831,0.291374474053296,2021,0.708625525946704
"E02005791",22,127,417,827,971,396,120,2880,0.00763888888888889,0.0440972222222222,0.144791666666667,0.287152777777778,0.337152777777778,0.1375,0.0416666666666667,566,0.196527777777778,2314,0.803472222222222
"E02005794",26,200,481,1064,1089,453,164,3477,0.00747771067011792,0.0575208513085994,0.138337647397181,0.306010928961749,0.313201035375324,0.130284728213978,0.0471670980730515,707,0.203336209375899,2770,0.796663790624101
"E02005795",19,627,1292,1338,597,168,71,4112,0.00462062256809339,0.152480544747082,0.31420233463035,0.325389105058366,0.145184824902724,0.0408560311284047,0.0172665369649805,1938,0.471303501945525,2174,0.528696498054475
"E02005796",13,84,363,763,834,621,305,2983,0.00435802883003688,0.0281595709017767,0.121689574254107,0.255782769024472,0.279584311096212,0.208179684880992,0.102246061012404,460,0.15420717398592,2523,0.84579282601408
"E02005797",32,585,820,1087,506,93,41,3164,0.0101137800252845,0.184892541087231,0.259165613147914,0.343552465233881,0.15992414664981,0.0293931731984829,0.0129582806573957,1437,0.45417193426043,1727,0.54582806573957
"E02005798",44,137,556,1301,793,348,160,3339,0.0131775980832585,0.0410302485774184,0.166516921233902,0.38963761605271,0.237496256364181,0.104222821203953,0.0479185384845762,737,0.220724767894579,2602,0.779275232105421
"E02005799",10,511,701,1532,478,79,15,3326,0.00300661455201443,0.153638003607937,0.210763680096212,0.460613349368611,0.14371617558629,0.023752254960914,0.00450992182802165,1222,0.367408298256164,2104,0.632591701743836
"E02005800",0,167,1539,2011,915,143,61,4836,0,0.0345326716294458,0.318238213399504,0.415839536807279,0.189205955334988,0.0295698924731183,0.0126137303556658,1706,0.35277088502895,3130,0.64722911497105
"E02005801",1,34,791,934,227,43,8,2038,0.000490677134445535,0.0166830225711482,0.388125613346418,0.45829244357213,0.111383709519136,0.021099116781158,0.00392541707556428,826,0.405299313052012,1212,0.594700686947988
"E02005802",1,116,525,1629,933,131,43,3378,0.00029603315571344,0.034339846062759,0.155417406749556,0.482238010657194,0.276198934280639,0.0387803433984606,0.0127294256956779,642,0.190053285968028,2736,0.809946714031971
"E02005803",5,389,1424,1601,616,98,19,4152,0.00120423892100193,0.0936897880539499,0.342967244701349,0.385597302504817,0.148362235067437,0.0236030828516378,0.00457610789980732,1818,0.437861271676301,2334,0.562138728323699
"E02005804",1,253,1897,2364,1162,210,63,5950,0.000168067226890756,0.0425210084033613,0.318823529411765,0.397310924369748,0.195294117647059,0.0352941176470588,0.0105882352941176,2151,0.361512605042017,3799,0.638487394957983
"E02005805",61,766,632,1403,398,97,14,3371,0.0180955206170276,0.227232275289232,0.187481459507565,0.416196974191635,0.118065855829131,0.0287748442598635,0.00415307030554731,1459,0.432809255413824,1912,0.567190744586176
"E02005806",43,670,1170,953,171,26,7,3040,0.0141447368421053,0.220394736842105,0.384868421052632,0.313486842105263,0.05625,0.00855263157894737,0.00230263157894737,1883,0.619407894736842,1157,0.380592105263158
"E02005807",22,449,404,923,460,151,42,2451,0.00897592819257446,0.183190534475724,0.164830681354549,0.376580987352101,0.187678498572011,0.0616075071399429,0.0171358629130967,875,0.356997144022848,1576,0.643002855977152
"E02005808",21,792,1885,2182,885,273,111,6149,0.00341518946170109,0.128801431127013,0.306553911205074,0.354854447877704,0.14392584160026,0.0443974630021142,0.0180517157261343,2698,0.438770531793788,3451,0.561229468206212
"E02005809",4,286,744,1142,336,52,13,2577,0.00155219247186651,0.110981761738456,0.288707799767171,0.443150950717889,0.130384167636787,0.0201785021342646,0.00504462553356616,1034,0.401241753977493,1543,0.598758246022507
"E02005810",20,463,734,993,723,269,71,3273,0.00611060189428659,0.141460433852734,0.224259089520318,0.303391384051329,0.22089825847846,0.0821875954781546,0.0216926367247174,1217,0.371830125267339,2056,0.628169874732661
"E02005811",54,452,788,1273,598,160,38,3363,0.016057091882248,0.134403806125483,0.234314600059471,0.378531073446328,0.177817424918228,0.0475765685399941,0.0112994350282486,1294,0.384775498067202,2069,0.615224501932798
"E02005812",60,1325,1265,1358,363,75,13,4459,0.0134559318232788,0.297151827764073,0.283695895940794,0.304552590266876,0.0814083875308365,0.0168199147790985,0.00291545189504373,2650,0.594303655528145,1809,0.405696344471855
"E02005813",120,563,3032,1768,533,93,36,6145,0.0195280716029292,0.0916192026037429,0.493409275834011,0.287713588283157,0.0867371847030106,0.0151342554922701,0.00585842148087876,3715,0.604556550040684,2430,0.395443449959317
"E02005814",13,539,625,937,290,44,10,2458,0.00528885272579333,0.219283970707893,0.254271765663141,0.381204231082181,0.117982099267697,0.0179007323026851,0.00406834825061025,1177,0.478844589096827,1281,0.521155410903173
"E02005815",36,458,673,1116,313,60,17,2673,0.0134680134680135,0.171343060231949,0.251777029554807,0.417508417508417,0.117096894874673,0.0224466891133558,0.00635989524878414,1167,0.43658810325477,1506,0.56341189674523
"E02005816",21,336,799,1148,414,123,43,2884,0.00728155339805825,0.116504854368932,0.277045769764216,0.398058252427184,0.143550624133148,0.0426490984743412,0.0149098474341193,1156,0.400832177531207,1728,0.599167822468793
"E02005817",11,413,836,1054,303,72,24,2713,0.00405455215628456,0.152230003685957,0.308145963877626,0.388499815702175,0.111684482123111,0.0265388868411353,0.00884629561371176,1260,0.464430519719867,1453,0.535569480280133
"E02005818",29,375,721,1030,506,198,55,2914,0.00995195607412491,0.128689087165408,0.247426218256692,0.353466026080988,0.173644474948524,0.0679478380233356,0.0188743994509266,1125,0.386067261496225,1789,0.613932738503775
"E02005819",23,506,692,1052,343,65,23,2704,0.00850591715976331,0.187130177514793,0.255917159763314,0.38905325443787,0.126849112426035,0.0240384615384615,0.00850591715976331,1221,0.45155325443787,1483,0.54844674556213
"E02005820",5,101,488,859,336,45,4,1838,0.00272034820457019,0.0549510337323177,0.26550598476605,0.467355821545158,0.182807399347116,0.0244831338411317,0.00217627856365615,594,0.323177366702938,1244,0.676822633297062
"E02005821",37,140,1371,980,281,54,23,2886,0.0128205128205128,0.0485100485100485,0.475051975051975,0.33957033957034,0.0973665973665974,0.0187110187110187,0.00796950796950797,1548,0.536382536382536,1338,0.463617463617464
"E02005822",4,406,1442,1594,726,127,26,4325,0.00092485549132948,0.0938728323699422,0.333410404624277,0.368554913294798,0.167861271676301,0.029364161849711,0.00601156069364162,1852,0.428208092485549,2473,0.571791907514451
"E02005823",0,201,1688,1291,368,67,10,3625,0,0.055448275862069,0.465655172413793,0.356137931034483,0.10151724137931,0.0184827586206897,0.00275862068965517,1889,0.521103448275862,1736,0.478896551724138
"E02005824",8,413,1165,1254,488,100,15,3443,0.00232355503920999,0.119953528899216,0.338367702584955,0.364217252396166,0.141736857391809,0.0290444379901249,0.00435666569851873,1586,0.460644786523381,1857,0.539355213476619
"E02005825",6,110,1066,1156,384,82,16,2820,0.00212765957446809,0.0390070921985816,0.378014184397163,0.409929078014184,0.136170212765957,0.0290780141843972,0.00567375886524823,1182,0.419148936170213,1638,0.580851063829787
"E02005826",8,176,1171,1061,378,59,13,2866,0.00279134682484299,0.0614096301465457,0.408583391486392,0.370202372644801,0.131891137473831,0.020586182833217,0.00453593859036985,1355,0.472784368457781,1511,0.527215631542219
"E02005827",4,477,1201,1173,391,87,20,3353,0.00119296152699075,0.142260662093647,0.358186698478974,0.349835967790039,0.116611989263346,0.0259469132120489,0.00596480763495377,1682,0.501640322099612,1671,0.498359677900388
"E02005828",8,307,954,1022,370,86,17,2764,0.00289435600578871,0.111070911722142,0.345151953690304,0.369753979739508,0.133863965267728,0.0311143270622287,0.00615050651230101,1269,0.459117221418234,1495,0.540882778581765
"E02005829",5,111,933,1019,281,65,9,2423,0.00206355757325629,0.0458109781262897,0.385059843169624,0.420553033429633,0.115971935617004,0.0268262484523318,0.00371440363186133,1049,0.43293437886917,1374,0.56706562113083
"E02005830",1,94,463,949,369,75,18,1969,0.000507872016251904,0.047739969527679,0.235144743524632,0.481970543423057,0.187404773996953,0.0380904012188928,0.00914169629253428,558,0.283392585068563,1411,0.716607414931437
"E02005831",5,796,1821,1120,300,54,9,4105,0.00121802679658952,0.193909866017052,0.443605359317905,0.272838002436054,0.0730816077953715,0.0131546894031669,0.00219244823386114,2622,0.638733252131547,1483,0.361266747868453
"E02005832",5,295,1464,1458,828,167,34,4251,0.0011761938367443,0.0693954363679134,0.34438955539873,0.342978122794637,0.194777699364855,0.0392848741472595,0.00799811808986121,1764,0.414961185603387,2487,0.585038814396613
"E02005833",2,143,650,1068,313,77,6,2259,0.000885347498893316,0.0633023461708721,0.287737937140328,0.472775564409031,0.138556883576804,0.0340858787073927,0.00265604249667995,795,0.351925630810093,1464,0.648074369189907
"E02005834",44,1103,1511,1020,236,37,5,3956,0.0111223458038423,0.27881698685541,0.381951466127401,0.25783619817998,0.0596562184024267,0.00935288169868554,0.0012639029322548,2658,0.671890798786653,1298,0.328109201213347
"E02005835",13,1475,1244,1697,488,104,28,5049,0.00257476728064963,0.292137056842939,0.246385422856011,0.336106159635571,0.0966528025351555,0.0205981382451971,0.00554565260447613,2732,0.5410972469796,2317,0.4589027530204
"E02005836",13,326,988,1241,510,197,60,3335,0.00389805097451274,0.0977511244377811,0.296251874062968,0.372113943028486,0.152923538230885,0.0590704647676162,0.0179910044977511,1327,0.397901049475262,2008,0.602098950524738
"E02005837",5,244,579,950,495,206,61,2540,0.00196850393700787,0.0960629921259843,0.227952755905512,0.374015748031496,0.19488188976378,0.0811023622047244,0.0240157480314961,828,0.325984251968504,1712,0.674015748031496
"E02005838",38,708,919,1557,362,72,8,3664,0.0103711790393013,0.193231441048035,0.250818777292576,0.424945414847162,0.0987991266375546,0.0196506550218341,0.00218340611353712,1665,0.454421397379913,1999,0.545578602620087
"E02005839",13,542,1167,1044,290,31,7,3094,0.00420168067226891,0.175177763413058,0.377181641887524,0.337427278603749,0.0937297996121526,0.0100193923723335,0.00226244343891403,1722,0.556561085972851,1372,0.443438914027149
"E02005840",1,816,1110,1289,279,40,8,3543,0.000282246683601468,0.230313293818798,0.313293818797629,0.363815975162292,0.0787468247248095,0.0112898673440587,0.00225797346881174,1927,0.543889359300028,1616,0.456110640699972
"E02005842",4,444,1435,1373,547,133,15,3951,0.00101240192356365,0.112376613515566,0.363199190078461,0.347506960263224,0.13844596304733,0.0336623639584915,0.00379650721336371,1883,0.47658820551759,2068,0.523411794482409
"E02005843",2,847,1053,1103,326,65,8,3404,0.000587544065804935,0.24882491186839,0.309341950646298,0.324030552291422,0.0957696827262045,0.0190951821386604,0.00235017626321974,1902,0.558754406580494,1502,0.441245593419506
"E02005844",3,491,1493,1338,480,123,22,3950,0.000759493670886076,0.124303797468354,0.377974683544304,0.33873417721519,0.121518987341772,0.0311392405063291,0.00556962025316456,1987,0.503037974683544,1963,0.496962025316456
"E02005846",3,208,1315,1307,667,111,33,3644,0.000823271130625686,0.0570801317233809,0.360867178924259,0.358671789242591,0.183040614709111,0.0304610318331504,0.00905598243688255,1526,0.418770581778266,2118,0.581229418221734
"E02005847",2,237,843,1253,392,66,15,2808,0.000712250712250712,0.0844017094017094,0.300213675213675,0.446225071225071,0.13960113960114,0.0235042735042735,0.00534188034188034,1082,0.385327635327635,1726,0.614672364672365
"E02005848",4,109,466,1016,422,122,51,2190,0.00182648401826484,0.0497716894977169,0.212785388127854,0.463926940639269,0.192694063926941,0.0557077625570776,0.0232876712328767,579,0.264383561643836,1611,0.735616438356164
"E02005849",8,317,453,1145,862,388,129,3302,0.00242277407631738,0.0960024227740763,0.137189582071472,0.346759539672925,0.261053906723198,0.117504542701393,0.0390672319806178,778,0.235614778921866,2524,0.764385221078134
"E02005850",4,196,459,979,456,94,16,2204,0.00181488203266788,0.088929219600726,0.208257713248639,0.444192377495463,0.206896551724138,0.0426497277676951,0.00725952813067151,659,0.299001814882033,1545,0.700998185117967
"E02005851",3,345,875,1024,334,68,14,2663,0.00112654900488171,0.129553135561397,0.328576793090499,0.384528726999624,0.125422455876831,0.0255351107773188,0.00525722868944799,1223,0.459256477656778,1440,0.540743522343222
"E02005852",8,494,675,1176,407,69,17,2846,0.0028109627547435,0.173576950105411,0.237174982431483,0.413211524947294,0.143007730147576,0.0242445537596627,0.00597329585382994,1177,0.413562895291637,1669,0.586437104708363
"E02005853",5,194,1054,1379,428,101,13,3174,0.0015752993068683,0.0611216131064902,0.332073093887839,0.434467548834279,0.134845620667927,0.0318210459987398,0.00409577819785759,1253,0.394770006301197,1921,0.605229993698803
"E02005856",4,81,542,999,489,104,4,2223,0.00179937022042285,0.0364372469635627,0.243814664867296,0.449392712550607,0.219973009446694,0.0467836257309941,0.00179937022042285,627,0.282051282051282,1596,0.717948717948718
"E02005857",11,302,587,1093,410,71,10,2484,0.00442834138486312,0.121578099838969,0.236312399355878,0.440016103059581,0.165056360708535,0.0285829307568438,0.00402576489533011,900,0.36231884057971,1584,0.63768115942029
"E02005858",11,74,693,1296,569,94,15,2752,0.00399709302325581,0.0268895348837209,0.251816860465116,0.47093023255814,0.206758720930233,0.034156976744186,0.00545058139534884,778,0.282703488372093,1974,0.717296511627907
"E02005859",8,197,961,1518,635,113,19,3451,0.00231816864676905,0.0570849029266879,0.278470008693132,0.439872500724428,0.184004636337294,0.0327441321356129,0.0055056505360765,1166,0.337873080266589,2285,0.662126919733411
"E02005860",8,444,1401,1638,730,109,30,4360,0.0018348623853211,0.101834862385321,0.321330275229358,0.375688073394495,0.16743119266055,0.025,0.00688073394495413,1853,0.425,2507,0.575
"E02005861",0,483,530,943,362,59,15,2392,0,0.201923076923077,0.221571906354515,0.394230769230769,0.15133779264214,0.0246655518394649,0.00627090301003344,1013,0.423494983277592,1379,0.576505016722408
"E02005862",1,110,1005,1265,277,39,5,2702,0.000370096225018505,0.0407105847520355,0.371946706143597,0.468171724648409,0.102516654330126,0.0144337527757217,0.00185048112509252,1116,0.413027387120651,1586,0.586972612879349
"E02005863",8,199,492,1159,534,96,11,2499,0.00320128051220488,0.0796318527410964,0.1968787515006,0.463785514205682,0.213685474189676,0.0384153661464586,0.00440176070428171,699,0.279711884753902,1800,0.720288115246098
"E02005864",3,60,908,1159,331,50,2,2513,0.00119379228014326,0.0238758456028651,0.361321130123359,0.461201750895344,0.131715081575806,0.0198965380023876,0.000795861520095503,971,0.386390768006367,1542,0.613609231993633
"E02005865",9,508,708,1095,391,77,24,2812,0.00320056899004267,0.180654338549075,0.251778093883357,0.389402560455192,0.139046941678521,0.0273826458036984,0.0085348506401138,1225,0.435633001422475,1587,0.564366998577525
"E02005866",20,607,965,1321,351,75,11,3350,0.00597014925373134,0.181194029850746,0.288059701492537,0.394328358208955,0.104776119402985,0.0223880597014925,0.00328358208955224,1592,0.475223880597015,1758,0.524776119402985
"E02005868",2,203,902,916,359,69,12,2463,0.000812017864393017,0.0824198132358912,0.366220056841251,0.371904181892002,0.145757206658546,0.0280146163215591,0.0048721071863581,1107,0.449451887941535,1356,0.550548112058465
"E02005869",20,81,928,960,289,48,10,2336,0.00856164383561644,0.0346746575342466,0.397260273972603,0.410958904109589,0.123715753424658,0.0205479452054795,0.00428082191780822,1029,0.440496575342466,1307,0.559503424657534
"E02005870",5,154,921,1121,475,75,16,2767,0.00180701120346946,0.0556559450668594,0.332851463679075,0.405131911817853,0.171666064329599,0.0271051680520419,0.00578243585110228,1080,0.390314419949404,1687,0.609685580050596
"E02005871",4,319,860,980,244,25,3,2435,0.00164271047227926,0.131006160164271,0.353182751540041,0.402464065708419,0.100205338809035,0.0102669404517454,0.00123203285420945,1183,0.485831622176591,1252,0.514168377823409
"E02005872",26,692,563,883,373,85,12,2634,0.00987091875474563,0.262718299164768,0.213743356112377,0.335231586940015,0.141609719058466,0.0322703113135915,0.00455580865603645,1281,0.486332574031891,1353,0.513667425968109
"E02005873",2,170,696,1418,665,174,14,3139,0.000637145587766805,0.0541573749601784,0.221726664542848,0.451736221726665,0.211850907932463,0.055431666135712,0.00446001911436763,868,0.276521185090793,2271,0.723478814909207
"E02005874",3,222,753,1195,708,145,15,3041,0.000986517592897073,0.0730023018743834,0.247615915817165,0.392962841170668,0.232818151923709,0.0476816836566919,0.00493258796448537,978,0.321604735284446,2063,0.678395264715554
"E02005875",59,927,701,1095,391,64,3,3240,0.0182098765432099,0.286111111111111,0.216358024691358,0.337962962962963,0.120679012345679,0.0197530864197531,0.000925925925925926,1687,0.520679012345679,1553,0.479320987654321
"E02005876",2,266,840,1307,591,124,15,3145,0.000635930047694754,0.0845786963434022,0.267090620031797,0.415580286168521,0.1879173290938,0.0394276629570747,0.00476947535771065,1108,0.352305246422894,2037,0.647694753577106
"E02005877",3,96,748,1179,541,93,8,2668,0.00112443778110945,0.0359820089955022,0.280359820089955,0.441904047976012,0.202773613193403,0.0348575712143928,0.00299850074962519,847,0.317466266866567,1821,0.682533733133433
"E02005878",3,133,1272,1800,794,153,12,4167,0.000719942404607631,0.0319174466042717,0.305255579553636,0.431965442764579,0.190544756419486,0.0367170626349892,0.00287976961843053,1408,0.337892968562515,2759,0.662107031437485
"E02005879",67,178,1108,1661,706,109,14,3843,0.0174342961228207,0.0463179807442103,0.28831641946396,0.432214415820973,0.183710642727036,0.0283632578714546,0.00364298724954463,1353,0.352068696330991,2490,0.647931303669009
"E02005880",25,152,768,826,232,38,6,2047,0.0122129946262824,0.0742550073277968,0.375183194919394,0.403517342452369,0.1133365901319,0.0185637518319492,0.00293111871030777,945,0.461651196873473,1102,0.538348803126527
"E02005881",27,221,990,934,273,52,5,2502,0.0107913669064748,0.0883293365307754,0.39568345323741,0.37330135891287,0.109112709832134,0.0207833733013589,0.00199840127897682,1238,0.49480415667466,1264,0.50519584332534
"E02005882",2,149,726,1131,290,35,3,2336,0.000856164383561644,0.0637842465753425,0.310787671232877,0.48416095890411,0.124143835616438,0.0149828767123288,0.00128424657534247,877,0.375428082191781,1459,0.624571917808219
"E02005883",5,289,1314,1118,384,59,24,3193,0.00156592546194801,0.0905104917005951,0.411525211399937,0.350140933291575,0.120263075477607,0.0184779204509865,0.00751644221735045,1608,0.50360162856248,1585,0.49639837143752
"E02005884",1,62,555,996,384,53,10,2061,0.000485201358563804,0.0300824842309558,0.269286754002911,0.483260553129549,0.186317321688501,0.0257156720038816,0.00485201358563804,618,0.299854439592431,1443,0.700145560407569
"E02005885",11,485,934,1285,415,74,7,3211,0.00342572407349735,0.151043288695111,0.290875116786048,0.400186857676736,0.129243226409218,0.0230457801308004,0.00218000622858922,1430,0.445344129554656,1781,0.554655870445344
"E02005886",10,608,1331,1513,361,44,6,3873,0.00258197779499096,0.156984249935451,0.343661244513297,0.390653240382133,0.0932093983991738,0.0113607022979602,0.00154918667699458,1949,0.503227472243739,1924,0.496772527756261
"E02005887",33,523,1357,2040,937,155,24,5069,0.00651015979483133,0.1031761688696,0.267705661866246,0.4024462418623,0.184849082659302,0.0305780232787532,0.00473466166896824,1913,0.377391990530677,3156,0.622608009469323
"E02005888",3,299,1326,1510,525,86,14,3763,0.000797236247674728,0.0794578793515812,0.35237842147223,0.40127557799628,0.139516343343077,0.0228541057666755,0.00372043582248206,1628,0.432633537071485,2135,0.567366462928514
"E02005889",8,176,1375,1436,370,57,8,3430,0.00233236151603499,0.0513119533527697,0.400874635568513,0.41865889212828,0.107871720116618,0.0166180758017493,0.00233236151603499,1559,0.454518950437318,1871,0.545481049562682
"E02005890",0,79,431,1040,300,45,1,1896,0,0.0416666666666667,0.227320675105485,0.548523206751055,0.158227848101266,0.0237341772151899,0.000527426160337553,510,0.268987341772152,1386,0.731012658227848
"E02005891",6,167,1594,813,202,31,8,2821,0.0021269053527118,0.0591988656504786,0.565047855370436,0.288195675292449,0.0716058135412974,0.010989010989011,0.00283587380361574,1767,0.626373626373626,1054,0.373626373626374
"E02005892",7,1049,1629,1572,543,105,14,4919,0.00142305346615166,0.213254726570441,0.331164870908721,0.319577149827201,0.110388290302907,0.0213458019922749,0.00284610693230331,2685,0.545842650945314,2234,0.454157349054686
"E02005893",39,885,1603,1642,596,113,29,4907,0.00794782963113919,0.180354595475851,0.326676176890157,0.334624006521296,0.121459140004076,0.0230283268799674,0.00590992459751376,2527,0.514978601997147,2380,0.485021398002853
"E02005894",12,1314,1473,1578,315,55,11,4758,0.00252206809583859,0.276166456494325,0.309583858764187,0.331651954602774,0.0662042875157629,0.0115594787725935,0.00231189575451871,2799,0.588272383354351,1959,0.411727616645649
"E02005895",48,214,484,911,711,287,60,2715,0.0176795580110497,0.0788213627992634,0.178268876611418,0.335543278084715,0.261878453038674,0.105709023941068,0.0220994475138122,746,0.274769797421731,1969,0.725230202578269
"E02005896",29,332,744,1052,393,171,37,2758,0.0105148658448151,0.12037708484409,0.269760696156635,0.381435823060189,0.142494561276287,0.0620014503263234,0.0134155184916606,1105,0.40065264684554,1653,0.59934735315446
"E02005897",30,754,881,1267,503,112,36,3583,0.00837287189506001,0.210438180295841,0.245883337984929,0.353614289701368,0.140385152107173,0.0312587217415574,0.010047446274072,1665,0.46469439017583,1918,0.53530560982417
"E02005898",24,513,1519,1724,447,81,15,4323,0.00555170020818876,0.118667591950035,0.351376359009947,0.398797131621559,0.103400416377516,0.0187369882026371,0.00346981263011797,2056,0.47559565116817,2267,0.52440434883183
"E02005899",5,433,2035,2110,1062,193,35,5873,0.000851353652307168,0.0737272262898008,0.346500936489018,0.359271241273625,0.180827515750043,0.0328622509790567,0.00595947556615018,2473,0.421079516431126,3400,0.578920483568875
"E02005900",8,306,758,1152,383,72,16,2695,0.00296846011131725,0.113543599257885,0.28126159554731,0.427458256029685,0.142115027829314,0.0267161410018553,0.00593692022263451,1072,0.397773654916512,1623,0.602226345083488
"E02005901",2,470,1062,1765,728,112,9,4148,0.000482160077145612,0.113307618129219,0.25602700096432,0.425506268081003,0.175506268081003,0.0270009643201543,0.00216972034715526,1534,0.369816779170685,2614,0.630183220829315
"E02005902",8,203,1169,1390,364,42,12,3188,0.00250941028858218,0.0636762860727729,0.366687578419072,0.436010037641154,0.114178168130489,0.0131744040150565,0.00376411543287327,1380,0.432873274780427,1808,0.567126725219573
"E02005903",9,605,1040,1713,467,72,12,3918,0.00229709035222052,0.154415518121491,0.265441551812149,0.437212863705972,0.119193466054109,0.0183767228177642,0.00306278713629403,1654,0.42215416028586,2264,0.57784583971414
"E02005904",53,1146,1410,937,330,104,24,4004,0.0132367632367632,0.286213786213786,0.352147852147852,0.234015984015984,0.0824175824175824,0.025974025974026,0.00599400599400599,2609,0.651598401598402,1395,0.348401598401598
"E02005905",9,136,555,704,277,92,22,1795,0.00501392757660167,0.0757660167130919,0.309192200557103,0.392200557103064,0.154317548746518,0.0512534818941504,0.0122562674094708,700,0.389972144846797,1095,0.610027855153203
"E02005906",19,231,583,806,337,121,25,2122,0.00895381715362865,0.108859566446748,0.274740810556079,0.379830348727615,0.158812441093308,0.0570216776625825,0.0117813383600377,833,0.392554194156456,1289,0.607445805843544
"E02005907",21,1012,1718,1409,311,54,6,4531,0.00463473846832929,0.223350253807107,0.379165747075701,0.310968881041713,0.0686382696976385,0.011917898918561,0.00132421099095122,2751,0.607150739351137,1780,0.392849260648863
"E02005908",39,664,1142,1253,445,105,18,3666,0.0106382978723404,0.181123840698309,0.311511183851609,0.341789416257501,0.121385706492089,0.0286415711947627,0.00490998363338789,1845,0.503273322422259,1821,0.496726677577741
"E02005909",28,102,513,1160,792,130,19,2744,0.0102040816326531,0.0371720116618076,0.186953352769679,0.422740524781341,0.288629737609329,0.0473760932944606,0.00692419825072886,643,0.23432944606414,2101,0.76567055393586
"E02005910",9,210,1302,1714,1023,187,30,4475,0.00201117318435754,0.046927374301676,0.290949720670391,0.383016759776536,0.228603351955307,0.0417877094972067,0.00670391061452514,1521,0.339888268156425,2954,0.660111731843575
"E02005911",5,136,1003,1190,278,55,4,2671,0.00187195806813927,0.0509172594533882,0.375514788468738,0.445526020217147,0.104080868588544,0.020591538749532,0.00149756645451142,1144,0.428304005990266,1527,0.571695994009734
"E02005912",16,441,1051,1332,370,66,7,3283,0.00487359122753579,0.134328358208955,0.320134023758757,0.405726469692355,0.112701797136765,0.0201035638135851,0.00213219616204691,1508,0.459335973195248,1775,0.540664026804752
"E02005913",63,1628,806,856,351,75,7,3786,0.0166402535657686,0.43000528262018,0.212889593238246,0.226096143687269,0.0927099841521395,0.0198098256735341,0.00184891706286318,2497,0.659535129424194,1289,0.340464870575806
"E02005914",12,580,1027,975,215,35,7,2851,0.00420904945633111,0.203437390389337,0.360224482637671,0.341985268326903,0.0754121360925991,0.0122763942476324,0.00245527884952648,1619,0.567870922483339,1232,0.432129077516661
"E02005915",15,214,514,723,331,80,27,1904,0.0078781512605042,0.112394957983193,0.269957983193277,0.379726890756303,0.173844537815126,0.0420168067226891,0.0141806722689076,743,0.390231092436975,1161,0.609768907563025
"E02005916",12,843,1138,1045,422,86,7,3553,0.00337742752603434,0.237264283703912,0.32029271038559,0.294117647058824,0.118772867998874,0.0242048972699128,0.00197016605685336,1993,0.560934421615536,1560,0.439065578384464
"E02005917",14,431,314,769,375,113,24,2041,0.006859382655561,0.211170994610485,0.153846153846154,0.376776090151886,0.183733463988241,0.0553650171484566,0.0117589416952474,759,0.3718765311122,1281,0.627633512983831
"E02005918",7,363,576,791,211,36,5,1989,0.00351935646053293,0.182503770739065,0.289592760180996,0.397687280040221,0.106083459024635,0.0180995475113122,0.00251382604323781,946,0.475615887380593,1043,0.524384112619407
"E02005919",77,641,669,850,348,88,24,2697,0.028550241008528,0.237671486837227,0.248053392658509,0.315164998146088,0.129032258064516,0.0326288468668891,0.00889877641824249,1387,0.514275120504264,1310,0.485724879495736
"E02005920",17,994,574,886,408,97,29,3006,0.00565535595475715,0.330671989354624,0.190951430472389,0.294743845642049,0.135728542914172,0.0322687957418496,0.00964737192282102,1585,0.52727877578177,1420,0.472388556220892
"E02005921",46,1137,175,524,589,230,59,2760,0.0166666666666667,0.41195652173913,0.0634057971014493,0.189855072463768,0.213405797101449,0.0833333333333333,0.0213768115942029,1358,0.492028985507246,1402,0.507971014492754
"E02005922",25,447,1809,902,116,15,1,3315,0.00754147812971342,0.134841628959276,0.545701357466063,0.27209653092006,0.0349924585218703,0.00452488687782805,0.000301659125188537,2281,0.688084464555053,1034,0.311915535444947
"E02005923",2,61,856,739,189,20,5,1872,0.00106837606837607,0.0325854700854701,0.457264957264957,0.394764957264957,0.100961538461538,0.0106837606837607,0.00267094017094017,919,0.490918803418803,953,0.509081196581197
"E02005924",4,1046,2745,1905,548,49,17,6314,0.00063351282863478,0.165663604687995,0.434748178650618,0.301710484637314,0.0867912575229648,0.00776053215077605,0.00269242952169781,3795,0.601045296167247,2519,0.398954703832753
"E02005925",39,149,1234,991,160,18,4,2595,0.015028901734104,0.0574181117533719,0.475529865125241,0.381888246628131,0.0616570327552987,0.0069364161849711,0.00154142581888247,1422,0.547976878612717,1173,0.452023121387283
"E02005926",28,981,782,1220,396,59,5,3471,0.00806683952751368,0.282627484874676,0.225295303946989,0.351483722270239,0.114088159031979,0.0169979832901181,0.00144050705848459,1791,0.515989628349179,1680,0.484010371650821
"E02005927",1,306,741,794,180,18,1,2041,0.000489955903968643,0.149926506614405,0.363057324840764,0.389024987751102,0.0881920627143557,0.00881920627143557,0.000489955903968643,1048,0.513473787359138,993,0.486526212640862
"E02005928",46,1832,658,905,355,62,16,3874,0.0118740320082602,0.472896231285493,0.169850283944244,0.233608673205989,0.091636551368095,0.0160041300980898,0.00413009808982963,2536,0.654620547237997,1338,0.345379452762003
"E02005929",23,297,429,819,612,209,56,2445,0.00940695296523517,0.121472392638037,0.175460122699386,0.334969325153374,0.250306748466258,0.085480572597137,0.0229038854805726,749,0.306339468302658,1696,0.693660531697342
"E02005930",9,1394,783,1067,542,225,50,4070,0.00221130221130221,0.342506142506143,0.192383292383292,0.262162162162162,0.133169533169533,0.0552825552825553,0.0122850122850123,2186,0.537100737100737,1884,0.462899262899263
"E02005931",394,1055,961,1110,563,181,50,4314,0.091330551692165,0.244552619378767,0.222763096893834,0.257301808066759,0.130505331478906,0.0419564209550301,0.0115901715345387,2410,0.558646267964766,1904,0.441353732035234
"E02005932",1,49,1459,793,106,7,1,2416,0.000413907284768212,0.0202814569536424,0.603890728476821,0.328228476821192,0.0438741721854305,0.00289735099337748,0.000413907284768212,1509,0.624586092715232,907,0.375413907284768
"E02005933",5,204,1094,953,138,13,4,2411,0.00207382828701784,0.0846121941103277,0.453753629199502,0.395271671505599,0.0572376607216922,0.00539195354624637,0.00165906262961427,1303,0.540439651596848,1108,0.459560348403152
"E02005934",7,101,1100,1116,164,19,7,2514,0.00278440731901352,0.0401750198886237,0.437549721559268,0.443914081145585,0.0652346857597454,0.00755767700875099,0.00278440731901352,1208,0.480509148766905,1306,0.519490851233095
"E02005935",20,939,1810,1109,173,32,14,4097,0.00488162069807176,0.229192091774469,0.441786673175494,0.270685867708079,0.0422260190383207,0.00781059311691482,0.00341713448865023,2769,0.675860385648035,1328,0.324139614351965
"E02005936",108,1963,759,960,644,244,38,4716,0.0229007633587786,0.416242578456319,0.160941475826972,0.203562340966921,0.136556403731976,0.0517387616624258,0.00805767599660729,2830,0.60008481764207,1886,0.39991518235793
"E02005937",4,252,959,955,241,38,5,2454,0.00162999185004075,0.102689486552567,0.39079054604727,0.389160554197229,0.0982070089649552,0.0154849225753871,0.00203748981255094,1215,0.495110024449878,1239,0.504889975550122
"E02005938",1,143,663,729,190,21,5,1752,0.000570776255707763,0.08162100456621,0.378424657534247,0.416095890410959,0.108447488584475,0.011986301369863,0.00285388127853881,807,0.460616438356164,945,0.539383561643836
"E02005939",5,304,851,914,280,33,12,2399,0.00208420175072947,0.126719466444352,0.354731137974156,0.380992080033347,0.11671529804085,0.0137557315548145,0.00500208420175073,1160,0.483534806169237,1239,0.516465193830763
"E02005940",37,431,982,841,325,49,12,2677,0.0138214419125887,0.161001120657452,0.366828539409787,0.3141576391483,0.121404557340306,0.018304071722077,0.00448262980948823,1450,0.541651101979828,1227,0.458348898020172
"E02005941",6,276,1207,1012,412,49,13,2975,0.00201680672268908,0.0927731092436975,0.405714285714286,0.340168067226891,0.138487394957983,0.0164705882352941,0.00436974789915966,1489,0.500504201680672,1486,0.499495798319328
"E02005942",3,164,1051,747,343,76,12,2396,0.00125208681135225,0.0684474123539232,0.43864774624374,0.311769616026711,0.143155258764608,0.0317195325542571,0.00500834724540901,1218,0.508347245409015,1178,0.491652754590985
"E02005943",8,132,732,1049,233,28,7,2189,0.00365463682046597,0.0603015075376884,0.334399269072636,0.4792142530836,0.106441297396071,0.0127912288716309,0.00319780721790772,872,0.39835541343079,1317,0.60164458656921
"E02005944",97,639,1638,827,157,21,3,3382,0.0286812536960378,0.188941454760497,0.484328799526907,0.244529863985807,0.0464222353636901,0.0062093435836783,0.000887049083382614,2374,0.701951507983442,1008,0.298048492016558
"E02005945",3,395,1512,1423,489,66,20,3908,0.000767656090071648,0.1010747185261,0.386898669396111,0.364124872057318,0.125127942681679,0.0168884339815763,0.00511770726714432,1910,0.488741044012283,1998,0.511258955987718
"E02005946",5,126,1194,1400,389,55,10,3179,0.00157282164202579,0.03963510537905,0.37558980811576,0.440390059767222,0.122365523749607,0.0173010380622837,0.00314564328405159,1325,0.416797735136835,1854,0.583202264863165
"E02005947",0,442,1261,951,443,69,24,3190,0,0.138557993730408,0.395297805642633,0.298119122257053,0.138871473354232,0.0216300940438871,0.00752351097178683,1703,0.533855799373041,1487,0.466144200626959
"E02005948",10,505,1365,1177,368,46,12,3483,0.00287108814240597,0.144989951191502,0.391903531438415,0.337927074361183,0.10565604364054,0.0132070054550675,0.00344530577088717,1880,0.539764570772323,1603,0.460235429227677
"E02005949",17,230,1458,952,209,16,1,2883,0.00589663544918488,0.0797780090183836,0.505723204994797,0.330211585154353,0.0724939299340964,0.0055497745404093,0.000346860908775581,1705,0.591397849462366,1178,0.408602150537634
"E02005950",1,336,1609,2032,695,57,29,4759,0.000210128178188695,0.0706030678714016,0.33809623870561,0.426980458079428,0.146039083841143,0.0119773061567556,0.00609371716747216,1946,0.408909434755201,2813,0.591090565244799
"E02005951",0,99,1095,1000,286,34,13,2527,0,0.0391768895924021,0.433320142461417,0.395726157499011,0.113177681044717,0.0134546893549664,0.00514444004748714,1194,0.472497032053819,1333,0.527502967946181
"E02005953",0,40,667,1019,360,34,10,2130,0,0.0187793427230047,0.313145539906103,0.478403755868545,0.169014084507042,0.015962441314554,0.00469483568075117,707,0.331924882629108,1423,0.668075117370892
"E02005954",73,234,1252,1653,430,62,13,3717,0.0196394942157654,0.062953995157385,0.336830777508744,0.444713478611784,0.115684691955878,0.0166801183750336,0.00349744417541028,1559,0.419424266881894,2158,0.580575733118106
"E02005955",62,860,2029,1319,315,53,10,4648,0.0133390705679862,0.185025817555938,0.436531841652324,0.283777969018933,0.0677710843373494,0.0114027538726334,0.00215146299483649,2951,0.634896729776248,1697,0.365103270223752
"E02005956",7,94,1380,711,136,16,0,2344,0.00298634812286689,0.0401023890784983,0.588737201365188,0.303327645051195,0.0580204778156997,0.0068259385665529,0,1481,0.631825938566553,863,0.368174061433447
"E02005957",9,71,1699,640,160,3,2,2584,0.00348297213622291,0.0274767801857585,0.657507739938081,0.247678018575851,0.0619195046439628,0.0011609907120743,0.000773993808049536,1779,0.688467492260062,805,0.311532507739938
"E02005958",1,84,716,877,178,27,4,1887,0.000529941706412295,0.0445151033386327,0.379438261791203,0.464758876523582,0.0943296237413885,0.014308426073132,0.00211976682564918,801,0.424483306836248,1086,0.575516693163752
"E02005959",11,188,372,623,260,79,25,1558,0.00706033376123235,0.120667522464698,0.238767650834403,0.39987163029525,0.166880616174583,0.0507060333761232,0.0160462130937099,571,0.366495507060334,987,0.633504492939666
"E02005960",4,1009,856,810,274,46,9,3008,0.00132978723404255,0.335438829787234,0.284574468085106,0.269281914893617,0.0910904255319149,0.0152925531914894,0.00299202127659574,1869,0.621343085106383,1139,0.378656914893617
"E02005961",14,152,615,818,371,111,29,2110,0.00663507109004739,0.0720379146919431,0.291469194312796,0.387677725118483,0.175829383886256,0.05260663507109,0.0137440758293839,781,0.370142180094787,1329,0.629857819905213
"E02005962",10,1016,624,962,475,141,28,3256,0.00307125307125307,0.312039312039312,0.191646191646192,0.295454545454545,0.145884520884521,0.0433046683046683,0.0085995085995086,1650,0.506756756756757,1606,0.493243243243243
"E02005963",45,466,675,782,421,140,28,2557,0.0175987485334376,0.182244818146265,0.263981228001564,0.305827141181072,0.164646069612828,0.0547516621040282,0.0109503324208056,1186,0.463824794681267,1371,0.536175205318733
"E02005964",22,621,465,973,463,138,35,2717,0.00809716599190283,0.228560912771439,0.171144644828855,0.358115568641884,0.170408538829591,0.0507913139492087,0.0128818549871181,1108,0.407802723592197,1609,0.592197276407803
"E02005965",8,336,374,657,550,196,51,2172,0.00368324125230203,0.154696132596685,0.17219152854512,0.302486187845304,0.253222836095764,0.0902394106813996,0.0234806629834254,718,0.330570902394107,1454,0.669429097605893
"E02005966",17,600,1331,1404,184,9,2,3547,0.00479278263321116,0.169157034113335,0.375246687341415,0.395827459825204,0.0518748237947561,0.00253735551170003,0.000563856780377784,1948,0.549196504087962,1599,0.450803495912038
"E02005967",11,1520,1009,735,198,32,10,3515,0.00312944523470839,0.432432432432432,0.287055476529161,0.209103840682788,0.0563300142247511,0.00910384068278805,0.00284495021337127,2540,0.722617354196302,975,0.277382645803698
"E02005968",8,792,868,1005,388,137,31,3229,0.00247754722824404,0.24527717559616,0.268813874264478,0.311241870548157,0.120161040569836,0.0424279962836792,0.00960049550944565,1668,0.516568597088882,1561,0.483431402911118
"E02005969",17,860,1169,1289,462,100,20,3917,0.00434005616543273,0.219555782486597,0.298442685728874,0.329078376308399,0.117947408731172,0.0255297421496043,0.00510594842992086,2046,0.522338524380904,1871,0.477661475619096
"E02005970",2,126,889,902,230,19,4,2172,0.000920810313075506,0.0580110497237569,0.409300184162063,0.415285451197053,0.105893186003683,0.00874769797421731,0.00184162062615101,1017,0.468232044198895,1155,0.531767955801105
"E02005971",2,372,633,813,197,35,3,2055,0.00097323600973236,0.181021897810219,0.308029197080292,0.395620437956204,0.0958637469586375,0.0170316301703163,0.00145985401459854,1007,0.490024330900243,1048,0.509975669099757
"E02005972",23,1965,863,1047,456,119,21,4494,0.00511793502447708,0.437249666221629,0.192033822874944,0.232977303070761,0.101468624833111,0.0264797507788162,0.00467289719626168,2851,0.63440142412105,1643,0.36559857587895
"E02005973",3,157,881,1055,381,72,22,2571,0.00116686114352392,0.0610657331777518,0.342668222481525,0.410346168805912,0.148191365227538,0.0280046674445741,0.00855698171917542,1041,0.4049008168028,1530,0.595099183197199
"E02005974",5,299,830,1142,438,71,12,2797,0.00178762960314623,0.106900250268144,0.296746514122274,0.408294601358599,0.15659635323561,0.0253843403646764,0.00429031104755095,1134,0.405434393993565,1663,0.594565606006435
"E02005975",21,305,535,947,451,111,21,2391,0.00878293601003764,0.127561689669594,0.223755750731911,0.396068590547888,0.188624006691761,0.0464240903387704,0.00878293601003764,861,0.360100376411543,1530,0.639899623588457
"E02005976",14,475,337,649,402,163,31,2071,0.0067600193143409,0.229357798165138,0.162723322066634,0.313375181071946,0.194109126026074,0.0787059391598262,0.0149686141960406,826,0.398841139546113,1245,0.601158860453887
"E02005977",22,304,508,663,268,41,23,1829,0.0120284308365227,0.166211044286495,0.277747402952433,0.362493165664297,0.146528157463095,0.0224166211044287,0.0125751776927283,834,0.455986878075451,995,0.544013121924549
"E02005978",6,418,835,933,316,76,20,2604,0.00230414746543779,0.160522273425499,0.320660522273426,0.358294930875576,0.121351766513057,0.0291858678955453,0.00768049155145929,1259,0.483486943164363,1345,0.516513056835638
"E02005979",15,677,1024,1294,472,86,23,3591,0.00417710944026733,0.188526872737399,0.285157337788917,0.360345307713729,0.131439710387079,0.0239487607908661,0.00640490114174325,1716,0.477861319966583,1875,0.522138680033417
"E02005980",172,1275,1031,1324,417,111,36,4366,0.0393953275309208,0.292029317453046,0.236142922583601,0.30325240494732,0.0955107650022904,0.0254237288135593,0.00824553366926248,2478,0.567567567567568,1888,0.432432432432432
"E02005981",5,62,978,1231,182,14,1,2473,0.00202183582693085,0.0250707642539426,0.395471087747675,0.497775980590376,0.0735948241002831,0.00566114031540639,0.000404367165386171,1045,0.422563687828548,1428,0.577436312171452
"E02005982",1,40,807,861,186,22,7,1924,0.00051975051975052,0.0207900207900208,0.419438669438669,0.447505197505198,0.0966735966735967,0.0114345114345114,0.00363825363825364,848,0.440748440748441,1076,0.559251559251559
"E02005983",4,574,2412,1590,462,76,20,5138,0.000778513040093422,0.111716621253406,0.469443363176333,0.309458933437135,0.0899182561307902,0.014791747761775,0.00389256520046711,2990,0.581938497469833,2148,0.418061502530167
"E02005984",26,1208,564,849,511,162,47,3368,0.00771971496437055,0.358669833729216,0.167458432304038,0.2520783847981,0.151722090261283,0.0480997624703088,0.0139548693586698,1798,0.533847980997625,1569,0.465855106888361
"E02005985",6,306,1489,998,155,15,0,2969,0.00202088245200404,0.103065005052206,0.501515661839003,0.336140114516672,0.0522061300101044,0.0050522061300101,0,1801,0.606601549343213,1168,0.393398450656787
"E02005986",21,1221,1470,1303,503,120,24,4662,0.0045045045045045,0.261904761904762,0.315315315315315,0.27949377949378,0.107893607893608,0.0257400257400257,0.00514800514800515,2712,0.581724581724582,1950,0.418275418275418
"E02005987",22,1455,1051,1009,313,47,9,3906,0.00563236047107015,0.372503840245776,0.269073220686124,0.258320532514081,0.0801331285202253,0.0120327700972862,0.00230414746543779,2528,0.64720942140297,1378,0.35279057859703
"E02005988",35,1783,938,933,158,12,2,3861,0.00906500906500906,0.461797461797462,0.242942242942243,0.241647241647242,0.0409220409220409,0.00310800310800311,0.000518000518000518,2756,0.713804713804714,1105,0.286195286195286
"E02005991",67,1015,1348,1255,371,59,18,4133,0.0162109847568352,0.245584321316235,0.32615533510767,0.303653520445197,0.0897653036535205,0.0142753447858698,0.00435518993467215,2430,0.58795064118074,1703,0.41204935881926
"E02005992",27,2296,1253,1161,644,161,35,5577,0.00484131253362023,0.411690873229335,0.224672763134302,0.20817643894567,0.115474269320423,0.0288685673301058,0.00627577550654474,3576,0.641204948897257,2001,0.358795051102743
"E02005993",10,758,1082,955,375,43,15,3238,0.00308832612723904,0.234095120444719,0.334156886967264,0.294935145151328,0.115812229771464,0.0132798023471279,0.00463248919085855,1850,0.571340333539222,1388,0.428659666460778
"E02005994",4,149,543,735,662,227,80,2400,0.00166666666666667,0.0620833333333333,0.22625,0.30625,0.275833333333333,0.0945833333333333,0.0333333333333333,696,0.29,1704,0.71
"E02005995",9,316,514,841,527,183,40,2430,0.0037037037037037,0.130041152263374,0.211522633744856,0.346090534979424,0.216872427983539,0.0753086419753086,0.0164609053497942,839,0.345267489711934,1591,0.654732510288066
"E02005996",16,750,833,1137,679,154,46,3615,0.00442600276625173,0.20746887966805,0.230428769017981,0.314522821576763,0.187828492392808,0.0426002766251729,0.0127247579529737,1599,0.442323651452282,2016,0.557676348547718
"E02005997",1,361,570,814,345,76,27,2194,0.000455788514129444,0.164539653600729,0.259799453053783,0.371011850501367,0.157247037374658,0.0346399270738377,0.012306289881495,932,0.424794895168642,1262,0.575205104831358
"E02005998",7,689,587,774,280,57,10,2404,0.00291181364392679,0.286605657237937,0.244176372712146,0.321963394342762,0.116472545757072,0.0237104825291181,0.00415973377703827,1283,0.53369384359401,1121,0.46630615640599
"E02005999",27,465,494,697,348,117,28,2176,0.0124080882352941,0.213694852941176,0.227022058823529,0.3203125,0.159926470588235,0.0537683823529412,0.0128676470588235,986,0.453125,1190,0.546875
"E02006000",4,350,2091,1287,332,43,7,4114,0.000972289742343218,0.0850753524550316,0.508264462809917,0.31283422459893,0.0807000486144871,0.0104521147301896,0.00170150704910063,2445,0.594312105007292,1669,0.405687894992708
"E02006001",3,1170,870,781,111,6,0,2941,0.00102006120367222,0.397823869432166,0.295817749064944,0.265555933356001,0.0377422645358721,0.00204012240734444,0,2043,0.694661679700782,898,0.305338320299218
"E02006002",2,896,1987,1310,425,56,20,4696,0.000425894378194208,0.190800681431005,0.423126064735945,0.278960817717206,0.0905025553662692,0.0119250425894378,0.00425894378194208,2885,0.614352640545145,1811,0.385647359454855
"E02006003",5,520,565,681,330,59,16,2176,0.00229779411764706,0.238970588235294,0.259650735294118,0.312959558823529,0.151654411764706,0.0271139705882353,0.00735294117647059,1090,0.500919117647059,1086,0.499080882352941
"E02006004",38,716,494,689,689,292,69,2987,0.0127217944425845,0.239705390023435,0.165383327753599,0.230666220287914,0.230666220287914,0.0977569467693338,0.0231001004352193,1248,0.417810512219618,1739,0.582189487780382
"E02006005",10,884,2376,942,129,12,4,4357,0.00229515721826945,0.20289189809502,0.545329355060822,0.216203809960982,0.0296075281156759,0.00275418866192334,0.000918062887307781,3270,0.750516410374111,1087,0.249483589625889
"E02006006",9,316,919,736,184,20,5,2189,0.00411146642302421,0.144358154408406,0.419826404751028,0.336226587482869,0.0840566468707172,0.00913659205116491,0.00228414801279123,1244,0.568296025582458,945,0.431703974417542
"E02006007",24,541,625,817,387,133,30,2557,0.0093859992178334,0.211576065701995,0.244427062964411,0.319515056707079,0.151349237387564,0.0520140789988267,0.0117324990222917,1190,0.465389127884239,1367,0.534610872115761
"E02006008",4,1446,1117,1307,360,107,39,4380,0.00091324200913242,0.33013698630137,0.255022831050228,0.298401826484018,0.0821917808219178,0.0244292237442922,0.0089041095890411,2567,0.586073059360731,1813,0.413926940639269
"E02006009",11,224,743,1198,324,101,33,2634,0.00417615793470008,0.085041761579347,0.282080485952923,0.454821564160972,0.123006833712984,0.0383447228549734,0.0125284738041002,978,0.37129840546697,1656,0.62870159453303
"E02006010",12,483,1393,1656,793,222,84,4643,0.00258453586043506,0.104027568382511,0.300021537798837,0.356665948740039,0.170794744777084,0.0478139134180487,0.0180917510230454,1888,0.406633642041783,2755,0.593366357958217
"E02006011",8,166,676,959,316,78,16,2219,0.00360522757999099,0.074808472284813,0.304641730509238,0.43217665615142,0.142406489409644,0.0351509689049121,0.00721045515998197,850,0.383055430374042,1369,0.616944569625958
"E02006012",3,121,719,1116,422,107,33,2521,0.00119000396667989,0.0479968266560889,0.28520428401428,0.442681475604919,0.167393891312971,0.0424434748115827,0.0130900436334788,843,0.334391114637049,1678,0.665608885362951
"E02006013",31,87,266,818,761,368,146,2477,0.0125151392813888,0.035123132821962,0.107387969317723,0.330238191360517,0.307226483649576,0.148566814695196,0.0589422688736375,384,0.155026241421074,2093,0.844973758578926
"E02006014",14,238,497,1082,693,271,131,2926,0.00478468899521531,0.0813397129186603,0.169856459330144,0.369788106630212,0.236842105263158,0.0926179084073821,0.044771018455229,749,0.255980861244019,2177,0.744019138755981
"E02006015",25,750,1366,1443,503,120,51,4258,0.0058713010803194,0.176139032409582,0.320807891028652,0.338891498356036,0.118130577736026,0.0281822451855331,0.0119774542038516,2141,0.502818224518553,2117,0.497181775481447
"E02006016",15,275,609,825,806,347,99,2976,0.00504032258064516,0.0924059139784946,0.204637096774194,0.277217741935484,0.270833333333333,0.116599462365591,0.0332661290322581,899,0.302083333333333,2077,0.697916666666667
"E02006017",36,483,779,975,453,179,77,2982,0.0120724346076459,0.161971830985915,0.261234071093226,0.326961770623742,0.151911468812877,0.0600268276324614,0.0258215962441315,1298,0.435278336686787,1684,0.564721663313213
"E02006018",24,560,1643,1765,497,85,26,4600,0.00521739130434783,0.121739130434783,0.357173913043478,0.383695652173913,0.10804347826087,0.0184782608695652,0.00565217391304348,2227,0.484130434782609,2373,0.515869565217391
"E02006019",2,305,797,938,307,69,19,2437,0.000820681165367255,0.125153877718506,0.327041444398851,0.384899466557242,0.125974558883874,0.0283135002051703,0.00779647107098892,1104,0.453016003282725,1333,0.546983996717275
"E02006020",15,134,616,812,469,215,74,2335,0.00642398286937901,0.0573875802997859,0.263811563169165,0.347751605995717,0.200856531049251,0.0920770877944325,0.0316916488222698,765,0.32762312633833,1570,0.67237687366167
"E02006021",9,535,632,870,567,273,105,2991,0.00300902708124373,0.178869943162822,0.211300568371782,0.290872617853561,0.189568706118355,0.0912738214643932,0.0351053159478435,1176,0.393179538615848,1815,0.606820461384152
"E02006022",13,197,405,681,431,132,57,1916,0.00678496868475992,0.102818371607516,0.211377870563674,0.355427974947808,0.224947807933194,0.0688935281837161,0.0297494780793319,615,0.32098121085595,1301,0.67901878914405
"E02006023",54,549,1226,1286,447,183,65,3810,0.0141732283464567,0.144094488188976,0.321784776902887,0.33753280839895,0.117322834645669,0.0480314960629921,0.0170603674540682,1829,0.48005249343832,1981,0.51994750656168
"E02006024",2,267,1699,1531,276,34,12,3821,0.000523423187647213,0.0698769955509029,0.444647997906307,0.400680450143941,0.0722323998953154,0.00889819419000262,0.00314053912588328,1968,0.515048416644857,1853,0.484951583355143
"E02006025",12,499,1438,1473,680,137,56,4295,0.00279394644935972,0.116181606519208,0.334807916181607,0.342956926658906,0.158323632130384,0.0318975552968568,0.0130384167636787,1949,0.453783469150175,2346,0.546216530849825
"E02006026",20,356,579,919,431,170,66,2541,0.00787091696182605,0.140102321920504,0.227863046044864,0.361668634395907,0.169618260527351,0.0669027941755214,0.025974025974026,955,0.375836284927194,1586,0.624163715072806
"E02006027",17,92,279,598,433,228,111,1758,0.00967007963594994,0.0523321956769056,0.158703071672355,0.340159271899886,0.246302616609784,0.129692832764505,0.0631399317406143,388,0.22070534698521,1370,0.77929465301479
"E02006028",77,614,641,1036,666,279,114,3427,0.022468631456084,0.179165450831631,0.187044061861687,0.302305223227313,0.194339072074701,0.0814123139772396,0.0332652465713452,1332,0.388678144149402,2095,0.611321855850598
"E02006029",1,104,1325,912,142,27,7,2518,0.00039714058776807,0.0413026211278793,0.526211278792693,0.36219221604448,0.0563939634630659,0.0107227958697379,0.00277998411437649,1430,0.56791104050834,1088,0.43208895949166
"E02006030",2,471,1076,861,196,27,7,2640,0.000757575757575758,0.178409090909091,0.407575757575758,0.326136363636364,0.0742424242424242,0.0102272727272727,0.00265151515151515,1549,0.586742424242424,1091,0.413257575757576
"E02006031",2,556,1428,1233,461,61,20,3761,0.000531773464504121,0.147833023132146,0.379686253655943,0.327838340866791,0.1225737835682,0.0162190906673757,0.00531773464504121,1986,0.528051050252592,1775,0.471948949747408
"E02006032",33,167,1262,1127,240,45,11,2885,0.0114384748700173,0.0578856152512998,0.437435008665511,0.390641247833622,0.0831889081455806,0.0155979202772964,0.00381282495667244,1462,0.506759098786828,1423,0.493240901213172
"E02006033",7,829,1530,1516,779,129,65,4855,0.00144181256436663,0.170751802265705,0.31513903192585,0.312255406797116,0.160453141091658,0.0265705458290422,0.0133882595262616,2366,0.487332646755922,2489,0.512667353244078
"E02006034",15,1008,1320,1520,313,47,8,4231,0.00354526116757268,0.238241550460884,0.311982982746396,0.359253131647365,0.0739777830300166,0.0111084849917277,0.00189080595603876,2343,0.553769794374852,1888,0.446230205625148
"E02006035",19,712,558,853,222,46,9,2419,0.00785448532451426,0.294336502687061,0.23067383216205,0.352625051674246,0.0917734601074824,0.0190161223646135,0.00372054568003307,1289,0.532864820173625,1130,0.467135179826375
"E02006036",27,903,837,1069,356,55,19,3266,0.00826699326393142,0.276484996938151,0.256276791181874,0.327311696264544,0.109001837109614,0.016840171463564,0.00581751377832211,1767,0.541028781383956,1499,0.458971218616044
"E02006037",27,331,978,1263,378,81,16,3074,0.00878334417696812,0.107677293428757,0.318152244632401,0.410865322055953,0.122966818477554,0.0263500325309044,0.00520494469746259,1336,0.434612882238126,1738,0.565387117761874
"E02006038",38,585,630,997,453,131,51,2885,0.0131715771230503,0.202772963604853,0.218370883882149,0.345580589254766,0.157019064124783,0.0454072790294627,0.0176776429809359,1253,0.434315424610052,1632,0.565684575389948
"E02006039",47,571,673,959,456,125,42,2873,0.0163592064044553,0.198746954403063,0.234249912982945,0.333797424295162,0.158719108945353,0.0435085276714236,0.0146188652975983,1291,0.449356073790463,1582,0.550643926209537
"E02006040",62,178,475,724,632,296,131,2498,0.0248198558847078,0.0712570056044836,0.190152121697358,0.289831865492394,0.253002401921537,0.118494795836669,0.0524419535628503,715,0.286228983186549,1783,0.713771016813451
"E02006041",26,110,250,602,557,276,139,1960,0.013265306122449,0.0561224489795918,0.127551020408163,0.307142857142857,0.284183673469388,0.140816326530612,0.0709183673469388,386,0.196938775510204,1574,0.803061224489796
"E02006042",8,277,662,795,377,114,64,2297,0.00348280365694384,0.12059207662168,0.288202002612103,0.346103613408794,0.164127122333478,0.0496299521114497,0.0278624292555507,947,0.412276882890727,1350,0.587723117109273
"E02006043",15,140,484,754,623,286,127,2429,0.00617538081515027,0.0576368876080692,0.199258954302182,0.310415808974887,0.256484149855908,0.117743927542198,0.0522848909016056,639,0.263071222725401,1790,0.736928777274599
"E02006044",13,63,234,561,618,399,216,2104,0.0061787072243346,0.0299429657794677,0.111216730038023,0.266634980988593,0.293726235741445,0.189638783269962,0.102661596958175,310,0.147338403041825,1794,0.852661596958175
"E02006045",9,568,1507,1706,634,162,59,4645,0.00193756727664155,0.122282023681378,0.32443487621098,0.367276641550054,0.136490850376749,0.0348762109795479,0.0127018299246502,2084,0.448654467168999,2561,0.551345532831001
"E02006046",11,192,573,906,712,357,132,2883,0.00381546999653139,0.0665972944849116,0.198751300728408,0.314255983350676,0.246964967048214,0.123829344432882,0.0457856399583767,776,0.269164065209851,2107,0.730835934790149
"E02006047",64,341,707,965,708,276,82,3143,0.0203627107858734,0.108495068405982,0.224944320712695,0.307031498568247,0.225262488068724,0.0878141902640789,0.0260897231944003,1112,0.35380209990455,2031,0.64619790009545
"E02006048",11,231,509,888,435,126,23,2223,0.00494826810616284,0.10391363022942,0.228969860548808,0.399460188933873,0.195681511470985,0.0566801619433198,0.0103463787674314,751,0.33783175888439,1472,0.662168241115609
"E02006049",7,80,1020,937,209,29,11,2293,0.00305276929786306,0.0348887919755778,0.444832097688618,0.408634976013956,0.0911469690361971,0.012647187091147,0.00479720889664195,1107,0.482773658962058,1186,0.517226341037942
"E02006050",16,552,1469,1355,534,85,36,4047,0.00395354583642204,0.13639733135656,0.362984927106499,0.334815913021992,0.131949592290586,0.0210032122559921,0.00889547813194959,2037,0.503335804299481,2010,0.496664195700519
"E02006051",12,851,582,989,552,168,57,3211,0.00373715353472438,0.265026471504204,0.181251946434133,0.308003737153535,0.171909062597322,0.0523201494861414,0.0177514792899408,1445,0.450015571473061,1766,0.549984428526939
"E02006052",11,164,709,1022,576,155,53,2690,0.00408921933085502,0.0609665427509294,0.263568773234201,0.379925650557621,0.214126394052045,0.0576208178438662,0.0197026022304833,884,0.328624535315985,1806,0.671375464684015
"E02006053",35,1089,1546,1299,406,60,16,4451,0.00786340148281285,0.244664120422377,0.347337676926533,0.291844529319254,0.0912154572006291,0.0134801168276792,0.00359469782071445,2670,0.599865198831723,1781,0.400134801168277
"E02006054",8,548,1396,1356,480,71,25,3884,0.00205973223480947,0.141091658084449,0.359423274974253,0.349124613800206,0.123583934088568,0.0182801235839341,0.00643666323377961,1952,0.502574665293512,1932,0.497425334706488
"E02006055",5,319,1533,1093,401,66,17,3434,0.00145602795573675,0.0928945835760047,0.446418171228888,0.318287711124054,0.116773442050087,0.0192195690157251,0.00495049504950495,1857,0.540768782760629,1577,0.459231217239371
"E02006056",49,325,486,912,668,239,77,2756,0.0177793904208999,0.117924528301887,0.176342525399129,0.330914368650218,0.242380261248186,0.0867198838896952,0.0279390420899855,860,0.312046444121916,1896,0.687953555878084
"E02006057",9,553,1414,1168,409,82,21,3656,0.0024617067833698,0.151258205689278,0.386761487964989,0.319474835886214,0.111870897155361,0.0224288840262582,0.00574398249452954,1976,0.540481400437637,1680,0.459518599562363
"E02006058",4,230,754,1001,361,109,36,2495,0.00160320641282565,0.0921843687374749,0.302204408817635,0.401202404809619,0.144689378757515,0.043687374749499,0.0144288577154309,988,0.395991983967936,1507,0.604008016032064
"E02006059",20,201,391,734,614,244,81,2285,0.0087527352297593,0.087964989059081,0.171115973741794,0.321225382932166,0.268708971553611,0.106783369803063,0.0354485776805252,612,0.267833698030635,1673,0.732166301969365
"E02006060",10,554,1454,1079,375,66,20,3558,0.00281056773468241,0.155705452501405,0.408656548622822,0.303260258572232,0.10539629005059,0.0185497470489039,0.00562113546936481,2018,0.56717256885891,1540,0.432827431141091
"E02006061",51,654,1061,1402,572,136,29,3905,0.0130601792573624,0.167477592829706,0.271702944942382,0.359026888604353,0.146478873239437,0.0348271446862996,0.00742637644046095,1766,0.452240717029449,2139,0.547759282970551
"E02006062",17,393,1034,1576,582,191,41,3834,0.004434011476265,0.102503912363067,0.269692227438706,0.411058946270214,0.151799687010955,0.0498174230568597,0.0106937923839332,1444,0.376630151278039,2390,0.623369848721961
"E02006063",32,239,334,858,555,275,64,2357,0.013576580398812,0.101400084853627,0.141705557912601,0.364022061943148,0.235468816291896,0.116673737802291,0.0271531607976241,605,0.25668222316504,1752,0.74331777683496
"E02006064",7,145,1221,1576,565,101,40,3655,0.00191518467852257,0.039671682626539,0.33406292749658,0.431190150478796,0.154582763337893,0.0276333789329685,0.0109439124487004,1373,0.375649794801642,2282,0.624350205198358
"E02006065",1,850,1781,1297,349,80,17,4375,0.000228571428571429,0.194285714285714,0.407085714285714,0.296457142857143,0.0797714285714286,0.0182857142857143,0.00388571428571429,2632,0.6016,1743,0.3984
"E02006066",9,431,632,1338,689,196,52,3347,0.00268897520167314,0.128772034657903,0.188825814161936,0.399760979982073,0.205855990439199,0.0585599043919928,0.0155363011652226,1072,0.320286824021512,2275,0.679713175978488
"E02006067",11,270,606,967,539,250,75,2718,0.00404709345106696,0.0993377483443709,0.222958057395143,0.355776306107432,0.198307579102281,0.0919793966151582,0.0275938189845475,887,0.326342899190581,1831,0.673657100809419
"E02006068",2,248,1487,1293,368,58,22,3478,0.000575043128234618,0.0713053479010926,0.427544565842438,0.37176538240368,0.10580793559517,0.0166762507188039,0.00632547441058079,1737,0.499424956871765,1741,0.500575043128235
"E02006069",58,532,2512,1508,631,121,50,5412,0.0107169253510717,0.09830007390983,0.464153732446415,0.278640059127864,0.116592756836659,0.0223577235772358,0.00923872875092387,3102,0.573170731707317,2310,0.426829268292683
"E02006070",3,1488,1036,969,292,61,9,3858,0.000777604976671851,0.385692068429238,0.268532918610679,0.251166407465008,0.0756868843960601,0.0158113011923276,0.00233281493001555,2527,0.655002592016589,1331,0.344997407983411
"E02006071",12,521,1295,1010,436,93,23,3390,0.00353982300884956,0.153687315634218,0.382005899705015,0.297935103244838,0.128613569321534,0.0274336283185841,0.00678466076696165,1828,0.539233038348083,1562,0.460766961651917
"E02006072",44,205,582,1203,837,341,88,3300,0.0133333333333333,0.0621212121212121,0.176363636363636,0.364545454545455,0.253636363636364,0.103333333333333,0.0266666666666667,831,0.251818181818182,2469,0.748181818181818
"E02006073",0,291,1709,1254,339,87,15,3695,0,0.0787550744248985,0.462516914749662,0.339377537212449,0.091745602165088,0.0235453315290934,0.0040595399188092,2000,0.54127198917456,1695,0.45872801082544
"E02006074",28,1935,1634,1044,436,155,27,5259,0.00532420612283704,0.367940673131774,0.310705457311276,0.198516828294353,0.0829054953413196,0.0294732838942765,0.00513405590416429,3597,0.683970336565887,1662,0.316029663434113
"E02006075",48,139,464,647,408,168,48,1922,0.0249739854318418,0.0723204994797086,0.241415192507804,0.336628511966701,0.212278876170656,0.0874089490114464,0.0249739854318418,651,0.338709677419355,1271,0.661290322580645
"E02006076",38,566,841,1138,566,240,71,3460,0.0109826589595376,0.163583815028902,0.243063583815029,0.328901734104046,0.163583815028902,0.069364161849711,0.0205202312138728,1445,0.417630057803468,2015,0.582369942196532
"E02006077",12,639,593,788,361,104,39,2536,0.00473186119873817,0.251971608832808,0.233832807570978,0.310725552050473,0.142350157728707,0.0410094637223975,0.0153785488958991,1244,0.490536277602524,1292,0.509463722397476
"E02006078",11,460,615,763,314,121,52,2336,0.00470890410958904,0.196917808219178,0.263270547945205,0.326626712328767,0.134417808219178,0.0517979452054795,0.0222602739726027,1086,0.464897260273973,1250,0.535102739726027
"E02006079",23,546,1262,957,464,146,44,3442,0.00668216153399187,0.15862870424172,0.36664729808251,0.278036025566531,0.134805345729227,0.042417199302731,0.0127832655432888,1831,0.531958163858222,1611,0.468041836141778
"E02006080",15,337,648,769,437,164,50,2420,0.00619834710743802,0.139256198347107,0.267768595041322,0.317768595041322,0.180578512396694,0.0677685950413223,0.0206611570247934,1000,0.413223140495868,1420,0.586776859504132
"E02006081",22,125,453,687,489,213,49,2038,0.0107948969578018,0.0613346418056919,0.222276741903827,0.337095191364082,0.239941118743867,0.104514229636899,0.0240431795878312,600,0.294406280667321,1438,0.705593719332679
"E02006082",10,390,769,912,446,183,34,2744,0.00364431486880466,0.142128279883382,0.280247813411079,0.332361516034985,0.162536443148688,0.0666909620991254,0.0123906705539359,1169,0.426020408163265,1575,0.573979591836735
"E02006083",18,226,771,816,242,69,19,2161,0.00832947709393799,0.104581212401666,0.356779268857011,0.377602961591856,0.111985192040722,0.031929662193429,0.00879222582137899,1015,0.469689958352615,1146,0.530310041647385
"E02006084",45,339,615,1006,532,205,66,2808,0.016025641025641,0.120726495726496,0.219017094017094,0.358262108262108,0.189458689458689,0.073005698005698,0.0235042735042735,999,0.355769230769231,1809,0.644230769230769
"E02006085",1,622,1336,777,192,30,3,2961,0.000337723741979061,0.210064167510976,0.451198919284026,0.26241134751773,0.0648429584599797,0.0101317122593718,0.00101317122593718,1959,0.661600810536981,1002,0.338399189463019
"E02006086",21,692,943,736,227,50,13,2682,0.00782997762863535,0.258016405667412,0.351603281133482,0.274422073079791,0.0846383296047726,0.0186428038777032,0.00484712900820283,1656,0.61744966442953,1026,0.38255033557047
"E02006087",1,92,1427,827,116,13,2,2478,0.000403551251008878,0.0371267150928168,0.575867635189669,0.333736884584342,0.0468119451170299,0.00524616626311542,0.000807102502017756,1520,0.613397901533495,958,0.386602098466505
"E02006088",4,270,1669,973,248,48,10,3222,0.00124146492861577,0.0837988826815642,0.518001241464929,0.301986343885785,0.0769708255741775,0.0148975791433892,0.00310366232153942,1943,0.603041589075109,1279,0.396958410924891
"E02006089",5,470,1236,1242,553,84,37,3627,0.00137854976564654,0.129583677970775,0.340777502067825,0.342431761786601,0.152467604080507,0.0231596360628619,0.0102012682657844,1711,0.471739729804246,1916,0.528260270195754
"E02006090",0,133,1230,940,324,63,16,2706,0,0.049150036954915,0.454545454545455,0.347376201034738,0.119733924611973,0.0232815964523282,0.00591278640059128,1363,0.50369549150037,1343,0.49630450849963
"E02006091",33,271,732,1531,784,289,73,3713,0.0088876918933477,0.0729868031241584,0.197145165634258,0.41233503905198,0.2111500134662,0.0778346350659844,0.0196606517640722,1036,0.279019660651764,2677,0.720980339348236
"E02006092",1,378,756,873,196,39,16,2259,0.000442673749446658,0.167330677290837,0.334661354581673,0.386454183266932,0.0867640548915449,0.0172642762284197,0.00708277999114653,1135,0.502434705621957,1124,0.497565294378043
"E02006093",15,347,1119,1141,546,182,51,3401,0.00441046750955601,0.102028815054396,0.329020876212879,0.335489561893561,0.160541017347839,0.0535136724492796,0.0149955895324904,1481,0.43546015877683,1920,0.56453984122317
"E02006094",18,213,240,785,500,225,69,2050,0.00878048780487805,0.10390243902439,0.117073170731707,0.382926829268293,0.24390243902439,0.109756097560976,0.0336585365853659,471,0.229756097560976,1579,0.770243902439024
"E02006095",21,252,1269,1285,498,125,48,3498,0.00600343053173242,0.072041166380789,0.362778730703259,0.36735277301315,0.142367066895369,0.0357347055460263,0.0137221269296741,1542,0.44082332761578,1956,0.55917667238422
"E02006096",41,678,1076,960,243,42,5,3045,0.0134646962233169,0.222660098522167,0.353366174055829,0.315270935960591,0.0798029556650246,0.0137931034482759,0.00164203612479475,1795,0.589490968801314,1250,0.410509031198686
"E02006097",38,301,1243,987,382,94,32,3077,0.0123496912577186,0.0978225544361391,0.403964900877478,0.320766980825479,0.124146896327592,0.0305492362690933,0.0103997400064998,1582,0.514137146571336,1495,0.485862853428664
"E02006098",24,148,429,916,631,262,78,2488,0.00964630225080386,0.0594855305466238,0.172427652733119,0.368167202572347,0.253617363344051,0.105305466237942,0.0313504823151125,601,0.241559485530547,1887,0.758440514469453
"E02006099",12,445,1028,792,297,142,48,2764,0.00434153400868307,0.160998552821997,0.37192474674385,0.286541244573082,0.107452966714906,0.0513748191027496,0.0173661360347323,1485,0.53726483357453,1279,0.46273516642547
"E02006100",3,641,941,1081,353,77,23,3119,0.000961846745751844,0.205514588008977,0.301699262584162,0.346585444052581,0.1131773004168,0.0246873998076307,0.00737415838409747,1585,0.508175697338891,1534,0.491824302661109
"E02006101",10,221,455,798,448,165,57,2154,0.00464252553389044,0.102599814298979,0.211234911792015,0.370473537604457,0.207985143918292,0.0766016713091922,0.0264623955431755,686,0.318477251624884,1468,0.681522748375116
"E02006102",53,81,1280,1018,269,53,7,2761,0.0191959434987323,0.029337196667874,0.463600144875045,0.368706990220934,0.0974284679463962,0.0191959434987323,0.0025353132922854,1414,0.512133285041652,1347,0.487866714958348
"E02006103",23,386,512,894,527,221,55,2619,0.0087819778541428,0.147384497899962,0.195494463535701,0.34135166093929,0.201221840397098,0.0843833524245895,0.0210003818251241,921,0.351660939289805,1697,0.647957235586102
"E02006104",12,1230,1408,1222,292,57,11,4232,0.00283553875236295,0.290642722117202,0.332703213610586,0.28875236294896,0.0689981096408318,0.013468809073724,0.0025992438563327,2650,0.626181474480151,1582,0.373818525519849
"E02006105",6,911,1723,1929,770,129,36,5504,0.00109011627906977,0.165515988372093,0.313045058139535,0.35047238372093,0.139898255813953,0.0234375,0.0065406976744186,2640,0.479651162790698,2864,0.520348837209302
"E02006106",11,1156,1578,901,210,30,9,3895,0.00282413350449294,0.296790757381258,0.405134788189987,0.231322207958922,0.0539152759948652,0.00770218228498074,0.00231065468549422,2745,0.704749679075738,1150,0.295250320924262
"E02006107",3,340,1669,1204,251,27,5,3499,0.000857387825092884,0.0971706201771935,0.476993426693341,0.344098313803944,0.0717347813661046,0.00771649042583595,0.00142897970848814,2012,0.575021434695627,1487,0.424978565304373
"E02006108",0,682,1894,1590,709,112,33,5020,0,0.135856573705179,0.377290836653386,0.316733067729084,0.141235059760956,0.0223107569721116,0.00657370517928287,2576,0.513147410358566,2444,0.486852589641434
"E02006109",28,453,824,1270,399,88,22,3084,0.00907911802853437,0.146887159533074,0.267185473411154,0.411802853437095,0.129377431906615,0.0285343709468223,0.00713359273670558,1305,0.423151750972763,1779,0.576848249027237
"E02006110",22,1434,1353,1229,563,115,25,4741,0.00464037122969838,0.30246783379034,0.28538283062645,0.25922801096815,0.118751318287281,0.0242564859734233,0.00527314912465725,2809,0.592491035646488,1932,0.407508964353512
"E02006111",18,693,997,1391,592,219,43,3953,0.00455350366810018,0.175309891221857,0.252213508727549,0.351884644573741,0.149759676195295,0.0554009612952188,0.0108778143182393,1708,0.432076903617506,2245,0.567923096382494
"E02006112",23,335,605,916,553,243,62,2737,0.00840336134453781,0.122396784800877,0.221044939715016,0.334672999634636,0.202046035805627,0.0887833394227256,0.0226525392765802,963,0.351845085860431,1774,0.648154914139569
"E02006113",6,282,973,1296,624,149,29,3359,0.0017862459065198,0.0839535576064305,0.289669544507294,0.385829115808276,0.185769574278059,0.0443584400119083,0.00863352188151235,1261,0.375409348020244,2098,0.624590651979756
"E02006114",36,168,619,980,669,281,96,2849,0.0126360126360126,0.058968058968059,0.217269217269217,0.343980343980344,0.234819234819235,0.0986310986310986,0.0336960336960337,823,0.288873288873289,2026,0.711126711126711
"E02006115",16,454,905,1037,595,226,105,3338,0.00479328939484721,0.13600958657879,0.271120431396046,0.310665068903535,0.178250449370881,0.0677052127022169,0.0314559616536848,1375,0.411923307369682,1963,0.588076692630317
"E02006116",17,97,510,1098,862,500,186,3270,0.00519877675840979,0.0296636085626911,0.155963302752294,0.335779816513761,0.263608562691131,0.152905198776758,0.0568807339449541,624,0.190825688073395,2646,0.809174311926605
"E02006117",7,151,273,810,854,435,159,2689,0.0026031982149498,0.0561547043510599,0.101524730383042,0.301227222015619,0.317590182223875,0.161770174786166,0.0591297880252882,431,0.160282632949052,2258,0.839717367050948
"E02006118",1,110,722,944,305,52,5,2139,0.000467508181393174,0.0514258999532492,0.337540906965872,0.441327723235157,0.142589995324918,0.0243104254324451,0.00233754090696587,833,0.389434315100514,1306,0.610565684899486
"E02006119",5,217,1099,1386,407,62,22,3198,0.00156347717323327,0.067854909318324,0.343652282676673,0.433395872420263,0.127267041901188,0.0193871169480926,0.00687929956222639,1321,0.41307066916823,1877,0.58692933083177
"E02006120",11,361,1105,1486,390,59,13,3425,0.00321167883211679,0.105401459854015,0.322627737226277,0.433868613138686,0.113868613138686,0.0172262773722628,0.0037956204379562,1477,0.431240875912409,1948,0.568759124087591
"E02006121",7,735,627,925,177,16,1,2488,0.00281350482315113,0.295418006430868,0.252009646302251,0.371784565916399,0.0711414790996785,0.00643086816720257,0.000401929260450161,1369,0.55024115755627,1119,0.44975884244373
"E02006122",6,887,630,1135,370,62,13,3103,0.00193361263293587,0.285852400902353,0.203029326458266,0.365775056397035,0.119239445697712,0.0199806638736706,0.00418949403802771,1523,0.490815339993555,1580,0.509184660006445
"E02006123",10,186,743,986,216,27,11,2179,0.00458926112895824,0.0853602569986232,0.340982101881597,0.452501147315282,0.0991280403854979,0.0123910050481872,0.00504818724185406,939,0.430931620009179,1240,0.569068379990821
"E02006124",6,328,839,1332,314,56,7,2882,0.00208188757807078,0.11380985426787,0.291117279666898,0.462179042331714,0.108952116585704,0.0194309507286607,0.00242886884108258,1173,0.407009021512838,1709,0.592990978487162
"E02006125",7,330,891,1315,401,56,13,3013,0.00232326584799203,0.109525389976767,0.295718552937272,0.436442084301361,0.133089943577829,0.0185861267839363,0.00431463657484235,1228,0.407567208762031,1785,0.592432791237969
"E02006126",4,285,708,1245,384,51,10,2687,0.00148864905098623,0.106066244882769,0.263490882024563,0.463342017119464,0.142910308894678,0.0189802754000744,0.00372162262746558,997,0.371045775958318,1690,0.628954224041682
"E02006127",2,55,831,893,169,14,0,1964,0.0010183299389002,0.0280040733197556,0.423116089613035,0.454684317718941,0.0860488798370672,0.00712830957230143,0,888,0.45213849287169,1076,0.547861507128309
"E02006128",18,267,1200,1378,438,83,16,3400,0.00529411764705882,0.0785294117647059,0.352941176470588,0.405294117647059,0.128823529411765,0.0244117647058824,0.00470588235294118,1485,0.436764705882353,1915,0.563235294117647
"E02006129",7,548,1401,1562,467,69,25,4079,0.00171610688894337,0.134346653591567,0.343466535915666,0.382936994361363,0.114488845305222,0.0169159107624418,0.00612895317479774,1956,0.479529296396176,2123,0.520470703603825
"E02006130",37,906,711,1186,375,29,13,3257,0.0113601473748849,0.278170095179613,0.218299048203869,0.36413877801658,0.115136628799509,0.00890389929382868,0.0039914031317163,1654,0.507829290758367,1603,0.492170709241633
"E02006131",21,269,622,893,539,232,90,2666,0.00787696924231058,0.100900225056264,0.23330832708177,0.334958739684921,0.202175543885972,0.0870217554388597,0.0337584396099025,912,0.342085521380345,1754,0.657914478619655
"E02006132",7,609,764,891,214,37,9,2531,0.00276570525483998,0.240616357171079,0.30185697352825,0.352034768866061,0.0845515606479652,0.0146187277755828,0.00355590675622284,1380,0.545239035954168,1151,0.454760964045832
"E02006133",28,582,1067,1083,311,72,17,3160,0.00886075949367089,0.184177215189873,0.337658227848101,0.342721518987342,0.0984177215189873,0.0227848101265823,0.00537974683544304,1677,0.530696202531646,1483,0.469303797468354
"E02006134",12,1073,949,1343,490,127,35,4029,0.00297840655249442,0.266319185902209,0.2355423181931,0.333333333333333,0.121618267560189,0.0315214693472326,0.00868701911144205,2034,0.504839910647803,1995,0.495160089352197
"E02006135",7,195,633,1171,266,51,8,2331,0.003003003003003,0.0836550836550837,0.271557271557272,0.502359502359502,0.114114114114114,0.0218790218790219,0.00343200343200343,835,0.358215358215358,1496,0.641784641784642
"E02006136",10,161,489,931,562,247,95,2495,0.00400801603206413,0.0645290581162325,0.195991983967936,0.37314629258517,0.225250501002004,0.098997995991984,0.0380761523046092,660,0.264529058116233,1835,0.735470941883768
"E02006137",2,256,1370,1208,608,103,23,3570,0.000560224089635854,0.0717086834733894,0.38375350140056,0.338375350140056,0.1703081232493,0.0288515406162465,0.00644257703081232,1628,0.456022408963585,1942,0.543977591036415
"E02006138",7,517,1161,945,406,118,25,3179,0.00220195029883611,0.162629757785467,0.365209185278389,0.297263290342875,0.127713117332494,0.0371185907518087,0.00786410821012897,1685,0.530040893362693,1494,0.469959106637307
"E02006139",29,553,1159,1220,592,129,25,3707,0.007823037496628,0.149177232263286,0.312651739951443,0.32910709468573,0.159697868896682,0.0347990288643108,0.00674399784192069,1741,0.469652009711357,1966,0.530347990288643
"E02006140",3,209,1185,1147,461,111,19,3135,0.000956937799043062,0.0666666666666667,0.37799043062201,0.365869218500797,0.147049441786284,0.0354066985645933,0.00606060606060606,1397,0.445614035087719,1738,0.554385964912281
"E02006141",0,769,1603,1752,968,197,61,5350,0,0.143738317757009,0.299626168224299,0.327476635514019,0.180934579439252,0.0368224299065421,0.0114018691588785,2372,0.443364485981308,2978,0.556635514018692
"E02006142",2,113,392,788,201,42,7,1545,0.00129449838187702,0.0731391585760518,0.253721682847896,0.510032362459547,0.130097087378641,0.0271844660194175,0.00453074433656958,507,0.328155339805825,1038,0.671844660194175
"E02006143",64,1821,878,1144,236,52,14,4209,0.0152055119980993,0.432644333570919,0.208600617723925,0.271798526966025,0.0560703254929912,0.0123544784984557,0.00332620574958422,2763,0.656450463292944,1446,0.343549536707056
"E02006144",12,290,1568,1213,432,71,23,3609,0.00332502078137988,0.0803546688833472,0.434469382100305,0.336104183984483,0.119700748129676,0.0196730396231643,0.00637295649764478,1870,0.518149071765032,1739,0.481850928234968
"E02006145",7,285,442,762,327,88,37,1948,0.00359342915811088,0.146303901437372,0.226899383983573,0.391170431211499,0.167864476386037,0.0451745379876797,0.018993839835729,734,0.376796714579055,1214,0.623203285420945
"E02006146",14,479,1237,1011,325,69,27,3162,0.00442757748260595,0.151486401012018,0.391208096141683,0.319734345351044,0.102783048703352,0.0218216318785579,0.00853889943074004,1730,0.547122074636306,1432,0.452877925363694
"E02006147",3,1128,875,1005,273,77,25,3386,0.000886001181334908,0.333136444181926,0.258417011222682,0.296810395747194,0.0806261075014767,0.022740696987596,0.0073833431777909,2006,0.592439456585942,1380,0.407560543414058
"E02006148",6,78,605,910,289,84,29,2001,0.00299850074962519,0.0389805097451274,0.302348825587206,0.454772613693153,0.144427786106947,0.0419790104947526,0.0144927536231884,689,0.344327836081959,1312,0.655672163918041
"E02006149",5,658,2484,1270,321,56,22,4816,0.00103820598006645,0.136627906976744,0.51578073089701,0.263704318936877,0.0666528239202658,0.0116279069767442,0.00456810631229236,3147,0.653446843853821,1669,0.346553156146179
"E02006150",6,308,1147,1807,396,48,6,3718,0.00161377084454008,0.0828402366863905,0.308499193114578,0.486013986013986,0.106508875739645,0.0129101667563206,0.00161377084454008,1461,0.392953200645508,2257,0.607046799354492
"E02006151",5,614,873,1227,391,67,13,3190,0.00156739811912226,0.192476489028213,0.273667711598746,0.384639498432602,0.122570532915361,0.0210031347962382,0.00407523510971787,1492,0.467711598746081,1698,0.532288401253919
"E02006152",4,1267,1517,1380,423,70,16,4677,0.00085524909129784,0.270900149668591,0.324353217874706,0.295060936497755,0.0904425914047466,0.0149668590977122,0.00342099636519136,2788,0.596108616634595,1889,0.403891383365405
"E02006153",27,1399,503,813,565,190,40,3537,0.00763358778625954,0.39553293751767,0.14221091320328,0.229855810008482,0.15973989256432,0.053717839977382,0.0113090189426067,1929,0.545377438507209,1608,0.454622561492791
"E02006154",7,125,563,1404,445,55,18,2617,0.0026748184944593,0.0477646159724876,0.215131830340084,0.53649216660298,0.170042032862056,0.0210164310278945,0.00687810470003821,695,0.265571264807031,1922,0.734428735192969
"E02006155",12,172,742,764,212,32,6,1940,0.00618556701030928,0.088659793814433,0.382474226804124,0.393814432989691,0.109278350515464,0.0164948453608247,0.00309278350515464,926,0.477319587628866,1014,0.522680412371134
"E02006156",6,101,651,954,429,103,28,2272,0.00264084507042254,0.0444542253521127,0.286531690140845,0.419894366197183,0.188820422535211,0.0453345070422535,0.0123239436619718,758,0.33362676056338,1514,0.66637323943662
"E02006157",6,147,751,858,374,114,30,2280,0.00263157894736842,0.0644736842105263,0.329385964912281,0.376315789473684,0.164035087719298,0.05,0.0131578947368421,904,0.396491228070175,1376,0.603508771929825
"E02006158",3,93,612,1117,308,61,15,2209,0.00135808057944771,0.0421004979628791,0.277048438207334,0.505658669081032,0.139429606156632,0.0276143051154368,0.00679040289723857,708,0.320507016749661,1501,0.679492983250339
"E02006159",1,83,674,858,288,34,11,1949,0.000513083632632119,0.0425859415084659,0.345818368394048,0.440225756798358,0.14776808619805,0.017444843509492,0.00564391995895331,758,0.388917393535146,1191,0.611082606464854
"E02006160",4,371,941,1180,406,54,7,2963,0.00134998312521093,0.125210934863314,0.317583530205872,0.398245021937226,0.13702328720891,0.0182247721903476,0.00236247046911914,1316,0.444144448194398,1647,0.555855551805602
"E02006161",5,122,524,912,177,30,7,1777,0.0028137310073157,0.0686550365785031,0.294879009566685,0.513224535734384,0.0996060776589758,0.0168823860438942,0.00393922341024198,651,0.366347777152504,1126,0.633652222847496
"E02006162",5,133,665,1187,488,113,24,2615,0.00191204588910134,0.0508604206500956,0.254302103250478,0.453919694072658,0.186615678776291,0.0432122370936903,0.00917782026768642,803,0.307074569789675,1812,0.692925430210325
"E02006163",15,97,845,1049,316,27,7,2356,0.00636672325976231,0.0411714770797963,0.358658743633277,0.445246179966044,0.134125636672326,0.0114601018675722,0.00297113752122241,957,0.406196943972835,1399,0.593803056027165
"E02006164",5,227,1090,1083,368,56,16,2845,0.00175746924428822,0.0797891036906854,0.383128295254833,0.38066783831283,0.129349736379613,0.0196836555360281,0.00562390158172232,1322,0.464674868189807,1523,0.535325131810193
"E02006165",1,265,872,1285,558,74,22,3077,0.00032499187520312,0.0861228469288268,0.283392915177121,0.417614559636009,0.181345466363341,0.0240493987650309,0.00714982125446864,1138,0.36984075398115,1939,0.630159246018849
"E02006166",0,55,425,1139,441,94,19,2173,0,0.0253106304647952,0.19558214450069,0.52416014726185,0.20294523699954,0.0432581684307409,0.0087436723423838,480,0.220892774965485,1693,0.779107225034515
"E02006167",17,833,1675,1192,282,35,4,4038,0.004210004952947,0.206290242694403,0.414809311540367,0.295195641406637,0.0698365527488856,0.00866765725606736,0.000990589400693413,2525,0.625309559187717,1513,0.374690440812283
"E02006168",10,631,1486,1636,630,89,19,4501,0.00222172850477672,0.140191068651411,0.33014885580982,0.363474783381471,0.139968895800933,0.0197733836925128,0.00422128415907576,2127,0.472561652966008,2374,0.527438347033993
"E02006169",12,488,635,734,268,46,12,2195,0.00546697038724374,0.222323462414579,0.289293849658314,0.334396355353075,0.122095671981777,0.0209567198177677,0.00546697038724374,1135,0.517084282460137,1060,0.482915717539863
"E02006170",1,180,470,707,272,60,19,1709,0.000585137507314219,0.105324751316559,0.275014628437683,0.413692217671153,0.159157401989468,0.0351082504388531,0.0111176126389702,651,0.380924517261557,1058,0.619075482738443
"E02006171",5,222,1116,1295,417,59,8,3122,0.00160153747597694,0.071108263933376,0.357463164638053,0.414798206278027,0.133568225496477,0.0188981422165279,0.0025624599615631,1343,0.430172966047406,1779,0.569827033952594
"E02006172",6,189,807,1479,391,36,7,2915,0.00205831903945111,0.0648370497427101,0.276843910806175,0.5073756432247,0.134133790737564,0.0123499142367067,0.00240137221269297,1002,0.343739279588336,1913,0.656260720411664
"E02006173",14,446,400,815,476,195,58,2404,0.00582362728785358,0.185524126455907,0.166389351081531,0.339018302828619,0.198003327787022,0.0811148086522463,0.024126455906822,860,0.357737104825291,1544,0.642262895174709
"E02006174",11,838,908,1357,364,108,27,3613,0.00304456130639358,0.231940215887074,0.251314696927761,0.375588153888735,0.100747301411569,0.0298920564627733,0.00747301411569333,1757,0.486299474121229,1856,0.513700525878771
"E02006175",6,217,781,801,248,58,23,2134,0.0028116213683224,0.101686972820993,0.365979381443299,0.37535145267104,0.116213683223993,0.0271790065604499,0.0107778819119025,1004,0.470477975632615,1130,0.529522024367385
"E02006176",7,231,519,863,532,160,54,2366,0.0029585798816568,0.0976331360946746,0.219357565511412,0.364750633981403,0.224852071005917,0.0676246830092984,0.0228233305156382,757,0.319949281487743,1609,0.680050718512257
"E02006177",19,300,800,1300,338,53,11,2821,0.00673520028358738,0.10634526763559,0.283587380361574,0.460829493087558,0.119815668202765,0.0187876639489543,0.00389932647997164,1119,0.396667848280752,1702,0.603332151719248
"E02006178",8,133,828,932,296,52,13,2262,0.00353669319186561,0.0587975243147657,0.36604774535809,0.412024756852343,0.130857648099027,0.0229885057471264,0.00574712643678161,969,0.428381962864722,1293,0.571618037135279
"E02006179",12,222,521,818,217,41,11,1842,0.00651465798045603,0.120521172638436,0.282844733984799,0.444082519001086,0.117806731813246,0.0222584147665581,0.00597176981541802,755,0.409880564603692,1087,0.590119435396308
"E02006180",6,406,631,823,256,45,15,2182,0.00274977085242896,0.186067827681027,0.289184234647113,0.37717690192484,0.117323556370302,0.0206232813932172,0.00687442713107241,1043,0.478001833180568,1139,0.521998166819432
"E02006181",6,237,779,785,180,31,7,2025,0.00296296296296296,0.117037037037037,0.384691358024691,0.387654320987654,0.0888888888888889,0.0153086419753086,0.00345679012345679,1022,0.504691358024691,1003,0.495308641975309
"E02006182",3,317,397,892,348,67,13,2037,0.00147275405007364,0.155621011291114,0.194894452626411,0.437898870888562,0.170839469808542,0.0328915071183112,0.00638193421698576,717,0.351988217967599,1320,0.648011782032401
"E02006185",5,214,985,1040,330,68,24,2666,0.0018754688672168,0.0802700675168792,0.36946736684171,0.390097524381095,0.123780945236309,0.0255063765941485,0.00900225056264066,1204,0.451612903225806,1462,0.548387096774194
"E02006186",15,546,820,1386,593,160,53,3573,0.00419815281276238,0.152812762384551,0.22949902043101,0.387909319899244,0.165966974531206,0.0447802966694654,0.0148334732717604,1381,0.386509935628324,2192,0.613490064371677
"E02006187",17,227,696,940,377,106,25,2388,0.00711892797319933,0.0950586264656616,0.291457286432161,0.393634840871022,0.15787269681742,0.0443886097152429,0.0104690117252931,940,0.393634840871022,1448,0.606365159128978
"E02006188",5,122,490,756,267,68,12,1720,0.00290697674418605,0.0709302325581395,0.284883720930233,0.43953488372093,0.155232558139535,0.0395348837209302,0.00697674418604651,617,0.358720930232558,1103,0.641279069767442
"E02006189",12,122,492,925,481,137,55,2224,0.00539568345323741,0.0548561151079137,0.221223021582734,0.41591726618705,0.216276978417266,0.0616007194244604,0.0247302158273381,626,0.281474820143885,1598,0.718525179856115
"E02006190",14,1127,1504,1590,524,83,19,4861,0.00288006583007612,0.231845299321127,0.30940135774532,0.327093190701502,0.107796749639992,0.0170746759925941,0.00390866076938901,2645,0.544126722896523,2216,0.455873277103477
"E02006191",3,285,548,1122,265,92,37,2352,0.00127551020408163,0.121173469387755,0.232993197278912,0.477040816326531,0.112670068027211,0.0391156462585034,0.0157312925170068,836,0.355442176870748,1516,0.644557823129252
"E02006192",30,638,635,955,512,233,70,3073,0.0097624471200781,0.207614708753661,0.206638464041653,0.310771233322486,0.166612430849333,0.0758216726326066,0.0227790432801822,1303,0.424015619915392,1770,0.575984380084608
"E02006193",63,1134,464,982,342,90,22,3097,0.0203422667097191,0.366160800774944,0.149822408782693,0.317081046173717,0.110429447852761,0.0290603810138844,0.00710364869228285,1661,0.536325476267355,1436,0.463674523732645
"E02006194",8,371,1149,1137,268,51,15,2999,0.00266755585195065,0.123707902634211,0.383127709236412,0.379126375458486,0.0893631210403468,0.0170056685561854,0.00500166722240747,1528,0.509503167722574,1471,0.490496832277426
"E02006195",5,494,714,1067,384,113,29,2806,0.00178189593727726,0.176051318602994,0.254454739843193,0.380256593014968,0.136849607982894,0.0402708481824661,0.0103349964362081,1213,0.432287954383464,1593,0.567712045616536
"E02006196",1,336,953,1264,304,44,3,2905,0.000344234079173838,0.11566265060241,0.328055077452668,0.435111876075731,0.104647160068847,0.0151462994836489,0.00103270223752151,1290,0.444061962134251,1615,0.555938037865749
"E02006197",41,693,2220,1781,642,105,29,5511,0.00743966612230085,0.125748502994012,0.4028307022319,0.323171838141898,0.116494284158955,0.0190528034839412,0.00526220286699329,2954,0.536018871348213,2557,0.463981128651787
"E02006198",8,828,495,1070,385,102,27,2915,0.00274442538593482,0.284048027444254,0.169811320754717,0.367066895368782,0.132075471698113,0.034991423670669,0.00926243567753002,1331,0.456603773584906,1584,0.543396226415094
"E02006199",33,858,586,1145,398,131,26,3177,0.0103871576959396,0.270066100094429,0.184450739691533,0.360402895813661,0.12527541706012,0.0412338684293359,0.00818382121498269,1477,0.464903997481901,1700,0.535096002518099
"E02006200",6,193,1337,1232,283,36,1,3088,0.00194300518134715,0.0625,0.432966321243523,0.398963730569948,0.0916450777202073,0.0116580310880829,0.000323834196891192,1536,0.49740932642487,1552,0.50259067357513
"E02006201",6,257,871,1747,465,63,7,3416,0.00175644028103044,0.0752341920374707,0.254976580796253,0.511416861826698,0.136124121779859,0.0184426229508197,0.00204918032786885,1134,0.331967213114754,2282,0.668032786885246
"E02006202",13,312,588,1046,546,215,70,2790,0.00465949820788531,0.111827956989247,0.210752688172043,0.374910394265233,0.195698924731183,0.0770609318996416,0.025089605734767,913,0.327240143369176,1877,0.672759856630824
"E02006203",5,179,1107,1021,314,45,7,2678,0.00186706497386109,0.066840926064227,0.413368185212845,0.381254667662435,0.117251680358476,0.0168035847647498,0.00261389096340553,1291,0.482076176250934,1387,0.517923823749066
"E02006204",3,183,644,1116,406,151,65,2568,0.00116822429906542,0.0712616822429906,0.250778816199377,0.434579439252336,0.15809968847352,0.0588006230529595,0.0253115264797508,830,0.323208722741433,1738,0.676791277258567
"E02006205",8,117,346,798,450,208,82,2009,0.0039820806371329,0.0582379293180687,0.172224987555998,0.397212543554007,0.223992035838726,0.103534096565455,0.0408163265306122,471,0.2344449975112,1538,0.7655550024888
"E02006206",1,111,973,1481,313,46,13,2938,0.000340367597004765,0.0377808032675289,0.331177671885636,0.504084411164057,0.106535057862491,0.0156569094622192,0.00442477876106195,1085,0.36929884275017,1853,0.63070115724983
"E02006207",9,87,322,965,292,55,16,1746,0.00515463917525773,0.0498281786941581,0.184421534936999,0.552691867124857,0.167239404352806,0.0315005727376861,0.00916380297823597,418,0.239404352806415,1328,0.760595647193585
"E02006208",1,248,984,1513,733,163,56,3698,0.000270416441319632,0.0670632774472688,0.266089778258518,0.409140075716604,0.19821525148729,0.0440778799351001,0.0151433207138994,1233,0.333423472147107,2465,0.666576527852893
"E02006209",5,192,898,1421,510,123,30,3179,0.00157282164202579,0.0603963510537905,0.282478766907833,0.446995910663731,0.160427807486631,0.0386914123938345,0.00943692985215477,1095,0.344447939603649,2084,0.655552060396351
"E02006210",4,38,209,477,498,285,141,1652,0.00242130750605327,0.0230024213075061,0.126513317191283,0.288740920096852,0.301452784503632,0.172518159806295,0.0853510895883777,251,0.151937046004843,1401,0.848062953995157
"E02006211",5,65,274,850,394,102,26,1716,0.00291375291375291,0.0378787878787879,0.15967365967366,0.495337995337995,0.22960372960373,0.0594405594405594,0.0151515151515152,344,0.2004662004662,1372,0.7995337995338
"E02006212",3,143,382,1026,391,97,35,2077,0.00144439094848339,0.0688493018777082,0.183919114106885,0.493981704381319,0.188252286952335,0.0467019740009629,0.0168512277323062,528,0.254212806933077,1549,0.745787193066923
"E02006213",15,250,390,988,427,162,70,2302,0.00651607298001738,0.108601216333623,0.169417897480452,0.429192006950478,0.185490877497828,0.0703735881841877,0.0304083405734144,655,0.284535186794092,1647,0.715464813205908
"E02006214",8,300,452,1111,343,57,25,2296,0.00348432055749129,0.130662020905923,0.196864111498258,0.483885017421603,0.149390243902439,0.0248257839721254,0.0108885017421603,760,0.331010452961672,1536,0.668989547038327
"E02006215",61,263,456,988,433,140,50,2391,0.0255123379339189,0.109995817649519,0.190715181932246,0.413216227519866,0.181095775826014,0.0585529067335843,0.0209117524048515,780,0.326223337515684,1611,0.673776662484316
"E02006216",9,215,612,1093,348,103,40,2420,0.00371900826446281,0.0888429752066116,0.252892561983471,0.451652892561983,0.143801652892562,0.0425619834710744,0.0165289256198347,836,0.345454545454545,1584,0.654545454545455
"E02006217",2,983,664,1202,328,50,8,3237,0.000617856039542787,0.30367624343528,0.205128205128205,0.371331479765215,0.101328390485017,0.0154464009885697,0.00247142415817115,1649,0.509422304603028,1588,0.490577695396972
"E02006218",2,1067,1307,1418,556,89,21,4460,0.000448430493273543,0.239237668161435,0.29304932735426,0.317937219730942,0.124663677130045,0.0199551569506726,0.0047085201793722,2376,0.532735426008969,2084,0.467264573991031
"E02006219",1,800,836,1043,230,28,15,2953,0.000338638672536404,0.270910938029123,0.283101930240433,0.353200135455469,0.0778868946833728,0.0094818828310193,0.00507958008804606,1637,0.554351506942093,1316,0.445648493057907
"E02006220",2,73,613,1076,345,59,13,2181,0.000917010545621275,0.0334708849151765,0.281063732232921,0.493351673544246,0.15818431911967,0.0270518110958276,0.00596056854653829,688,0.315451627693718,1493,0.684548372306281
"E02006221",1,72,698,973,223,25,5,1997,0.000500751126690035,0.0360540811216825,0.349524286429644,0.487230846269404,0.111667501251878,0.0125187781672509,0.00250375563345018,771,0.386079118678017,1226,0.613920881321983
"E02006222",3,136,663,915,284,40,14,2055,0.00145985401459854,0.0661800486618005,0.322627737226277,0.445255474452555,0.138199513381995,0.0194647201946472,0.00681265206812652,802,0.390267639902676,1253,0.609732360097324
"E02006223",10,44,1228,720,120,10,1,2133,0.0046882325363338,0.0206282231598687,0.575714955461791,0.337552742616034,0.0562587904360056,0.0046882325363338,0.00046882325363338,1282,0.601031411157993,851,0.398968588842007
"E02006224",3,203,922,968,152,14,3,2265,0.00132450331125828,0.0896247240618102,0.407064017660044,0.427373068432671,0.0671081677704194,0.00618101545253863,0.00132450331125828,1128,0.498013245033113,1137,0.501986754966887
"E02006225",2,141,702,980,209,33,15,2082,0.000960614793467819,0.0677233429394813,0.337175792507205,0.470701248799232,0.100384245917387,0.015850144092219,0.00720461095100865,845,0.405859750240154,1237,0.594140249759846
"E02006226",3,442,1317,1101,338,48,7,3256,0.000921375921375921,0.135749385749386,0.40448402948403,0.338144963144963,0.103808353808354,0.0147420147420147,0.00214987714987715,1762,0.541154791154791,1494,0.458845208845209
"E02006227",20,409,467,808,544,194,38,2480,0.00806451612903226,0.16491935483871,0.188306451612903,0.325806451612903,0.219354838709677,0.0782258064516129,0.0153225806451613,896,0.361290322580645,1584,0.638709677419355
"E02006228",18,230,484,782,409,150,31,2104,0.00855513307984791,0.109315589353612,0.230038022813688,0.371673003802281,0.194391634980989,0.0712927756653992,0.0147338403041825,732,0.347908745247148,1372,0.652091254752852
"E02006229",34,430,704,856,306,62,14,2406,0.0141313383208645,0.178719866999169,0.29260182876143,0.355777223607648,0.127182044887781,0.0257689110556941,0.0058187863674148,1168,0.485453034081463,1238,0.514546965918537
"E02006230",31,723,1419,1324,492,124,26,4139,0.00748973181928002,0.174679874365789,0.342836433921237,0.319884029958927,0.118869292099541,0.0299589272771201,0.00628171055810582,2173,0.525006040106306,1966,0.474993959893694
"E02006231",32,540,1072,1063,305,89,28,3129,0.0102269095557686,0.172579098753595,0.342601470118249,0.339725151805689,0.0974752317034196,0.0284435922019815,0.00894854586129754,1644,0.525407478427613,1485,0.474592521572387
"E02006232",25,656,494,738,391,121,25,2450,0.0102040816326531,0.267755102040816,0.201632653061224,0.301224489795918,0.159591836734694,0.0493877551020408,0.0102040816326531,1175,0.479591836734694,1275,0.520408163265306
"E02006233",21,546,1933,1925,627,129,45,5226,0.00401836969001148,0.104477611940299,0.369881362418676,0.368350554917719,0.119977037887486,0.0246842709529277,0.00861079219288174,2500,0.478377344048986,2726,0.521622655951014
"E02006234",26,566,1516,958,287,35,11,3399,0.00764930862018241,0.166519564577817,0.446013533392174,0.281847602235952,0.0844365989997058,0.0102971462194763,0.00323624595469256,2108,0.620182406590174,1291,0.379817593409826
"E02006235",20,219,491,838,679,310,72,2629,0.00760745530620008,0.0833016356028908,0.186763027767212,0.318752377329783,0.258273107645493,0.117915557246101,0.0273868391023203,730,0.277672118676303,1899,0.722327881323697
"E02006236",30,774,763,1264,467,158,35,3491,0.00859352621025494,0.221712976224577,0.218562016614151,0.362073904325408,0.133772558006302,0.045259238040676,0.0100257805786308,1567,0.448868519048983,1924,0.551131480951017
"E02006237",17,295,456,875,740,233,44,2660,0.00639097744360902,0.110902255639098,0.171428571428571,0.328947368421053,0.278195488721804,0.087593984962406,0.0165413533834586,768,0.288721804511278,1892,0.711278195488722
"E02006238",9,231,1532,1748,527,101,18,4166,0.00216034565530485,0.0554488718194911,0.367738838214114,0.419587133941431,0.126500240038406,0.0242438790206433,0.0043206913106097,1772,0.42534805568891,2394,0.57465194431109
"E02006239",5,153,474,1343,700,167,24,2866,0.00174459176552687,0.0533845080251221,0.165387299371947,0.468597348220516,0.244242847173761,0.0582693649685973,0.00837404047452896,632,0.220516399162596,2234,0.779483600837404
"E02006240",17,782,1009,1551,836,213,49,4457,0.00381422481489791,0.175454341485304,0.22638546107247,0.347991922818039,0.187570114426744,0.047789993269015,0.0109939421135293,1808,0.405654027372672,2649,0.594345972627328
"E02006241",5,291,1539,1620,382,53,19,3910,0.00127877237851662,0.0744245524296675,0.393606138107417,0.414322250639386,0.0976982097186701,0.0135549872122762,0.00485933503836317,1835,0.469309462915601,2074,0.530434782608696
"E02006242",10,1322,2043,860,664,191,37,5127,0.00195045835771406,0.257850594889799,0.398478642480983,0.167739418763409,0.129510434952214,0.0372537546323386,0.00721669592354203,3375,0.658279695728496,1752,0.341720304271504
"E02006243",6,827,1785,1410,442,61,19,4550,0.00131868131868132,0.181758241758242,0.392307692307692,0.30989010989011,0.0971428571428571,0.0134065934065934,0.00417582417582418,2618,0.575384615384615,1932,0.424615384615385
"E02006245",14,335,1014,1020,225,32,7,2647,0.00528900642236494,0.126558367963733,0.383075179448432,0.385341896486589,0.0850018889308651,0.0120891575368342,0.00264450321118247,1363,0.51492255383453,1284,0.48507744616547
"E02006246",2,53,614,1042,306,48,9,2074,0.000964320154291225,0.0255544840887175,0.296046287367406,0.502410800385728,0.147540983606557,0.0231436837029894,0.00433944069431051,669,0.322565091610415,1405,0.677434908389585
"E02006247",3,339,1446,1261,329,56,15,3449,0.000869817338358945,0.0982893592345607,0.419251957089011,0.365613221223543,0.0953899681066976,0.0162365903160336,0.00434908669179472,1788,0.518411133661931,1661,0.481588866338069
"E02006248",2,118,812,1217,382,54,16,2601,0.000768935024990388,0.0453671664744329,0.312187620146098,0.467896962706651,0.146866589773164,0.0207612456747405,0.00615148019992311,932,0.358323721645521,1669,0.641676278354479
"E02006249",3,327,962,1315,650,157,37,3451,0.000869313242538395,0.094755143436685,0.278759779773979,0.381048971312663,0.188351202549986,0.0454940596928427,0.0107215299913069,1292,0.374384236453202,2159,0.625615763546798
"E02006250",7,263,1437,1938,846,135,56,4682,0.00149508756941478,0.0561725758222982,0.306920119607006,0.413925672789406,0.180692011960701,0.0288338316958565,0.0119607005553182,1707,0.364587782998718,2975,0.635412217001282
"E02006251",1,811,2267,2154,901,156,61,6351,0.000157455518815934,0.127696425759723,0.356951661155724,0.339159187529523,0.141867422453157,0.0245630609352858,0.00960478664777201,3079,0.484805542434262,3272,0.515194457565738
"E02006252",1,443,1388,1402,498,75,20,3827,0.000261301280376274,0.115756467206689,0.362686177162268,0.366344395087536,0.130128037627384,0.0195975960282205,0.00522602560752548,1832,0.478703945649334,1995,0.521296054350666
"E02006253",12,54,626,1199,344,74,6,2315,0.00518358531317495,0.0233261339092873,0.270410367170626,0.51792656587473,0.148596112311015,0.0319654427645788,0.00259179265658747,692,0.298920086393089,1623,0.701079913606911
"E02006254",20,575,1917,1337,347,50,15,4261,0.00469373386528984,0.134944848627083,0.449894390988031,0.313776108894626,0.0814362825627787,0.0117343346632246,0.00352030039896738,2512,0.589532973480404,1749,0.410467026519596
"E02006255",3,542,1293,1255,452,64,24,3633,0.000825763831544178,0.149187998898982,0.355904211395541,0.345444536195981,0.124415083952656,0.0176162950729425,0.00660611065235343,1838,0.505917974126067,1795,0.494082025873933
"E02006256",1,900,1735,1475,375,68,19,4573,0.000218674830527006,0.196807347474306,0.379400830964356,0.322545375027334,0.0820030614476274,0.0148698884758364,0.00415482178001312,2636,0.576426853269189,1937,0.423573146730811
"E02006257",2,101,1287,909,171,26,6,2502,0.000799360511590727,0.0403677058353317,0.514388489208633,0.363309352517986,0.0683453237410072,0.0103916866506795,0.00239808153477218,1390,0.555555555555556,1112,0.444444444444444
"E02006258",59,359,1632,987,271,33,3,3344,0.0176435406698565,0.107356459330144,0.488038277511962,0.295155502392345,0.0810406698564593,0.00986842105263158,0.000897129186602871,2050,0.613038277511962,1294,0.386961722488038
"E02006259",3,162,1551,1044,202,26,1,2989,0.00100368016058883,0.0541987286717966,0.518902643024423,0.349280695884911,0.0675811308129809,0.00869856139176982,0.000334560053529609,1716,0.574105051856808,1273,0.425894948143192
"E02006260",3,76,1146,1393,306,48,16,2988,0.00100401606425703,0.0254350736278447,0.383534136546185,0.46619812583668,0.102409638554217,0.0160642570281124,0.00535475234270415,1225,0.409973226238286,1763,0.590026773761713
"E02006261",35,322,623,897,546,234,75,2732,0.0128111273792094,0.117862371888726,0.228038067349927,0.328330893118594,0.199853587115666,0.0856515373352855,0.0274524158125915,980,0.358711566617862,1752,0.641288433382138
"E02006262",20,398,509,1077,752,235,71,3062,0.00653167864141084,0.129980404964076,0.166231221423906,0.351730894839974,0.245591116917048,0.0767472240365774,0.0231874591770085,927,0.302743305029393,2135,0.697256694970607
"E02006263",8,340,505,868,579,230,72,2602,0.00307455803228286,0.130668716372022,0.194081475787856,0.33358954650269,0.222521137586472,0.0883935434281322,0.0276710222905457,853,0.32782475019216,1749,0.67217524980784
"E02006264",61,1377,906,1107,427,118,30,4026,0.0151515151515152,0.342026825633383,0.225037257824143,0.274962742175857,0.106060606060606,0.0293094883258818,0.00745156482861401,2344,0.582215598609041,1682,0.417784401390959
"E02006265",77,800,496,828,523,161,28,2913,0.0264332303467216,0.274630964641263,0.170271198077583,0.284243048403708,0.179539993134226,0.0552694816340542,0.00961208376244422,1373,0.471335393065568,1540,0.528664606934432
"E02006266",30,1075,812,1084,498,168,41,3708,0.00809061488673139,0.289913700107875,0.21898597626753,0.292340884573894,0.134304207119741,0.0453074433656958,0.0110571736785329,1917,0.516990291262136,1791,0.483009708737864
"E02006267",34,284,422,872,677,308,70,2667,0.0127484064491939,0.106486689163855,0.158230221222347,0.326959130108736,0.253843269591301,0.115485564304462,0.026246719160105,740,0.277465316835396,1927,0.722534683164604
"E02006268",12,344,945,872,218,39,10,2440,0.00491803278688525,0.140983606557377,0.387295081967213,0.357377049180328,0.089344262295082,0.015983606557377,0.00409836065573771,1301,0.533196721311475,1139,0.466803278688525
"E02006269",28,954,776,805,289,99,23,2974,0.00941492938802959,0.320780094149294,0.260928043039677,0.270679219905851,0.0971755211835911,0.0332885003362475,0.00773369199731002,1758,0.591123066577001,1216,0.408876933422999
"E02006270",33,1104,2656,1360,389,98,20,5660,0.00583038869257951,0.195053003533569,0.469257950530035,0.240282685512367,0.0687279151943463,0.0173144876325088,0.00353356890459364,3793,0.670141342756184,1867,0.329858657243816
"E02006271",22,1044,1181,1048,339,87,25,3746,0.00587293112653497,0.278697277095569,0.315269620928991,0.279765082754939,0.0904965296316071,0.0232247730912974,0.00667378537106247,2247,0.599839829151094,1499,0.400160170848905
"E02006272",24,673,676,924,347,92,28,2764,0.00868306801736614,0.243487698986975,0.244573082489146,0.334298118668596,0.125542691751085,0.0332850940665702,0.0101302460202605,1373,0.496743849493488,1391,0.503256150506512
"E02006273",27,265,402,821,473,128,35,2151,0.0125523012552301,0.123198512319851,0.186889818688982,0.381682938168294,0.219897721989772,0.0595072059507206,0.0162715016271502,694,0.322640632264063,1457,0.677359367735937
"E02006274",20,94,394,974,453,158,41,2134,0.00937207122774133,0.0440487347703843,0.184629803186504,0.456419868791003,0.212277413308341,0.0740393626991565,0.0192127460168697,508,0.23805060918463,1626,0.76194939081537
"E02006275",20,372,1228,819,120,23,2,2584,0.00773993808049536,0.143962848297214,0.475232198142415,0.316950464396285,0.0464396284829721,0.00890092879256966,0.000773993808049536,1620,0.626934984520124,964,0.373065015479876
"E02006276",36,1631,512,803,387,113,22,3504,0.0102739726027397,0.46546803652968,0.146118721461187,0.229166666666667,0.110445205479452,0.0322488584474886,0.00627853881278539,2179,0.621860730593607,1325,0.378139269406393
"E02006277",7,290,1715,914,96,15,0,3037,0.00230490615739216,0.0954889693776753,0.56470200856108,0.300954889693777,0.0316101415870925,0.00493908462298321,0,2012,0.662495884096147,1025,0.337504115903852
"E02006278",5,835,1959,1543,606,98,36,5082,0.000983864620228257,0.164305391578119,0.385478158205431,0.30362062180244,0.119244391971665,0.0192837465564738,0.00708382526564345,2799,0.550767414403778,2283,0.449232585596222
"E02006279",13,187,1109,1406,388,38,9,3150,0.00412698412698413,0.0593650793650794,0.352063492063492,0.446349206349206,0.123174603174603,0.0120634920634921,0.00285714285714286,1309,0.415555555555556,1841,0.584444444444445
"E02006280",15,358,481,1119,809,258,55,3095,0.00484652665589661,0.115670436187399,0.155411954765751,0.361550888529887,0.261389337641357,0.0833602584814216,0.0177705977382876,854,0.275928917609047,2241,0.724071082390953
"E02006281",3,472,1393,1190,382,48,18,3506,0.000855675984027382,0.134626354820308,0.397318881916714,0.339418140330861,0.108956075299487,0.0136908157444381,0.00513405590416429,1868,0.53280091272105,1638,0.46719908727895
"E02006282",36,240,350,792,519,174,38,2149,0.0167519776640298,0.111679851093532,0.162866449511401,0.368543508608655,0.241507677989763,0.0809678920428106,0.0176826430898092,626,0.291298278268962,1523,0.708701721731038
"E02006283",56,758,353,719,519,207,32,2644,0.0211800302571861,0.286686838124054,0.133509833585477,0.271936459909228,0.196293494704992,0.0782904689863843,0.0121028744326778,1167,0.441376701966717,1477,0.558623298033283
"E02006284",42,557,1122,918,212,30,4,2885,0.0145580589254766,0.193067590987868,0.388908145580589,0.318197573656846,0.0734835355285962,0.0103986135181976,0.00138648180242634,1721,0.596533795493934,1164,0.403466204506066
"E02006285",12,199,1225,1134,100,4,0,2674,0.00448765893792072,0.0744203440538519,0.458115183246073,0.424083769633508,0.037397157816006,0.00149588631264024,0,1436,0.537023186237846,1238,0.462976813762154
"E02006286",5,413,1650,1505,384,31,12,4000,0.00125,0.10325,0.4125,0.37625,0.096,0.00775,0.003,2068,0.517,1932,0.483
"E02006287",30,275,438,770,743,357,127,2742,0.0109409190371991,0.100291757840992,0.159737417943107,0.280816921954778,0.270970094821298,0.13019693654267,0.0463165572574763,743,0.270970094821298,1997,0.728300510576222
"E02006288",28,675,661,1034,796,280,89,3563,0.00785854616895874,0.189447095144541,0.185517822060062,0.290204883525119,0.22340724108897,0.0785854616895874,0.0249789503227617,1364,0.382823463373562,2199,0.617176536626438
"E02006289",18,880,1137,1248,598,195,51,4127,0.00436152168645505,0.21322994911558,0.275502786527744,0.30239883692755,0.144899442694451,0.0472498182699297,0.0123576447782893,2035,0.49309425732978,2092,0.50690574267022
"E02006290",38,615,1366,1667,631,147,41,4505,0.00843507214206437,0.136514983351831,0.303218645948946,0.370033296337403,0.140066592674806,0.032630410654828,0.00910099889012209,2019,0.448168701442841,2486,0.551831298557159
"E02006291",20,735,904,1111,342,94,12,3218,0.00621504039776259,0.228402734617775,0.280919825978869,0.345245494095712,0.10627719080174,0.0292106898694842,0.00372902423865755,1659,0.515537600994406,1559,0.484462399005594
"E02006292",19,303,363,744,537,208,54,2228,0.0085278276481149,0.135996409335727,0.162926391382406,0.333931777378815,0.241023339317774,0.0933572710951526,0.0242369838420108,685,0.307450628366248,1543,0.692549371633752
"E02006293",32,351,979,1566,917,305,86,4236,0.00755429650613787,0.0828611898016997,0.231114258734655,0.369688385269122,0.216477809254013,0.0720018885741265,0.0203021718602455,1362,0.321529745042493,2874,0.678470254957507
"E02006294",7,292,1001,1332,540,86,30,3288,0.00212895377128954,0.0888077858880779,0.304440389294404,0.405109489051095,0.164233576642336,0.0261557177615572,0.00912408759124088,1300,0.395377128953771,1988,0.604622871046229
"E02006295",12,228,1279,1356,246,38,7,3166,0.00379027163613392,0.0720151610865445,0.403979785217941,0.428300694883133,0.0777005685407454,0.0120025268477574,0.00221099178774479,1519,0.479785217940619,1647,0.520214782059381
"E02006296",19,580,2019,1309,329,69,12,4337,0.00438090846207056,0.133732995157943,0.465529167627392,0.301821535623703,0.0758588886326954,0.0159096149412036,0.00276688955499193,2618,0.603643071247406,1719,0.396356928752594
"E02006297",5,203,740,1011,224,36,9,2228,0.00224416517055655,0.0911131059245961,0.33213644524237,0.453770197486535,0.100538599640934,0.0161579892280072,0.0040394973070018,948,0.425493716337522,1280,0.574506283662478
"E02006298",19,459,1015,1256,390,67,17,3223,0.00589512876202296,0.142413900093081,0.314923983865963,0.389699038163202,0.121005274588892,0.020788085634502,0.00527458889233633,1493,0.463233012721067,1730,0.536766987278933
"E02006299",6,297,770,1375,453,103,14,3018,0.00198807157057654,0.0984095427435388,0.255135851557323,0.455599734923791,0.150099403578529,0.0341285619615639,0.0046388336646786,1073,0.355533465871438,1945,0.644466534128562
"E02006300",14,673,1260,1268,273,29,10,3527,0.00396937907570173,0.190813722710519,0.357244116813156,0.359512333427842,0.0774028919761837,0.0082222852282393,0.00283527076835838,1947,0.552027218599376,1580,0.447972781400624
"E02006301",0,319,1020,1128,595,139,28,3229,0,0.098792195726231,0.315887271601115,0.349334159182409,0.18426757510065,0.0430473830907402,0.00867141529885413,1339,0.414679467327346,1890,0.585320532672654
"E02006302",9,141,617,996,530,133,43,2469,0.00364520048602673,0.0571081409477521,0.249898744430944,0.403402187120292,0.214661806399352,0.0538679627379506,0.0174159578776833,767,0.310652085864723,1702,0.689347914135277
"E02006303",13,176,2036,898,172,29,6,3330,0.0039039039039039,0.0528528528528528,0.611411411411411,0.26966966966967,0.0516516516516516,0.00870870870870871,0.0018018018018018,2225,0.668168168168168,1105,0.331831831831832
"E02006304",10,766,868,1238,290,51,7,3230,0.00309597523219814,0.237151702786378,0.268730650154799,0.38328173374613,0.0897832817337461,0.0157894736842105,0.0021671826625387,1644,0.508978328173375,1586,0.491021671826625
"E02006305",0,213,1401,2327,722,117,46,4826,0,0.0441359303771239,0.290302527973477,0.48217985909656,0.149606299212598,0.0242436800663075,0.00953170327393286,1614,0.334438458350601,3212,0.665561541649399
"E02006306",3,138,966,1327,460,55,25,2974,0.00100874243443174,0.0464021519838601,0.324815063887021,0.446200403496974,0.1546738399462,0.0184936112979153,0.00840618695359785,1107,0.372225958305313,1867,0.627774041694687
"E02006307",3,106,608,1098,317,50,11,2193,0.00136798905608755,0.0483356133150935,0.277245782033744,0.500683994528044,0.144550843593251,0.0227998176014592,0.00501595987232102,717,0.326949384404925,1476,0.673050615595075
"E02006308",2,311,1569,1778,708,169,65,4602,0.000434593654932638,0.0675793133420252,0.340938722294654,0.386353759235115,0.153846153846154,0.0367231638418079,0.0141242937853107,1882,0.408952629291612,2720,0.591047370708388
"E02006309",3,57,1123,998,266,58,10,2515,0.00119284294234592,0.0226640159045726,0.446520874751491,0.396819085487078,0.105765407554672,0.0230616302186879,0.00397614314115308,1183,0.47037773359841,1332,0.529622266401591
"E02006310",6,187,1359,994,187,29,11,2773,0.00216372160115399,0.0674359899026325,0.490082942661378,0.358456545257843,0.0674359899026325,0.0104579877389109,0.00396682293544897,1552,0.559682654165164,1221,0.440317345834836
"E02006311",17,403,1119,1441,584,124,26,3714,0.00457727517501346,0.108508346795907,0.301292407108239,0.387991383952612,0.157242864835757,0.03338718362951,0.00700053850296177,1539,0.41437802907916,2175,0.58562197092084
"E02006312",20,119,955,1154,369,117,29,2763,0.00723850886717336,0.0430691277596815,0.345638798407528,0.417661961635903,0.133550488599349,0.0423452768729642,0.0104958378574014,1094,0.395946435034383,1669,0.604053564965617
"E02006313",20,195,1363,1622,464,161,43,3868,0.00517063081695967,0.0504136504653568,0.352378490175801,0.419338159255429,0.119958634953464,0.0416235780765253,0.0111168562564633,1578,0.407962771458118,2290,0.592037228541882
"E02006314",6,185,857,1061,447,166,59,2781,0.00215749730312837,0.0665228335131248,0.308162531463502,0.381517439769867,0.160733549083064,0.0596907587198849,0.021215390147429,1048,0.376842862279755,1733,0.623157137720245
"E02006315",13,286,947,1124,609,161,43,3183,0.0040841972981464,0.0898523405592209,0.297518064718819,0.353125981778197,0.191328934967012,0.0505812126924285,0.0135092679861766,1246,0.391454602576186,1937,0.608545397423814
"E02006316",12,383,1149,1213,466,103,35,3361,0.00357036596251116,0.113954180303481,0.341862540910443,0.360904492710503,0.138649211544183,0.0306456411782208,0.0104135673906575,1544,0.459387087176436,1817,0.540612912823564
"E02006317",1,67,636,897,245,29,9,1884,0.000530785562632696,0.0355626326963907,0.337579617834395,0.476114649681529,0.130042462845011,0.0153927813163482,0.00477707006369427,704,0.373673036093418,1180,0.626326963906582
"E02006318",2,364,722,987,522,116,18,2731,0.000732332478945441,0.13328451116807,0.264372024899304,0.361406078359575,0.19113877700476,0.0424752837788356,0.00659099231050897,1088,0.39838886854632,1643,0.60161113145368
"E02006319",0,181,873,1045,291,48,9,2447,0,0.0739681242337556,0.356763383735186,0.427053534940744,0.118921127911729,0.0196158561503882,0.00367797302819779,1054,0.430731507968942,1393,0.569268492031058
"E02006320",9,379,982,980,262,71,19,2702,0.00333086602516654,0.140266469282013,0.363434492968172,0.362694300518135,0.0969652109548483,0.0262768319763138,0.00703182827535159,1370,0.507031828275352,1332,0.492968171724648
"E02006321",2,129,612,860,440,75,8,2126,0.000940733772342427,0.0606773283160865,0.287864534336783,0.404515522107244,0.206961429915334,0.035277516462841,0.00376293508936971,743,0.349482596425212,1383,0.650517403574788
"E02006322",3,100,711,854,351,58,7,2084,0.00143953934740883,0.0479846449136276,0.341170825335892,0.40978886756238,0.168426103646833,0.027831094049904,0.00335892514395393,814,0.390595009596929,1270,0.609404990403071
"E02006323",10,651,1176,1022,394,79,21,3353,0.00298240381747689,0.194154488517745,0.350730688935282,0.304801670146138,0.117506710408589,0.0235609901580674,0.00626304801670146,1837,0.547867581270504,1516,0.452132418729496
"E02006324",12,161,832,1013,269,41,3,2331,0.00514800514800515,0.0690690690690691,0.356928356928357,0.434577434577435,0.115401115401115,0.0175890175890176,0.00128700128700129,1005,0.431145431145431,1326,0.568854568854569
"E02006325",9,347,692,880,578,135,8,2649,0.00339750849377123,0.130992827482069,0.261230653076633,0.332200830502076,0.218195545488864,0.0509626274065685,0.00302000755001887,1048,0.395620989052473,1601,0.604379010947527
"E02006326",2,784,1208,981,374,67,9,3425,0.000583941605839416,0.228905109489051,0.352700729927007,0.286423357664234,0.109197080291971,0.0195620437956204,0.00262773722627737,1994,0.582189781021898,1431,0.417810218978102
"E02006327",4,289,998,977,356,69,8,2701,0.0014809329877823,0.106997408367271,0.369492780451685,0.361717882265827,0.131803035912625,0.0255460940392447,0.00296186597556461,1291,0.477971121806738,1410,0.522028878193262
"E02006328",3,416,1588,1573,668,91,32,4371,0.000686341798215511,0.0951727293525509,0.363303591855411,0.359871882864333,0.152825440402654,0.0208190345458705,0.00732097918096545,2007,0.459162663006177,2364,0.540837336993823
"E02006329",8,362,995,965,420,74,24,2848,0.00280898876404494,0.127106741573034,0.34936797752809,0.338834269662921,0.14747191011236,0.0259831460674157,0.00842696629213483,1365,0.479283707865169,1483,0.520716292134831
"E02006330",4,303,1104,1565,543,97,13,3629,0.00110223201984018,0.0834940755028934,0.304216037475889,0.431248277762469,0.149627996693304,0.0267291264811243,0.00358225406448057,1411,0.388812344998622,2218,0.611187655001378
"E02006331",3,180,677,890,379,75,14,2218,0.00135256988277728,0.0811541929666366,0.305229936880072,0.401262398557259,0.170874661857529,0.0338142470694319,0.00631199278629396,860,0.387736699729486,1358,0.612263300270514
"E02006332",4,424,1027,857,275,57,10,2654,0.00150715900527506,0.159758854559156,0.386963074604371,0.322908816880181,0.10361718161266,0.0214770158251696,0.00376789751318764,1455,0.548229088168802,1199,0.451770911831198
"E02006333",16,546,1308,1315,502,85,15,3787,0.00422498019540533,0.144177449168207,0.345392130974386,0.347240559809876,0.132558753630842,0.0224452072880908,0.0039609189331925,1870,0.493794560337998,1917,0.506205439662002
"E02006334",6,539,860,1000,446,57,11,2919,0.00205549845837616,0.184652278177458,0.294621445700582,0.342583076396026,0.152792052072628,0.0195272353545735,0.00376841384035629,1405,0.481329222336417,1514,0.518670777663583
"E02006335",12,166,725,1045,480,89,4,2521,0.00476001586671956,0.0658468861562872,0.28758429194764,0.414518048393495,0.190400634668782,0.0353034510115034,0.00158667195557319,903,0.358191193970647,1618,0.641808806029353
"E02006336",1,134,673,871,273,28,5,1985,0.000503778337531486,0.0675062972292192,0.33904282115869,0.438790931989924,0.137531486146096,0.0141057934508816,0.00251889168765743,808,0.407052896725441,1177,0.592947103274559
"E02006337",1,35,369,1038,573,103,9,2128,0.000469924812030075,0.0164473684210526,0.173402255639098,0.487781954887218,0.269266917293233,0.0484022556390977,0.00422932330827068,405,0.19031954887218,1723,0.80968045112782
"E02006338",1,92,361,831,386,68,12,1751,0.000571102227298686,0.0525414049114792,0.206167904054826,0.474585950885208,0.220445459737293,0.0388349514563107,0.00685322672758424,454,0.259280411193604,1297,0.740719588806396
"E02006339",2,690,1713,1004,222,25,4,3660,0.000546448087431694,0.188524590163934,0.468032786885246,0.27431693989071,0.060655737704918,0.00683060109289617,0.00109289617486339,2405,0.657103825136612,1255,0.342896174863388
"E02006341",7,336,1222,1382,534,77,11,3569,0.00196133370692071,0.0941440179321939,0.342392827122443,0.387223311852059,0.149621742785094,0.0215746707761278,0.00308209582516111,1565,0.438498178761558,2004,0.561501821238442
"E02006342",5,703,1686,1177,539,88,20,4218,0.00118539592223803,0.166666666666667,0.399715504978663,0.279042200094832,0.127785680417259,0.0208629682313893,0.00474158368895211,2394,0.567567567567568,1824,0.432432432432432
"E02006343",4,254,491,1121,545,59,20,2494,0.00160384923817161,0.101844426623897,0.196872493985565,0.449478748997594,0.218524458700882,0.0236567762630313,0.00801924619085806,749,0.300320769847634,1745,0.699679230152366
"E02006344",27,440,786,986,459,165,35,2898,0.0093167701863354,0.151828847481021,0.271221532091097,0.340234644582471,0.158385093167702,0.056935817805383,0.0120772946859903,1253,0.432367149758454,1645,0.567632850241546
"E02006345",5,88,640,879,296,85,27,2020,0.00247524752475248,0.0435643564356436,0.316831683168317,0.435148514851485,0.146534653465347,0.0420792079207921,0.0133663366336634,733,0.362871287128713,1287,0.637128712871287
"E02006346",84,464,825,1179,515,102,23,3192,0.0263157894736842,0.145363408521303,0.258458646616541,0.369360902255639,0.161340852130326,0.0319548872180451,0.00720551378446115,1373,0.430137844611529,1819,0.569862155388471
"E02006347",5,113,956,1021,304,48,5,2452,0.00203915171288744,0.0460848287112561,0.389885807504078,0.416394779771615,0.123980424143556,0.0195758564437194,0.00203915171288744,1074,0.438009787928222,1378,0.561990212071778
"E02006348",28,296,946,1135,288,58,9,2760,0.0101449275362319,0.107246376811594,0.342753623188406,0.411231884057971,0.104347826086957,0.0210144927536232,0.00326086956521739,1270,0.460144927536232,1490,0.539855072463768
"E02006349",7,121,1273,1101,273,26,5,2806,0.00249465431218817,0.0431218816821098,0.453670705630791,0.392373485388453,0.0972915181753386,0.00926585887384177,0.00178189593727726,1401,0.499287241625089,1405,0.500712758374911
"E02006350",6,151,970,779,166,24,4,2100,0.00285714285714286,0.0719047619047619,0.461904761904762,0.370952380952381,0.079047619047619,0.0114285714285714,0.0019047619047619,1127,0.536666666666667,973,0.463333333333333
"E02006351",6,148,1198,1171,292,32,5,2852,0.00210378681626928,0.0518934081346424,0.420056100981767,0.410589060308555,0.102384291725105,0.0112201963534362,0.0017531556802244,1352,0.474053295932679,1500,0.525946704067321
"E02006352",11,71,550,1037,271,28,4,1972,0.00557809330628803,0.0360040567951318,0.278904665314402,0.525862068965517,0.137423935091278,0.0141987829614604,0.00202839756592292,632,0.320486815415821,1340,0.679513184584179
"E02006353",21,198,922,890,242,29,3,2305,0.00911062906724512,0.0859002169197397,0.4,0.386117136659436,0.104989154013015,0.0125813449023861,0.00130151843817787,1141,0.495010845986985,1164,0.504989154013015
"E02006354",8,461,1003,1207,523,64,5,3271,0.00244573524915928,0.140935493732803,0.306634056863345,0.369000305716906,0.159889941913788,0.0195658819932742,0.00152858453072455,1472,0.450015285845307,1799,0.549984714154693
"E02006355",6,82,797,966,191,14,4,2060,0.0029126213592233,0.0398058252427184,0.386893203883495,0.468932038834951,0.0927184466019417,0.00679611650485437,0.00194174757281553,885,0.429611650485437,1175,0.570388349514563
"E02006356",7,693,2120,2072,1134,139,34,6199,0.00112921438941765,0.111792224552347,0.341990643652202,0.334247459267624,0.182932731085659,0.0224229714470076,0.00548475560574286,2820,0.454912082593967,3379,0.545087917406033
"E02006357",113,1347,718,880,245,29,6,3338,0.0338526063511084,0.4035350509287,0.215098861593769,0.263630916716597,0.073397243858598,0.00868783702816057,0.00179748352306771,2178,0.652486518873577,1160,0.347513481126423
"E02006358",5,591,927,1098,378,36,7,3042,0.00164365548980934,0.194280078895464,0.304733727810651,0.36094674556213,0.124260355029586,0.0118343195266272,0.00230111768573307,1523,0.500657462195924,1519,0.499342537804076
"E02006359",14,194,818,858,440,80,12,2416,0.00579470198675497,0.0802980132450331,0.338576158940397,0.355132450331126,0.182119205298013,0.033112582781457,0.00496688741721854,1026,0.424668874172185,1390,0.575331125827815
"E02006360",9,211,649,1032,580,146,45,2672,0.00336826347305389,0.0789670658682635,0.242889221556886,0.38622754491018,0.217065868263473,0.0546407185628743,0.0168413173652695,869,0.325224550898204,1803,0.674775449101796
"E02006361",11,125,427,529,443,159,42,1736,0.00633640552995392,0.0720046082949309,0.245967741935484,0.304723502304147,0.255184331797235,0.0915898617511521,0.0241935483870968,563,0.324308755760369,1173,0.675691244239631
"E02006362",4,141,549,927,397,59,10,2087,0.00191662673694298,0.0675610924772401,0.263057019645424,0.444178246286536,0.190225203641591,0.028270244369909,0.00479156684235745,694,0.332534738859607,1393,0.667465261140393
"E02006363",7,90,572,716,366,73,5,1829,0.00382722799343904,0.0492072170585019,0.31273920174959,0.391470749043193,0.200109349371241,0.0399125205030071,0.00273373428102788,669,0.365773646801531,1160,0.634226353198469
"E02006364",2,889,1477,1062,442,66,11,3949,0.000506457330969866,0.225120283616105,0.374018738921246,0.268928842744999,0.11192707014434,0.0167130919220056,0.00278551532033426,2368,0.599645479868321,1581,0.400354520131679
"E02006365",5,373,833,873,393,65,10,2552,0.00195924764890282,0.14615987460815,0.32641065830721,0.342084639498433,0.153996865203762,0.0254702194357367,0.00391849529780564,1211,0.474529780564263,1341,0.525470219435737
"E02006366",6,175,603,1056,389,54,9,2292,0.00261780104712042,0.0763525305410122,0.263089005235602,0.460732984293194,0.169720767888307,0.0235602094240838,0.00392670157068063,784,0.342059336823735,1508,0.657940663176265
"E02006367",6,293,532,851,352,48,7,2089,0.00287218764959311,0.140258496888463,0.254667304930589,0.407371948300622,0.168501675442796,0.0229775011967449,0.00335088559119196,831,0.397797989468645,1258,0.602202010531355
"E02006368",2,172,566,797,288,35,10,1870,0.00106951871657754,0.0919786096256685,0.302673796791444,0.42620320855615,0.154010695187166,0.018716577540107,0.0053475935828877,740,0.39572192513369,1130,0.60427807486631
"E02006369",12,115,454,716,436,112,16,1861,0.00644814615797958,0.061794734013971,0.243954862976894,0.384739387426115,0.234282643739925,0.0601826974744761,0.00859752821063944,581,0.312197743148845,1280,0.687802256851155
"E02006370",4,131,773,976,458,87,35,2464,0.00162337662337662,0.0531655844155844,0.313717532467532,0.396103896103896,0.185876623376623,0.0353084415584416,0.0142045454545455,908,0.368506493506494,1556,0.631493506493507
"E02006371",4,310,1064,1063,508,92,24,3065,0.00130505709624796,0.101141924959217,0.347145187601958,0.346818923327896,0.165742251223491,0.0300163132137031,0.00783034257748776,1378,0.449592169657422,1687,0.550407830342577
"E02006372",0,112,931,745,278,57,14,2137,0,0.0524099204492279,0.435657463734207,0.348619560131025,0.130088909686476,0.0266729059429106,0.00655124005615349,1043,0.488067384183435,1094,0.511932615816565
"E02006373",17,98,454,832,613,222,66,2302,0.00738488271068636,0.0425716768027802,0.197219808861859,0.361424847958297,0.266290182450043,0.0964378801042572,0.0286707211120765,569,0.247176368375326,1733,0.752823631624674
"E02006374",6,170,647,763,392,127,26,2131,0.00281557954012201,0.0797747536367902,0.30361332707649,0.358047864852182,0.183951196621305,0.0595964335992492,0.012200844673862,823,0.386203660253402,1308,0.613796339746598
"E02006375",3,301,551,766,380,43,7,2051,0.00146270112140419,0.146757679180887,0.268649439297903,0.373476352998537,0.185275475377864,0.0209653827401268,0.00341296928327645,855,0.416869819600195,1196,0.583130180399805
"E02006376",1,179,920,1059,450,69,12,2690,0.000371747211895911,0.066542750929368,0.342007434944238,0.393680297397769,0.16728624535316,0.0256505576208178,0.00446096654275093,1100,0.408921933085502,1590,0.591078066914498
"E02006377",6,219,479,801,296,48,5,1854,0.00323624595469256,0.118122977346278,0.258360302049622,0.432038834951456,0.159654800431499,0.0258899676375405,0.00269687162891046,704,0.379719525350593,1150,0.620280474649407
"E02006378",2,169,949,920,421,86,11,2558,0.000781860828772478,0.0660672400312744,0.370992963252541,0.35965598123534,0.164581704456607,0.0336200156372166,0.00430023455824863,1120,0.437842064112588,1438,0.562157935887412
"E02006379",5,529,1364,792,151,20,3,2864,0.00174581005586592,0.184706703910615,0.476256983240223,0.276536312849162,0.0527234636871508,0.00698324022346369,0.00104748603351955,1898,0.662709497206704,966,0.337290502793296
"E02006380",3,283,658,932,398,77,11,2362,0.0012701100762066,0.119813717188823,0.278577476714649,0.394580863674852,0.168501270110076,0.0325994919559695,0.00465707027942422,944,0.399661303979678,1418,0.600338696020322
"E02006381",7,348,743,830,331,68,13,2340,0.00299145299145299,0.148717948717949,0.317521367521368,0.354700854700855,0.141452991452991,0.0290598290598291,0.00555555555555556,1098,0.469230769230769,1242,0.530769230769231
"E02006382",7,244,1040,948,235,32,4,2510,0.00278884462151394,0.0972111553784861,0.414342629482072,0.377689243027888,0.0936254980079681,0.0127490039840637,0.00159362549800797,1291,0.514342629482072,1219,0.485657370517928
"E02006383",2,488,1220,1372,672,128,21,3903,0.00051242633871381,0.12503202664617,0.312580066615424,0.351524468357674,0.17217524980784,0.0327952856776838,0.005380476556495,1710,0.438124519600307,2193,0.561875480399693
"E02006384",14,539,2165,1322,491,81,9,4621,0.0030296472624973,0.116641419606146,0.468513308807617,0.286085262930102,0.106254057563298,0.0175286734473058,0.00194763038303398,2718,0.588184375676261,1903,0.411815624323739
"E02006385",29,1113,2200,1284,490,80,22,5218,0.00555768493675738,0.213300114986585,0.421617477960905,0.246071291682637,0.0939057110003833,0.0153315446531238,0.00421617477960905,3342,0.640475277884247,1876,0.359524722115753
"E02006386",5,264,935,1233,647,121,17,3222,0.00155183116076971,0.0819366852886406,0.290192427063935,0.38268156424581,0.2008069522036,0.0375543140906269,0.00527622594661701,1204,0.373680943513346,2018,0.626319056486654
"E02006387",3,224,956,778,346,49,5,2361,0.00127064803049555,0.0948750529436679,0.404913172384583,0.329521389241847,0.146548072850487,0.0207539178314274,0.00211774671749259,1183,0.501058873358746,1178,0.498941126641254
"E02006388",18,342,1265,1251,479,70,7,3432,0.00524475524475524,0.0996503496503496,0.368589743589744,0.36451048951049,0.139568764568765,0.0203962703962704,0.00203962703962704,1625,0.473484848484849,1807,0.526515151515151
"E02006389",16,179,837,854,396,88,35,2405,0.00665280665280665,0.0744282744282744,0.348024948024948,0.355093555093555,0.164656964656965,0.0365904365904366,0.0145530145530146,1032,0.429106029106029,1373,0.570893970893971
"E02006390",53,1584,1105,1070,274,44,6,4136,0.0128143133462282,0.382978723404255,0.267166344294004,0.258704061895551,0.066247582205029,0.0106382978723404,0.00145067698259188,2742,0.662959381044487,1394,0.337040618955513
"E02006391",8,631,942,785,183,34,9,2592,0.00308641975308642,0.243441358024691,0.363425925925926,0.302854938271605,0.0706018518518518,0.0131172839506173,0.00347222222222222,1581,0.609953703703704,1011,0.390046296296296
"E02006392",23,546,1598,1283,492,83,21,4046,0.00568462679189323,0.134948096885813,0.394957983193277,0.317103311913001,0.121601581809194,0.0205140879881364,0.00519031141868512,2167,0.535590706870984,1879,0.464409293129016
"E02006393",0,328,1165,1174,357,40,13,3077,0,0.106597335066623,0.378615534611635,0.381540461488463,0.116022099447514,0.0129996750081248,0.00422489437764056,1493,0.485212869678258,1584,0.514787130321742
"E02006394",6,637,1543,1252,452,74,19,3983,0.00150640220938991,0.159929701230228,0.387396434848104,0.314335927692694,0.11348229977404,0.0185789605824755,0.00477027366306804,2186,0.548832538287723,1797,0.451167461712277
"E02006395",2,330,1052,1413,501,54,14,3366,0.0005941770647653,0.0980392156862745,0.312537136066548,0.419786096256685,0.148841354723708,0.0160427807486631,0.0041592394533571,1384,0.411170528817588,1982,0.588829471182412
"E02006396",22,293,551,651,282,115,58,1972,0.0111561866125761,0.148580121703854,0.279411764705882,0.330121703853955,0.143002028397566,0.058316430020284,0.0294117647058824,866,0.439148073022312,1106,0.560851926977688
"E02006397",5,357,868,790,296,72,12,2400,0.00208333333333333,0.14875,0.361666666666667,0.329166666666667,0.123333333333333,0.03,0.005,1230,0.5125,1170,0.4875
"E02006398",2,603,1362,1282,456,69,22,3796,0.000526870389884088,0.158851422550053,0.358798735511064,0.337723919915701,0.120126448893572,0.0181770284510011,0.00579557428872497,1967,0.518177028451001,1829,0.481822971548999
"E02006399",14,1047,1302,1460,663,161,65,4712,0.00297113752122241,0.222198641765705,0.276315789473684,0.309847198641766,0.140704584040747,0.0341680814940577,0.0137945670628183,2363,0.501485568760611,2349,0.498514431239389
"E02006400",25,537,682,750,263,71,16,2344,0.0106655290102389,0.229095563139932,0.290955631399317,0.319965870307167,0.112201365187713,0.0302901023890785,0.0068259385665529,1244,0.530716723549488,1100,0.469283276450512
"E02006401",10,775,1232,1361,506,94,29,4007,0.00249563264287497,0.19341152982281,0.307461941602196,0.339655602695283,0.126279011729473,0.0234589468430247,0.00723733466433741,2017,0.503369104067881,1990,0.496630895932119
"E02006402",3,143,741,1326,475,71,16,2775,0.00108108108108108,0.0515315315315315,0.267027027027027,0.477837837837838,0.171171171171171,0.0255855855855856,0.00576576576576577,887,0.31963963963964,1888,0.68036036036036
"E02006403",7,64,1123,1242,348,32,14,2830,0.00247349823321555,0.0226148409893993,0.396819787985866,0.43886925795053,0.122968197879859,0.0113074204946996,0.0049469964664311,1194,0.421908127208481,1636,0.578091872791519
"E02006404",13,509,1091,947,204,22,6,2792,0.00465616045845272,0.18230659025788,0.390759312320917,0.339183381088825,0.0730659025787966,0.00787965616045845,0.00214899713467049,1613,0.577722063037249,1179,0.422277936962751
"E02006405",4,742,1091,1528,625,108,20,4118,0.000971345313258863,0.180184555609519,0.264934434191355,0.371053909664886,0.151772705196697,0.0262263234579893,0.00485672656629432,1837,0.446090335114133,2281,0.553909664885867
"E02006406",4,726,2104,1568,505,66,16,4989,0.000801763880537182,0.145520144317498,0.421727801162558,0.314291441170575,0.101222689917819,0.0132291040288635,0.00320705552214873,2834,0.568049709360593,2155,0.431950290639407
"E02006407",3,199,991,1320,503,93,12,3121,0.000961230374879846,0.0637616148670298,0.317526433835309,0.422941364947132,0.161166292854854,0.0297981416212752,0.00384492149951938,1193,0.382249279077219,1928,0.617750720922781
"E02006408",11,260,1241,1298,351,53,16,3230,0.00340557275541796,0.0804953560371517,0.384210526315789,0.401857585139319,0.108668730650155,0.0164086687306502,0.00495356037151703,1512,0.468111455108359,1718,0.531888544891641
"E02006409",4,65,1070,1006,237,27,7,2416,0.00165562913907285,0.0269039735099338,0.442880794701987,0.416390728476821,0.0980960264900662,0.0111754966887417,0.00289735099337748,1139,0.471440397350993,1277,0.528559602649007
"E02006410",4,169,1513,1317,353,32,6,3394,0.00117855038302887,0.0497937536829699,0.445786682380672,0.388037713612257,0.104007071302298,0.009428403064231,0.00176782557454331,1686,0.496758986446671,1708,0.50324101355333
"E02006411",4,51,682,1035,380,48,9,2209,0.00181077410593029,0.0230873698506111,0.308736985061114,0.468537799909461,0.172023540063377,0.0217292892711634,0.00407424173834314,737,0.333635129017655,1472,0.666364870982345
"E02006412",7,531,813,997,405,77,12,2842,0.00246305418719212,0.186840253342716,0.28606615059817,0.350809289232935,0.142505277973258,0.0270935960591133,0.00422237860661506,1351,0.475369458128079,1491,0.524630541871921
"E02006413",11,130,635,943,298,69,20,2106,0.00522317188983856,0.0617283950617284,0.301519468186135,0.447768281101614,0.141500474833808,0.0327635327635328,0.00949667616334283,776,0.368471035137702,1330,0.631528964862298
"E02006414",3,87,641,910,311,54,12,2018,0.00148662041625372,0.0431119920713578,0.317641228939544,0.450941526263627,0.154112983151635,0.0267591674925669,0.00594648166501487,731,0.362239841427156,1287,0.637760158572844
"E02006415",8,290,720,986,422,97,28,2551,0.00313602508820071,0.113680909447276,0.282242257938064,0.386515092120737,0.165425323402587,0.0380243041944336,0.0109760878087025,1018,0.39905919247354,1533,0.60094080752646
"E02006416",5,180,702,1255,502,88,23,2755,0.00181488203266788,0.0653357531760436,0.25480943738657,0.455535390199637,0.182214156079855,0.0319419237749546,0.00834845735027223,887,0.321960072595281,1868,0.678039927404719
"E02006417",6,393,951,934,177,21,10,2492,0.00240770465489567,0.157704654895666,0.381621187800963,0.374799357945425,0.0710272873194221,0.00842696629213483,0.00401284109149278,1350,0.541733547351525,1142,0.458266452648475
"E02006418",2,82,735,990,252,34,7,2102,0.000951474785918173,0.0390104662226451,0.349666983824929,0.470980019029496,0.11988582302569,0.0161750713606089,0.00333016175071361,819,0.389628924833492,1283,0.610371075166508
"E02006419",0,138,1294,1148,257,41,10,2888,0,0.0477839335180055,0.448060941828255,0.397506925207756,0.08898891966759,0.014196675900277,0.00346260387811634,1432,0.49584487534626,1456,0.50415512465374
"E02006420",6,416,1025,1091,342,65,16,2961,0.00202634245187437,0.140493076663289,0.346166835528538,0.368456602499156,0.115501519756839,0.021952043228639,0.00540357987166498,1447,0.488686254643701,1514,0.511313745356299
"E02006421",6,591,826,1062,252,45,14,2796,0.00214592274678112,0.21137339055794,0.295422031473534,0.379828326180258,0.0901287553648069,0.0160944206008584,0.0050071530758226,1423,0.508941344778255,1373,0.491058655221745
"E02006422",1,148,570,926,204,27,1,1877,0.00053276505061268,0.0788492274906766,0.303676078849227,0.493340436867342,0.108684070324987,0.0143846563665424,0.00053276505061268,719,0.383058071390517,1158,0.616941928609483
"E02006423",3,401,1764,1582,488,68,8,4314,0.000695410292072323,0.0929531757070005,0.408901251738526,0.366713027352805,0.113120074177098,0.0157626332869726,0.00185442744552619,2168,0.502549837737599,2146,0.497450162262402
"E02006424",4,135,527,805,275,33,0,1779,0.00224845418774592,0.075885328836425,0.296233839235526,0.452501405283867,0.154581225407532,0.0185497470489039,0,666,0.374367622259696,1113,0.625632377740304
"E02006425",0,178,857,864,208,24,10,2141,0,0.0831387202241943,0.40028024287716,0.403549743110696,0.0971508640822046,0.0112097150864082,0.00467071461933676,1035,0.483418963101354,1106,0.516581036898646
"E02006426",3,46,630,779,209,18,3,1688,0.00177725118483412,0.0272511848341232,0.373222748815166,0.461492890995261,0.123815165876777,0.0106635071090047,0.00177725118483412,679,0.402251184834123,1009,0.597748815165877
"E02006427",44,734,978,824,306,48,20,2954,0.014895057549086,0.248476641841571,0.331076506431957,0.278943805010156,0.103588354773189,0.016249153689912,0.00677048070412999,1756,0.594448205822613,1198,0.405551794177387
"E02006429",11,937,1182,1030,432,79,14,3685,0.00298507462686567,0.25427408412483,0.320759837177748,0.279511533242877,0.117232021709634,0.021438263229308,0.00379918588873813,2130,0.578018995929444,1555,0.421981004070556
"E02006430",53,379,1219,1090,313,41,4,3099,0.0171022910616328,0.122297515327525,0.393352694417554,0.351726363343014,0.101000322684737,0.0132300742174895,0.00129073894804776,1651,0.532752500806712,1448,0.467247499193288
"E02006431",19,646,1143,1419,671,116,33,4047,0.00469483568075117,0.15962441314554,0.2824314306894,0.35063009636768,0.165801828514949,0.0286632073140598,0.00815418828762046,1808,0.446750679515691,2239,0.553249320484309
"E02006432",8,197,536,702,328,64,10,1845,0.0043360433604336,0.106775067750678,0.290514905149051,0.380487804878049,0.177777777777778,0.0346883468834688,0.00542005420054201,741,0.401626016260163,1104,0.598373983739837
"E02006433",8,394,851,1186,595,144,35,3213,0.00248988484282602,0.122626828509181,0.264861500155618,0.369125427948957,0.185185185185185,0.0448179271708683,0.0108932461873638,1253,0.389978213507625,1960,0.610021786492375
"E02006434",36,232,618,673,248,32,9,1848,0.0194805194805195,0.125541125541126,0.334415584415584,0.364177489177489,0.134199134199134,0.0173160173160173,0.00487012987012987,886,0.479437229437229,962,0.520562770562771
"E02006435",17,133,440,785,353,99,27,1854,0.00916936353829558,0.0717367853290183,0.237324703344121,0.423408845738943,0.190399137001079,0.0533980582524272,0.0145631067961165,590,0.318230852211435,1264,0.681769147788565
"E02006436",7,180,546,819,308,62,17,1939,0.0036101083032491,0.0928313563692625,0.28158844765343,0.422382671480144,0.15884476534296,0.0319752449716349,0.00876740587931924,733,0.378029912325941,1206,0.621970087674059
"E02006437",14,322,700,940,416,124,26,2542,0.00550747442958301,0.126671911880409,0.27537372147915,0.36978756884343,0.163650668764752,0.0487804878048781,0.010228166797797,1036,0.407553107789142,1506,0.592446892210858
"E02006438",27,210,599,1020,432,148,33,2469,0.0109356014580802,0.0850546780072904,0.24260834345889,0.413122721749696,0.174969623329283,0.0599432968813285,0.0133657351154313,836,0.338598622924261,1633,0.661401377075739
"E02006439",5,409,629,855,292,36,1,2227,0.00224517287831163,0.183655141445891,0.282442748091603,0.383924562191289,0.131118096093399,0.0161652447238437,0.000449034575662326,1043,0.468343062415806,1184,0.531656937584194
"E02006440",1,178,689,1116,343,46,9,2382,0.000419815281276238,0.0747271200671704,0.289252728799328,0.468513853904282,0.14399664147775,0.019311502938707,0.00377833753148615,868,0.364399664147775,1514,0.635600335852225
"E02006441",4,445,1364,1308,511,76,22,3730,0.00107238605898123,0.119302949061662,0.365683646112601,0.350670241286863,0.136997319034853,0.0203753351206434,0.00589812332439678,1813,0.486058981233244,1917,0.513941018766756
"E02006442",12,189,572,790,318,86,8,1975,0.00607594936708861,0.0956962025316456,0.289620253164557,0.4,0.161012658227848,0.0435443037974684,0.00405063291139241,773,0.391392405063291,1202,0.608607594936709
"E02006443",60,261,818,1151,320,40,17,2667,0.0224971878515186,0.0978627671541057,0.30671166104237,0.431571053618298,0.119985001874766,0.0149981252343457,0.00637420322459693,1139,0.427071616047994,1528,0.572928383952006
"E02006444",6,188,778,914,322,52,7,2267,0.00264666960741068,0.0829289810322011,0.343184825760918,0.403176003528893,0.142037935597706,0.0229378032642258,0.00308778120864579,972,0.428760476400529,1295,0.571239523599471
"E02006445",7,571,1234,1276,492,79,18,3677,0.00190372586347566,0.155289638292086,0.335599673646995,0.347022028827849,0.133804732118575,0.021484906173511,0.00489529507750884,1812,0.492793037802556,1865,0.507206962197444
"E02006446",5,135,560,865,438,122,18,2143,0.00233317778814746,0.0629958002799813,0.261315912272515,0.40363975734951,0.204386374241717,0.0569295380307979,0.00839944003733084,700,0.326644890340644,1443,0.673355109659356
"E02006447",6,288,703,842,299,45,8,2191,0.00273847558192606,0.131446827932451,0.320858055682337,0.384299406663624,0.136467366499315,0.0205385668644455,0.00365130077590141,997,0.455043359196714,1194,0.544956640803286
"E02006448",48,480,598,961,353,49,11,2500,0.0192,0.192,0.2392,0.3844,0.1412,0.0196,0.0044,1126,0.4504,1374,0.5496
"E02006449",7,179,755,882,319,62,9,2213,0.00316312697695436,0.0808856755535472,0.341165838228649,0.398553999096249,0.144148215092634,0.0280162675101672,0.00406687754179846,941,0.42521464075915,1272,0.57478535924085
"E02006450",22,243,408,621,521,209,63,2087,0.0105414470531864,0.116435074269286,0.195495927168184,0.297556300910398,0.249640632486823,0.100143747005271,0.0301868711068519,673,0.322472448490656,1414,0.677527551509344
"E02006451",10,1286,1066,1502,527,90,8,4489,0.00222766763198931,0.286478057473825,0.23746936957006,0.334595678324794,0.117398084205836,0.0200490086879038,0.00178213410559145,2362,0.526175094675874,2127,0.473824905324126
"E02006453",6,399,766,890,586,233,69,2949,0.00203458799593082,0.1353001017294,0.259749067480502,0.301797219396406,0.198711427602577,0.0790098338419803,0.0233977619532045,1171,0.397083757205832,1778,0.602916242794168
"E02006454",3,196,899,889,357,58,15,2417,0.00124120810922631,0.0810922631361192,0.371948696731485,0.367811336367398,0.147703764997931,0.0239966901117087,0.00620604054613157,1098,0.454282167976831,1319,0.545717832023169
"E02006455",82,221,807,872,316,56,7,2361,0.0347310461668784,0.0936044049131724,0.341804320203304,0.369335027530707,0.133841592545532,0.023718763235917,0.00296484540448962,1110,0.470139771283355,1251,0.529860228716646
"E02006456",1,182,1014,1220,365,63,11,2856,0.000350140056022409,0.0637254901960784,0.355042016806723,0.427170868347339,0.127801120448179,0.0220588235294118,0.0038515406162465,1197,0.419117647058824,1659,0.580882352941177
"E02006457",9,373,883,1414,493,81,12,3265,0.00275650842266462,0.114241960183767,0.270444104134763,0.433078101071975,0.150995405819296,0.0248085758039816,0.00367534456355283,1265,0.387442572741194,2000,0.612557427258805
"E02006458",7,246,1056,1146,356,61,7,2879,0.0024313997915943,0.0854463355331712,0.366794025703369,0.398054880166725,0.123654046543939,0.0211879124696075,0.0024313997915943,1309,0.454671761028135,1570,0.545328238971865
"E02006459",64,632,1513,1488,304,46,10,4057,0.0157752033522307,0.155780133103278,0.372935666748829,0.366773477939364,0.0749322159230959,0.0113384274094158,0.00246487552378605,2209,0.544491003204338,1848,0.455508996795662
"E02006460",3,52,1751,1585,305,23,5,3724,0.000805585392051557,0.0139634801288937,0.470193340494092,0.42561761546724,0.0819011815252417,0.00617615467239527,0.00134264232008593,1806,0.484962406015038,1918,0.515037593984963
"E02006461",5,175,838,961,376,70,7,2432,0.00205592105263158,0.0719572368421053,0.344572368421053,0.395148026315789,0.154605263157895,0.0287828947368421,0.00287828947368421,1018,0.418585526315789,1414,0.581414473684211
"E02006462",7,149,1258,1191,291,47,9,2952,0.00237127371273713,0.0504742547425474,0.426151761517615,0.403455284552846,0.0985772357723577,0.0159214092140921,0.00304878048780488,1414,0.4789972899729,1538,0.5210027100271
"E02006463",3,1734,2720,1645,566,83,17,6768,0.000443262411347518,0.256205673758865,0.401891252955083,0.243055555555556,0.083628841607565,0.0122635933806147,0.00251182033096927,4457,0.658540189125296,2311,0.341459810874705
"E02006464",3,59,1088,973,232,37,4,2396,0.00125208681135225,0.0246243739565943,0.454090150250417,0.406093489148581,0.0968280467445743,0.0154424040066778,0.00166944908180301,1150,0.479966611018364,1246,0.520033388981636
"E02006465",9,190,807,812,299,55,5,2177,0.0041341295360588,0.0872760679834635,0.370693615066605,0.372990353697749,0.137344970142398,0.0252641249425815,0.00229673863114378,1006,0.462103812586128,1171,0.537896187413872
"E02006466",13,913,1243,1382,357,35,11,3954,0.00328780981284775,0.230905412240769,0.314365199797673,0.34951947395043,0.090288315629742,0.00885179564997471,0.00278199291856348,2169,0.54855842185129,1785,0.45144157814871
"E02006467",43,470,615,818,241,68,12,2267,0.0189677988531098,0.207322452580503,0.271283634759594,0.360829289810322,0.106307895897662,0.0299955888839877,0.00529333921482135,1128,0.497573886193207,1139,0.502426113806793
"E02006468",37,711,790,1469,502,97,34,3640,0.0101648351648352,0.19532967032967,0.217032967032967,0.403571428571429,0.137912087912088,0.0266483516483516,0.00934065934065934,1538,0.422527472527473,2102,0.577472527472528
"E02006469",22,181,839,1367,522,114,34,3079,0.00714517700552127,0.0587853199090614,0.272491068528743,0.443975316661254,0.169535563494641,0.0370250081195193,0.0110425462812601,1042,0.338421565443326,2037,0.661578434556674
"E02006470",31,472,1603,1839,764,117,20,4846,0.00639702847709451,0.0973999174576971,0.330788278992984,0.379488237721832,0.157655798596781,0.0241436236070986,0.00412711514651259,2106,0.434585224927776,2740,0.565414775072224
"E02006471",15,151,532,903,375,83,30,2089,0.00718046912398277,0.0722833891814265,0.254667304930589,0.432264241263763,0.179511728099569,0.0397319291527046,0.0143609382479655,698,0.334131163235998,1391,0.665868836764002
"E02006472",12,762,829,1247,587,140,46,3623,0.00331217223295611,0.210322936792713,0.228815898426718,0.34418989787469,0.162020425062103,0.038642009384488,0.0126966602263318,1603,0.442451007452388,2020,0.557548992547612
"E02006473",6,338,1014,1556,584,109,25,3632,0.00165198237885463,0.0930616740088106,0.279185022026432,0.4284140969163,0.16079295154185,0.030011013215859,0.00688325991189427,1358,0.373898678414097,2274,0.626101321585903
"E02006474",5,146,520,833,453,137,66,2160,0.00231481481481481,0.0675925925925926,0.240740740740741,0.385648148148148,0.209722222222222,0.0634259259259259,0.0305555555555556,671,0.310648148148148,1489,0.689351851851852
"E02006475",21,1798,540,1058,368,65,13,3863,0.00543618949003365,0.465441366813358,0.139787729743722,0.273880403831219,0.095262749158685,0.0168263008024851,0.00336526016049702,2359,0.610665286047114,1504,0.389334713952886
"E02006476",9,922,1238,1008,414,55,11,3657,0.00246103363412633,0.252119223407164,0.338528848783156,0.275635767022149,0.113207547169811,0.0150396499863276,0.00300792999726552,2169,0.593109105824446,1488,0.406890894175554
"E02006477",20,1382,418,1051,273,35,4,3183,0.00628338045868677,0.434181589695256,0.131322651586554,0.33019164310399,0.0857681432610745,0.0109959158027019,0.00125667609173735,1820,0.571787621740496,1363,0.428212378259504
"E02006478",7,676,813,1165,241,35,10,2947,0.00237529691211401,0.229385816084153,0.275873769935528,0.395317271801832,0.0817780794027825,0.0118764845605701,0.00339328130302002,1496,0.507634882931795,1451,0.492365117068205
"E02006479",4,373,1132,1673,846,134,42,4204,0.000951474785918173,0.0887250237868697,0.269267364414843,0.397954329210276,0.201236917221694,0.0318744053282588,0.00999048525214082,1509,0.358943862987631,2695,0.641056137012369
"E02006480",29,107,726,1223,384,59,13,2541,0.0114128295946478,0.0421094057457694,0.285714285714286,0.481306572215663,0.15112160566706,0.0232192050373869,0.00511609602518693,862,0.339236521054703,1679,0.660763478945297
"E02006481",2,184,694,1101,427,63,12,2483,0.000805477245267821,0.0741039065646396,0.279500604107934,0.443415223519936,0.17196939186468,0.0253725332259364,0.00483286347160693,880,0.354409987917841,1603,0.645590012082159
"E02006482",4,225,1027,844,274,44,10,2428,0.00164744645799012,0.092668863261944,0.422981878088962,0.347611202635914,0.112850082372323,0.0181219110378913,0.00411861614497529,1256,0.517298187808896,1172,0.482701812191104
"E02006483",72,156,780,1074,476,68,15,2641,0.0272624006058311,0.0590685346459674,0.295342673229837,0.406664142370314,0.180234759560772,0.0257478227943961,0.00567966679288148,1008,0.381673608481636,1633,0.618326391518364
"E02006484",2,117,955,1359,374,49,19,2875,0.000695652173913044,0.040695652173913,0.332173913043478,0.472695652173913,0.130086956521739,0.0170434782608696,0.00660869565217391,1074,0.373565217391304,1801,0.626434782608696
"E02006485",4,175,333,984,223,27,2,1748,0.0022883295194508,0.100114416475973,0.190503432494279,0.562929061784897,0.127574370709382,0.0154462242562929,0.0011441647597254,512,0.292906178489703,1236,0.707093821510298
"E02006486",6,322,639,983,281,34,6,2271,0.00264200792602378,0.141787758696609,0.281373844121532,0.432848965213562,0.12373403786878,0.0149713782474681,0.00264200792602378,967,0.425803610744166,1304,0.574196389255834
"E02006487",3,133,807,1110,402,42,6,2503,0.00119856172592889,0.0531362365161806,0.32241310427487,0.443467838593688,0.160607271274471,0.0167798641630044,0.00239712345185777,943,0.37674790251698,1560,0.62325209748302
"E02006488",6,304,429,924,298,56,6,2023,0.00296589223924864,0.150271873455264,0.212061295106278,0.456747404844291,0.147305981216016,0.027681660899654,0.00296589223924864,739,0.365299060800791,1284,0.634700939199209
"E02006489",6,350,1126,1189,393,55,10,3129,0.00191754554170662,0.111856823266219,0.359859379993608,0.379993608181528,0.125599232981783,0.0175775007989773,0.00319590923617769,1482,0.473633748801534,1647,0.526366251198466
"E02006490",5,171,718,1178,373,36,16,2497,0.00200240288346015,0.0684821786143372,0.287545054064878,0.471766119343212,0.149379255106127,0.0144173007609131,0.00640768922707249,894,0.358029635562675,1603,0.641970364437325
"E02006493",9,847,1534,1119,196,8,2,3715,0.00242261103633917,0.227994616419919,0.412920592193809,0.30121130551817,0.0527590847913863,0.00215343203230148,0.00053835800807537,2390,0.643337819650067,1325,0.356662180349933
"E02006494",3,634,1305,1257,407,51,17,3674,0.000816548720740337,0.172563962983125,0.355198693522047,0.342133913990201,0.110778443113772,0.0138813282525857,0.00462710941752858,1942,0.528579205225912,1732,0.471420794774088
"E02006495",25,307,728,934,309,73,14,2390,0.0104602510460251,0.128451882845188,0.304602510460251,0.390794979079498,0.12928870292887,0.0305439330543933,0.00585774058577406,1060,0.443514644351464,1330,0.556485355648536
"E02006496",1,74,723,1490,563,62,19,2932,0.00034106412005457,0.0252387448840382,0.246589358799454,0.50818553888131,0.192019099590723,0.0211459754433834,0.00648021828103683,798,0.272169167803547,2134,0.727830832196453
"E02006497",1,286,1376,1231,369,68,13,3344,0.000299043062200957,0.0855263157894737,0.411483253588517,0.368122009569378,0.110346889952153,0.0203349282296651,0.00388755980861244,1663,0.497308612440191,1681,0.502691387559809
"E02006498",43,831,1985,1293,319,51,8,4530,0.00949227373068433,0.183443708609272,0.438189845474614,0.285430463576159,0.0704194260485651,0.0112582781456954,0.00176600441501104,2859,0.631125827814569,1671,0.36887417218543
"E02006499",2,222,392,815,339,61,9,1840,0.00108695652173913,0.120652173913043,0.21304347826087,0.442934782608696,0.184239130434783,0.0331521739130435,0.00489130434782609,616,0.334782608695652,1224,0.665217391304348
"E02006500",47,836,700,863,293,48,10,2797,0.0168037182695745,0.298891669646049,0.250268144440472,0.308544869503039,0.104755094744369,0.0171612441902038,0.00357525920629246,1583,0.565963532356096,1214,0.434036467643904
"E02006501",15,431,911,1296,419,70,11,3153,0.00475737392959087,0.136695210910244,0.288931176657152,0.411037107516651,0.132889311766572,0.0222010783380907,0.00348874088169997,1357,0.430383761496987,1796,0.569616238503013
"E02006502",7,107,1052,1583,490,65,9,3313,0.00211288862058557,0.032297011771808,0.31753697555086,0.477814669483851,0.14790220344099,0.0196196800482946,0.00271657108361002,1166,0.351946875943254,2147,0.648053124056746
"E02006503",55,1100,662,907,437,134,44,3339,0.0164719976040731,0.329439952081462,0.198262952979934,0.271638215034441,0.130877508235999,0.0401317759808326,0.0131775980832585,1817,0.544174902665469,1522,0.455825097334531
"E02006504",8,118,387,636,414,145,43,1751,0.00456881781838949,0.067390062821245,0.221016561964592,0.363221016561965,0.236436322101656,0.0828098229583095,0.0245573957738435,513,0.292975442604226,1238,0.707024557395774
"E02006505",20,168,827,912,476,173,46,2622,0.007627765064836,0.0640732265446224,0.315408085430969,0.347826086956522,0.181540808543097,0.0659801678108314,0.0175438596491228,1015,0.387109077040427,1607,0.612890922959573
"E02006506",5,215,769,899,234,42,14,2178,0.00229568411386593,0.0987144168962351,0.35307621671258,0.412764003673095,0.107438016528926,0.0192837465564738,0.00642791551882461,989,0.454086317722681,1189,0.545913682277319
"E02006507",25,1384,1179,1276,333,73,34,4304,0.00580855018587361,0.321561338289963,0.273931226765799,0.296468401486989,0.0773698884758364,0.0169609665427509,0.0078996282527881,2588,0.601301115241636,1716,0.398698884758364
"E02006508",21,1498,965,1263,608,189,59,4603,0.00456224201607647,0.325439930480122,0.209645883119705,0.274386269824028,0.132087768846405,0.0410601781446883,0.0128177275689768,2484,0.539648055615903,2119,0.460351944384097
"E02006509",17,369,1013,1052,275,51,10,2787,0.00609974883387155,0.132400430570506,0.363473268747757,0.377466810190169,0.0986724076067456,0.0182992465016146,0.0035880875493362,1399,0.501973448152135,1388,0.498026551847865
"E02006510",45,1024,529,627,458,187,58,2928,0.0153688524590164,0.349726775956284,0.180669398907104,0.214139344262295,0.156420765027322,0.0638661202185792,0.0198087431693989,1598,0.545765027322404,1330,0.454234972677596
"E02006511",26,989,1158,1217,430,124,44,3988,0.00651955867602808,0.247993981945838,0.29037111334002,0.305165496489468,0.107823470411234,0.0310932798395186,0.0110330992978937,2173,0.544884653961886,1815,0.455115346038114
"E02006512",21,954,2514,1624,508,71,35,5727,0.0036668412781561,0.166579360921949,0.438973284442116,0.283569058844072,0.0887026366334905,0.0123974157499563,0.00611140213026017,3489,0.609219486642221,2238,0.390780513357779
"E02006513",13,989,1381,819,321,64,14,3601,0.0036101083032491,0.274645931685643,0.383504582060539,0.227436823104693,0.0891419050263816,0.017772840877534,0.00388780894196057,2383,0.661760622049431,1218,0.338239377950569
"E02006514",10,425,1615,1557,563,98,27,4295,0.00232828870779977,0.0989522700814901,0.376018626309662,0.362514551804424,0.131082654249127,0.0228172293364377,0.00628637951105937,2050,0.477299185098952,2245,0.522700814901048
"E02006515",10,1205,1023,1214,578,168,52,4250,0.00235294117647059,0.283529411764706,0.240705882352941,0.285647058823529,0.136,0.0395294117647059,0.0122352941176471,2238,0.526588235294118,2012,0.473411764705882
"E02006516",27,633,763,1189,1078,435,86,4211,0.00641177867489907,0.150320588933745,0.181192115886963,0.282355734979815,0.255996200427452,0.103300878651152,0.0204227024459748,1423,0.337924483495607,2788,0.662075516504393
"E02006517",105,1592,626,1016,739,226,56,4360,0.0240825688073395,0.365137614678899,0.143577981651376,0.23302752293578,0.169495412844037,0.0518348623853211,0.0128440366972477,2323,0.532798165137615,2037,0.467201834862385
"E02006518",30,779,1202,1260,750,271,73,4365,0.00687285223367698,0.178465063001145,0.275372279495991,0.288659793814433,0.171821305841924,0.0620847651775487,0.0167239404352806,2011,0.460710194730813,2354,0.539289805269187
"E02006519",4,422,806,1414,562,88,14,3310,0.00120845921450151,0.127492447129909,0.243504531722054,0.427190332326284,0.169788519637462,0.0265861027190332,0.00422960725075529,1232,0.372205438066465,2078,0.627794561933535
"E02006520",97,342,1046,1308,298,36,7,3134,0.0309508615188258,0.109125717932355,0.333758774728781,0.417358008934269,0.0950861518825782,0.01148691767709,0.00223356732610083,1485,0.473835354179962,1649,0.526164645820038
"E02006521",23,139,728,1204,328,41,3,2466,0.00932684509326845,0.0563665855636659,0.295214922952149,0.488240064882401,0.133008921330089,0.0166261151662612,0.00121654501216545,890,0.360908353609084,1576,0.639091646390916
"E02006522",18,242,286,659,549,258,79,2091,0.00860832137733142,0.115734098517456,0.136776661884266,0.315160210425634,0.262553802008608,0.12338593974175,0.0377809660449546,546,0.261119081779053,1545,0.738880918220947
"E02006523",77,490,784,1368,551,153,49,3472,0.0221774193548387,0.141129032258065,0.225806451612903,0.394009216589862,0.158698156682028,0.0440668202764977,0.0141129032258065,1351,0.389112903225806,2121,0.610887096774194
"E02006524",8,39,892,944,175,22,2,2082,0.00384245917387128,0.0187319884726225,0.428434197886647,0.453410182516811,0.0840537944284342,0.010566762728146,0.000960614793467819,939,0.451008645533141,1143,0.548991354466859
"E02006525",16,627,2105,2399,936,141,27,6251,0.00255959046552552,0.100303951367781,0.336746120620701,0.383778595424732,0.149736042233243,0.0225563909774436,0.00431930891057431,2748,0.439609662454007,3503,0.560390337545993
"E02006526",5,348,1201,1555,394,50,8,3561,0.001404099971918,0.0977253580454928,0.337264813254704,0.436675091266498,0.110643077787138,0.01404099971918,0.0022465599550688,1554,0.436394271272115,2007,0.563605728727886
"E02006527",23,356,1182,1629,735,121,13,4059,0.00566642030056664,0.0877063316087706,0.29120473022912,0.401330376940133,0.181079083518108,0.029810298102981,0.00320275930032028,1561,0.384577482138458,2498,0.615422517861542
"E02006528",5,366,1507,2035,876,134,21,4944,0.00101132686084142,0.0740291262135922,0.304813915857605,0.41161003236246,0.177184466019417,0.0271035598705502,0.00424757281553398,1878,0.379854368932039,3066,0.620145631067961
"E02006529",7,688,2552,1826,389,61,17,5540,0.00126353790613718,0.124187725631769,0.460649819494585,0.329602888086643,0.0702166064981949,0.0110108303249097,0.00306859205776173,3247,0.586101083032491,2293,0.413898916967509
"E02006530",139,2683,1733,1368,489,80,12,6504,0.0213714637146371,0.412515375153752,0.266451414514145,0.210332103321033,0.0751845018450184,0.01230012300123,0.0018450184501845,4555,0.700338253382534,1949,0.299661746617466
"E02006531",8,510,1581,1824,561,57,8,4549,0.00175862826994944,0.112112552209277,0.347548911848758,0.400967245548472,0.123323807430204,0.0125302264233898,0.00175862826994944,2099,0.461420092327984,2450,0.538579907672016
"E02006532",142,1941,996,1074,388,85,16,4642,0.030590262817751,0.41813873330461,0.214562688496338,0.231365790607497,0.0835846617837139,0.0183110728134425,0.003446790176648,3079,0.663291684618699,1563,0.336708315381301
"E02006533",58,358,1417,1296,228,35,12,3404,0.0170387779083431,0.105170387779083,0.416274970622797,0.380728554641598,0.0669800235017626,0.0102820211515864,0.00352526439482961,1833,0.538484136310223,1571,0.461515863689777
"E02006534",0,81,659,1307,472,67,19,2605,0,0.0310940499040307,0.252975047984645,0.501727447216891,0.181190019193858,0.0257197696737044,0.0072936660268714,740,0.284069097888676,1865,0.715930902111324
"E02006535",3,245,540,1032,307,43,5,2175,0.00137931034482759,0.11264367816092,0.248275862068966,0.47448275862069,0.141149425287356,0.0197701149425287,0.00229885057471264,788,0.362298850574713,1387,0.637701149425287
"E02006536",1,89,456,1031,336,58,13,1984,0.000504032258064516,0.0448588709677419,0.229838709677419,0.519657258064516,0.169354838709677,0.0292338709677419,0.00655241935483871,546,0.275201612903226,1438,0.724798387096774
"E02006537",0,295,1435,1597,404,57,26,3814,0,0.0773466177241741,0.376245411641321,0.418720503408495,0.105925537493445,0.0149449396958574,0.00681699003670687,1730,0.453592029365496,2084,0.546407970634505
"E02006538",9,670,1554,1351,474,85,20,4163,0.00216190247417728,0.160941628633197,0.37328849387461,0.324525582512611,0.113860196973337,0.0204179678116743,0.00480422772039395,2233,0.536392024981984,1930,0.463607975018016
"E02006539",6,76,721,1236,325,61,8,2433,0.00246609124537608,0.0312371557747637,0.296341964652692,0.508014796547472,0.133579942457871,0.0250719276613235,0.00328812166050144,803,0.330045211672832,1630,0.669954788327168
"E02006540",44,337,632,963,274,62,16,2328,0.0189003436426117,0.144759450171821,0.271477663230241,0.413659793814433,0.117697594501718,0.0266323024054983,0.00687285223367698,1013,0.435137457044674,1315,0.564862542955326
"E02006541",5,231,1007,1415,457,66,17,3198,0.00156347717323327,0.0722326454033771,0.314884302689181,0.442464040025016,0.142901813633521,0.0206378986866792,0.00531582238899312,1243,0.388680425265791,1955,0.611319574734209
"E02006542",3,227,671,902,491,124,35,2453,0.00122299225438239,0.0925397472482674,0.273542600896861,0.367713004484305,0.200163065633918,0.0505503465144721,0.0142682429677945,901,0.367305340399511,1552,0.632694659600489
"E02006543",36,322,510,891,337,89,15,2200,0.0163636363636364,0.146363636363636,0.231818181818182,0.405,0.153181818181818,0.0404545454545455,0.00681818181818182,868,0.394545454545455,1332,0.605454545454545
"E02006544",29,1734,1057,1399,489,137,32,4877,0.00594627844986672,0.355546442485134,0.216731597293418,0.28685667418495,0.100266557309822,0.0280910395735083,0.00656141070330121,2820,0.578224318228419,2057,0.421775681771581
"E02006545",8,1591,1487,1090,302,66,10,4554,0.00175669740887132,0.349363197189284,0.326526130873957,0.239350021958718,0.0663153271848924,0.0144927536231884,0.00219587176108915,3086,0.677646025472112,1468,0.322353974527888
"E02006546",92,900,1573,1411,326,42,9,4353,0.0211348495290604,0.206753962784287,0.36135998162187,0.324144268320698,0.074890879852975,0.00964851826326671,0.00206753962784287,2565,0.589248793935217,1788,0.410751206064783
"E02006547",263,1022,723,754,240,104,28,3134,0.083918315252074,0.326100829610721,0.230695596681557,0.240587109125718,0.0765794511805999,0.0331844288449266,0.00893426930440332,2008,0.640714741544352,1126,0.359285258455648
"E02006548",3,244,1333,1484,310,54,19,3447,0.000870322019147084,0.0707861908906295,0.386713083841021,0.430519292138091,0.0899332753118654,0.0156657963446475,0.0055120394545982,1580,0.458369596750798,1867,0.541630403249202
"E02006549",9,165,424,1257,482,75,11,2423,0.00371440363186133,0.0680973999174577,0.174989682212134,0.518778373916632,0.198926950061907,0.0309533635988444,0.00453982666116385,598,0.246801485761453,1825,0.753198514238547
"E02006550",3,245,962,1701,465,71,9,3456,0.000868055555555556,0.0708912037037037,0.278356481481481,0.4921875,0.134548611111111,0.0205439814814815,0.00260416666666667,1210,0.350115740740741,2246,0.649884259259259
"E02006551",4,178,1140,1774,663,109,14,3882,0.00103039670273055,0.0458526532715095,0.293663060278207,0.456980937661,0.170788253477589,0.0280783101494075,0.00360638845955693,1322,0.340546110252447,2560,0.659453889747553
"E02006552",1,223,1151,1545,813,141,48,3922,0.000254971953085161,0.0568587455379908,0.29347271800102,0.393931667516573,0.207292197858236,0.0359510453850077,0.0122386537480877,1375,0.350586435492096,2547,0.649413564507904
"E02006553",5,903,1075,1213,306,62,10,3574,0.00139899272523783,0.252658086177952,0.300783435926133,0.339395635142697,0.0856183547845551,0.0173475097929491,0.00279798545047566,1983,0.554840514829323,1591,0.445159485170677
"E02006554",6,118,878,1132,420,71,24,2649,0.00226500566251416,0.0445451113627784,0.331445828614572,0.427331068327671,0.158550396375991,0.0268025670064175,0.00906002265005663,1002,0.378255945639864,1647,0.621744054360136
"E02006555",1,127,1250,1219,339,40,11,2987,0.00033478406427854,0.0425175761633746,0.418480080348175,0.408101774355541,0.113491797790425,0.0133913625711416,0.00368262470706394,1378,0.461332440575829,1609,0.538667559424171
"E02006556",3,716,1048,1488,527,90,21,3893,0.000770613922424865,0.183919856152068,0.269201130233753,0.382224505522733,0.135371179039301,0.023118417672746,0.00539429745697406,1767,0.453891600308246,2126,0.546108399691754
"E02006557",0,292,1098,1069,389,38,14,2900,0,0.100689655172414,0.378620689655172,0.368620689655172,0.134137931034483,0.0131034482758621,0.00482758620689655,1390,0.479310344827586,1510,0.520689655172414
"E02006558",1,361,2302,2113,957,181,47,5962,0.000167728950016773,0.060550150956055,0.386112042938611,0.354411271385441,0.160516605166052,0.0303589399530359,0.00788326065078833,2664,0.446829922844683,3298,0.553170077155317
"E02006559",5,102,794,1687,487,54,9,3138,0.00159337157425112,0.0325047801147228,0.253027405991077,0.537603569152326,0.155194391332059,0.017208413001912,0.00286806883365201,901,0.287125557680051,2237,0.712874442319949
"E02006560",30,396,918,1728,473,68,32,3645,0.00823045267489712,0.108641975308642,0.251851851851852,0.474074074074074,0.129766803840878,0.0186556927297668,0.00877914951989026,1344,0.368724279835391,2301,0.631275720164609
"E02006561",5,68,598,803,482,183,52,2191,0.00228206298493838,0.031036056595162,0.272934732998631,0.366499315381105,0.21999087174806,0.0835235052487449,0.0237334550433592,671,0.306252852578731,1520,0.693747147421269
"E02006562",7,166,372,615,624,263,71,2118,0.00330500472143532,0.0783758262511804,0.175637393767705,0.290368271954674,0.294617563739377,0.124173748819641,0.0335221907459868,545,0.257318224740321,1573,0.742681775259679
"E02006563",5,48,300,583,619,340,95,1990,0.00251256281407035,0.0241206030150754,0.150753768844221,0.292964824120603,0.31105527638191,0.170854271356784,0.0477386934673367,353,0.177386934673367,1637,0.822613065326633
"E02006564",4,321,1193,1162,537,139,43,3399,0.00117681671079729,0.0944395410414828,0.350985583995293,0.341865254486614,0.157987643424537,0.0408943807002059,0.0126507796410709,1518,0.446601941747573,1881,0.553398058252427
"E02006565",6,180,588,910,906,367,119,3076,0.00195058517555267,0.05851755526658,0.191157347204161,0.295838751625488,0.294538361508453,0.119310793237971,0.0386866059817945,774,0.251625487646294,2302,0.748374512353706
"E02006566",5,695,865,917,487,202,67,3238,0.00154416306361952,0.214638665843113,0.267140210006177,0.28319950586782,0.150401482396541,0.0623841877702285,0.0206917850525015,1565,0.483323038912909,1673,0.516676961087091
"E02006567",21,367,656,928,492,140,44,2648,0.00793051359516616,0.138595166163142,0.24773413897281,0.350453172205438,0.185800604229607,0.0528700906344411,0.0166163141993958,1044,0.394259818731118,1604,0.605740181268882
"E02006568",92,1320,2398,1544,519,88,23,5984,0.0153743315508021,0.220588235294118,0.400735294117647,0.258021390374332,0.0867312834224599,0.0147058823529412,0.00384358288770053,3810,0.636697860962567,2174,0.363302139037433
"E02006569",18,716,833,1040,331,115,30,3083,0.00583846902367824,0.232241323386312,0.270191372040221,0.33733376581252,0.107362958157639,0.0373013298734998,0.00973078170613039,1567,0.508271164450211,1516,0.491728835549789
"E02006570",1,687,1763,1522,560,102,37,4672,0.000214041095890411,0.147046232876712,0.377354452054795,0.325770547945205,0.11986301369863,0.0218321917808219,0.00791952054794521,2451,0.524614726027397,2221,0.475385273972603
"E02006571",89,1126,1085,1091,363,63,10,3827,0.0232558139534884,0.294225241703684,0.283511889208257,0.285079696890515,0.0948523647765874,0.0164619806637053,0.00261301280376274,2300,0.60099294486543,1527,0.39900705513457
"E02006572",43,1365,1260,1212,431,98,44,4453,0.00965641140803952,0.306534920278464,0.282955311026274,0.272176061082416,0.096788681787559,0.0220076353020436,0.00988097911520323,2668,0.599146642712778,1785,0.400853357287222
"E02006573",37,711,1560,1762,755,189,55,5069,0.0072992700729927,0.140264351943184,0.307753008482935,0.347603077530085,0.148944565002959,0.0372854606431249,0.0108502663247189,2308,0.455316630499112,2761,0.544683369500888
"E02006574",34,355,1373,1943,572,101,19,4397,0.00773254491698886,0.0807368660450307,0.312258357971344,0.441892199226745,0.130088696838754,0.0229702069592904,0.00432112804184671,1762,0.400727768933364,2635,0.599272231066636
"E02006575",4,111,960,923,175,16,6,2195,0.00182232346241458,0.0505694760820046,0.437357630979499,0.420501138952164,0.0797266514806378,0.00728929384965831,0.00273348519362187,1075,0.489749430523918,1120,0.510250569476082
"E02006576",5,1629,918,1066,214,34,4,3870,0.00129198966408269,0.42093023255814,0.237209302325581,0.275452196382429,0.055297157622739,0.00878552971576227,0.00103359173126615,2552,0.659431524547804,1318,0.340568475452196
"E02006577",1,318,1346,891,180,9,4,2749,0.000363768643142961,0.115678428519462,0.489632593670426,0.324117861040378,0.065478355765733,0.00327391778828665,0.00145507457257184,1665,0.60567479083303,1084,0.39432520916697
"E02006578",1,1089,1941,1207,256,36,16,4546,0.00021997360316762,0.239551253849538,0.42696876374835,0.265508139023317,0.0563132424109107,0.00791904971403432,0.00351957765068192,3031,0.666739991201056,1515,0.333260008798944
"E02006579",3,145,1157,1077,210,24,3,2619,0.0011454753722795,0.055364642993509,0.441771668575792,0.411225658648339,0.0801832760595647,0.00916380297823597,0.0011454753722795,1305,0.498281786941581,1314,0.501718213058419
"E02006580",10,89,1062,982,169,23,4,2339,0.00427533133817871,0.0380504489097905,0.454040188114579,0.419837537409149,0.0722530996152202,0.00983326207781103,0.00171013253527148,1161,0.496365968362548,1178,0.503634031637452
"E02006581",4,787,1600,1259,343,43,7,4043,0.00098936433341578,0.194657432599555,0.395745733366312,0.311402423942617,0.0848379915904032,0.0106356665842196,0.00173138758347762,2391,0.591392530299283,1652,0.408607469700717
"E02006582",10,223,1050,977,91,7,1,2359,0.00423908435777872,0.0945315811784655,0.445103857566766,0.414158541754981,0.0385756676557863,0.0029673590504451,0.000423908435777872,1283,0.54387452310301,1076,0.45612547689699
"E02006583",0,145,1257,1333,226,10,2,2973,0,0.0487722838883283,0.422805247225025,0.44836865119408,0.0760174907500841,0.00336360578540195,0.00067272115708039,1402,0.471577531113353,1571,0.528422468886646
"E02006584",2,174,1251,548,33,0,2,2010,0.00099502487562189,0.0865671641791045,0.622388059701493,0.272636815920398,0.0164179104477612,0,0.00099502487562189,1427,0.709950248756219,583,0.290049751243781
"E02006585",4,26,996,927,138,22,2,2115,0.00189125295508274,0.0122931442080378,0.470921985815603,0.438297872340426,0.0652482269503546,0.0104018912529551,0.000945626477541371,1026,0.485106382978723,1089,0.514893617021277
"E02006586",0,35,975,718,87,9,2,1826,0,0.0191675794085433,0.53395399780942,0.393209200438116,0.047645125958379,0.00492880613362541,0.00109529025191676,1010,0.553121577217963,816,0.446878422782037
"E02006587",2,123,1764,951,137,14,2,2993,0.000668225860340795,0.0410958904109589,0.589375208820581,0.317741396592048,0.0457734714333445,0.00467758102238557,0.000668225860340795,1889,0.631139325091881,1104,0.368860674908119
"E02006588",4,1625,1346,1029,370,126,41,4541,0.000880863245981061,0.357850693679806,0.296410482272627,0.226602070028628,0.0814798502532482,0.0277471922484034,0.00902884827130588,2975,0.655142039198414,1566,0.344857960801586
"E02006589",11,480,1055,1637,272,37,6,3498,0.00314465408805031,0.137221269296741,0.301600914808462,0.46798170383076,0.0777587192681532,0.0105774728416238,0.00171526586620926,1546,0.441966838193253,1952,0.558033161806747
"E02006590",1,321,1132,1134,414,85,15,3102,0.000322372662798195,0.103481624758221,0.364925854287556,0.365570599613153,0.133462282398453,0.0274016763378465,0.00483558994197292,1454,0.468729851708575,1648,0.531270148291425
"E02006591",18,258,1005,1187,334,38,8,2848,0.00632022471910112,0.0905898876404494,0.352879213483146,0.416783707865169,0.117275280898876,0.0133426966292135,0.00280898876404494,1281,0.449789325842697,1567,0.550210674157303
"E02006592",9,299,331,658,444,147,56,1944,0.00462962962962963,0.15380658436214,0.170267489711934,0.338477366255144,0.228395061728395,0.0756172839506173,0.0288065843621399,639,0.328703703703704,1305,0.671296296296296
"E02006593",16,717,1987,1607,536,75,15,4953,0.00323036543508984,0.144760751059964,0.40117100747022,0.324449828386836,0.10821724207551,0.0151423379769836,0.00302846759539673,2720,0.549162123965274,2233,0.450837876034726
"E02006594",4,1826,1216,951,187,25,6,4215,0.000948991696322657,0.433214709371293,0.288493475682088,0.225622775800712,0.0443653618030842,0.00593119810201661,0.00142348754448399,3046,0.722657176749703,1169,0.277342823250297
"E02006595",9,252,585,795,545,160,32,2378,0.00378469301934399,0.105971404541632,0.246005046257359,0.334314550042052,0.229184188393608,0.0672834314550042,0.0134566862910008,846,0.355761143818335,1532,0.644238856181665
"E02006596",18,656,804,1268,210,44,1,3001,0.00599800066644452,0.218593802065978,0.267910696434522,0.422525824725092,0.0699766744418527,0.0146617794068644,0.000333222259246918,1478,0.492502499166944,1523,0.507497500833056
"E02006597",45,1463,1301,1049,446,135,42,4481,0.010042401249721,0.326489622852042,0.290336978353046,0.234099531354608,0.0995313546083463,0.0301272037491631,0.00937290783307297,2809,0.626869002454809,1672,0.373130997545191
"E02006598",4,93,290,612,445,166,42,1652,0.00242130750605327,0.0562953995157385,0.175544794188862,0.37046004842615,0.269370460048426,0.100484261501211,0.0254237288135593,387,0.234261501210654,1265,0.765738498789346
"E02006599",5,156,580,929,409,141,34,2254,0.00221827861579414,0.0692102928127773,0.257320319432121,0.412156166814552,0.181455190771961,0.0625554569653949,0.0150842945874002,741,0.328748890860692,1513,0.671251109139308
"E02006600",14,515,1333,1470,630,197,48,4207,0.00332778702163062,0.122415022581412,0.316852864273829,0.349417637271215,0.149750415973378,0.0468267173758022,0.0114095555027335,1862,0.442595673876872,2345,0.557404326123128
"E02006601",11,480,886,1094,420,122,29,3042,0.00361604207758054,0.157790927021696,0.291255752794214,0.359631821170283,0.138067061143984,0.0401051939513478,0.00953320184089415,1377,0.452662721893491,1665,0.547337278106509
"E02006602",8,653,558,998,410,135,26,2788,0.00286944045911047,0.234218077474892,0.200143472022956,0.357962697274032,0.147058823529412,0.0484218077474892,0.00932568149210904,1219,0.437230989956958,1569,0.562769010043042
"E02006603",4,143,796,1239,452,74,12,2720,0.00147058823529412,0.0525735294117647,0.292647058823529,0.455514705882353,0.166176470588235,0.0272058823529412,0.00441176470588235,943,0.346691176470588,1777,0.653308823529412
"E02006604",6,906,2076,1864,619,90,29,5590,0.00107334525939177,0.162075134168157,0.371377459749553,0.33345259391771,0.110733452593918,0.0161001788908766,0.00518783542039356,2988,0.534525939177102,2602,0.465474060822898
"E02006605",21,665,560,751,294,61,16,2368,0.00886824324324324,0.280827702702703,0.236486486486486,0.31714527027027,0.124155405405405,0.0257601351351351,0.00675675675675676,1246,0.526182432432432,1122,0.473817567567568
"E02006606",6,253,885,1117,253,55,4,2573,0.00233190827827439,0.0983287990672367,0.343956471045472,0.434123591138749,0.0983287990672367,0.0213758258841819,0.00155460551884959,1144,0.444617178390983,1429,0.555382821609017
"E02006607",10,737,581,999,374,51,14,2766,0.00361532899493854,0.26644974692697,0.210050614605929,0.36117136659436,0.135213304410701,0.0184381778741865,0.00506146059291396,1328,0.480115690527838,1438,0.519884309472162
"E02006608",13,473,477,647,224,56,13,1903,0.00683131897004729,0.248554913294798,0.250656857593274,0.339989490278508,0.117708880714661,0.0294272201786653,0.00683131897004729,963,0.506043089858119,940,0.493956910141881
"E02006609",13,249,399,727,582,218,49,2237,0.00581135449262405,0.111309789897184,0.178363880196692,0.324988824318283,0.260169870362092,0.0974519445686187,0.021904336164506,661,0.2954850245865,1576,0.7045149754135
"E02006610",36,987,590,804,558,176,62,3213,0.0112044817927171,0.30718954248366,0.183629007158419,0.250233426704015,0.173669467787115,0.0547774665421724,0.0192966075319016,1613,0.502023031434796,1600,0.497976968565204
"E02006611",40,752,1071,1432,428,63,7,3793,0.0105457421566043,0.19825995254416,0.282362246243079,0.377537569206433,0.112839441075666,0.0166095438966517,0.00184550487740575,1863,0.491167940943844,1930,0.508832059056156
"E02006612",5,1108,2811,1527,448,63,16,5978,0.000836400133824021,0.185346269655403,0.470224155235865,0.255436600869856,0.0749414519906323,0.0105386416861827,0.00267648042823687,3924,0.656406825025092,2054,0.343593174974908
"E02006613",9,324,1267,990,214,17,7,2828,0.00318246110325318,0.114568599717115,0.448019801980198,0.35007072135785,0.0756718528995757,0.00601131541725601,0.00247524752475248,1600,0.565770862800566,1228,0.434229137199434
"E02006614",32,1659,1444,1339,422,68,10,4974,0.00643345396059509,0.333534378769602,0.290309609971854,0.269199839163651,0.0848411741053478,0.0136710896662646,0.00201045436268597,3135,0.630277442702051,1839,0.369722557297949
"E02006615",2,275,870,947,141,13,2,2250,0.000888888888888889,0.122222222222222,0.386666666666667,0.420888888888889,0.0626666666666667,0.00577777777777778,0.000888888888888889,1147,0.509777777777778,1103,0.490222222222222
"E02006616",20,1210,907,1046,279,42,9,3513,0.00569313976658127,0.344434955878167,0.258183888414461,0.2977512097922,0.0794192997438087,0.0119555935098207,0.00256191289496157,2137,0.608311984059209,1376,0.391688015940791
"E02006617",5,589,1432,1326,413,59,15,3839,0.0013024225058609,0.153425371190414,0.373013805678562,0.345402448554311,0.10758009898411,0.0153685855691586,0.0039072675175827,2026,0.527741599374837,1813,0.472258400625163
"E02006618",31,293,573,797,144,12,0,1850,0.0167567567567568,0.158378378378378,0.30972972972973,0.430810810810811,0.0778378378378378,0.00648648648648649,0,897,0.484864864864865,953,0.515135135135135
"E02006619",13,563,754,979,500,137,47,2993,0.00434346809221517,0.188105579685934,0.25192114934848,0.327096558636819,0.167056465085199,0.0457734714333445,0.0157033077180087,1330,0.444370197126629,1663,0.555629802873371
"E02006620",73,837,1043,1381,466,98,13,3911,0.0186653029915623,0.214011761697775,0.266683712605472,0.353106622347226,0.119151112247507,0.0250575300434671,0.00332395806699054,1953,0.49936077729481,1958,0.50063922270519
"E02006621",4,62,492,1298,460,69,10,2395,0.00167014613778706,0.0258872651356994,0.205427974947808,0.5419624217119,0.192066805845511,0.0288100208768267,0.00417536534446764,558,0.232985386221294,1837,0.767014613778706
"E02006622",1,111,796,1273,418,64,8,2671,0.000374391613627855,0.0415574691126919,0.298015724447772,0.476600524148259,0.156495694496443,0.0239610632721827,0.00299513290902284,908,0.339947585174092,1763,0.660052414825908
"E02006623",3,177,1178,1267,388,48,6,3067,0.00097815454841865,0.0577111183567004,0.38408868601239,0.41310727094881,0.126507988262145,0.0156504727746984,0.0019563090968373,1358,0.442777958917509,1709,0.557222041082491
"E02006624",1,89,465,1079,411,81,9,2135,0.000468384074941452,0.0416861826697892,0.217798594847775,0.505386416861827,0.192505854800937,0.0379391100702576,0.00421545667447307,555,0.259953161592506,1580,0.740046838407494
"E02006625",1,68,726,1322,404,62,19,2602,0.000384319754035357,0.0261337432744043,0.279016141429669,0.508070714834743,0.155265180630284,0.0238278247501922,0.00730207532667179,795,0.305534204458109,1807,0.694465795541891
"E02006626",10,1252,1185,1105,205,32,9,3798,0.00263296471827278,0.329647182727751,0.312006319115324,0.290942601369142,0.0539757767245919,0.00842548709847288,0.0023696682464455,2447,0.644286466561348,1351,0.355713533438652
"E02006627",1,475,1071,1445,442,81,10,3525,0.000283687943262411,0.134751773049645,0.303829787234043,0.409929078014184,0.125390070921986,0.0229787234042553,0.00283687943262411,1547,0.43886524822695,1978,0.56113475177305
"E02006628",0,170,1130,1672,574,92,31,3669,0,0.0463341509948215,0.307985827200872,0.455710002725538,0.156445898064868,0.0250749523030799,0.00844916871082039,1300,0.354319978195694,2369,0.645680021804306
"E02006629",2,71,883,1391,405,74,21,2847,0.000702493853178785,0.0249385317878469,0.310151036178433,0.488584474885845,0.142255005268704,0.025992272567615,0.00737618545837724,956,0.335792061819459,1891,0.664207938180541
"E02006630",0,492,1708,1808,1013,164,48,5233,0,0.0940187273074718,0.326390215937321,0.345499713357539,0.193579208866807,0.0313395757691573,0.00917255876170457,2200,0.420408943244793,3033,0.579591056755207
"E02006631",19,722,2089,2276,1091,199,61,6457,0.00294254297661453,0.111816633111352,0.323524856744618,0.352485674461824,0.168963915130866,0.0308192659129627,0.00944711166176243,2830,0.438284032832585,3627,0.561715967167415
"E02006632",2,198,1048,1636,694,113,19,3710,0.000539083557951483,0.0533692722371968,0.282479784366577,0.440970350404313,0.187061994609164,0.0304582210242588,0.00512129380053908,1248,0.336388140161725,2462,0.663611859838275
"E02006633",30,176,701,1628,534,86,9,3164,0.00948166877370417,0.0556257901390645,0.221554993678887,0.514538558786346,0.168773704171934,0.027180783817952,0.00284450063211125,907,0.286662452591656,2257,0.713337547408344
"E02006634",6,153,510,1060,682,174,52,2637,0.00227531285551763,0.0580204778156997,0.193401592718999,0.401971937808115,0.258627227910504,0.0659840728100114,0.0197193780811528,669,0.253697383390216,1968,0.746302616609784
"E02006635",5,488,1105,1178,414,92,11,3293,0.00151837230488916,0.148193136957182,0.335560279380504,0.357728515031886,0.125721226844822,0.0279380504099605,0.00334041907075615,1598,0.485271788642575,1695,0.514728211357425
"E02006636",10,139,490,920,828,210,43,2640,0.00378787878787879,0.0526515151515152,0.185606060606061,0.348484848484849,0.313636363636364,0.0795454545454545,0.0162878787878788,639,0.242045454545455,2001,0.757954545454545
"E02006637",7,824,1955,1159,322,53,4,4324,0.00161887141535615,0.190564292321924,0.452127659574468,0.268038852913969,0.074468085106383,0.0122571692876966,0.000925069380203515,2786,0.644310823311748,1538,0.355689176688252
"E02006638",9,261,1078,1013,401,94,19,2875,0.0031304347826087,0.0907826086956522,0.37495652173913,0.352347826086957,0.139478260869565,0.032695652173913,0.00660869565217391,1348,0.468869565217391,1527,0.531130434782609
"E02006639",36,108,444,966,763,222,57,2596,0.0138674884437596,0.0416024653312789,0.171032357473035,0.37211093990755,0.293913713405239,0.0855161787365177,0.0219568567026194,588,0.226502311248074,2008,0.773497688751926
"E02006640",7,59,347,913,823,253,55,2457,0.00284900284900285,0.024013024013024,0.141229141229141,0.371591371591372,0.334961334961335,0.102971102971103,0.0223850223850224,413,0.168091168091168,2044,0.831908831908832
"E02006641",64,564,477,894,646,195,44,2884,0.0221914008321775,0.195561719833564,0.165395284327323,0.30998613037448,0.223994452149792,0.0676144244105409,0.0152565880721221,1105,0.383148404993065,1779,0.616851595006935
"E02006642",5,82,192,784,598,219,40,1920,0.00260416666666667,0.0427083333333333,0.1,0.408333333333333,0.311458333333333,0.1140625,0.0208333333333333,279,0.1453125,1641,0.8546875
"E02006644",17,301,648,859,361,112,42,2340,0.00726495726495727,0.128632478632479,0.276923076923077,0.367094017094017,0.154273504273504,0.0478632478632479,0.0179487179487179,966,0.412820512820513,1374,0.587179487179487
"E02006645",16,588,957,1097,441,119,35,3253,0.00491853673532124,0.180756225023056,0.294189978481402,0.337227174915463,0.135567168767292,0.0365816169689517,0.0107592991085152,1561,0.479864740239779,1692,0.520135259760221
"E02006646",12,907,717,824,264,69,18,2811,0.00426894343649947,0.322660974742085,0.255069370330843,0.293134115972963,0.0939167556029883,0.0245464247598719,0.0064034151547492,1636,0.581999288509427,1175,0.418000711490573
"E02006647",19,106,323,689,528,173,31,1869,0.0101658640984484,0.0567148207597646,0.172819689673622,0.36864633493847,0.282504012841092,0.0925628678437667,0.0165864098448368,448,0.239700374531835,1421,0.760299625468165
"E02006648",35,197,595,770,510,179,53,2339,0.0149636596836255,0.0842240273621206,0.254382214621633,0.329200513039761,0.218041898247114,0.0765284309533989,0.0226592560923472,827,0.353569901667379,1512,0.646430098332621
"E02006649",4,453,1233,1156,261,29,9,3145,0.00127186009538951,0.144038155802862,0.392050874403816,0.367567567567568,0.0829888712241653,0.00922098569157393,0.00286168521462639,1690,0.537360890302067,1455,0.462639109697933
"E02006650",8,624,1453,1887,422,105,30,4529,0.00176639434753809,0.137778759107971,0.320821373371605,0.416648266725547,0.0931773018326341,0.0231839258114374,0.00662397880326783,2085,0.460366526827114,2444,0.539633473172886
"E02006651",11,218,410,880,549,208,66,2342,0.00469684030742955,0.0930828351836038,0.175064047822374,0.375747224594364,0.234415029888984,0.0888129803586678,0.0281810418445773,639,0.272843723313407,1703,0.727156276686593
"E02006652",4,472,1220,1444,433,52,14,3639,0.00109920307776862,0.129705963176697,0.335256938719428,0.396812311074471,0.118988733168453,0.014289640010992,0.00384721077219016,1696,0.466062104973894,1943,0.533937895026106
"E02006653",1,192,1375,1607,278,38,4,3495,0.000286123032904149,0.0549356223175966,0.393419170243205,0.459799713876967,0.0795422031473534,0.0108726752503577,0.0011444921316166,1568,0.448640915593705,1927,0.551359084406295
"E02006654",15,833,1904,1503,515,56,19,4845,0.00309597523219814,0.171929824561404,0.392982456140351,0.310216718266254,0.106295149638803,0.0115583075335397,0.00392156862745098,2752,0.568008255933953,2093,0.431991744066047
"E02006655",34,890,432,823,575,203,41,2998,0.0113408939292862,0.296864576384256,0.144096064042695,0.274516344229486,0.191794529686458,0.0677118078719146,0.0136757838559039,1356,0.452301534356237,1642,0.547698465643763
"E02006656",3,50,969,1102,168,14,3,2309,0.00129926375054136,0.021654395842356,0.419662191424859,0.477262884365526,0.0727587700303162,0.00606323083585968,0.00129926375054136,1022,0.442615851017757,1287,0.557384148982243
"E02006657",13,821,2302,1269,257,46,8,4716,0.00275657336726039,0.174088210347752,0.488125530110263,0.269083969465649,0.0544953350296862,0.0097540288379983,0.00169635284139101,3136,0.664970313825276,1580,0.335029686174724
"E02006658",2,690,1056,1225,332,55,12,3372,0.000593119810201661,0.204626334519573,0.313167259786477,0.363285883748517,0.0984578884934757,0.0163107947805457,0.00355871886120996,1748,0.518386714116251,1624,0.481613285883749
"E02006659",13,514,954,1128,356,88,24,3077,0.00422489437764056,0.167045823854404,0.310042248943776,0.366590835229119,0.115697107572311,0.0285992850178746,0.00779980500487488,1481,0.481312967175821,1596,0.518687032824179
"E02006660",14,1179,1916,1819,647,136,29,5740,0.0024390243902439,0.205400696864111,0.333797909407666,0.316898954703833,0.112717770034843,0.0236933797909408,0.00505226480836237,3109,0.541637630662021,2631,0.458362369337979
"E02006661",54,480,1195,1268,346,106,22,3471,0.0155574762316335,0.13828867761452,0.344281186977816,0.365312590031691,0.0996830884471334,0.0305387496398732,0.00633823105733218,1729,0.49812734082397,1742,0.50187265917603
"E02006662",139,535,759,910,172,43,6,2564,0.0542121684867395,0.208658346333853,0.296021840873635,0.354914196567863,0.0670826833073323,0.0167706708268331,0.00234009360374415,1433,0.558892355694228,1131,0.441107644305772
"E02006663",9,1636,1929,1094,247,50,15,4980,0.00180722891566265,0.3285140562249,0.387349397590361,0.219678714859438,0.0495983935742972,0.0100401606425703,0.00301204819277108,3574,0.717670682730924,1406,0.282329317269076
"E02006664",10,140,427,858,452,131,30,2048,0.0048828125,0.068359375,0.20849609375,0.4189453125,0.220703125,0.06396484375,0.0146484375,577,0.28173828125,1471,0.71826171875
"E02006665",15,207,652,835,617,257,78,2661,0.0056369785794814,0.0777903043968433,0.245020668921458,0.313791807591131,0.231867718902668,0.0965802329951146,0.0293122886133033,874,0.328447951897783,1787,0.671552048102217
"E02006666",2,541,759,744,149,23,7,2225,0.000898876404494382,0.24314606741573,0.341123595505618,0.33438202247191,0.0669662921348315,0.0103370786516854,0.00314606741573034,1302,0.585168539325843,923,0.414831460674157
"E02006667",1,1002,1124,803,139,25,7,3101,0.000322476620445018,0.323121573685908,0.3624637213802,0.258948726217349,0.0448242502418575,0.00806191551112544,0.00225733634311512,2127,0.685907771686553,974,0.314092228313447
"E02006668",1,91,680,799,222,39,5,1837,0.000544365813826892,0.0495372890582471,0.370168753402286,0.434948285247686,0.12084921066957,0.0212302667392488,0.00272182906913446,772,0.42025040827436,1065,0.57974959172564
"E02006669",20,456,759,1453,895,261,67,3911,0.00511378164152391,0.116594221426745,0.194068013295832,0.371516236256712,0.228841728458195,0.066734850421887,0.0171311684991051,1235,0.315776016364101,2676,0.684223983635899
"E02006670",1,428,1095,1177,371,69,19,3160,0.000316455696202532,0.135443037974684,0.346518987341772,0.37246835443038,0.117405063291139,0.0218354430379747,0.0060126582278481,1524,0.482278481012658,1636,0.517721518987342
"E02006671",3,325,1069,1117,450,81,18,3063,0.000979431929480901,0.106105125693764,0.349004244205028,0.364675155076722,0.146914789422135,0.0264446620959843,0.00587659157688541,1397,0.456088801828273,1666,0.543911198171727
"E02006672",41,1517,1093,672,312,80,15,3730,0.0109919571045576,0.406702412868633,0.293029490616622,0.180160857908847,0.0836461126005362,0.0214477211796247,0.00402144772117962,2651,0.710723860589812,1079,0.289276139410188
"E02006673",3,99,863,849,314,63,29,2220,0.00135135135135135,0.0445945945945946,0.388738738738739,0.382432432432432,0.141441441441441,0.0283783783783784,0.0130630630630631,965,0.434684684684685,1255,0.565315315315315
"E02006674",0,253,1024,789,184,26,6,2282,0,0.110867659947415,0.448729184925504,0.345749342681858,0.0806310254163015,0.0113935144609991,0.00262927256792287,1277,0.559596844872918,1005,0.440403155127082
"E02006675",18,216,586,965,471,136,22,2414,0.00745650372825186,0.0894780447390224,0.242750621375311,0.399751449875725,0.195111847555924,0.0563380281690141,0.00911350455675228,820,0.339685169842585,1594,0.660314830157415
"E02006676",10,139,351,850,665,290,84,2389,0.00418585182084554,0.058183340309753,0.146923398911679,0.355797404771871,0.278359146086229,0.121389702804521,0.0351611552951026,500,0.209292591042277,1889,0.790707408957723
"E02006677",9,270,630,990,443,103,39,2484,0.0036231884057971,0.108695652173913,0.253623188405797,0.398550724637681,0.178341384863124,0.0414653784219002,0.0157004830917874,909,0.365942028985507,1575,0.634057971014493
"E02006678",3,287,932,895,242,30,11,2400,0.00125,0.119583333333333,0.388333333333333,0.372916666666667,0.100833333333333,0.0125,0.00458333333333333,1222,0.509166666666667,1178,0.490833333333333
"E02006679",66,1585,1541,1126,428,79,24,4849,0.013611053825531,0.326871519901011,0.317797484017323,0.23221282738709,0.0882656217776861,0.0162920189729841,0.00494947411837492,3192,0.658280057743865,1657,0.341719942256135
"E02006680",13,279,1004,1093,379,51,12,2831,0.00459201695513953,0.0985517484987637,0.35464500176616,0.386082656305193,0.133874955845991,0.0180148357470858,0.00423878488166726,1296,0.457788767220064,1535,0.542211232779936
"E02006681",16,144,519,778,361,128,25,1971,0.00811770674784373,0.0730593607305936,0.263318112633181,0.394723490613902,0.183155758498224,0.0649416539827499,0.0126839167935058,679,0.344495180111618,1292,0.655504819888381
"E02006682",10,585,1160,1407,550,123,16,3851,0.00259672812256557,0.151908595170086,0.301220462217606,0.365359646844975,0.142820046741106,0.0319397559075565,0.00415476499610491,1755,0.455725785510257,2096,0.544274214489743
"E02006683",79,326,1132,828,227,54,18,2664,0.0296546546546547,0.122372372372372,0.424924924924925,0.310810810810811,0.0852102102102102,0.0202702702702703,0.00675675675675676,1537,0.576951951951952,1127,0.423048048048048
"E02006684",0,516,1105,940,445,61,13,3080,0,0.167532467532468,0.358766233766234,0.305194805194805,0.144480519480519,0.0198051948051948,0.00422077922077922,1621,0.526298701298701,1459,0.473701298701299
"E02006685",7,845,1787,993,309,55,11,4007,0.00174694285001248,0.210880958322935,0.445969553281757,0.247816321437484,0.0771150486648365,0.0137259795358123,0.00274519590716247,2639,0.658597454454704,1368,0.341402545545296
"E02006686",10,95,527,613,127,16,5,1393,0.00717875089734386,0.0681981335247667,0.378320172290022,0.440057430007179,0.091170136396267,0.0114860014357502,0.00358937544867193,632,0.453697056712132,761,0.546302943287868
"E02006687",14,407,1219,962,202,27,3,2834,0.00494001411432604,0.143613267466478,0.430134086097389,0.339449541284404,0.0712773465067043,0.00952717007762879,0.00105857445306987,1640,0.578687367678193,1194,0.421312632321807
"E02006688",8,80,602,860,308,46,11,1915,0.00417754569190601,0.0417754569190601,0.314360313315927,0.449086161879896,0.160835509138381,0.0240208877284595,0.00574412532637076,690,0.360313315926893,1225,0.639686684073107
"E02006689",5,211,466,810,427,132,33,2084,0.00239923224568138,0.101247600767754,0.223608445297505,0.388675623800384,0.20489443378119,0.0633397312859885,0.0158349328214971,682,0.32725527831094,1402,0.67274472168906
"E02006690",65,330,489,973,437,125,25,2444,0.0265957446808511,0.135024549918167,0.200081833060556,0.398117839607201,0.178805237315876,0.0511456628477905,0.0102291325695581,884,0.361702127659574,1560,0.638297872340426
"E02006692",0,176,1001,786,171,30,11,2175,0,0.0809195402298851,0.460229885057471,0.361379310344828,0.0786206896551724,0.0137931034482759,0.00505747126436782,1177,0.541149425287356,998,0.458850574712644
"E02006693",9,675,733,884,202,23,10,2536,0.00354889589905363,0.266167192429022,0.28903785488959,0.348580441640379,0.0796529968454259,0.00906940063091483,0.00394321766561514,1417,0.558753943217666,1119,0.441246056782334
"E02006694",24,253,993,969,390,90,12,2731,0.00878798974734529,0.0926400585865983,0.363603075796412,0.354815086049066,0.142804833394361,0.0329549615525449,0.00439399487367265,1270,0.465031124130355,1461,0.534968875869645
"E02006695",49,95,273,735,830,345,75,2402,0.0203996669442132,0.0395503746877602,0.113655287260616,0.305995004163197,0.345545378850958,0.143630308076603,0.0312239800166528,417,0.17360532889259,1985,0.82639467110741
"E02006696",12,419,516,870,392,80,9,2298,0.00522193211488251,0.182332463011314,0.224543080939948,0.378590078328982,0.170583115752829,0.0348128807658834,0.00391644908616188,947,0.412097476066144,1351,0.587902523933856
"E02006697",19,128,424,837,498,184,59,2149,0.00884132154490461,0.0595625872498837,0.19730107026524,0.389483480688692,0.231735691019079,0.0856212191717078,0.0274546300604933,571,0.265704979060028,1578,0.734295020939972
"E02006698",3,48,358,914,346,50,13,1732,0.00173210161662818,0.0277136258660508,0.206697459584296,0.527713625866051,0.199769053117783,0.0288683602771363,0.00750577367205543,409,0.236143187066975,1323,0.763856812933025
"E02006699",3,61,608,877,224,75,8,1856,0.00161637931034483,0.0328663793103448,0.327586206896552,0.472521551724138,0.120689655172414,0.0404094827586207,0.00431034482758621,672,0.362068965517241,1184,0.637931034482759
"E02006700",4,249,391,683,310,64,11,1712,0.00233644859813084,0.145443925233645,0.22838785046729,0.398948598130841,0.18107476635514,0.0373831775700935,0.00642523364485981,644,0.376168224299065,1068,0.623831775700935
"E02006701",21,506,609,807,369,85,5,2402,0.00874271440466278,0.210657785179017,0.253538717735221,0.335970024979184,0.153621981681932,0.0353871773522065,0.00208159866777685,1136,0.472939217318901,1266,0.527060782681099
"E02006702",4,198,717,813,202,30,10,1974,0.00202634245187437,0.100303951367781,0.36322188449848,0.411854103343465,0.102330293819656,0.0151975683890578,0.00506585612968592,919,0.465552178318136,1055,0.534447821681864
"E02006703",4,407,589,977,365,51,13,2406,0.00166251039068994,0.169160432252702,0.244804655029094,0.406068162926018,0.151704073150457,0.0211970074812968,0.00540315876974231,1000,0.415627597672485,1406,0.584372402327514
"E02006704",4,164,564,810,395,99,28,2064,0.00193798449612403,0.0794573643410853,0.273255813953488,0.392441860465116,0.191375968992248,0.0479651162790698,0.0135658914728682,732,0.354651162790698,1332,0.645348837209302
"E02006705",71,364,594,1167,401,52,13,2662,0.026671675432006,0.136739293764087,0.223140495867769,0.438392186326071,0.150638617580766,0.019534184823441,0.00488354620586026,1029,0.386551465063862,1633,0.613448534936138
"E02006706",23,344,1175,1037,371,30,4,2984,0.00770777479892761,0.115281501340483,0.393766756032172,0.347520107238606,0.124329758713137,0.0100536193029491,0.00134048257372654,1542,0.516756032171582,1442,0.483243967828418
"E02006707",4,71,618,892,252,44,4,1885,0.00212201591511936,0.0376657824933687,0.327851458885942,0.473209549071618,0.13368700265252,0.023342175066313,0.00212201591511936,693,0.36763925729443,1192,0.63236074270557
"E02006708",46,261,1528,917,261,33,16,3062,0.0150228608752449,0.0852384062704115,0.499020248203788,0.299477465708687,0.0852384062704115,0.0107772697583279,0.00522534291312867,1835,0.599281515349445,1227,0.400718484650555
"E02006709",3,599,600,916,290,92,29,2529,0.00118623962040332,0.236852510873863,0.237247924080664,0.362198497429814,0.114669829972321,0.0363780150257019,0.0114669829972321,1202,0.475286674574931,1327,0.524713325425069
"E02006710",59,300,461,889,721,354,113,2897,0.0203658957542285,0.103555402140145,0.159130134622023,0.30686917500863,0.248878149810148,0.122195374525371,0.0390058681394546,820,0.283051432516396,2077,0.716948567483604
"E02006711",101,346,476,769,732,317,102,2843,0.0355258529722125,0.121702427013718,0.167428772423496,0.270488920154766,0.257474498768906,0.111501934576152,0.0358775940907492,923,0.324657052409427,1920,0.675342947590573
"E02006712",97,1029,422,750,508,212,53,3071,0.03158580267014,0.335070009768805,0.137414522956692,0.244220123738196,0.165418430478671,0.0690328883099967,0.0172582220774992,1548,0.504070335395637,1523,0.495929664604363
"E02006713",20,419,818,1007,479,86,16,2845,0.0070298769771529,0.147275922671353,0.287521968365554,0.353954305799648,0.168365553602812,0.0302284710017575,0.00562390158172232,1257,0.44182776801406,1588,0.55817223198594
"E02006714",43,302,356,642,398,144,59,1944,0.022119341563786,0.155349794238683,0.183127572016461,0.330246913580247,0.204732510288066,0.0740740740740741,0.0303497942386831,701,0.36059670781893,1243,0.63940329218107
"E02006715",26,520,1054,1185,456,80,17,3338,0.00778909526662672,0.155781905332534,0.31575793888556,0.355002995805872,0.136608747753146,0.0239664469742361,0.00509286998202517,1600,0.479328939484721,1738,0.520671060515279
"E02006716",11,305,1257,922,238,20,4,2757,0.00398984403336961,0.110627493652521,0.455930359085963,0.334421472615161,0.0863257163583605,0.00725426187885383,0.00145085237577077,1573,0.570547696771853,1184,0.429452303228146
"E02006717",126,640,437,663,426,147,44,2483,0.0507450664518727,0.257752718485703,0.175996778091019,0.267015706806283,0.171566653242046,0.0592025775271849,0.0177204993958921,1203,0.484494563028594,1280,0.515505436971405
"E02006718",140,337,799,946,356,81,13,2672,0.0523952095808383,0.126122754491018,0.299026946107784,0.354041916167665,0.133233532934132,0.030314371257485,0.00486526946107784,1276,0.477544910179641,1396,0.522455089820359
"E02006719",9,338,919,1299,573,137,42,3317,0.00271329514621646,0.101899306602352,0.277057582152547,0.391618932770576,0.172746457642448,0.0413023816701839,0.0126620440156768,1266,0.381670183901116,2051,0.618329816098884
"E02006720",12,274,562,836,592,226,66,2568,0.00467289719626168,0.106697819314642,0.218847352024922,0.325545171339564,0.230529595015576,0.088006230529595,0.0257009345794393,848,0.330218068535826,1720,0.669781931464174
"E02006721",3,673,572,738,134,16,2,2138,0.00140318054256314,0.314780168381665,0.267539756782039,0.345182413470533,0.0626753975678204,0.00748362956033676,0.000935453695042095,1248,0.583723105706268,890,0.416276894293732
"E02006722",0,118,950,635,108,13,2,1826,0,0.0646221248630887,0.52026286966046,0.347754654983571,0.0591456736035049,0.00711938663745893,0.00109529025191676,1068,0.584884994523549,758,0.415115005476451
"E02006723",9,581,1652,1008,108,11,4,3373,0.00266824785057812,0.172250222353988,0.489771716572784,0.298843759264749,0.0320189742069374,0.00326119181737326,0.00118588793359028,2242,0.66469018677735,1131,0.33530981322265
"E02006724",1,230,1044,776,543,84,23,2701,0.000370233246945576,0.0851536467974824,0.386523509811181,0.287300999629767,0.201036653091448,0.0310995927434284,0.00851536467974824,1275,0.472047389855609,1426,0.527952610144391
"E02006725",7,66,906,658,119,11,0,1767,0.00396151669496321,0.0373514431239389,0.512733446519525,0.372382569326542,0.0673457838143746,0.00622524052065648,0,979,0.554046406338427,788,0.445953593661573
"E02006726",4,193,831,877,296,55,18,2274,0.00175901495162709,0.084872471416007,0.365435356200528,0.385664028144239,0.130167106420405,0.0241864555848725,0.0079155672823219,1028,0.452066842568162,1246,0.547933157431838
"E02006727",4,96,617,806,166,35,3,1727,0.00231615518239722,0.0555877243775333,0.357266936884771,0.46670526925304,0.0961204400694847,0.0202663578459757,0.00173711638679792,717,0.415170816444702,1010,0.584829183555298
"E02006728",2,383,739,1070,288,45,7,2534,0.000789265982636148,0.151144435674822,0.291633780584057,0.422257300710339,0.113654301499605,0.0177584846093133,0.00276243093922652,1124,0.443567482241515,1410,0.556432517758485
"E02006729",6,266,642,1031,186,15,3,2149,0.0027919962773383,0.123778501628664,0.298743601675198,0.479758026989297,0.0865518845974872,0.00697999069334574,0.00139599813866915,914,0.425314099581201,1235,0.5746859004188
"E02006730",7,342,1023,669,108,8,3,2160,0.00324074074074074,0.158333333333333,0.473611111111111,0.309722222222222,0.05,0.0037037037037037,0.00138888888888889,1372,0.635185185185185,788,0.364814814814815
"E02006731",1,92,943,871,184,20,4,2115,0.000472813238770686,0.0434988179669031,0.445862884160756,0.411820330969267,0.0869976359338061,0.00945626477541371,0.00189125295508274,1036,0.48983451536643,1079,0.51016548463357
"E02006732",2,78,666,1099,280,30,7,2162,0.000925069380203515,0.0360777058279371,0.308048103607771,0.508325624421832,0.129509713228492,0.0138760407030527,0.0032377428307123,746,0.345050878815911,1416,0.654949121184089
"E02006733",1,107,687,820,270,80,18,1983,0.000504286434694907,0.053958648512355,0.346444780635401,0.413514876449823,0.136157337367625,0.0403429147755925,0.00907715582450832,795,0.400907715582451,1188,0.599092284417549
"E02006734",2,280,605,1182,545,90,23,2727,0.000733406674000733,0.102676934360103,0.221855518885222,0.433443344334433,0.1998533186652,0.033003300330033,0.00843417675100843,887,0.325265859919325,1840,0.674734140080675
"E02006735",7,235,1603,629,220,13,4,2711,0.00258207303578015,0.0866838804869052,0.591294725193655,0.232017705643674,0.0811508668388049,0.00479527849502029,0.00147547030616009,1845,0.680560678716341,866,0.319439321283659
"E02006736",5,44,1044,1150,158,12,2,2415,0.0020703933747412,0.0182194616977226,0.432298136645963,0.476190476190476,0.0654244306418219,0.00496894409937888,0.00082815734989648,1093,0.452587991718427,1322,0.547412008281573
"E02006737",2,402,798,1226,570,85,18,3101,0.000644953240890035,0.129635601418897,0.257336343115124,0.395356336665592,0.18381167365366,0.0274105127378265,0.00580457916801032,1202,0.387616897774911,1899,0.612383102225089
"E02006738",9,190,1555,1523,487,72,21,3857,0.00233341975628727,0.0492610837438424,0.403163080114078,0.394866476536168,0.126263935701322,0.0186673580502982,0.00544464609800363,1754,0.454757583614208,2103,0.545242416385792
"E02006739",2,55,482,795,247,43,15,1639,0.0012202562538133,0.0335570469798658,0.294081757169005,0.485051860890787,0.150701647345943,0.026235509456986,0.00915192190359976,539,0.328859060402685,1100,0.671140939597315
"E02006740",6,316,1409,1547,771,133,49,4231,0.00141810446702907,0.0746868352635311,0.333018199007327,0.365634601748996,0.182226424013236,0.0314346490191444,0.0115811864807374,1731,0.409123138737887,2500,0.590876861262113
"E02006741",3,363,779,849,80,5,7,2086,0.00143815915627996,0.174017257909875,0.373441994247363,0.406999041227229,0.0383509108341323,0.00239693192713327,0.00335570469798658,1145,0.548897411313519,941,0.451102588686481
"E02006742",6,398,1395,1301,498,64,20,3682,0.00162954915806627,0.108093427485062,0.378870179250407,0.353340575774036,0.1352525801195,0.0173818576860402,0.00543183052688756,1799,0.488593155893536,1883,0.511406844106464
"E02006743",5,400,860,982,226,33,11,2517,0.00198649185538339,0.158919348430671,0.341676599125944,0.390147000397298,0.0897894318633294,0.0131108462455304,0.00437028208184346,1265,0.502582439411998,1252,0.497417560588002
"E02006744",2,277,1240,1264,649,96,30,3558,0.000562113546936481,0.0778527262507026,0.348510399100618,0.355255761663856,0.182405845980888,0.0269814502529511,0.00843170320404722,1519,0.426925238898257,2039,0.573074761101742
"E02006745",33,613,758,1198,445,74,15,3136,0.0105229591836735,0.19547193877551,0.241709183673469,0.382015306122449,0.141900510204082,0.0235969387755102,0.00478316326530612,1404,0.447704081632653,1732,0.552295918367347
"E02006746",18,925,994,1125,483,80,30,3655,0.00492476060191518,0.253077975376197,0.271956224350205,0.307797537619699,0.132147742818057,0.0218878248974008,0.00820793433652531,1937,0.529958960328317,1718,0.470041039671683
"E02006747",3,51,825,940,117,9,4,1949,0.00153925089789636,0.0261672652642381,0.423293996921498,0.482298614674192,0.0600307850179579,0.00461775269368907,0.00205233453052848,879,0.451000513083633,1070,0.548999486916367
"E02006748",26,1100,601,752,467,201,67,3214,0.00808960796515246,0.342252644679527,0.186994399502178,0.23397635345364,0.145301804604854,0.0625388923459863,0.0208462974486621,1727,0.537336652146858,1487,0.462663347853143
"E02006749",1,40,1025,847,111,12,4,2040,0.000490196078431373,0.0196078431372549,0.502450980392157,0.415196078431373,0.0544117647058824,0.00588235294117647,0.00196078431372549,1066,0.522549019607843,974,0.477450980392157
"E02006750",4,209,1003,966,241,31,13,2467,0.0016214025131739,0.084718281313336,0.406566680178354,0.391568706931496,0.0976895014187272,0.0125658694770977,0.00526955816781516,1216,0.492906364004864,1251,0.507093635995136
"E02006751",6,67,778,1004,278,42,9,2184,0.00274725274725275,0.0306776556776557,0.356227106227106,0.45970695970696,0.127289377289377,0.0192307692307692,0.00412087912087912,851,0.389652014652015,1333,0.610347985347985
"E02006752",44,855,568,1055,164,18,5,2709,0.0162421557770395,0.315614617940199,0.209671465485419,0.389442598744924,0.0605389442598745,0.00664451827242525,0.00184569952011812,1467,0.541528239202658,1242,0.458471760797342
"E02006753",20,529,467,736,353,162,48,2315,0.00863930885529158,0.228509719222462,0.201727861771058,0.31792656587473,0.152483801295896,0.0699784017278618,0.0207343412526998,1016,0.438876889848812,1299,0.561123110151188
"E02006754",15,104,316,483,515,201,68,1702,0.00881316098707403,0.0611045828437133,0.18566392479436,0.283783783783784,0.302585193889542,0.118096357226792,0.0399529964747356,435,0.255581668625147,1267,0.744418331374853
"E02006755",10,184,342,622,392,148,37,1735,0.00576368876080692,0.106051873198847,0.197118155619597,0.35850144092219,0.225936599423631,0.0853025936599424,0.0213256484149856,536,0.308933717579251,1199,0.691066282420749
"E02006756",23,989,421,669,283,118,38,2541,0.00905155450609996,0.389216843762298,0.165682802046438,0.263282172373081,0.111373475009839,0.0464384100747737,0.0149547422274695,1433,0.563951200314837,1108,0.436048799685163
"E02006757",32,246,450,833,477,149,43,2230,0.0143497757847534,0.110313901345291,0.201793721973094,0.373542600896861,0.21390134529148,0.0668161434977578,0.0192825112107623,728,0.326457399103139,1502,0.673542600896861
"E02006758",115,596,590,684,308,83,22,2398,0.0479566305254379,0.248540450375313,0.24603836530442,0.285237698081735,0.128440366972477,0.0346121768140117,0.00917431192660551,1301,0.542535446205171,1097,0.457464553794829
"E02006759",157,993,1098,1171,394,44,16,3873,0.0405370513813581,0.256390395042603,0.283501161890008,0.302349599793442,0.101729925122644,0.0113607022979602,0.00413116447198554,2248,0.580428608313968,1625,0.419571391686031
"E02006760",23,716,829,1108,449,80,24,3229,0.00712294828120161,0.221740476927841,0.256735831526788,0.343140291111799,0.139052338185197,0.0247754722824404,0.00743264168473212,1568,0.485599256735831,1661,0.514400743264169
"E02006761",1,391,1382,1059,379,57,27,3296,0.000303398058252427,0.118628640776699,0.419296116504854,0.32129854368932,0.11498786407767,0.0172936893203883,0.00819174757281553,1774,0.538228155339806,1522,0.461771844660194
"E02006762",61,1025,753,810,288,56,8,3001,0.020326557814062,0.341552815728091,0.250916361212929,0.269910029990003,0.0959680106631123,0.0186604465178274,0.00266577807397534,1839,0.612795734755082,1162,0.387204265244918
"E02006763",48,869,974,973,254,44,12,3174,0.0151228733459357,0.273787019533711,0.306868304977946,0.306553245116572,0.0800252047889099,0.0138626339004411,0.00378071833648393,1891,0.595778197857593,1283,0.404221802142407
"E02006764",4,228,941,813,157,20,3,2166,0.00184672206832872,0.105263157894737,0.434441366574331,0.375346260387812,0.0724838411819021,0.00923361034164358,0.00138504155124654,1173,0.541551246537396,993,0.458448753462604
"E02006765",8,245,711,909,467,129,35,2504,0.00319488817891374,0.0978434504792332,0.283945686900958,0.363019169329073,0.186501597444089,0.051517571884984,0.0139776357827476,964,0.384984025559105,1540,0.615015974440895
"E02006766",15,197,471,830,637,201,55,2406,0.00623441396508728,0.0818786367414796,0.195760598503741,0.344970906068163,0.264754779717373,0.0835411471321696,0.0228595178719867,683,0.283873649210308,1723,0.716126350789692
"E02006767",55,788,808,1151,540,173,67,3582,0.0153545505304299,0.21998883305416,0.225572305974316,0.321328866554997,0.150753768844221,0.0482970407593523,0.0187046342825237,1651,0.460915689558906,1931,0.539084310441094
"E02006768",0,93,595,996,275,40,11,2010,0,0.0462686567164179,0.296019900497512,0.495522388059702,0.13681592039801,0.0199004975124378,0.0054726368159204,688,0.34228855721393,1322,0.65771144278607
"E02006769",15,99,455,1043,520,94,28,2254,0.00665483584738243,0.043921916592724,0.201863354037267,0.462732919254658,0.230700976042591,0.0417036379769299,0.0124223602484472,569,0.252440106477374,1685,0.747559893522626
"E02006770",1,577,1766,1059,478,55,16,3952,0.000253036437246964,0.146002024291498,0.446862348178138,0.267965587044534,0.120951417004049,0.013917004048583,0.00404858299595142,2344,0.593117408906883,1608,0.406882591093117
"E02006771",30,161,585,888,401,132,54,2251,0.0133274100399822,0.0715237672145713,0.259884495779654,0.394491337183474,0.178143047534429,0.0586406041759218,0.023989338071968,776,0.344735673034207,1475,0.655264326965793
"E02006772",0,152,656,1094,355,50,13,2320,0,0.0655172413793104,0.282758620689655,0.471551724137931,0.15301724137931,0.021551724137931,0.00560344827586207,808,0.348275862068966,1512,0.651724137931035
"E02006773",2,221,966,1469,570,87,8,3323,0.000601865783930184,0.0665061691242853,0.290701173638279,0.44207041829672,0.171531748420102,0.026181161600963,0.00240746313572073,1189,0.357809208546494,2134,0.642190791453506
"E02006774",19,124,743,1243,679,95,24,2927,0.00649128800819952,0.0423641954219337,0.253843525794329,0.424666894431158,0.231978134608814,0.0324564400409976,0.00819952169456782,886,0.302699009224462,2041,0.697300990775538
"E02006775",2,591,754,852,198,36,10,2443,0.000818665575112567,0.241915677445763,0.308636921817438,0.348751534997953,0.0810478919361441,0.0147359803520262,0.00409332787556283,1347,0.551371264838314,1096,0.448628735161686
"E02006776",7,28,857,984,161,17,2,2056,0.00340466926070039,0.0136186770428016,0.416828793774319,0.478599221789883,0.0783073929961089,0.00826848249027237,0.000972762645914397,892,0.433852140077821,1164,0.566147859922179
"E02006777",7,102,387,936,533,201,70,2236,0.00313059033989267,0.0456171735241503,0.173076923076923,0.418604651162791,0.238372093023256,0.0898926654740608,0.0313059033989267,496,0.221824686940966,1740,0.778175313059034
"E02006778",5,333,494,1017,397,65,9,2320,0.0021551724137931,0.143534482758621,0.212931034482759,0.438362068965517,0.171120689655172,0.0280172413793103,0.00387931034482759,832,0.358620689655172,1488,0.641379310344828
"E02006779",16,423,1080,1113,387,102,33,3154,0.00507292327203551,0.134115409004439,0.342422320862397,0.35288522511097,0.122701331642359,0.0323398858592264,0.0104629042485732,1519,0.481610653138871,1635,0.518389346861129
"E02006780",4,70,669,827,227,43,4,1844,0.00216919739696312,0.0379609544468547,0.362798264642082,0.448481561822126,0.123101952277657,0.0233188720173536,0.00216919739696312,743,0.4029284164859,1101,0.5970715835141
"E02006781",3,31,104,251,265,194,149,997,0.00300902708124373,0.0310932798395186,0.104312938816449,0.251755265797392,0.26579739217653,0.194583751253761,0.149448345035105,138,0.138415245737212,859,0.861584754262788
"E02006782",44,166,667,1141,452,63,13,2546,0.0172820109976434,0.0652003142183818,0.261979575805185,0.44815396700707,0.177533385703064,0.0247446975648075,0.00510604870384918,877,0.34446190102121,1669,0.65553809897879
"E02006783",0,12,863,1062,227,24,9,2197,0,0.0054619936276741,0.392808375056896,0.483386436049158,0.103322712790168,0.0109239872553482,0.00409649522075558,875,0.39827036868457,1322,0.60172963131543
"E02006784",0,207,1039,1009,276,37,10,2578,0,0.0802948021722265,0.403025601241272,0.391388673390225,0.107059736229635,0.0143522110162917,0.00387897595034911,1246,0.483320403413499,1332,0.516679596586501
"E02006785",3,68,481,1094,309,46,11,2012,0.00149105367793241,0.0337972166998012,0.239065606361829,0.543737574552684,0.153578528827038,0.0228628230616302,0.00546719681908549,552,0.274353876739563,1460,0.725646123260437
"E02006786",4,203,777,1143,319,35,8,2489,0.00160707111289675,0.0815588589795098,0.312173563680193,0.459220570510245,0.128163921253515,0.0140618722378465,0.00321414222579349,984,0.395339493772599,1505,0.604660506227401
"E02006787",0,70,619,1152,475,53,11,2380,0,0.0294117647058824,0.260084033613445,0.484033613445378,0.199579831932773,0.0222689075630252,0.0046218487394958,689,0.289495798319328,1691,0.710504201680672
"E02006788",0,131,654,1146,329,25,18,2303,0,0.0568823273990447,0.283977420755536,0.49761181068172,0.142857142857143,0.0108554059921841,0.00781589231437256,785,0.340859748154581,1518,0.659140251845419
"E02006789",4,185,713,727,278,57,18,1982,0.00201816347124117,0.0933400605449041,0.359737638748739,0.366801210898083,0.140262361251261,0.0287588294651867,0.00908173562058527,902,0.455095862764884,1080,0.544904137235116
"E02006790",17,232,636,987,401,102,25,2400,0.00708333333333333,0.0966666666666667,0.265,0.41125,0.167083333333333,0.0425,0.0104166666666667,885,0.36875,1515,0.63125
"E02006791",0,454,1202,1406,399,46,15,3522,0,0.128904031800114,0.341283361726292,0.399204997160704,0.113287904599659,0.013060760931289,0.00425894378194208,1656,0.470187393526405,1866,0.529812606473595
"E02006792",8,501,1608,1725,584,85,26,4537,0.00176327970024245,0.110425391227683,0.354419219748733,0.380207185364778,0.128719418117699,0.018734846815076,0.00573065902578797,2117,0.466607890676659,2420,0.533392109323341
"E02006793",0,493,1383,1301,364,36,11,3588,0,0.137402452619844,0.385451505016722,0.362597547380156,0.101449275362319,0.0100334448160535,0.00306577480490524,1876,0.522853957636566,1712,0.477146042363434
"E02006794",0,509,1755,1229,348,22,15,3878,0,0.131253223310985,0.452552862300155,0.31691593604951,0.0897369778236204,0.00567302733367715,0.0038679731820526,2264,0.58380608561114,1614,0.41619391438886
"E02006795",0,15,545,1067,323,35,9,1994,0,0.00752256770310933,0.273319959879639,0.535105315947843,0.161985957873621,0.0175526579739218,0.0045135406218656,560,0.280842527582748,1434,0.719157472417252
"E02006796",5,425,846,1394,487,66,12,3235,0.00154559505409583,0.131375579598145,0.261514683153014,0.430911901081917,0.150540958268934,0.0204018547140649,0.00370942812982998,1276,0.394435857805255,1959,0.605564142194745
"E02006798",1,1100,1686,1056,211,26,10,4090,0.000244498777506112,0.268948655256724,0.412224938875306,0.258190709046455,0.0515892420537897,0.00635696821515892,0.00244498777506112,2787,0.681418092909535,1303,0.318581907090465
"E02006799",3,322,800,1718,456,28,14,3341,0.000897934750074828,0.0963783298413649,0.239449266686621,0.514217300209518,0.136486082011374,0.00838072433403173,0.00419036216701586,1125,0.33672553127806,2216,0.663274468721939
"E02006800",30,269,1272,2011,545,72,14,4213,0.00712081652029433,0.0638499881319725,0.301922620460479,0.477332067410396,0.12936150011868,0.0170899596487064,0.00332304770947069,1571,0.372893425112746,2642,0.627106574887254
"E02006801",1,1309,2299,1094,311,41,16,5071,0.000197199763360284,0.258134490238612,0.453362255965293,0.215736541116151,0.0613291264050483,0.00808519029777164,0.00315519621376454,3609,0.711693945967265,1462,0.288306054032735
"E02006802",0,1623,1344,1000,298,29,9,4303,0,0.377178712526145,0.312340227748083,0.232396002788752,0.0692540088310481,0.00673948408087381,0.00209156402509877,2967,0.689518940274227,1336,0.310481059725773
"E02006803",16,504,1110,1184,236,38,8,3096,0.00516795865633075,0.162790697674419,0.358527131782946,0.382428940568475,0.0762273901808786,0.0122739018087855,0.00258397932816537,1630,0.526485788113695,1466,0.473514211886305
"E02006804",5,283,924,1281,408,69,19,2989,0.00167280026764804,0.0946804951488792,0.309133489461358,0.428571428571429,0.13650050184008,0.023084643693543,0.00635664101706256,1212,0.405486784877886,1777,0.594513215122114
"E02006805",2,209,1033,1367,385,60,17,3073,0.000650829808005207,0.0680117149365441,0.336153595834689,0.444842173771559,0.125284738041002,0.0195248942401562,0.00553205336804426,1244,0.404816140579239,1829,0.595183859420762
"E02006806",116,682,670,1274,399,75,15,3231,0.035902197462086,0.211080160940885,0.207366140513773,0.394305168678428,0.123491179201486,0.0232126276694522,0.00464252553389044,1468,0.454348498916744,1763,0.545651501083256
"E02006807",1,46,225,1240,648,82,17,2259,0.000442673749446658,0.0203629924745463,0.099601593625498,0.548915449313856,0.286852589641434,0.0362992474546259,0.00752545374059318,272,0.120407259849491,1987,0.879592740150509
"E02006808",0,574,299,1022,388,63,17,2363,0,0.242911553110453,0.126534066864156,0.432501057977148,0.164198053322048,0.026661024121879,0.00719424460431655,873,0.369445619974609,1490,0.630554380025391
"E02006809",1,32,402,1065,525,87,19,2131,0.000469263256687001,0.015016424213984,0.188643829188175,0.499765368371657,0.246363209760676,0.0408259033317691,0.00891600187705303,435,0.204129516658846,1696,0.795870483341154
"E02006810",3,163,1132,1384,483,99,25,3289,0.000912131346913956,0.0495591365156583,0.344177561568866,0.420796594709638,0.146853146853147,0.0301003344481605,0.0076010945576163,1298,0.394648829431438,1991,0.605351170568562
"E02006811",23,1216,1211,1237,346,43,5,4081,0.00563587356040186,0.297966184758638,0.296740994854202,0.303111982357265,0.084783141386915,0.0105366331781426,0.00122518990443519,2450,0.600343053173242,1631,0.399656946826758
"E02006812",6,282,836,1238,364,53,10,2789,0.00215130871280029,0.101111509501613,0.299749013983507,0.443886697741126,0.130512728576551,0.0190032269630692,0.00358551452133381,1124,0.40301183219792,1665,0.59698816780208
"E02006813",0,118,1199,1521,244,33,6,3121,0,0.0378083947452739,0.384171739826979,0.487343800064082,0.0781800704902275,0.0105735341236783,0.00192246074975969,1317,0.421980134572252,1804,0.578019865427748
"E02006814",2,137,793,1331,314,41,11,2629,0.000760745530620008,0.0521110688474705,0.301635602890833,0.506276150627615,0.119437048307341,0.0155952833777102,0.00418410041841004,932,0.354507417268924,1697,0.645492582731076
"E02006815",47,507,1015,1518,367,71,19,3544,0.0132618510158014,0.143058690744921,0.286399548532731,0.428329571106095,0.103555304740406,0.0200338600451467,0.00536117381489842,1569,0.442720090293454,1975,0.557279909706546
"E02006816",7,1084,729,982,347,89,11,3249,0.00215450907971684,0.333641120344721,0.224376731301939,0.302246845183133,0.106802092951677,0.0273930440135426,0.00338565712526931,1820,0.560172360726377,1429,0.439827639273623
"E02006817",2,177,727,1189,588,86,12,2781,0.000719165767709457,0.0636461704422869,0.261416756562388,0.427544048903272,0.21143473570658,0.0309241280115067,0.00431499460625674,906,0.325782092772384,1875,0.674217907227616
"E02006818",1,26,443,1240,523,88,16,2337,0.000427899015832264,0.0111253744116389,0.189559264013693,0.530594779632007,0.223791185280274,0.0376551133932392,0.00684638425331622,470,0.201112537441164,1867,0.798887462558836
"E02006819",14,108,1315,1187,240,21,5,2890,0.00484429065743945,0.0373702422145329,0.455017301038062,0.410726643598616,0.0830449826989619,0.00726643598615917,0.00173010380622837,1437,0.497231833910035,1453,0.502768166089965
"E02006820",3,447,831,1506,396,53,14,3250,0.000923076923076923,0.137538461538462,0.255692307692308,0.463384615384615,0.121846153846154,0.0163076923076923,0.00430769230769231,1281,0.394153846153846,1969,0.605846153846154
"E02006821",10,175,693,950,302,50,9,2189,0.00456829602558246,0.079945180447693,0.316582914572864,0.433988122430333,0.13796253997259,0.0228414801279123,0.00411146642302421,878,0.40109639104614,1311,0.59890360895386
"E02006822",3,686,782,1410,409,84,17,3391,0.000884694780300796,0.202300206428782,0.230610439398408,0.415806546741374,0.120613388381009,0.0247714538484223,0.00501327042170451,1471,0.43379534060749,1920,0.56620465939251
"E02006823",11,235,816,1187,438,106,21,2814,0.003909026297086,0.0835110163468372,0.28997867803838,0.42181947405828,0.155650319829424,0.0376687988628287,0.00746268656716418,1062,0.377398720682303,1752,0.622601279317697
"E02006824",3,187,928,1455,380,42,9,3004,0.00099866844207723,0.0622503328894807,0.308921438082557,0.484354194407457,0.126498002663116,0.0139813581890812,0.00299600532623169,1118,0.372170439414114,1886,0.627829560585885
"E02006825",41,200,375,1027,644,169,29,2485,0.0164989939637827,0.0804828973843058,0.150905432595573,0.41327967806841,0.259154929577465,0.0680080482897384,0.0116700201207243,616,0.247887323943662,1869,0.752112676056338
"E02006826",5,348,1772,1801,619,97,20,4662,0.00107250107250107,0.0746460746460746,0.38009438009438,0.386314886314886,0.132775632775633,0.0208065208065208,0.00429000429000429,2125,0.455812955812956,2537,0.544187044187044
"E02006827",33,356,1217,1303,502,91,27,3529,0.00935109096061207,0.100878435817512,0.344856899971663,0.369226409747804,0.142249929158402,0.0257863417398697,0.00765089260413715,1606,0.455086426749787,1923,0.544913573250212
"E02006828",1,276,878,966,230,42,8,2401,0.00041649312786339,0.114952103290296,0.365680966264057,0.402332361516035,0.0957934194085798,0.0174927113702624,0.00333194502290712,1155,0.481049562682216,1246,0.518950437317784
"E02006829",10,526,714,974,235,58,15,2532,0.00394944707740916,0.207740916271722,0.281990521327014,0.384676145339652,0.0928120063191153,0.0229067930489731,0.00592417061611374,1250,0.493680884676145,1282,0.506319115323855
"E02006830",3,402,1083,840,153,20,3,2504,0.00119808306709265,0.160543130990415,0.432507987220447,0.335463258785943,0.0611022364217252,0.00798722044728434,0.00119808306709265,1488,0.594249201277955,1016,0.405750798722045
"E02006831",3,94,609,891,236,37,6,1876,0.00159914712153518,0.0501066098081023,0.324626865671642,0.474946695095949,0.125799573560768,0.0197228144989339,0.00319829424307036,706,0.376332622601279,1170,0.623667377398721
"E02006832",0,29,648,871,290,63,14,1915,0,0.0151436031331593,0.338381201044386,0.454830287206266,0.151436031331593,0.0328981723237598,0.00731070496083551,677,0.353524804177546,1238,0.646475195822454
"E02006833",37,1217,1247,1259,522,149,40,4471,0.00827555356743458,0.272198613285618,0.278908521583538,0.281592484902706,0.116752404383807,0.033325877879669,0.00894654439722657,2501,0.559382688436591,1970,0.440617311563409
"E02006834",128,383,1980,1100,137,14,4,3746,0.0341697810998398,0.102242391884677,0.528563801388147,0.293646556326749,0.0365723438334223,0.00373731980779498,0.00106780565936999,2491,0.664975974372664,1255,0.335024025627336
"E02006835",4,314,848,742,230,53,4,2195,0.00182232346241458,0.143052391799544,0.386332574031891,0.338041002277904,0.104783599088838,0.0241457858769932,0.00182232346241458,1166,0.53120728929385,1029,0.46879271070615
"E02006836",22,178,879,951,437,87,11,2565,0.00857699805068226,0.0693957115009747,0.342690058479532,0.370760233918129,0.17037037037037,0.0339181286549708,0.00428849902534113,1079,0.420662768031189,1486,0.579337231968811
"E02006837",3,581,872,1305,720,110,11,3602,0.000832870627429206,0.16129927817879,0.242087729039423,0.362298722931705,0.199888950583009,0.0305385896724042,0.00305385896724042,1456,0.404219877845641,2146,0.595780122154359
"E02006838",14,259,618,946,336,90,19,2282,0.00613496932515337,0.113496932515337,0.270815074496056,0.414548641542507,0.147239263803681,0.0394390885188431,0.00832602979842244,891,0.390446976336547,1391,0.609553023663453
"E02006839",43,303,760,1017,519,129,35,2806,0.0153243050605845,0.107982893799002,0.270848182466144,0.362437633642195,0.18496079828938,0.0459729151817534,0.0124732715609408,1106,0.394155381325731,1700,0.605844618674269
"E02006840",7,201,1147,1935,703,132,42,4167,0.00167986561075114,0.0482361411087113,0.275257979361651,0.464362850971922,0.168706503479722,0.0316774658027358,0.0100791936645068,1355,0.325173986081114,2812,0.674826013918887
"E02006841",0,695,2465,1097,239,31,7,4534,0,0.153286281429202,0.543670048522276,0.241949713277459,0.0527128363475959,0.00683722981914424,0.00154389060432289,3160,0.696956329951478,1374,0.303043670048522
"E02006842",0,91,916,899,309,29,10,2254,0,0.0403726708074534,0.406388642413487,0.398846495119787,0.137089618456078,0.012866015971606,0.00443655723158829,1007,0.446761313220941,1247,0.55323868677906
"E02006843",21,2874,4961,1331,265,49,13,9514,0.00220727349169645,0.302081143577885,0.521442085347908,0.139899096068951,0.027853689299979,0.00515030481395838,0.00136640739962161,7856,0.82573050241749,1658,0.17426949758251
"E02006844",0,1211,2727,869,291,38,7,5143,0,0.235465681508847,0.530235271242466,0.168967528679759,0.0565817616177328,0.00738868364767645,0.00136107330351935,3938,0.765700952751312,1205,0.234299047248688
"E02006845",87,872,2172,638,131,17,5,3922,0.022182559918409,0.22233554309026,0.553799082100969,0.162672106068332,0.033401325854156,0.00433452320244773,0.0012748597654258,3131,0.798317185109638,791,0.201682814890362
"E02006846",18,1424,2328,512,46,7,1,4336,0.00415129151291513,0.328413284132841,0.53690036900369,0.118081180811808,0.0106088560885609,0.00161439114391144,0.000230627306273063,3770,0.869464944649447,566,0.130535055350554
"E02006847",4,557,2572,462,72,6,0,3673,0.00108902804247209,0.151647154914239,0.700245031309556,0.125782738905527,0.0196025047644977,0.00163354206370814,0,3133,0.852981214266267,540,0.147018785733733
"E02006848",2,958,2735,117,18,0,0,3830,0.000522193211488251,0.250130548302872,0.714099216710183,0.0305483028720627,0.00469973890339426,0,0,3695,0.964751958224543,135,0.0352480417754569
"E02006849",12,523,1786,970,210,7,0,3508,0.00342075256556442,0.149087799315849,0.509122006841505,0.276510832383124,0.0598631698973774,0.00199543899657925,0,2321,0.661630558722919,1187,0.338369441277081
"E02006850",52,705,2223,1568,775,79,15,5417,0.00959940926712202,0.130145837179251,0.410374746169467,0.289459110208603,0.143068118884992,0.0145837179250508,0.00276906036551597,2980,0.550119992615839,2437,0.449880007384161
"E02006851",7,1734,3585,1607,534,105,23,7595,0.000921658986175115,0.228308097432521,0.472021066491113,0.211586570111916,0.0703094140882159,0.0138248847926267,0.00302830809743252,5326,0.701250822909809,2269,0.298749177090191
"E02006852",22,449,1378,1913,799,103,26,4690,0.0046908315565032,0.0957356076759062,0.293816631130064,0.407889125799574,0.170362473347548,0.0219616204690832,0.00554371002132196,1849,0.394243070362473,2841,0.605756929637527
"E02006853",0,4572,2412,467,81,13,0,7545,0,0.60596421471173,0.319681908548708,0.061895294897283,0.0107355864811133,0.00172299536116634,0,6984,0.925646123260437,561,0.0743538767395626
"E02006854",2,6760,1933,396,67,10,3,9171,0.000218078726420238,0.737106095300403,0.21077308908516,0.0431795878312071,0.00730563733507796,0.00109039363210119,0.000327118089630357,8695,0.948097263111984,476,0.0519027368880166
"E02006855",1,240,1123,1051,272,36,7,2730,0.000366300366300366,0.0879120879120879,0.411355311355311,0.384981684981685,0.0996336996336996,0.0131868131868132,0.00256410256410256,1364,0.4996336996337,1366,0.5003663003663
"E02006856",5,730,2572,1939,614,90,28,5978,0.000836400133824021,0.122114419538307,0.430244228839077,0.324355971896956,0.10270993643359,0.0150552024088324,0.00468384074941452,3307,0.553195048511208,2671,0.446804951488792
"E02006857",2,517,1201,1304,296,37,7,3364,0.000594530321046373,0.153686087990488,0.357015457788347,0.387633769322235,0.0879904875148633,0.0109988109393579,0.00208085612366231,1720,0.511296076099881,1644,0.488703923900119
"E02006858",1,596,2301,555,196,32,9,3690,0.0002710027100271,0.161517615176152,0.623577235772358,0.150406504065041,0.0531165311653117,0.00867208672086721,0.0024390243902439,2898,0.785365853658537,792,0.214634146341463
"E02006859",1,164,1898,492,15,1,0,2571,0.000388953714507974,0.0637884091793077,0.738234150136134,0.191365227537923,0.0058343057176196,0.000388953714507974,0,2063,0.802411513029949,508,0.197588486970051
"E02006861",0,301,2313,2409,797,84,26,5930,0,0.0507588532883642,0.390050590219224,0.406239460370995,0.134401349072513,0.0141652613827993,0.00438448566610455,2614,0.440809443507589,3316,0.559190556492411
"E02006862",13,235,656,864,172,17,2,1959,0.00663603879530373,0.119959162838183,0.33486472690148,0.44104134762634,0.0877998979070955,0.00867789688616641,0.00102092904543134,904,0.461459928534967,1055,0.538540071465033
"E02006863",18,944,2846,478,57,3,0,4346,0.00414173953060285,0.217211228716061,0.654855039116429,0.109986194201565,0.0131155085135757,0.000690289921767142,0,3808,0.876208007363093,538,0.123791992636908
"E02006864",7,588,728,1199,374,62,22,2980,0.0023489932885906,0.197315436241611,0.244295302013423,0.402348993288591,0.125503355704698,0.0208053691275168,0.00738255033557047,1323,0.443959731543624,1657,0.556040268456376
"E02006865",7,692,914,967,342,62,8,2992,0.00233957219251337,0.231283422459893,0.30548128342246,0.323195187165775,0.114304812834225,0.0207219251336898,0.00267379679144385,1613,0.539104278074866,1379,0.460895721925134
"E02006866",38,967,1413,817,166,7,2,3410,0.0111436950146628,0.283577712609971,0.414369501466276,0.239589442815249,0.0486803519061584,0.00205278592375367,0.000586510263929619,2418,0.709090909090909,992,0.290909090909091
"E02006867",3,476,840,1188,233,36,7,2783,0.00107797340998922,0.17103844771829,0.301832554796982,0.426877470355731,0.0837226015091628,0.0129356809198706,0.00251527128997485,1319,0.473948975925261,1464,0.526051024074739
"E02006868",18,817,2211,1753,560,100,10,5469,0.00329127811300055,0.149387456573414,0.404278661546901,0.320533918449442,0.102395319071128,0.0182848784055586,0.00182848784055586,3046,0.556957396233315,2423,0.443042603766685
"E02006869",1,399,1397,1426,300,50,3,3576,0.000279642058165548,0.111577181208054,0.390659955257271,0.398769574944072,0.0838926174496644,0.0139821029082774,0.000838926174496644,1797,0.50251677852349,1779,0.49748322147651
"E02006871",6,83,1294,2009,543,96,24,4055,0.00147965474722565,0.0204685573366215,0.319112207151665,0.495437731196054,0.133908754623921,0.0236744759556104,0.00591861898890259,1383,0.341060419235512,2672,0.658939580764488
"E02006872",2,552,1138,1698,617,197,58,4262,0.000469263256687001,0.129516658845612,0.267010793054904,0.398404504927264,0.14476771468794,0.0462224307836696,0.013608634443923,1692,0.396996715157203,2570,0.603003284842797
"E02006873",171,1782,2185,261,43,0,1,4443,0.0384875084402431,0.401080351114112,0.491784830069773,0.0587440918298447,0.00967814539725411,0,0.000225073148773351,4138,0.931352689624128,305,0.0686473103758722
"E02006874",84,970,1406,1002,475,137,22,4096,0.0205078125,0.23681640625,0.34326171875,0.24462890625,0.115966796875,0.033447265625,0.00537109375,2460,0.6005859375,1636,0.3994140625
"E02006875",0,2732,3900,1374,470,45,10,8531,0,0.32024381666862,0.457156253663111,0.161059664752081,0.0550931895440159,0.00527487984995897,0.00117219552221311,6632,0.777400070331731,1899,0.222599929668269
"E02006876",1,1253,2321,991,153,27,7,4753,0.000210393435724805,0.263622974963181,0.488323164317273,0.208499894803282,0.0321901956658952,0.00568062276456975,0.00147275405007364,3575,0.752156532716179,1178,0.247843467283821
"E02006877",102,1936,1749,834,165,19,0,4805,0.0212278876170656,0.402913631633715,0.363995837669095,0.173569198751301,0.0343392299687825,0.00395421436004162,0,3787,0.788137356919875,1018,0.211862643080125
"E02006878",92,2821,2689,589,103,1,0,6295,0.014614773629865,0.44813343923749,0.427164416203336,0.0935663224781573,0.0163621922160445,0.000158856235107228,0,5602,0.889912629070691,693,0.110087370929309
"E02006879",2,337,1922,1524,621,101,47,4554,0.00043917435221783,0.0740008783487044,0.422046552481335,0.334650856389987,0.136363636363636,0.0221783047870004,0.010320597277119,2261,0.496486605182257,2293,0.503513394817743
"E02006880",0,297,1468,1617,659,114,35,4190,0,0.0708830548926014,0.35035799522673,0.385918854415274,0.15727923627685,0.0272076372315036,0.00835322195704057,1765,0.421241050119332,2425,0.578758949880668
"E02006881",3,284,989,1918,844,170,53,4261,0.000704060079793476,0.0666510208871157,0.232105139638582,0.450129077681295,0.198075569115231,0.0398967378549636,0.0124383947430181,1276,0.299460220605492,2985,0.700539779394508
"E02006882",7,145,691,1472,466,76,17,2874,0.00243562978427279,0.0504523312456507,0.240431454418928,0.512178148921364,0.16214335421016,0.0264439805149617,0.00591510090466249,843,0.293319415448852,2031,0.706680584551148
"E02006883",1,478,1698,1147,484,100,17,3925,0.000254777070063694,0.121783439490446,0.432611464968153,0.292229299363057,0.123312101910828,0.0254777070063694,0.0043312101910828,2177,0.554649681528662,1748,0.445350318471338
"E02006884",16,343,1326,2318,920,179,66,5168,0.00309597523219814,0.0663699690402477,0.256578947368421,0.448529411764706,0.178018575851393,0.0346362229102167,0.0127708978328173,1685,0.326044891640867,3483,0.673955108359133
"E02006885",0,565,2105,1781,729,116,21,5317,0,0.10626293022381,0.395899943577205,0.334963325183374,0.13710739138612,0.0218168139928531,0.0039495956366372,2670,0.502162873801016,2647,0.497837126198984
"E02006886",58,1952,1454,1608,777,245,45,6139,0.00944779280013031,0.317967095618179,0.236846391920508,0.261931910734647,0.126567844925884,0.0399087799315849,0.00733018406906662,3464,0.564261280338817,2675,0.435738719661183
"E02006887",13,2428,2622,1184,367,72,25,6711,0.00193711816420802,0.361794069438236,0.390701832811802,0.176426762032484,0.0546863358664879,0.0107286544479213,0.00372522723886157,5063,0.754433020414245,1648,0.245566979585755
"E02006888",3,118,1012,1477,442,73,15,3140,0.000955414012738854,0.0375796178343949,0.322292993630573,0.470382165605096,0.140764331210191,0.0232484076433121,0.00477707006369427,1133,0.360828025477707,2007,0.639171974522293
"E02006889",6,411,1235,891,258,33,8,2842,0.00211118930330753,0.144616467276566,0.434553131597467,0.313511611541168,0.0907811400422238,0.0116115411681914,0.00281491907107671,1652,0.58128078817734,1190,0.41871921182266
"E02006890",5,223,1185,1963,650,85,30,4141,0.00120743781695243,0.0538517266360782,0.286162762617725,0.474040086935523,0.156966916203816,0.0205264428881913,0.00724462690171456,1413,0.341221927070756,2728,0.658778072929244
"E02006891",41,947,812,1123,348,109,39,3419,0.0119918104708979,0.27698157355952,0.237496343960222,0.328458613629716,0.101784147411524,0.0318806668616555,0.0114068441064639,1800,0.526469727990641,1619,0.473530272009359
"E02006892",2,297,814,1147,485,86,35,2866,0.000697836706210747,0.103628750872296,0.284019539427774,0.400209351011863,0.169225401256106,0.0300069783670621,0.0122121423586881,1113,0.388346127006281,1753,0.611653872993719
"E02006893",61,499,1202,1544,331,34,4,3675,0.0165986394557823,0.13578231292517,0.327074829931973,0.420136054421769,0.0900680272108844,0.00925170068027211,0.00108843537414966,1762,0.479455782312925,1913,0.520544217687075
"E02006894",103,842,1589,2185,909,107,41,5776,0.0178324099722992,0.145775623268698,0.275103878116344,0.378289473684211,0.157375346260388,0.0185249307479224,0.0070983379501385,2534,0.438711911357341,3242,0.561288088642659
"E02006895",4,2389,3144,651,171,44,3,6406,0.000624414611301904,0.372931626600062,0.490789884483297,0.101623477989385,0.0266937246331564,0.00686856072432095,0.000468310958476428,5537,0.864345925694661,869,0.135654074305339
"E02006896",0,4099,3221,923,160,19,6,8428,0,0.486355007119127,0.382178452776459,0.109515899383009,0.018984337921215,0.00225439012814428,0.000711912672045562,7320,0.868533459895586,1108,0.131466540104414
"E02006897",189,2300,3393,1225,421,100,8,7636,0.0247511786275537,0.301204819277108,0.444342587742273,0.160424305919329,0.0551335777894185,0.0130958617077004,0.00104766893661603,5882,0.770298585646936,1754,0.229701414353064
"E02006898",1,1894,3263,1230,211,32,11,6642,0.000150557061126167,0.28515507377296,0.491267690454682,0.185185185185185,0.0317675398976212,0.00481782595603734,0.00165612767238783,5158,0.776573321288768,1484,0.223426678711232
"E02006899",0,2179,4167,1322,425,37,11,8141,0,0.267657535929247,0.511853580641199,0.162387913032797,0.0522048888342955,0.00454489620439749,0.00135118535806412,6346,0.779511116570446,1795,0.220488883429554
"E02006900",0,68,939,1936,995,116,34,4088,0,0.0166340508806262,0.229696673189824,0.473581213307241,0.24339530332681,0.0283757338551859,0.00831702544031311,1007,0.24633072407045,3081,0.75366927592955
"E02006902",110,3391,3411,1032,306,37,9,8296,0.0132594021215043,0.408751205400193,0.411162005785921,0.124397299903568,0.0368852459016393,0.00445998071359691,0.00108486017357763,6912,0.833172613307618,1384,0.166827386692382
"E02006903",17,152,1677,2094,423,72,6,4441,0.00382796667417248,0.0342265255573069,0.377617653681603,0.471515424453952,0.0952488178338212,0.0162125647376717,0.00135104706147264,1846,0.415672145913083,2595,0.584327854086917
"E02006904",33,2085,3469,1436,484,38,10,7555,0.00436796823295831,0.275976174718729,0.459166115155526,0.190072799470549,0.0640635340833885,0.00502978160158835,0.00132362673726009,5587,0.739510258107214,1968,0.260489741892786
"E02006905",21,336,1959,1549,370,40,5,4280,0.00490654205607477,0.0785046728971963,0.457710280373832,0.361915887850467,0.0864485981308411,0.00934579439252336,0.00116822429906542,2316,0.541121495327103,1964,0.458878504672897
"E02006906",10,167,960,1758,673,141,24,3733,0.00267881060809001,0.0447361371551031,0.257165818376641,0.470934904902223,0.180283953924458,0.0377712295740691,0.00642914545941602,1137,0.304580766139834,2596,0.695419233860166
"E02006907",0,1371,2349,1336,396,49,15,5516,0,0.248549673676577,0.425852066715011,0.242204496011603,0.0717911530094271,0.00888324873096447,0.00271936185641769,3720,0.674401740391588,1796,0.325598259608412
"E02006908",2,298,1642,961,296,33,7,3239,0.000617474529175672,0.0920037048471751,0.506946588453226,0.29669651126891,0.0913862303179994,0.0101883297313986,0.00216116085211485,1942,0.599567767829577,1297,0.400432232170423
"E02006909",52,1632,1110,1753,341,59,10,4957,0.0104902158563647,0.329231389953601,0.223925761549324,0.35364131531168,0.0687916078273149,0.0119023602985677,0.00201734920314706,2794,0.56364736735929,2163,0.43635263264071
"E02006910",32,683,1145,1543,483,52,26,3964,0.00807265388496468,0.172300706357215,0.288849646821393,0.389253279515641,0.121846619576186,0.0131180625630676,0.0065590312815338,1860,0.469223007063572,2104,0.530776992936428
"E02006912",0,3841,4214,1754,586,74,13,10482,0,0.366437702728487,0.402022514787254,0.167334478153024,0.055905361572219,0.00705972142720855,0.00124022133180691,8055,0.768460217515741,2427,0.231539782484259
"E02006913",3,620,2129,770,195,27,3,3747,0.000800640512409928,0.165465705898052,0.568187883640246,0.205497731518548,0.0520416333066453,0.00720576461168935,0.000800640512409928,2752,0.734454230050707,995,0.265545769949293
"E02006914",2,1370,1743,548,194,24,2,3883,0.000515065670873036,0.35281998454803,0.448879732165851,0.141127993819212,0.0499613700746845,0.00618078805047644,0.000515065670873036,3115,0.802214782384754,768,0.197785217615246
"E02006915",6,362,2170,612,228,11,8,3397,0.00176626435089785,0.106564615837504,0.63879894024139,0.180158963791581,0.0671180453341183,0.00323815130997939,0.00235501913453047,2538,0.747129820429791,859,0.252870179570209
"E02006916",0,1589,2486,835,170,28,4,5112,0,0.310837245696401,0.486306729264476,0.163341158059468,0.0332550860719875,0.0054773082942097,0.000782472613458529,4075,0.797143974960876,1037,0.202856025039124
"E02006917",0,5281,3107,769,140,14,1,9312,0,0.567117697594502,0.333655498281787,0.0825816151202749,0.0150343642611684,0.00150343642611684,0.000107388316151203,8388,0.900773195876289,924,0.0992268041237113
"E02006918",0,914,1608,797,181,7,2,3509,0,0.260473069250499,0.458250213736107,0.227130236534625,0.0515816471929325,0.00199487033342833,0.000569962952408094,2522,0.718723282986606,987,0.281276717013394
"E02006919",22,962,1742,1162,430,59,20,4397,0.00500341141687514,0.218785535592449,0.396179213099841,0.264271093927678,0.0977939504207414,0.0134182397088924,0.00454855583352286,2726,0.619968160109165,1671,0.380031839890835
"E02006920",10,481,1466,983,297,76,19,3332,0.00300120048019208,0.144357743097239,0.439975990396158,0.295018007202881,0.0891356542617047,0.0228091236494598,0.00570228091236495,1957,0.587334933973589,1375,0.412665066026411
"E02006921",0,139,1224,1007,234,37,4,2645,0,0.0525519848771267,0.462759924385633,0.380718336483932,0.088468809073724,0.0139886578449905,0.00151228733459357,1363,0.51531190926276,1282,0.48468809073724
"E02006922",26,384,1609,2008,523,65,13,4628,0.00561797752808989,0.0829732065687122,0.347666378565255,0.433880726015557,0.113007778738116,0.0140449438202247,0.00280898876404494,2019,0.436257562662057,2609,0.563742437337943
"E02006924",0,331,984,1620,475,88,20,3518,0,0.0940875497441728,0.279704377487209,0.46048891415577,0.13501989766913,0.0250142126208073,0.00568504832291074,1315,0.373791927231381,2203,0.626208072768619
"E02006925",0,36,701,1402,544,73,18,2774,0,0.0129776496034607,0.252703677000721,0.505407354001442,0.196106705118962,0.0263157894736842,0.00648882480173035,737,0.265681326604182,2037,0.734318673395818
"E02006926",0,87,1310,918,78,14,1,2408,0,0.0361295681063123,0.544019933554817,0.381229235880399,0.0323920265780731,0.00581395348837209,0.000415282392026578,1397,0.58014950166113,1011,0.419850498338871
"E02006927",1,3367,1520,1159,394,75,12,6528,0.000153186274509804,0.51577818627451,0.232843137254902,0.177542892156863,0.0603553921568627,0.0114889705882353,0.00183823529411765,4888,0.748774509803922,1640,0.251225490196078
"E02006928",8,3767,2101,522,156,12,3,6569,0.00121784137616075,0.573451057999696,0.319835591414218,0.0794641497944893,0.0237479068351347,0.00182676206424113,0.000456690516060283,5876,0.894504490790075,693,0.105495509209925
"E02006930",49,1887,986,1368,411,54,20,4775,0.010261780104712,0.395183246073298,0.206492146596859,0.286492146596859,0.0860732984293194,0.0113089005235602,0.00418848167539267,2922,0.611937172774869,1853,0.388062827225131
"E02006931",9,495,1755,1606,538,84,41,4528,0.00198763250883392,0.109319787985866,0.387588339222615,0.354681978798587,0.118816254416961,0.0185512367491166,0.0090547703180212,2259,0.498895759717314,2269,0.501104240282686
"E02006932",178,2133,3198,1297,504,86,33,7429,0.0239601561448378,0.28711805088168,0.430475164894333,0.174586081572217,0.0678422398707767,0.0115762552160452,0.00444205142011038,5509,0.741553371920851,1920,0.258446628079149
"E02006933",0,2385,3637,932,151,27,12,7144,0,0.333846584546473,0.509098544232923,0.130459126539754,0.0211366181410974,0.00377939529675252,0.00167973124300112,6022,0.842945128779395,1122,0.157054871220605
"E02006934",0,1977,3625,1512,313,55,22,7504,0,0.263459488272921,0.483075692963753,0.201492537313433,0.0417110874200426,0.00732942430703625,0.0029317697228145,5602,0.746535181236674,1902,0.253464818763326
"E02006935",45,559,1904,1148,208,28,7,3899,0.011541420877148,0.143370094896127,0.488330341113106,0.29443447037702,0.0533470120543729,0.00718132854578097,0.00179533213644524,2508,0.643241856886381,1391,0.356758143113619
"E02006936",1,564,1304,850,175,23,8,2925,0.000341880341880342,0.192820512820513,0.445811965811966,0.290598290598291,0.0598290598290598,0.00786324786324786,0.00273504273504274,1869,0.638974358974359,1056,0.361025641025641
"E02006937",9,689,1610,1683,665,108,21,4785,0.00188087774294671,0.143991640543365,0.336468129571578,0.351724137931034,0.138975966562173,0.0225705329153605,0.00438871473354232,2308,0.482340647857889,2477,0.517659352142111
"E02006938",0,376,2475,1164,356,36,12,4419,0,0.0850871237836615,0.560081466395112,0.263408010862186,0.080561212944105,0.00814663951120163,0.00271554650373388,2851,0.645168590178773,1568,0.354831409821227
"E02006939",40,2495,2248,1148,376,66,25,6398,0.00625195373554236,0.389965614254455,0.35135979993748,0.179431072210066,0.0587683651140982,0.0103157236636449,0.00390747108471397,4783,0.747577367927477,1615,0.252422632072523
"E02006940",0,1033,2189,1525,391,37,17,5192,0,0.198959938366718,0.421610169491525,0.293721109399075,0.0753081664098613,0.00712634822804314,0.00327426810477658,3222,0.620570107858243,1970,0.379429892141757
"E02006941",0,967,2265,791,251,42,5,4321,0,0.223790789169174,0.524184216616524,0.183059476972923,0.0580884054616987,0.00971997222865078,0.00115713955102985,3232,0.747975005785698,1089,0.252024994214302
"E02006942",1,964,2027,896,157,18,5,4068,0.000245821042281219,0.236971484759095,0.498279252704031,0.220255653883972,0.0385939036381514,0.00442477876106195,0.0012291052114061,2992,0.735496558505408,1076,0.264503441494592
"E02006943",1,447,1350,888,286,54,9,3035,0.000329489291598023,0.147281713344316,0.444810543657331,0.292586490939044,0.0942339373970346,0.0177924217462932,0.00296540362438221,1798,0.592421746293246,1237,0.407578253706755
"E02006944",1,240,909,877,477,58,26,2588,0.000386398763523957,0.0927357032457496,0.351236476043277,0.33887171561051,0.184312210200927,0.0224111282843895,0.0100463678516229,1150,0.44435857805255,1438,0.55564142194745
"E02006945",15,811,736,1168,310,57,24,3121,0.00480615187439923,0.259852611342518,0.235821851970522,0.37423902595322,0.0993271387375841,0.0182633771227171,0.00768984299903877,1562,0.50048061518744,1559,0.49951938481256
"E02006946",1,314,524,949,364,58,28,2238,0.000446827524575514,0.140303842716711,0.234137622877569,0.424039320822163,0.162645218945487,0.0259159964253798,0.0125111706881144,839,0.374888293118856,1399,0.625111706881144
"E02006947",0,325,1807,1448,854,152,30,4616,0,0.0704072790294627,0.391464471403813,0.31369150779896,0.185008665511265,0.0329289428076256,0.00649913344887348,2132,0.461871750433276,2484,0.538128249566724
"E02006948",0,425,2103,1174,434,59,27,4222,0,0.100663192799621,0.498105163429654,0.278067266698247,0.10279488394126,0.0139744197063003,0.0063950734249171,2528,0.598768356229275,1694,0.401231643770725
"E02006949",33,265,952,1183,429,55,19,2936,0.0112397820163488,0.0902588555858311,0.32425068119891,0.402929155313351,0.146117166212534,0.018732970027248,0.00647138964577657,1250,0.42574931880109,1686,0.57425068119891
"E02006950",11,591,1772,1120,349,47,23,3913,0.00281114234602607,0.151035011500128,0.45284947610529,0.286225402504472,0.0891898798875543,0.0120112445693841,0.00587784308714541,2374,0.606695629951444,1539,0.393304370048556
"E02006951",2,1297,1499,1108,562,74,31,4573,0.000437349661054013,0.283621255193527,0.327793570959983,0.242291712223923,0.122895254756178,0.0161819374589985,0.0067789197463372,2798,0.611852175814564,1775,0.388147824185436
"E02006952",22,1596,1887,896,354,69,39,4863,0.004523956405511,0.328192473781616,0.388032078963603,0.184248406333539,0.0727945712523134,0.014188772362739,0.00801974090067859,3505,0.72074850915073,1358,0.27925149084927
"E02006953",0,3558,2118,604,94,6,2,6382,0,0.55750548417424,0.33187088686932,0.0946411783140081,0.0147289251018489,0.000940144155437167,0.000313381385145722,5676,0.88937637104356,706,0.11062362895644
"E02006954",3,2889,805,676,152,26,8,4559,0.000658039043649923,0.633691599034876,0.176573810046063,0.148278131169116,0.0333406448782628,0.005703005044966,0.00175477078306646,3697,0.810923448124589,862,0.189076551875411
"E02006955",0,5207,877,265,71,10,3,6433,0,0.809420177211254,0.136328307166174,0.0411938442406342,0.0110368412871133,0.00155448468832582,0.000466345406497746,6084,0.945748484377429,349,0.0542515156225711
"E02006956",0,2200,897,959,195,20,12,4283,0,0.513658650478636,0.209432640672426,0.223908475367733,0.0455288349287882,0.00466962409526033,0.0028017744571562,3097,0.723091291151062,1186,0.276908708848938
"E02006957",6,228,1531,613,296,76,27,2777,0.00216060496939143,0.0821029888368743,0.551314368023046,0.220741807706158,0.106589845156644,0.0273676629456248,0.00972272236226143,1765,0.635577961829312,1012,0.364422038170688
"E02006958",4,783,1847,784,297,33,11,3759,0.00106411279595637,0.20830007980846,0.491354083532854,0.208566108007449,0.0790103750997606,0.00877893056664006,0.00292631018888002,2634,0.700718276137271,1125,0.299281723862729
"E02006959",0,5041,4103,867,152,36,157,10356,0,0.486770954036307,0.396195442255697,0.0837195828505214,0.0146774816531479,0.00347624565469293,0.0151602935496331,9144,0.882966396292005,1212,0.117033603707995
"E02006960",81,4062,2610,682,107,5,0,7547,0.0107327414866835,0.538227110109977,0.345832781237578,0.0903670332582483,0.0141778190009275,0.000662514906585398,0,6753,0.894792632834239,794,0.105207367165761
"E02006961",9,1569,2525,622,77,3,1,4806,0.00187265917602996,0.326466916354557,0.525384935497295,0.129421556387849,0.0160216396171452,0.000624219725343321,0.000208073241781107,4103,0.853724511027882,703,0.146275488972118
"E02006962",0,1692,1930,343,68,6,1,4040,0,0.418811881188119,0.477722772277228,0.0849009900990099,0.0168316831683168,0.00148514851485149,0.000247524752475248,3622,0.896534653465346,418,0.103465346534653
"E02006963",0,3323,2696,465,94,6,0,6584,0,0.504708383961118,0.409477521263669,0.0706257594167679,0.014277035236938,0.000911300121506683,0,6019,0.914185905224787,565,0.0858140947752126
"E02006964",25,344,1551,352,28,4,0,2304,0.0108506944444444,0.149305555555556,0.673177083333333,0.152777777777778,0.0121527777777778,0.00173611111111111,0,1920,0.833333333333333,384,0.166666666666667
"E02006965",93,491,1004,695,325,76,16,2700,0.0344444444444444,0.181851851851852,0.371851851851852,0.257407407407407,0.12037037037037,0.0281481481481481,0.00592592592592593,1588,0.588148148148148,1112,0.411851851851852
"E02006966",4,346,329,740,329,73,5,1826,0.00219058050383352,0.189485213581599,0.180175246440307,0.4052573932092,0.180175246440307,0.0399780941949617,0.00273822562979189,679,0.371851040525739,1147,0.628148959474261
"E02006967",6,71,731,992,292,30,3,2125,0.00282352941176471,0.0334117647058824,0.344,0.466823529411765,0.137411764705882,0.0141176470588235,0.00141176470588235,808,0.380235294117647,1317,0.619764705882353
"E02006968",0,236,1109,1673,631,90,22,3761,0,0.0627492688114863,0.294868386067535,0.444828503057697,0.16777452805105,0.0239298059026855,0.00584950810954533,1345,0.357617654879022,2416,0.642382345120978
"E02006969",0,1052,1456,1176,313,41,9,4047,0,0.259945638744749,0.359772671114406,0.29058561897702,0.0773412404250062,0.0101309612058315,0.0022238695329874,2508,0.619718309859155,1539,0.380281690140845
"E02006970",71,514,611,847,193,14,3,2253,0.0315135375055482,0.228140257434532,0.271193963604083,0.375943186861962,0.0856635596981802,0.00621393697292499,0.00133155792276964,1196,0.530847758544163,1057,0.469152241455837
"E02006971",0,109,660,1100,212,9,12,2102,0,0.0518553758325404,0.313986679352997,0.523311132254995,0.100856327307326,0.00428163653663178,0.00570884871550904,769,0.365842055185538,1333,0.634157944814463
"E02006972",30,1676,1099,397,71,11,3,3287,0.00912686340127776,0.509887435351384,0.334347429266809,0.120778825676909,0.021600243383024,0.00334651658046851,0.000912686340127776,2805,0.853361728019471,482,0.146638271980529
"E02006973",0,1440,1680,564,89,8,4,3785,0,0.380449141347424,0.443857331571995,0.149009247027741,0.0235138705416116,0.00211360634081902,0.00105680317040951,3120,0.824306472919419,665,0.175693527080581
"E02006974",7,172,1272,2143,628,98,36,4356,0.00160697887970615,0.039485766758494,0.292011019283747,0.491965105601469,0.144168962350781,0.0224977043158861,0.00826446280991736,1451,0.333103764921947,2905,0.666896235078053
"E02006975",1,757,1952,646,125,17,3,3501,0.000285632676378178,0.21622393601828,0.557554984290203,0.184518708940303,0.0357040845472722,0.00485575549842902,0.000856898029134533,2710,0.774064552984861,791,0.225935447015139
"E02006976",0,328,1420,594,103,14,5,2464,0,0.133116883116883,0.576298701298701,0.241071428571429,0.041801948051948,0.00568181818181818,0.00202922077922078,1748,0.709415584415584,716,0.290584415584416
"E02006978",29,1544,1288,1085,339,30,15,4330,0.00669745958429561,0.356581986143187,0.297459584295612,0.250577367205543,0.0782909930715935,0.0069284064665127,0.00346420323325635,2861,0.660739030023095,1469,0.339260969976905
"E02006979",1,1327,1592,1053,304,30,16,4323,0.000231320842007865,0.306962757344437,0.368262780476521,0.243580846634282,0.0703215359703909,0.00693962526023595,0.00370113347212584,2920,0.675456858662966,1403,0.324543141337034
"E02006980",3,168,391,935,378,69,8,1952,0.00153688524590164,0.0860655737704918,0.20030737704918,0.478995901639344,0.193647540983607,0.0353483606557377,0.00409836065573771,562,0.287909836065574,1390,0.712090163934426
"E02006981",6,389,697,939,348,50,7,2436,0.00246305418719212,0.159688013136289,0.286124794745484,0.385467980295567,0.142857142857143,0.0205254515599343,0.0028735632183908,1092,0.448275862068966,1344,0.551724137931034
"E02006982",10,260,1312,1790,442,91,22,3927,0.00254647313470843,0.0662083015024191,0.334097275273746,0.455818691112809,0.112554112554113,0.0231729055258467,0.00560224089635854,1582,0.402852049910873,2345,0.597147950089127
"E02006983",1,1401,1466,578,134,10,1,3591,0.000278473962684489,0.390142021720969,0.408242829295461,0.160957950431635,0.0373155109997215,0.00278473962684489,0.000278473962684489,2868,0.798663324979114,723,0.201336675020886
"E02006984",0,1485,1949,551,62,7,0,4054,0,0.366304884065121,0.480759743463246,0.135915145535274,0.0152935372471633,0.00172668968919586,0,3434,0.847064627528367,620,0.152935372471633
"E02006985",1,27,521,1397,566,85,35,2632,0.000379939209726444,0.010258358662614,0.197948328267477,0.530775075987842,0.215045592705167,0.0322948328267477,0.0132978723404255,549,0.208586626139818,2083,0.791413373860182
"E02006986",0,220,639,1186,406,52,13,2516,0,0.0874403815580286,0.253974562798092,0.471383147853736,0.161367249602544,0.0206677265500795,0.00516693163751987,859,0.341414944356121,1657,0.658585055643879
"E02006987",2,3353,1861,797,255,26,14,6308,0.000317057704502219,0.531547241597971,0.295022194039315,0.126347495244134,0.040424857324033,0.00412175015852885,0.00221940393151554,5216,0.826886493341788,1092,0.173113506658212
"E02006988",20,445,1584,1359,504,64,29,4005,0.00499375780274657,0.111111111111111,0.395505617977528,0.339325842696629,0.125842696629213,0.015980024968789,0.00724094881398252,2049,0.511610486891386,1956,0.488389513108614
"E02006989",1,113,1165,1266,448,62,27,3082,0.000324464633354964,0.036664503569111,0.378001297858533,0.410772225827385,0.145360155743024,0.0201168072680078,0.00876054510058404,1279,0.414990266060999,1803,0.585009733939001
"E02006990",4,1131,2041,1280,428,97,22,5003,0.000799520287827304,0.22606436138317,0.407955226863882,0.255846492104737,0.0855486707975215,0.0193883669798121,0.00439736158305017,3176,0.634819108534879,1827,0.365180891465121
"E02006991",0,3519,1156,148,34,5,1,4863,0,0.723627390499692,0.237713345671396,0.0304338885461649,0.00699156899033518,0.00102817191034341,0.000205634382068682,4675,0.961340736171088,188,0.0386592638289122
"E02006992",7,3098,646,662,146,12,5,4576,0.00152972027972028,0.677010489510489,0.141171328671329,0.144667832167832,0.0319055944055944,0.00262237762237762,0.00109265734265734,3751,0.819711538461538,825,0.180288461538462
"E02006993",1,3357,887,281,65,5,1,4597,0.000217533173809006,0.730258864476833,0.192951925168588,0.0611268218403307,0.0141396562975854,0.00108766586904503,0.000217533173809006,4245,0.92342832281923,352,0.0765716771807701
"E02006994",7,842,1866,909,176,25,10,3835,0.00182529335071708,0.219556714471969,0.486571056062581,0.237027379400261,0.0458930899608866,0.00651890482398957,0.00260756192959583,2715,0.707953063885267,1120,0.292046936114733
"E02006995",10,5901,326,1,0,0,0,6238,0.00160307790958641,0.945976274446938,0.0522603398525168,0.000160307790958641,0,0,0,6237,0.999839692209041,1,0.000160307790958641
"E02006996",0,3864,747,581,93,14,1,5300,0,0.729056603773585,0.140943396226415,0.109622641509434,0.0175471698113208,0.00264150943396226,0.000188679245283019,4611,0.87,689,0.13
"E02006997",0,2270,2169,389,57,7,2,4894,0,0.463833265222722,0.443195749897834,0.0794850837760523,0.011646914589293,0.00143032284429914,0.000408663669799755,4439,0.907029015120556,455,0.0929709848794442
"E02006998",1,1087,1942,648,122,20,1,3821,0.000261711593823606,0.28448050248626,0.508243915205444,0.169589112797697,0.03192881444648,0.00523423187647213,0.000261711593823606,3030,0.792986129285527,791,0.207013870714473
"E02006999",0,5302,1681,153,24,3,0,7163,0,0.740192656708083,0.234678207454977,0.0213597654613989,0.00335055144492531,0.000418818930615664,0,6983,0.97487086416306,180,0.0251291358369398
"E02007000",1,288,652,797,240,52,17,2047,0.000488519785051295,0.140693698094773,0.318514899853444,0.389350268685882,0.117244748412311,0.0254030288226673,0.00830483634587201,941,0.459697117733268,1106,0.540302882266732
"E02007001",14,101,400,957,443,82,21,2018,0.00693756194251734,0.0500495540138751,0.198216055500496,0.474231912784936,0.219524281466799,0.0406342913776016,0.010406342913776,515,0.255203171456888,1503,0.744796828543112
"E02007002",16,429,1266,1606,471,74,17,3879,0.00412477442639856,0.110595514307811,0.326372776488786,0.414024233049755,0.121423047177108,0.0190770817220933,0.00438257282804847,1711,0.441093065222996,2168,0.558906934777004
"E02007003",113,384,1326,1928,851,168,44,4814,0.0234732031574574,0.0797673452430411,0.275446614042376,0.400498545907769,0.176776069796427,0.0348982135438305,0.00914000830909846,1823,0.378687162442875,2991,0.621312837557125
"E02007004",3,380,1384,883,228,24,7,2909,0.00103128222756961,0.130629082158817,0.475764867652114,0.303540735647989,0.0783774492952905,0.00825025782055689,0.00240632519766243,1767,0.607425232038501,1142,0.392574767961499
"E02007005",64,1254,813,981,284,27,4,3427,0.0186752261453166,0.365917712284797,0.237233732127225,0.286256200758681,0.0828713160198424,0.00787861103005544,0.00116720163408229,2131,0.621826670557339,1296,0.378173329442661
"E02007006",1,1260,1354,617,266,53,19,3570,0.000280112044817927,0.352941176470588,0.379271708683473,0.172829131652661,0.0745098039215686,0.0148459383753501,0.00532212885154062,2615,0.73249299719888,955,0.26750700280112
"E02007007",3,666,1366,631,164,34,7,2871,0.00104493207941484,0.231974921630094,0.47579240682689,0.219784047370254,0.0571229536746778,0.0118425635667015,0.00243817485196796,2035,0.708812260536398,836,0.291187739463601
"E02007008",11,4005,672,261,43,5,0,4997,0.00220132079247549,0.80148088853312,0.134480688413048,0.052231338803282,0.00860516309785871,0.00100060036021613,0,4688,0.938162897738643,309,0.0618371022613568
"E02007009",2,637,1934,1486,427,48,17,4551,0.000439463854098,0.139969237530213,0.424961546912766,0.326521643594814,0.0938255328499231,0.010547132498352,0.003735442759833,2573,0.565370248297078,1978,0.434629751702922
"E02007010",39,1576,1111,585,210,58,13,3592,0.0108574610244989,0.438752783964365,0.309298440979955,0.162861915367483,0.0584632516703786,0.0161469933184855,0.00361915367483296,2726,0.75890868596882,866,0.24109131403118
"E02007011",51,2246,1054,306,129,21,10,3817,0.0133612784909615,0.588420225307833,0.276133088813204,0.0801676709457689,0.0337961750065496,0.00550170290804297,0.00261985852763951,3351,0.877914592611999,466,0.122085407388001
"E02007012",8,1493,1486,210,26,5,0,3228,0.00247831474597274,0.462515489467162,0.460346964064436,0.0650557620817844,0.0080545229244114,0.00154894671623296,0,2987,0.925340768277571,241,0.0746592317224287
"E02007013",45,3303,1234,7,0,1,0,4590,0.00980392156862745,0.719607843137255,0.268845315904139,0.00152505446623094,0,0.000217864923747277,0,4582,0.998257080610022,8,0.00174291938997821
"E02007014",5,225,1381,980,108,7,0,2706,0.00184774575018477,0.0831485587583149,0.510347376201035,0.362158167036216,0.0399113082039911,0.00258684405025868,0,1611,0.595343680709534,1095,0.404656319290466
"E02007015",451,2709,1504,319,97,20,5,5105,0.0883447600391773,0.530656219392752,0.294613124387855,0.0624877571008815,0.0190009794319295,0.0039177277179236,0.000979431929480901,4664,0.913614103819784,441,0.0863858961802155
"E02007016",190,1617,1079,611,55,6,0,3558,0.0534007869589657,0.454468802698145,0.303260258572232,0.171725688589095,0.0154581225407532,0.00168634064080944,0,2886,0.811129848229342,672,0.188870151770658
"E02007017",0,115,904,979,301,38,6,2343,0,0.049082373026035,0.385830132309006,0.417840375586854,0.1284677763551,0.0162185232607768,0.00256081946222791,1019,0.434912505335041,1324,0.565087494664959
"E02007018",1,269,970,1011,255,24,10,2540,0.000393700787401575,0.105905511811024,0.381889763779528,0.398031496062992,0.100393700787402,0.0094488188976378,0.00393700787401575,1240,0.488188976377953,1300,0.511811023622047
"E02007019",0,927,1200,817,189,22,15,3170,0,0.292429022082019,0.378548895899054,0.257728706624606,0.0596214511041009,0.00694006309148265,0.00473186119873817,2127,0.670977917981073,1043,0.329022082018927
"E02007020",0,20,585,1385,311,31,19,2351,0,0.00850701829008932,0.248830284985113,0.589111016588686,0.132284134410889,0.0131858783496385,0.00808166737558486,605,0.257337303275202,1746,0.742662696724798
"E02007021",5,160,1153,1077,282,26,4,2707,0.0018470631695604,0.0591060214259328,0.425932766900628,0.39785740672331,0.104174362763207,0.00960472848171407,0.00147765053564832,1318,0.486885851496121,1389,0.513114148503879
"E02007022",16,608,1201,1704,1041,430,155,5155,0.00310378273520854,0.117943743937924,0.232977691561591,0.330552861299709,0.201939864209505,0.0834141610087294,0.0300678952473327,1825,0.354025218234724,3330,0.645974781765276
"E02007023",48,863,984,785,147,19,4,2850,0.0168421052631579,0.30280701754386,0.345263157894737,0.275438596491228,0.0515789473684211,0.00666666666666667,0.00140350877192982,1895,0.664912280701754,955,0.335087719298246
"E02007024",9,444,1173,913,372,77,10,2998,0.00300200133422282,0.148098732488326,0.391260840560374,0.304536357571714,0.124082721814543,0.0256837891927952,0.00333555703802535,1626,0.542361574382922,1372,0.457638425617078
"E02007025",34,1088,747,786,476,109,13,3253,0.0104518905625576,0.334460498001844,0.22963418383031,0.241623117122656,0.146326467875807,0.033507531509376,0.00399631109744851,1869,0.574546572394713,1384,0.425453427605287
"E02007026",1,653,1498,659,143,54,7,3015,0.00033167495854063,0.216583747927032,0.496849087893864,0.218573797678275,0.0474295190713101,0.017910447761194,0.00232172470978441,2152,0.713764510779436,863,0.286235489220564
"E02007027",108,2543,617,930,565,160,61,4984,0.021669341894061,0.510232744783307,0.123796147672552,0.186597110754414,0.113362760834671,0.0321027287319422,0.012239165329053,3268,0.65569823434992,1716,0.34430176565008
"E02007028",4,2963,314,3,6,0,1,3291,0.00121543603767852,0.900334244910362,0.0954117289577636,0.000911577028258888,0.00182315405651778,0,0.000303859009419629,3281,0.996961409905804,10,0.00303859009419629
"E02007029",9,283,936,1709,911,292,93,4233,0.00212615166548547,0.0668556579258209,0.221119773210489,0.403732577368297,0.215213796361918,0.0689818095913064,0.0219702338766832,1228,0.290101582801795,3005,0.709898417198205
"E02007030",78,1885,224,429,358,173,61,3208,0.0243142144638404,0.587593516209476,0.0698254364089776,0.133728179551122,0.111596009975062,0.053927680798005,0.0190149625935162,2187,0.681733167082294,1021,0.318266832917706
"E02007031",22,619,1223,764,265,91,38,3022,0.00727994705493051,0.204831237590999,0.404698874917273,0.252812706816678,0.0876902713434811,0.0301125082726671,0.0125744540039709,1864,0.616810059563203,1158,0.383189940436797
"E02007032",3,165,1042,1205,238,64,16,2733,0.00109769484083425,0.0603732162458836,0.381266008049762,0.44090742773509,0.0870837907061837,0.0234174899377973,0.00585437248444932,1210,0.44273691913648,1523,0.55726308086352
"E02007033",4,434,840,970,237,42,11,2538,0.00157604412923562,0.171000788022065,0.33096926713948,0.382190701339638,0.0933806146572104,0.016548463356974,0.00433412135539795,1278,0.50354609929078,1260,0.49645390070922
"E02007034",275,1220,1289,755,93,8,1,3641,0.0755287009063444,0.335072782202692,0.354023619884647,0.2073606152156,0.0255424333974183,0.00219719857182093,0.000274649821477616,2784,0.764625102993683,857,0.235374897006317
"E02007035",29,199,1045,1096,250,46,7,2672,0.0108532934131737,0.0744760479041916,0.391092814371257,0.410179640718563,0.093562874251497,0.0172155688622754,0.00261976047904192,1273,0.476422155688623,1399,0.523577844311377
"E02007038",104,349,1088,2430,933,160,35,5099,0.020396156109041,0.0684447930966856,0.213375171602275,0.476564032163169,0.182977054324377,0.0313787017062169,0.00686409099823495,1541,0.302216120808002,3558,0.697783879191998
"E02007039",4,8,266,1004,601,97,28,2008,0.00199203187250996,0.00398406374501992,0.132470119521912,0.5,0.299302788844622,0.0483067729083665,0.0139442231075697,278,0.138446215139442,1730,0.861553784860558
"E02007040",0,39,249,1056,584,79,36,2043,0,0.0190895741556534,0.121879588839941,0.516886930983847,0.2858541360744,0.0386686245717083,0.0176211453744493,288,0.140969162995595,1755,0.859030837004405
"E02007041",27,358,643,1249,1007,410,126,3820,0.00706806282722513,0.093717277486911,0.168324607329843,0.32696335078534,0.263612565445026,0.107329842931937,0.0329842931937173,1028,0.269109947643979,2792,0.730890052356021
"E02007042",5,538,899,1066,209,45,14,2776,0.00180115273775216,0.193804034582133,0.323847262247839,0.384005763688761,0.0752881844380403,0.0162103746397695,0.00504322766570605,1442,0.519452449567723,1334,0.480547550432277
"E02007043",2,211,1252,985,216,39,7,2712,0.000737463126843658,0.0778023598820059,0.46165191740413,0.363200589970501,0.079646017699115,0.0143805309734513,0.0025811209439528,1465,0.540191740412979,1247,0.459808259587021
"E02007044",43,922,1267,918,292,51,30,3523,0.0122055066704513,0.261708770933863,0.35963667328981,0.260573374964519,0.0828839057621345,0.0144762986091399,0.00851546977008232,2232,0.633550950894124,1291,0.366449049105876
"E02007045",6,255,660,1082,343,67,16,2429,0.00247015232606011,0.104981473857555,0.271716755866612,0.445450802799506,0.141210374639769,0.0275833676410045,0.00658707286949362,921,0.379168382050226,1508,0.620831617949774
"E02007046",5,254,975,1050,221,28,7,2540,0.00196850393700787,0.1,0.383858267716535,0.413385826771654,0.087007874015748,0.0110236220472441,0.00275590551181102,1234,0.485826771653543,1306,0.514173228346457
"E02007047",14,1153,1421,680,120,15,4,3407,0.00410918696800704,0.338420898150866,0.417082477252715,0.199589081303199,0.0352216025829175,0.00440270032286469,0.00117405341943058,2588,0.759612562371588,819,0.240387437628412
"E02007048",5,330,594,868,374,124,35,2330,0.00214592274678112,0.141630901287554,0.254935622317597,0.372532188841202,0.160515021459227,0.0532188841201717,0.0150214592274678,929,0.398712446351931,1401,0.601287553648069
"E02007049",190,2863,1026,306,98,26,11,4520,0.0420353982300885,0.633407079646018,0.226991150442478,0.0676991150442478,0.0216814159292035,0.00575221238938053,0.00243362831858407,4079,0.902433628318584,441,0.0975663716814159
"E02007050",2,1526,1311,731,122,12,1,3705,0.000539811066126856,0.411875843454791,0.353846153846154,0.197300944669366,0.0329284750337382,0.00323886639676113,0.000269905533063428,2839,0.766261808367072,866,0.233738191632928
"E02007051",5,2132,1322,433,104,22,7,4025,0.00124223602484472,0.529689440993789,0.328447204968944,0.107577639751553,0.0258385093167702,0.00546583850931677,0.00173913043478261,3459,0.859378881987578,566,0.140621118012422
"E02007052",1,314,2085,1176,258,26,5,3865,0.000258732212160414,0.08124191461837,0.539456662354463,0.304269081500647,0.0667529107373868,0.00672703751617076,0.00129366106080207,2400,0.620957309184993,1465,0.379042690815007
"E02007053",2,552,1643,944,348,44,16,3549,0.000563539025077487,0.155536770921386,0.462947309101155,0.265990419836574,0.0980557903634827,0.0123978585517047,0.00450831220061989,2197,0.619047619047619,1352,0.380952380952381
"E02007054",62,1110,1812,485,110,15,8,3602,0.0172126596335369,0.308162132148806,0.50305385896724,0.134647418101055,0.0305385896724042,0.00416435313714603,0.00222098833981122,2984,0.828428650749583,618,0.171571349250416
"E02007055",15,333,1203,974,211,38,7,2781,0.00539374325782093,0.119741100323625,0.432578209277238,0.350233728874506,0.0758719884933477,0.0136641495864797,0.0025170801869831,1551,0.557713052858684,1230,0.442286947141316
"E02007056",3,2243,1013,498,125,18,3,3903,0.000768639508070715,0.574686138867538,0.259543940558545,0.127594158339739,0.0320266461696131,0.00461183704842429,0.000768639508070715,3259,0.834998718934153,644,0.165001281065847
"E02007057",2,670,1578,735,149,16,4,3154,0.000634115409004439,0.212428662016487,0.500317057704502,0.233037412809131,0.0472415979708307,0.00507292327203551,0.00126823081800888,2250,0.713379835129994,904,0.286620164870006
"E02007058",5,209,1615,3148,1504,270,98,6849,0.000730033581544751,0.0305154037085706,0.235800846838955,0.459629142940575,0.219594101328661,0.0394218134034166,0.0143086581982771,1829,0.26704628412907,5020,0.73295371587093
"E02007059",4,202,1789,2126,998,163,58,5340,0.000749063670411985,0.0378277153558052,0.33501872659176,0.39812734082397,0.18689138576779,0.0305243445692884,0.0108614232209738,1995,0.373595505617977,3345,0.626404494382023
"E02007060",8,960,1667,840,393,60,24,3952,0.00202429149797571,0.242914979757085,0.421811740890688,0.212550607287449,0.0994433198380567,0.0151821862348178,0.00607287449392713,2635,0.666751012145749,1317,0.333248987854251
"E02007061",7,373,1812,1055,379,61,19,3706,0.00188882892606584,0.100647598488937,0.488936859147329,0.284673502428494,0.102266594711279,0.0164597949271452,0.00512682137075013,2192,0.591473286562331,1514,0.408526713437669
"E02007062",4,555,1566,527,47,3,0,2702,0.00148038490007402,0.20540340488527,0.579570688378979,0.195040710584752,0.0173945225758697,0.00111028867505551,0,2125,0.786454478164323,577,0.213545521835677
"E02007063",19,326,1090,1017,51,2,0,2505,0.00758483033932136,0.130139720558882,0.435129740518962,0.405988023952096,0.0203592814371257,0.000798403193612774,0,1435,0.572854291417166,1070,0.427145708582834
"E02007064",15,167,811,1133,360,56,7,2549,0.00588466065123578,0.0655158885837583,0.318163985876814,0.444488034523343,0.141231855629659,0.0219693997646136,0.0027461749705767,993,0.389564535111809,1556,0.610435464888191
"E02007065",137,2168,933,383,96,10,3,3730,0.0367292225201072,0.581233243967828,0.250134048257373,0.102680965147453,0.0257372654155496,0.00268096514745308,0.000804289544235925,3238,0.868096514745308,492,0.131903485254692
"E02007066",198,1846,1371,402,54,6,0,3877,0.0510704152695383,0.476141346401857,0.353623936033015,0.103688418880578,0.0139282950735104,0.00154758834150116,0,3415,0.880835697704411,462,0.119164302295589
"E02007067",301,927,821,666,272,76,16,3079,0.0977590126664502,0.301071776550828,0.266645014615135,0.216303994803508,0.0883403702500812,0.0246833387463462,0.00519649236765183,2049,0.665475803832413,1030,0.334524196167587
"E02007068",3,859,1414,634,216,19,7,3152,0.000951776649746193,0.27252538071066,0.448604060913706,0.201142131979695,0.0685279187817259,0.00602791878172589,0.00222081218274112,2276,0.722081218274112,876,0.277918781725888
"E02007069",25,393,623,755,218,22,10,2046,0.0122189638318671,0.19208211143695,0.304496578690127,0.369012707722385,0.106549364613881,0.010752688172043,0.00488758553274682,1041,0.508797653958944,1005,0.491202346041056
"E02007070",1,184,883,591,230,81,20,1990,0.00050251256281407,0.0924623115577889,0.443718592964824,0.296984924623116,0.115577889447236,0.0407035175879397,0.0100502512562814,1068,0.536683417085427,922,0.463316582914573
"E02007071",8,1298,1103,1017,300,44,5,3775,0.00211920529801325,0.343841059602649,0.292185430463576,0.269403973509934,0.0794701986754967,0.0116556291390728,0.00132450331125828,2409,0.638145695364238,1366,0.361854304635762
"E02007072",18,2417,1367,182,21,0,0,4011,0.00448765893792072,0.602592869608576,0.340812764896535,0.0453752181500873,0.00523560209424084,0,0,3802,0.947893293443032,203,0.0506108202443281
"E02007073",4,1124,855,764,66,4,1,2818,0.0014194464158978,0.398864442867282,0.303406671398155,0.27111426543648,0.0234208658623137,0.0014194464158978,0.00035486160397445,1983,0.703690560681334,835,0.296309439318666
"E02007074",13,871,1664,880,368,125,48,3969,0.00327538422776518,0.219450743260267,0.419249181153943,0.221718316956412,0.0927185689090451,0.0314940791131267,0.0120937263794407,2548,0.641975308641975,1421,0.358024691358025
"E02007075",0,1485,2032,650,142,16,3,4328,0,0.3431146025878,0.469500924214418,0.150184842883549,0.0328096118299445,0.00369685767097967,0.000693160813308688,3517,0.812615526802218,811,0.187384473197782
"E02007076",26,2282,1146,245,66,19,5,3789,0.00686196885721826,0.602269728160465,0.302454473475851,0.0646608603853259,0.0174188440221694,0.00501451570335181,0.0013196093956189,3454,0.911586170493534,335,0.0884138295064661
"E02007077",4,2439,525,211,46,12,1,3238,0.00123533045089561,0.753242742433601,0.162137121680049,0.0651636812847437,0.0142063001852996,0.00370599135268684,0.000308832612723904,2968,0.916615194564546,270,0.083384805435454
"E02007078",9,292,1142,678,154,13,4,2292,0.00392670157068063,0.12739965095986,0.49825479930192,0.295811518324607,0.0671902268760907,0.00567190226876091,0.00174520069808028,1443,0.629581151832461,849,0.370418848167539
"E02007079",62,982,1275,659,64,28,14,3084,0.0201037613488975,0.318417639429313,0.413424124513619,0.213683527885863,0.0207522697795071,0.00907911802853437,0.00453955901426719,2319,0.751945525291829,765,0.248054474708171
"E02007080",46,1328,1969,308,16,0,0,3667,0.0125443141532588,0.36214889555495,0.536951186255795,0.0839923643305154,0.00436323970548132,0,0,3343,0.911644395964003,324,0.0883556040359967
"E02007081",1,141,731,2042,804,94,25,3838,0.000260552371026576,0.0367378843147473,0.190463783220427,0.532047941636269,0.209484106305367,0.0244919228764982,0.00651380927566441,873,0.227462219906201,2965,0.772537780093799
"E02007082",5,469,1613,2203,976,165,25,5457,0.000916254352208173,0.0859446582371266,0.295583654022357,0.403701667582921,0.178852849551035,0.0302363936228697,0.00458127176104087,2087,0.382444566611691,3369,0.617372182517867
"E02007083",0,7484,1610,121,11,2,0,9228,0,0.811009969657564,0.174469007368877,0.0131122670134374,0.00119202427394885,0.000216731686172518,0,9094,0.985478977026441,134,0.0145210229735587
"E02007084",0,880,1941,1078,246,34,8,4187,0,0.210174349176021,0.463577740625746,0.257463577740626,0.0587532839742059,0.00812037258180081,0.00191067590160019,2821,0.673752089801767,1366,0.326247910198233
"E02007085",135,536,1347,1614,598,104,24,4358,0.0309775126204681,0.122992198256081,0.309086737035337,0.37035337310693,0.137218907755851,0.0238641578705828,0.00550711335474988,2018,0.463056447911886,2340,0.536943552088114
"E02007086",54,3353,745,521,193,19,3,4888,0.0110474631751228,0.685965630114566,0.152414075286416,0.106587561374795,0.0394844517184943,0.00388707037643208,0.000613747954173486,4152,0.849427168576105,736,0.150572831423895
"E02007087",8,912,1001,497,175,45,7,2645,0.00302457466918715,0.344801512287335,0.378449905482042,0.187901701323251,0.0661625708884688,0.0170132325141777,0.00264650283553875,1921,0.726275992438563,724,0.273724007561437
"E02007088",17,308,559,870,608,236,43,2641,0.00643695569859902,0.1166224914805,0.21166224914805,0.329420673987126,0.23021582733813,0.0893600908746687,0.0162817114729269,884,0.334721696327149,1757,0.665278303672851
"E02007089",5,224,1667,633,71,24,7,2631,0.00190041809198024,0.0851387305207146,0.633599391866211,0.240592930444698,0.0269859369061193,0.00912200684150513,0.00266058532877233,1896,0.720638540478905,735,0.279361459521095
"E02007090",12,193,827,727,193,22,4,1978,0.00606673407482305,0.0975733063700708,0.418099089989889,0.367542972699697,0.0975733063700708,0.0111223458038423,0.00202224469160768,1032,0.521739130434783,946,0.478260869565217
"E02007091",0,69,746,1035,105,8,1,1964,0,0.035132382892057,0.379837067209776,0.526985743380855,0.0534623217922607,0.00407331975560081,0.000509164969450102,815,0.414969450101833,1149,0.585030549898167
"E02007092",4,127,1067,749,188,38,2,2175,0.00183908045977011,0.0583908045977012,0.490574712643678,0.344367816091954,0.0864367816091954,0.0174712643678161,0.000919540229885057,1198,0.550804597701149,977,0.449195402298851
"E02007093",7,399,499,806,570,205,47,2533,0.00276352151598895,0.15752072641137,0.196999605211212,0.318199763126727,0.2250296091591,0.0809317015396763,0.0185550730359258,905,0.357283853138571,1628,0.642716146861429
"E02007094",3,403,741,1379,438,86,14,3064,0.00097911227154047,0.131527415143603,0.241840731070496,0.450065274151436,0.142950391644909,0.0280678851174935,0.00456919060052219,1147,0.37434725848564,1917,0.62565274151436
"E02007095",72,2958,1500,521,109,15,9,5184,0.0138888888888889,0.570601851851852,0.289351851851852,0.100501543209877,0.0210262345679012,0.00289351851851852,0.00173611111111111,4530,0.873842592592593,654,0.126157407407407
"E02007096",5,182,893,653,101,7,1,1842,0.00271444082519001,0.0988056460369164,0.484799131378936,0.354505971769815,0.0548317046688382,0.00380021715526602,0.000542888165038002,1080,0.586319218241042,762,0.413680781758958
"E02007097",0,336,1075,1358,364,35,8,3176,0,0.105793450881612,0.338476070528967,0.427581863979849,0.114609571788413,0.0110201511335013,0.00251889168765743,1411,0.444269521410579,1765,0.555730478589421
"E02007098",0,343,1179,1116,236,23,3,2900,0,0.118275862068966,0.406551724137931,0.384827586206897,0.0813793103448276,0.00793103448275862,0.00103448275862069,1522,0.524827586206897,1378,0.475172413793103
"E02007099",0,603,2434,1070,394,43,12,4556,0,0.132352941176471,0.5342405618964,0.234855136084284,0.0864793678665496,0.00943810359964881,0.00263388937664618,3037,0.666593503072871,1519,0.333406496927129
"E02007100",3,900,1576,622,121,11,5,3238,0.000926497838171711,0.277949351451513,0.486720197652872,0.192093885114268,0.0373687461395923,0.00339715873996294,0.00154416306361952,2479,0.765596046942557,759,0.234403953057443
"E02007101",1,43,1335,1528,411,42,9,3369,0.000296823983377857,0.0127634312852478,0.396260017809439,0.453547046601365,0.121994657168299,0.01246660730187,0.00267141585040071,1379,0.409320273078065,1990,0.590679726921935
"E02007102",19,426,1304,631,198,41,6,2625,0.00723809523809524,0.162285714285714,0.496761904761905,0.240380952380952,0.0754285714285714,0.0156190476190476,0.00228571428571429,1749,0.666285714285714,876,0.333714285714286
"E02007103",18,299,1417,1256,125,6,2,3123,0.00576368876080692,0.095741274415626,0.453730387447967,0.40217739353186,0.0400256163944925,0.00192122958693564,0.00064040986231188,1734,0.5552353506244,1389,0.4447646493756
"E02007104",12,556,902,586,162,15,2,2235,0.00536912751677852,0.248769574944072,0.403579418344519,0.262192393736018,0.0724832214765101,0.00671140939597315,0.000894854586129754,1470,0.657718120805369,765,0.342281879194631
"E02007105",5,407,1876,1673,375,40,5,4381,0.00114129194247889,0.0929011641177813,0.428212736818078,0.381876283953435,0.0855968956859165,0.00913033553983109,0.00114129194247889,2288,0.522255192878338,2093,0.477744807121662
"E02007106",2,652,1611,1745,230,23,0,4263,0.000469153178512784,0.152943936195168,0.377902885292048,0.409336148252404,0.0539526155289702,0.00539526155289702,0,2265,0.531315974665728,1998,0.468684025334272
"E02007107",11,387,780,1212,634,216,65,3305,0.00332829046898638,0.117095310136157,0.236006051437216,0.366717095310136,0.191830559757942,0.0653555219364599,0.0196671709531014,1178,0.35642965204236,2127,0.64357034795764
"E02007108",1,957,1538,850,211,23,7,3587,0.000278784499581823,0.266796766099805,0.428770560356844,0.23696682464455,0.0588235294117647,0.00641204349038193,0.00195149149707276,2496,0.695846110956231,1091,0.304153889043769
"E02007109",1,526,1455,940,272,28,10,3232,0.000309405940594059,0.162747524752475,0.450185643564356,0.290841584158416,0.0841584158415842,0.00866336633663366,0.00309405940594059,1982,0.613242574257426,1250,0.386757425742574
"E02007110",3,1324,2093,665,112,17,5,4219,0.000711068973690448,0.313818440388718,0.496089120644703,0.157620289168049,0.0265465750177767,0.00402939085091254,0.00118511495615075,3420,0.810618630007111,799,0.189381369992889
"E02007111",9,2068,1735,812,256,46,27,4953,0.00181708055723804,0.417524732485362,0.350292751867555,0.16394104583081,0.0516858469614375,0.0092873006258833,0.00545124167171411,3812,0.769634564910155,1141,0.230365435089845
"E02007112",0,3494,1324,100,5,6,0,4929,0,0.708865895719213,0.268614323392169,0.0202880908906472,0.00101440454453236,0.00121728545343883,0,4818,0.977480219111382,111,0.0225197808886184
"E02007113",80,4276,1685,495,68,17,1,6622,0.0120809423135005,0.645726366656599,0.254454847478103,0.0747508305647841,0.0102688009664754,0.00256720024161885,0.000151011778918756,6041,0.912262156448203,581,0.087737843551797
"E02007114",0,1857,1680,500,57,5,4,4103,0,0.452595661710943,0.40945649524738,0.121862052156958,0.0138922739458932,0.00121862052156958,0.000974896417255667,3537,0.862052156958323,566,0.137947843041677
"E02007115",0,372,2720,1589,391,54,20,5146,0,0.072289156626506,0.528565876408861,0.3087835211815,0.0759813447337738,0.0104935872522347,0.00388651379712398,3092,0.600855033035367,2054,0.399144966964633
"E02007116",2,344,1319,988,304,32,3,2992,0.000668449197860963,0.114973262032086,0.440842245989305,0.330213903743315,0.101604278074866,0.0106951871657754,0.00100267379679144,1665,0.556483957219251,1327,0.443516042780749
"W02000001",24,191,825,1272,855,507,236,3910,0.0061381074168798,0.048849104859335,0.210997442455243,0.325319693094629,0.218670076726343,0.129667519181586,0.0603580562659847,1040,0.265984654731458,2870,0.734015345268542
"W02000002",59,125,307,622,843,450,202,2608,0.0226226993865031,0.0479294478527607,0.11771472392638,0.238496932515337,0.323236196319018,0.172546012269939,0.0774539877300613,491,0.188266871165644,2117,0.811733128834356
"W02000003",10,609,2002,1518,787,152,65,5143,0.00194439043359907,0.118413377406183,0.389266964806533,0.295158467820338,0.153023527124247,0.0295547345907058,0.0126385378183939,2621,0.509624732646315,2522,0.490375267353685
"W02000004",78,366,715,1050,587,330,151,3277,0.0238022581629539,0.111687519072322,0.218187366493744,0.320415013732072,0.179127250534025,0.100701861458651,0.0460787305462313,1159,0.35367714372902,2118,0.64632285627098
"W02000005",44,139,672,1093,991,477,201,3617,0.0121647774398673,0.038429637821399,0.185789328172519,0.302184130494885,0.273983964611557,0.131877246336743,0.0555709151230301,855,0.236383743433785,2762,0.763616256566215
"W02000006",122,338,958,1020,330,132,63,2963,0.0411744853189335,0.114073574080324,0.323320958488019,0.344245696928788,0.111373607829902,0.0445494431319609,0.0212622342220722,1418,0.478569017887276,1545,0.521430982112724
"W02000007",30,120,560,1055,689,350,219,3023,0.00992391663910023,0.0396956665564009,0.185246443929871,0.348991068475025,0.227919285478002,0.115779027456169,0.0724445914654317,710,0.234866027125372,2313,0.765133972874628
"W02000008",5,140,850,896,328,85,33,2337,0.00213949507916132,0.0599058622165169,0.363714163457424,0.383397518185708,0.140350877192982,0.0363714163457424,0.0141206675224647,995,0.425759520753102,1342,0.574240479246898
"W02000009",46,166,374,904,834,439,242,3005,0.0153078202995008,0.0552412645590682,0.124459234608985,0.300831946755408,0.277537437603993,0.146089850249584,0.0805324459234609,586,0.195008319467554,2419,0.804991680532446
"W02000010",13,265,1258,1388,478,58,37,3497,0.00371747211895911,0.0757792393480126,0.359736917357735,0.396911638547326,0.136688590220189,0.0165856448384329,0.0105804975693452,1536,0.439233628824707,1961,0.560766371175293
"W02000011",70,377,945,1017,286,54,23,2772,0.0252525252525253,0.136002886002886,0.340909090909091,0.366883116883117,0.103174603174603,0.0194805194805195,0.0082972582972583,1392,0.502164502164502,1380,0.497835497835498
"W02000012",97,106,509,921,543,248,126,2550,0.0380392156862745,0.0415686274509804,0.199607843137255,0.361176470588235,0.212941176470588,0.0972549019607843,0.0494117647058823,712,0.27921568627451,1838,0.72078431372549
"W02000013",12,131,508,737,408,197,71,2064,0.00581395348837209,0.063468992248062,0.246124031007752,0.357073643410853,0.197674418604651,0.0954457364341085,0.0343992248062015,651,0.315406976744186,1413,0.684593023255814
"W02000014",24,51,318,623,686,474,198,2374,0.0101095197978096,0.0214827295703454,0.133951137320977,0.262426284751474,0.288963774220725,0.19966301600674,0.0834035383319292,393,0.165543386689132,1981,0.834456613310868
"W02000015",22,216,1051,1202,417,82,38,3028,0.00726552179656539,0.071334214002642,0.347093791281374,0.396961690885073,0.137714663143989,0.0270805812417437,0.0125495376486129,1289,0.425693527080581,1739,0.574306472919419
"W02000016",9,121,276,646,592,317,176,2137,0.0042115114646701,0.056621431913898,0.129153018249883,0.302292934019654,0.277023865231633,0.148338792700047,0.0823584464202153,406,0.189985961628451,1731,0.810014038371549
"W02000017",27,84,490,924,574,364,210,2673,0.0101010101010101,0.0314253647586981,0.183314627759072,0.345679012345679,0.21473999251777,0.136176580621025,0.0785634118967452,601,0.22484100261878,2072,0.77515899738122
"W02000018",8,32,404,854,557,361,179,2395,0.00334029227557411,0.0133611691022965,0.168684759916493,0.356576200417537,0.232567849686848,0.150730688935282,0.0747390396659708,444,0.185386221294363,1951,0.814613778705637
"W02000019",16,119,502,845,651,361,165,2659,0.00601729973674314,0.0447536667920271,0.188792779240316,0.317788642346747,0.244828883038736,0.135765325310267,0.0620534035351636,637,0.239563745769086,2022,0.760436254230914
"W02000020",5,132,308,628,657,415,187,2332,0.00214408233276158,0.0566037735849057,0.132075471698113,0.269296740994854,0.281732418524871,0.177958833619211,0.080188679245283,445,0.19082332761578,1887,0.80917667238422
"W02000021",25,152,522,979,802,397,213,3090,0.00809061488673139,0.0491909385113269,0.168932038834951,0.316828478964401,0.259546925566343,0.128478964401294,0.0689320388349515,699,0.22621359223301,2391,0.77378640776699
"W02000022",54,44,249,682,720,446,220,2415,0.022360248447205,0.0182194616977226,0.103105590062112,0.2824016563147,0.298136645962733,0.184679089026915,0.0910973084886128,347,0.143685300207039,2068,0.856314699792961
"W02000023",29,108,250,431,817,501,283,2419,0.0119884249689955,0.0446465481603969,0.10334849111203,0.178172798677139,0.337742868954113,0.207110376188508,0.116990491938818,387,0.159983464241422,2032,0.840016535758578
"W02000024",17,82,315,524,460,355,181,1934,0.00879007238883144,0.0423991726990693,0.16287487073423,0.270941054808687,0.237849017580145,0.183557394002068,0.09358841778697,414,0.21406411582213,1520,0.78593588417787
"W02000025",16,89,633,857,590,332,178,2695,0.00593692022263451,0.0330241187384045,0.234879406307978,0.317996289424861,0.218923933209648,0.123191094619666,0.0660482374768089,738,0.273840445269017,1957,0.726159554730983
"W02000026",32,117,635,1200,880,585,250,3699,0.00865098675317653,0.0316301703163017,0.171668018383347,0.32441200324412,0.237902135712355,0.158150851581509,0.0675858340091917,784,0.211949175452825,2915,0.788050824547175
"W02000027",4,334,1640,1809,929,205,92,5013,0.000797925393975663,0.0666267703969679,0.327149411530022,0.360861759425494,0.185318172750848,0.0408936764412527,0.0183522840614403,1978,0.394574107320965,3035,0.605425892679035
"W02000028",4,142,941,1246,369,56,23,2781,0.00143833153541891,0.0510607695073714,0.3383674937073,0.448040273282992,0.132686084142395,0.0201366414958648,0.00827040632865876,1087,0.39086659475009,1694,0.60913340524991
"W02000029",2,51,455,1209,442,75,38,2272,0.000880281690140845,0.0224471830985916,0.200264084507042,0.532130281690141,0.194542253521127,0.0330105633802817,0.0167253521126761,508,0.223591549295775,1764,0.776408450704225
"W02000030",3,180,865,1323,492,98,22,2983,0.00100569896077774,0.0603419376466644,0.289976533690915,0.443513241702984,0.164934629567549,0.0328528327187395,0.0073751257123701,1048,0.351324170298357,1935,0.648675829701643
"W02000031",10,69,994,1421,392,76,27,2989,0.00334560053529609,0.023084643693543,0.332552693208431,0.475409836065574,0.131147540983607,0.0254265640682503,0.00903312144529943,1073,0.35898293743727,1916,0.64101706256273
"W02000032",31,557,904,1430,536,87,28,3573,0.00867618247970893,0.155891407780577,0.25300867618248,0.400223901483347,0.150013993842709,0.0243492863140218,0.00783655191715645,1492,0.417576266442765,2081,0.582423733557235
"W02000033",3,258,1059,1360,632,155,68,3535,0.000848656294200849,0.072984441301273,0.2995756718529,0.384724186704385,0.178783592644979,0.0438472418670438,0.0192362093352192,1320,0.373408769448373,2215,0.626591230551626
"W02000034",8,325,986,1304,427,85,32,3167,0.00252604988948532,0.102620776760341,0.311335648879065,0.411746131986107,0.134827912851279,0.0268392800757815,0.0101041995579413,1319,0.416482475528892,1848,0.583517524471108
"W02000035",7,186,803,1406,856,309,129,3696,0.00189393939393939,0.0503246753246753,0.217261904761905,0.380411255411255,0.231601731601732,0.0836038961038961,0.0349025974025974,996,0.269480519480519,2700,0.73051948051948
"W02000036",16,511,1292,2419,608,109,49,5004,0.00319744204636291,0.102118305355715,0.258193445243805,0.483413269384492,0.121502797761791,0.0217825739408473,0.00979216626698641,1819,0.363509192645883,3185,0.636490807354117
"W02000037",33,267,552,1208,450,116,46,2672,0.0123502994011976,0.0999251497005988,0.206586826347305,0.452095808383234,0.168413173652695,0.0434131736526946,0.0172155688622754,852,0.318862275449102,1820,0.681137724550898
"W02000038",19,171,657,1033,526,175,103,2684,0.00707898658718331,0.0637108792846498,0.24478390461997,0.384873323397914,0.195976154992548,0.0652011922503726,0.0383755588673621,847,0.315573770491803,1837,0.684426229508197
"W02000039",6,204,729,1337,580,176,77,3109,0.00192988099067224,0.0656159536828562,0.234480540366677,0.430041814088131,0.18655516243165,0.0566098423930524,0.0247668060469604,939,0.302026375040206,2170,0.697973624959794
"W02000040",25,106,198,526,594,412,258,2119,0.0117980179329873,0.050023596035866,0.0934403020292591,0.248230297310052,0.280320906087777,0.19443133553563,0.121755545068429,329,0.155261915998112,1790,0.844738084001888
"W02000041",10,160,582,1060,830,469,236,3347,0.00298775022408127,0.0478040035853003,0.17388706304153,0.316701523752614,0.247983268598745,0.140125485509411,0.0705109052883179,752,0.224678816850911,2595,0.775321183149089
"W02000042",8,102,593,1174,430,70,8,2385,0.00335429769392034,0.0427672955974843,0.248637316561845,0.492243186582809,0.180293501048218,0.0293501048218029,0.00335429769392034,703,0.294758909853249,1682,0.705241090146751
"W02000043",10,138,509,874,380,79,25,2015,0.00496277915632754,0.0684863523573201,0.252605459057072,0.433746898263027,0.188585607940447,0.0392059553349876,0.0124069478908189,657,0.32605459057072,1358,0.67394540942928
"W02000044",4,81,457,978,354,65,8,1947,0.00205444273240883,0.0416024653312789,0.234720082177709,0.50231124807396,0.181818181818182,0.0333846944016436,0.00410888546481767,542,0.278376990241397,1405,0.721623009758603
"W02000045",18,274,1259,2029,1032,220,104,4936,0.00364667747163695,0.0555105348460292,0.255064829821718,0.411061588330632,0.209076175040519,0.0445705024311183,0.0210696920583468,1551,0.314222042139384,3385,0.685777957860616
"W02000047",15,124,600,805,267,48,20,1879,0.00798296966471527,0.0659925492283129,0.319318786588611,0.428419372006386,0.142096860031932,0.0255455029270889,0.0106439595529537,739,0.393294305481639,1140,0.606705694518361
"W02000049",110,145,543,615,638,301,137,2489,0.0441944556046605,0.058256327842507,0.218159903575733,0.247087183607875,0.256327842507031,0.12093210124548,0.0550421856167135,798,0.320610687022901,1691,0.679389312977099
"W02000050",3,177,580,1014,328,82,28,2212,0.00135623869801085,0.0800180831826401,0.262206148282098,0.458408679927667,0.148282097649186,0.0370705244122966,0.0126582278481013,760,0.343580470162749,1452,0.656419529837251
"W02000051",20,310,577,767,306,99,44,2123,0.00942063118228921,0.146019783325483,0.271785209609044,0.361281205840791,0.144135657089025,0.0466321243523316,0.0207253886010363,907,0.427225624116816,1216,0.572774375883184
"W02000052",83,164,579,945,463,130,65,2429,0.0341704405104981,0.0675174969123096,0.2383696994648,0.389048991354467,0.190613421160972,0.0535199670646357,0.0267599835323178,826,0.340057636887608,1603,0.659942363112392
"W02000053",8,231,478,734,380,141,72,2044,0.00391389432485323,0.113013698630137,0.23385518590998,0.359099804305284,0.185909980430528,0.0689823874755382,0.0352250489236791,717,0.350782778864971,1327,0.649217221135029
"W02000054",53,109,273,522,538,299,120,1914,0.0276907001044932,0.0569487983281087,0.142633228840125,0.272727272727273,0.281086729362591,0.156217345872518,0.0626959247648903,435,0.227272727272727,1479,0.772727272727273
"W02000055",75,211,723,815,361,84,28,2297,0.0326512842838485,0.0918589464518938,0.3147583804963,0.354810622551154,0.157161515019591,0.0365694383979103,0.0121898127993034,1009,0.439268611232042,1288,0.560731388767958
"W02000056",10,113,267,461,487,284,129,1751,0.00571102227298686,0.0645345516847516,0.152484294688749,0.263278126784694,0.27812678469446,0.162193032552827,0.0736721873215306,390,0.222729868646488,1361,0.777270131353512
"W02000057",11,243,584,722,529,229,128,2446,0.0044971381847915,0.0993458708094849,0.238757154538021,0.295175797219951,0.216271463614064,0.0936222403924775,0.0523303352412101,838,0.342600163532298,1608,0.657399836467702
"W02000058",34,155,437,647,450,241,129,2093,0.0162446249402771,0.0740563784042045,0.208791208791209,0.309125656951744,0.215002388915432,0.115145723841376,0.0616340181557573,626,0.29909221213569,1467,0.70090778786431
"W02000059",64,228,592,954,394,171,70,2473,0.0258794985847149,0.0921957137080469,0.239385361908613,0.385766275778407,0.159320663162151,0.0691467852810352,0.0283057015770319,884,0.357460574201375,1589,0.642539425798625
"W02000060",28,382,1505,1543,446,102,37,4043,0.00692555033391046,0.094484293841207,0.372248330447687,0.381647291615137,0.11031412317586,0.0252287905021024,0.00915162008409597,1915,0.473658174622805,2128,0.526341825377195
"W02000061",10,846,1112,971,288,40,13,3280,0.00304878048780488,0.257926829268293,0.339024390243902,0.296036585365854,0.0878048780487805,0.0121951219512195,0.00396341463414634,1968,0.6,1312,0.4
"W02000062",3,57,483,731,218,33,10,1535,0.00195439739413681,0.0371335504885993,0.314657980456026,0.476221498371335,0.142019543973941,0.0214983713355049,0.00651465798045603,543,0.353745928338762,992,0.646254071661238
"W02000063",34,196,377,769,677,384,141,2578,0.013188518231187,0.0760279286268425,0.146237393328161,0.298293250581846,0.262606671838635,0.148952676493406,0.0546935608999224,607,0.235453840186191,1971,0.764546159813809
"W02000064",28,226,988,864,257,44,17,2424,0.0115511551155116,0.0932343234323432,0.407590759075908,0.356435643564356,0.106023102310231,0.0181518151815182,0.00701320132013201,1242,0.512376237623762,1182,0.487623762376238
"W02000065",12,114,757,974,262,33,10,2162,0.00555041628122109,0.0527289546716004,0.350138760407031,0.450508788159112,0.12118408880666,0.015263644773358,0.00462534690101758,883,0.408418131359852,1279,0.591581868640148
"W02000066",125,737,1263,1422,501,113,45,4206,0.0297194484070376,0.175225867807893,0.300285306704708,0.338088445078459,0.119115549215407,0.026866381359962,0.0106990014265335,2125,0.505230622919639,2081,0.494769377080361
"W02000067",4,179,595,733,196,49,18,1774,0.00225479143179256,0.100901916572717,0.335400225479143,0.413190529875986,0.110484780157835,0.0276211950394589,0.0101465614430665,778,0.438556933483653,996,0.561443066516347
"W02000068",15,163,565,742,251,48,25,1809,0.00829187396351575,0.0901050304035379,0.31232725262576,0.410171365395246,0.138750690989497,0.0265339966832504,0.0138197899391929,743,0.410724156992814,1066,0.589275843007186
"W02000069",5,336,601,766,232,67,14,2021,0.0024740227610094,0.166254329539832,0.29737753587333,0.37902028698664,0.114794656110836,0.033151904997526,0.00692726373082632,942,0.466105888174171,1079,0.533894111825829
"W02000070",4,375,1092,1322,350,72,23,3238,0.00123533045089561,0.115812229771464,0.337245213094503,0.408276714021001,0.108091414453366,0.0222359481161211,0.00710315009264978,1471,0.454292773316862,1767,0.545707226683138
"W02000071",1,188,499,949,239,35,8,1919,0.000521104742053153,0.0979676915059927,0.260031266284523,0.494528400208442,0.124544033350703,0.0182386659718603,0.00416883793642522,688,0.358520062532569,1231,0.641479937467431
"W02000072",7,601,1607,1457,339,50,10,4071,0.00171947924342913,0.147629575042987,0.394743306312945,0.357897322525178,0.0832719233603537,0.0122819945959224,0.00245639891918448,2215,0.544092360599361,1856,0.455907639400639
"W02000073",1,624,1278,1400,368,51,22,3744,0.000267094017094017,0.166666666666667,0.341346153846154,0.373931623931624,0.0982905982905983,0.0136217948717949,0.00587606837606838,1903,0.508279914529915,1841,0.491720085470085
"W02000074",16,635,1275,1308,379,54,13,3680,0.00434782608695652,0.172554347826087,0.346467391304348,0.355434782608696,0.102989130434783,0.0146739130434783,0.00353260869565217,1926,0.523369565217391,1754,0.476630434782609
"W02000075",5,781,444,651,195,42,21,2139,0.00233754090696587,0.365123889668069,0.207573632538569,0.304347826086957,0.091164095371669,0.0196353436185133,0.00981767180925666,1230,0.575035063113605,909,0.424964936886396
"W02000076",50,167,479,867,555,212,83,2413,0.0207210940737671,0.0692084542063821,0.198508081226689,0.359303771239121,0.230004144218815,0.0878574388727725,0.0343970161624534,696,0.288437629506838,1717,0.711562370493162
"W02000077",14,125,489,644,356,125,49,1802,0.00776914539400666,0.0693673695893452,0.271365149833518,0.357380688124306,0.197558268590455,0.0693673695893452,0.0271920088790233,628,0.34850166481687,1174,0.65149833518313
"W02000080",56,288,1037,994,226,38,11,2650,0.0211320754716981,0.108679245283019,0.391320754716981,0.375094339622641,0.0852830188679245,0.0143396226415094,0.00415094339622642,1381,0.521132075471698,1269,0.478867924528302
"W02000081",1,150,682,730,162,35,11,1771,0.000564652738565782,0.0846979107848673,0.385093167701863,0.412196499153021,0.0914737436476567,0.0197628458498024,0.0062111801242236,833,0.470355731225296,938,0.529644268774703
"W02000082",1,248,1018,1091,292,39,10,2699,0.000370507595405706,0.091885883660615,0.377176732123009,0.404223786587625,0.108188217858466,0.0144497962208225,0.00370507595405706,1267,0.469433123379029,1432,0.530566876620971
"W02000083",4,421,1278,984,286,68,28,3069,0.00130335614206582,0.137178233952428,0.416422287390029,0.320625610948192,0.0931899641577061,0.0221570544151189,0.00912349299446074,1703,0.554903877484523,1366,0.445096122515477
"W02000085",2,280,965,1392,491,69,10,3209,0.000623247117482082,0.0872545964474914,0.300716734185104,0.433779993767529,0.153007167341851,0.0215020255531318,0.00311623558741041,1247,0.388594577750078,1962,0.611405422249922
"W02000087",5,144,1435,682,70,11,3,2350,0.00212765957446809,0.0612765957446808,0.61063829787234,0.290212765957447,0.0297872340425532,0.00468085106382979,0.00127659574468085,1584,0.674042553191489,766,0.325957446808511
"W02000088",3,332,1291,1392,451,52,19,3540,0.000847457627118644,0.0937853107344633,0.364689265536723,0.393220338983051,0.127401129943503,0.0146892655367232,0.00536723163841808,1626,0.459322033898305,1914,0.540677966101695
"W02000089",41,348,1637,1149,341,41,9,3566,0.0114974761637689,0.0975883342680875,0.459057767807067,0.322209758833427,0.0956253505328099,0.0114974761637689,0.00252383623107123,2026,0.568143578238923,1540,0.431856421761077
"W02000090",3,59,553,601,239,125,42,1622,0.00184956843403206,0.0363748458692972,0.340937114673243,0.370530209617756,0.147348951911221,0.0770653514180025,0.0258939580764488,615,0.379161528976572,1007,0.620838471023428
"W02000091",0,162,568,757,287,56,15,1845,0,0.0878048780487805,0.307859078590786,0.41029810298103,0.155555555555556,0.0303523035230352,0.00813008130081301,730,0.395663956639566,1115,0.604336043360434
"W02000092",4,174,906,930,391,61,21,2487,0.00160836349014877,0.0699638118214717,0.364294330518697,0.37394451145959,0.157217531162043,0.0245275432247688,0.00844390832328106,1084,0.435866505830318,1403,0.564133494169682
"W02000093",3,135,694,753,318,84,52,2039,0.00147130946542423,0.0662089259440902,0.340362923001471,0.369298675821481,0.155958803334968,0.0411966650318784,0.0255026974006866,832,0.408043158410986,1207,0.591956841589014
"W02000094",18,358,1073,1039,425,100,48,3061,0.00588043123162365,0.116955243384515,0.350539039529565,0.339431558314276,0.138843515191114,0.0326690623979092,0.0156811499509964,1449,0.473374714145704,1612,0.526625285854296
"W02000095",7,81,433,719,476,181,83,1980,0.00353535353535354,0.0409090909090909,0.218686868686869,0.363131313131313,0.24040404040404,0.0914141414141414,0.0419191919191919,521,0.263131313131313,1459,0.736868686868687
"W02000096",12,73,600,715,457,215,72,2144,0.00559701492537313,0.0340485074626866,0.279850746268657,0.333488805970149,0.213152985074627,0.100279850746269,0.0335820895522388,685,0.319496268656716,1459,0.680503731343284
"W02000097",62,136,487,915,789,458,257,3104,0.0199742268041237,0.0438144329896907,0.156894329896907,0.294780927835052,0.254188144329897,0.147551546391753,0.0827963917525773,685,0.220682989690722,2419,0.779317010309278
"W02000098",12,152,415,749,450,183,89,2050,0.00585365853658537,0.0741463414634146,0.202439024390244,0.365365853658537,0.219512195121951,0.0892682926829268,0.0434146341463415,579,0.282439024390244,1471,0.717560975609756
"W02000099",56,236,1066,946,330,98,46,2778,0.0201583873290137,0.0849532037437005,0.383729301655868,0.34053275737941,0.118790496760259,0.0352771778257739,0.0165586753059755,1358,0.488840892728582,1420,0.511159107271418
"W02000100",24,90,504,571,509,317,188,2203,0.0108942351339083,0.0408533817521562,0.228778937812074,0.259192010894235,0.231048570131639,0.143894689060372,0.0853381752156151,618,0.280526554698139,1585,0.719473445301861
"W02000101",45,66,283,663,428,239,138,1862,0.0241675617615467,0.0354457572502685,0.151987110633727,0.356068743286788,0.229860365198711,0.128356605800215,0.0741138560687433,394,0.211600429645542,1468,0.788399570354458
"W02000102",20,97,444,661,441,241,134,2038,0.0098135426889107,0.0475956820412169,0.217860647693817,0.324337585868499,0.216388616290481,0.118253189401374,0.0657507360157017,561,0.275269872423945,1477,0.724730127576055
"W02000103",52,178,336,581,385,243,125,1900,0.0273684210526316,0.0936842105263158,0.176842105263158,0.30578947368421,0.202631578947368,0.127894736842105,0.0657894736842105,566,0.297894736842105,1334,0.702105263157895
"W02000104",45,264,1114,856,325,91,34,2729,0.0164895566141444,0.0967387321363137,0.40820813484793,0.313668010260169,0.119091242213265,0.0333455478197142,0.0124587761084646,1423,0.521436423598388,1306,0.478563576401612
"W02000105",18,99,1120,755,150,21,1,2164,0.00831792975970425,0.0457486136783734,0.517560073937153,0.348890942698706,0.0693160813308688,0.00970425138632163,0.000462107208872458,1237,0.571626617375231,927,0.428373382624769
"W02000106",77,161,535,777,451,249,155,2405,0.032016632016632,0.0669438669438669,0.222453222453222,0.323076923076923,0.187525987525988,0.103534303534304,0.0644490644490645,773,0.321413721413721,1632,0.678586278586279
"W02000107",20,147,839,1272,828,365,162,3633,0.00550509221029452,0.0404624277456647,0.230938618221855,0.350123864574732,0.227910817506193,0.100467932837875,0.0445912469033856,1006,0.276906138177814,2627,0.723093861822185
"W02000108",20,85,532,874,547,263,108,2429,0.00823384108686702,0.0349938246191848,0.219020172910663,0.359818855496089,0.225195553725813,0.108275010292301,0.0444627418690819,637,0.262247838616715,1792,0.737752161383285
"W02000109",37,208,1104,927,378,51,27,2732,0.0135431918008785,0.0761346998535871,0.404099560761347,0.339311859443631,0.138360175695461,0.0186676427525622,0.00988286969253294,1349,0.493777452415813,1383,0.506222547584187
"W02000110",30,133,490,812,606,310,146,2527,0.0118717847249703,0.0526315789473684,0.193905817174515,0.321329639889197,0.2398100514444,0.122675108824693,0.0577760189948556,653,0.258409180846854,1874,0.741590819153146
"W02000111",15,264,700,992,695,282,131,3079,0.0048717115946736,0.0857421240662553,0.227346541084768,0.322182526794414,0.225722637219877,0.0915881779798636,0.0425462812601494,979,0.317960376745697,2100,0.682039623254303
"W02000113",6,326,1073,1466,377,95,36,3379,0.00177567327611719,0.0964782480023676,0.317549570878958,0.433856170464634,0.111571470849364,0.0281148268718556,0.0106540396567032,1405,0.415803492157443,1974,0.584196507842557
"W02000114",12,177,495,865,493,177,61,2280,0.00526315789473684,0.0776315789473684,0.217105263157895,0.379385964912281,0.216228070175439,0.0776315789473684,0.0267543859649123,684,0.3,1596,0.7
"W02000116",35,155,422,800,697,318,135,2562,0.0136612021857923,0.0604996096799375,0.164715066354411,0.312256049960968,0.272053083528493,0.124121779859485,0.0526932084309134,612,0.238875878220141,1950,0.76112412177986
"W02000117",6,171,1153,1409,642,125,53,3559,0.00168586681652149,0.0480472042708626,0.323967406574881,0.395897724079798,0.1803877493678,0.0351222253441978,0.0148918235459399,1330,0.373700477662265,2229,0.626299522337735
"W02000118",25,265,1229,776,244,69,29,2637,0.00948047023132347,0.100492984452029,0.466059916571862,0.294273795980281,0.0925293894577171,0.0261660978384528,0.0109973454683352,1519,0.576033371255214,1118,0.423966628744786
"W02000120",23,175,433,748,855,331,134,2699,0.00852167469433123,0.0648388291959985,0.160429788810671,0.277139681363468,0.316783994071878,0.122638014079289,0.0496480177843646,631,0.233790292701,2068,0.766209707299
"W02000122",28,182,325,722,827,403,161,2648,0.0105740181268882,0.0687311178247734,0.12273413897281,0.272658610271903,0.312311178247734,0.152190332326284,0.0608006042296073,535,0.202039274924471,2113,0.797960725075529
"W02000123",24,182,624,789,705,332,136,2792,0.00859598853868195,0.0651862464183381,0.223495702005731,0.282593123209169,0.252507163323782,0.1189111747851,0.0487106017191977,830,0.297277936962751,1962,0.702722063037249
"W02000124",50,378,1000,1494,891,307,132,4252,0.0117591721542803,0.0888993414863594,0.235183443085607,0.351364063969897,0.209548447789276,0.0722013170272813,0.0310442144873001,1428,0.335841956726246,2824,0.664158043273753
"W02000125",24,215,429,731,854,454,306,3013,0.00796548290740126,0.0713574510454696,0.142383006969798,0.242615333554597,0.283438433455028,0.150680384998341,0.101559907069366,668,0.221705940922668,2345,0.778294059077332
"W02000126",76,199,315,783,852,488,241,2954,0.025727826675694,0.0673662830060934,0.106635071090047,0.265064319566689,0.288422477995938,0.165199729180772,0.0815842924847664,590,0.199729180771835,2364,0.800270819228165
"W02000127",40,217,844,1305,806,318,147,3677,0.0108784335055752,0.0590155017677454,0.229534946967637,0.354908893119391,0.21920043513734,0.0864835463693228,0.0399782431329889,1101,0.299428882240957,2576,0.700571117759043
"W02000128",49,191,447,843,692,345,131,2698,0.0181616011860638,0.0707931801334322,0.165678280207561,0.312453669384729,0.25648628613788,0.127872498146775,0.0485544848035582,687,0.254633061527057,2011,0.745366938472943
"W02000129",32,293,330,621,604,263,105,2248,0.0142348754448399,0.130338078291815,0.146797153024911,0.276245551601424,0.268683274021352,0.116992882562278,0.0467081850533808,655,0.291370106761566,1593,0.708629893238434
"W02000130",4,112,1078,1065,421,87,20,2787,0.00143523501973448,0.0401865805525655,0.386795837818443,0.382131324004306,0.151058485827054,0.031216361679225,0.00717617509867241,1194,0.428417653390743,1593,0.571582346609257
"W02000131",46,373,844,1027,327,62,23,2702,0.0170244263508512,0.138045891931902,0.312361213915618,0.380088823094004,0.121021465581051,0.0229459659511473,0.00851221317542561,1263,0.467431532198372,1439,0.532568467801628
"W02000132",26,425,588,752,554,234,103,2682,0.00969425801640567,0.158463832960477,0.21923937360179,0.280387770320656,0.206562266964952,0.087248322147651,0.0384041759880686,1039,0.387397464578673,1643,0.612602535421327
"W02000133",48,295,607,957,765,347,157,3176,0.0151133501259446,0.0928841309823678,0.191120906801008,0.30132241813602,0.240869017632242,0.109256926952141,0.0494332493702771,950,0.29911838790932,2226,0.70088161209068
"W02000134",60,164,650,1132,559,226,72,2863,0.0209570380719525,0.0572825707300035,0.227034579112819,0.39538945162417,0.195249738037024,0.0789381767376877,0.025148445686343,874,0.305274187914775,1989,0.694725812085225
"W02000135",103,277,1089,906,399,79,27,2880,0.0357638888888889,0.0961805555555556,0.378125,0.314583333333333,0.138541666666667,0.0274305555555556,0.009375,1469,0.510069444444444,1411,0.489930555555556
"W02000136",25,322,801,1237,740,293,94,3512,0.00711845102505695,0.0916856492027335,0.228075170842825,0.352220956719818,0.210706150341686,0.0834282460136674,0.0267653758542141,1148,0.326879271070615,2364,0.673120728929385
"W02000137",9,368,890,1071,357,83,34,2812,0.00320056899004267,0.130867709815078,0.316500711237553,0.380867709815078,0.126955903271693,0.0295163584637269,0.0120910384068279,1267,0.450568990042674,1545,0.549431009957326
"W02000138",61,288,1435,1577,508,108,32,4009,0.0152157645298079,0.0718383636817161,0.357944624594662,0.393364928909953,0.126714891494138,0.0269393863806436,0.00798204040907957,1784,0.444998752806186,2225,0.555001247193814
"W02000139",22,381,658,1031,597,276,102,3067,0.0071731333550701,0.124225627649169,0.214541897619824,0.336159113139876,0.194652755135311,0.0899902184545158,0.0332572546462341,1061,0.345940658624063,2006,0.654059341375937
"W02000140",51,242,943,882,390,152,69,2729,0.018688164162697,0.0886771711249542,0.345547819714181,0.32319530963723,0.142909490655918,0.0556980578966654,0.0252839868083547,1236,0.452913155001832,1493,0.547086844998168
"W02000141",9,265,888,1143,497,149,57,3008,0.00299202127659574,0.0880984042553191,0.295212765957447,0.37998670212766,0.165226063829787,0.0495345744680851,0.0189494680851064,1162,0.386303191489362,1846,0.613696808510638
"W02000142",14,99,332,621,534,283,127,2010,0.00696517412935323,0.0492537313432836,0.165174129353234,0.308955223880597,0.265671641791045,0.140796019900498,0.06318407960199,445,0.221393034825871,1565,0.778606965174129
"W02000143",11,41,279,615,478,271,144,1839,0.00598151169113649,0.022294725394236,0.151712887438825,0.33442088091354,0.259923871669386,0.147362697117999,0.0783034257748776,331,0.179989124524198,1508,0.820010875475802
"W02000144",39,103,291,808,844,476,260,2821,0.0138248847926267,0.0365118752215526,0.103154909606523,0.28642325416519,0.29918468628146,0.168734491315136,0.0921658986175115,433,0.153491669620702,2388,0.846508330379298
"W02000145",31,84,492,823,643,321,144,2538,0.012214342001576,0.033096926713948,0.193853427895981,0.324271079590229,0.253349093774626,0.126477541371158,0.0567375886524823,607,0.239164696611505,1931,0.760835303388495
"W02000146",23,110,256,662,584,340,164,2139,0.010752688172043,0.0514258999532492,0.119682094436653,0.309490416082281,0.273024777933614,0.158952781673679,0.0766713417484806,389,0.181860682561945,1750,0.818139317438055
"W02000147",31,443,875,935,489,222,85,3080,0.0100649350649351,0.143831168831169,0.284090909090909,0.303571428571429,0.158766233766234,0.0720779220779221,0.0275974025974026,1349,0.437987012987013,1731,0.562012987012987
"W02000148",15,85,736,860,304,69,18,2087,0.00718735026353618,0.0407283181600383,0.352659319597508,0.412074748442741,0.145663632007666,0.0330618112122664,0.00862482031624341,836,0.400574988021083,1251,0.599425011978917
"W02000149",24,287,887,1042,455,114,48,2857,0.00840042002100105,0.100455022751138,0.310465523276164,0.364718235911796,0.159257962898145,0.039901995099755,0.0168008400420021,1198,0.419320966048302,1659,0.580679033951698
"W02000151",9,94,626,1117,720,328,112,3006,0.0029940119760479,0.0312707917498337,0.208250166333999,0.371590153027279,0.239520958083832,0.109115103127079,0.0372588157019295,729,0.24251497005988,2277,0.75748502994012
"W02000152",72,263,945,1027,504,179,59,3049,0.0236142997704165,0.0862577894391604,0.309937684486717,0.336831748114136,0.165300098392916,0.0587077730403411,0.0193506067563135,1280,0.419809773696294,1769,0.580190226303706
"W02000153",55,584,378,837,628,359,189,3030,0.0181518151815182,0.192739273927393,0.124752475247525,0.276237623762376,0.207260726072607,0.118481848184818,0.0623762376237624,1017,0.335643564356436,2013,0.664356435643564
"W02000154",20,224,825,1118,488,117,24,2816,0.00710227272727273,0.0795454545454545,0.29296875,0.397017045454545,0.173295454545455,0.0415482954545455,0.00852272727272727,1069,0.379616477272727,1747,0.620383522727273
"W02000156",31,238,454,873,818,361,106,2881,0.0107601527247484,0.0826102047900035,0.157584172162444,0.303019784796946,0.283929191253037,0.125303713988199,0.0367927802846234,723,0.250954529677195,2158,0.749045470322805
"W02000157",36,515,736,1062,670,283,82,3384,0.0106382978723404,0.152186761229314,0.217494089834515,0.313829787234043,0.197990543735225,0.083628841607565,0.0242316784869976,1287,0.38031914893617,2097,0.61968085106383
"W02000158",14,253,531,734,261,74,25,1892,0.00739957716701903,0.133720930232558,0.280655391120507,0.387949260042283,0.137949260042283,0.0391120507399577,0.0132135306553911,798,0.421775898520085,1094,0.578224101479915
"W02000159",29,171,609,742,355,112,49,2067,0.0140299951620706,0.0827285921625544,0.294629898403483,0.358974358974359,0.171746492501209,0.05418480890179,0.0237058538945331,809,0.391388485728108,1258,0.608611514271892
"W02000160",10,191,647,937,338,60,25,2208,0.00452898550724638,0.0865036231884058,0.293025362318841,0.424365942028986,0.153079710144928,0.0271739130434783,0.0113224637681159,848,0.384057971014493,1360,0.615942028985507
"W02000161",3,36,493,710,254,47,8,1551,0.00193423597678917,0.02321083172147,0.31785944551902,0.457769181173437,0.163765312701483,0.0303030303030303,0.00515796260477112,532,0.343004513217279,1019,0.656995486782721
"W02000162",77,321,811,1137,473,119,39,2977,0.0258649647295935,0.107826671145448,0.272421901242862,0.38192811555257,0.158884783338932,0.0399731273093719,0.0131004366812227,1209,0.406113537117904,1768,0.593886462882096
"W02000163",1,48,437,883,432,74,19,1894,0.000527983104540655,0.0253431890179514,0.230728616684266,0.466209081309398,0.228088701161563,0.0390707497360085,0.0100316789862724,486,0.256599788806758,1408,0.743400211193242
"W02000164",5,220,620,1002,528,142,40,2557,0.00195541650371529,0.0860383261634728,0.242471646460696,0.391865467344544,0.206491982792335,0.0555338287055143,0.0156433320297223,845,0.330465389127884,1712,0.669534610872116
"W02000165",1,65,653,962,415,65,19,2180,0.000458715596330275,0.0298165137614679,0.29954128440367,0.441284403669725,0.190366972477064,0.0298165137614679,0.00871559633027523,719,0.329816513761468,1461,0.670183486238532
"W02000166",82,408,922,964,342,78,16,2812,0.0291607396870555,0.145092460881935,0.327880512091038,0.342816500711238,0.121621621621622,0.0277382645803698,0.00568990042674253,1412,0.502133712660028,1400,0.497866287339972
"W02000167",4,596,1491,1727,694,106,25,4643,0.000861511953478355,0.128365281068275,0.321128580659057,0.37195778591428,0.149472323928495,0.0228300667671764,0.00538444970923972,2091,0.45035537368081,2552,0.54964462631919
"W02000168",6,268,769,739,368,95,30,2275,0.00263736263736264,0.117802197802198,0.338021978021978,0.324835164835165,0.161758241758242,0.0417582417582418,0.0131868131868132,1043,0.458461538461538,1232,0.541538461538462
"W02000169",9,125,802,1159,561,194,80,2930,0.00307167235494881,0.0426621160409556,0.273720136518771,0.395563139931741,0.191467576791809,0.0662116040955631,0.0273037542662116,936,0.319453924914676,1994,0.680546075085324
"W02000170",2,346,897,1086,367,66,11,2775,0.000720720720720721,0.124684684684685,0.323243243243243,0.391351351351351,0.132252252252252,0.0237837837837838,0.00396396396396396,1245,0.448648648648649,1530,0.551351351351351
"W02000171",40,309,1133,921,245,48,19,2715,0.0147329650092081,0.113812154696133,0.41731123388582,0.339226519337017,0.0902394106813996,0.0176795580110497,0.00699815837937385,1482,0.54585635359116,1233,0.45414364640884
"W02000172",114,479,1143,1328,437,103,17,3621,0.0314830157415079,0.132283899475283,0.315658657829329,0.366749516708092,0.12068489367578,0.0284451808892571,0.00469483568075117,1736,0.47942557304612,1885,0.52057442695388
"W02000173",23,305,1028,766,234,42,6,2404,0.00956738768718802,0.126871880199667,0.427620632279534,0.318635607321131,0.0973377703826955,0.0174708818635607,0.00249584026622296,1356,0.564059900166389,1048,0.435940099833611
"W02000174",18,453,782,1065,444,91,16,2869,0.00627396305332869,0.157894736842105,0.272568839316835,0.371209480655281,0.154757755315441,0.0317183687696061,0.00557685604740328,1253,0.436737539212269,1616,0.563262460787731
"W02000175",10,77,860,1299,588,117,28,2979,0.00335683115139308,0.0258475998657268,0.288687479019805,0.436052366565962,0.197381671701913,0.0392749244712991,0.00939912722390064,947,0.317891910036925,2032,0.682108089963075
"W02000176",36,100,907,1215,442,69,19,2788,0.0129124820659971,0.0358680057388809,0.32532281205165,0.435796269727403,0.158536585365854,0.0247489239598278,0.00681492109038737,1043,0.374103299856528,1745,0.625896700143472
"W02000177",34,113,904,831,299,44,12,2237,0.0151989271345552,0.0505140813589629,0.404112650871703,0.371479660259276,0.133661153330353,0.0196691998211891,0.00536432722396066,1051,0.469825659365221,1186,0.530174340634779
"W02000178",25,165,1601,1183,283,37,5,3299,0.00757805395574416,0.0500151561079115,0.485298575325856,0.358593513185814,0.0857835707790239,0.0112155198545014,0.00151561079114883,1791,0.542891785389512,1508,0.457108214610488
"W02000179",1,202,681,800,245,57,6,1992,0.000502008032128514,0.10140562248996,0.341867469879518,0.401606425702811,0.122991967871486,0.0286144578313253,0.00301204819277108,884,0.443775100401606,1108,0.556224899598394
"W02000180",2,30,1105,1101,375,68,6,2687,0.000744324525493115,0.0111648678823967,0.411239300334946,0.40975065128396,0.139560848529959,0.0253070338667659,0.00223297357647934,1137,0.423148492742836,1550,0.576851507257164
"W02000181",3,572,1116,919,336,44,8,2998,0.00100066711140761,0.19079386257505,0.372248165443629,0.30653769179453,0.112074716477652,0.0146764509673115,0.00266844563042028,1691,0.564042695130087,1307,0.435957304869913
"W02000182",1,82,554,1285,576,95,13,2606,0.000383729854182655,0.0314658480429777,0.212586339217191,0.493092862624712,0.22102839600921,0.0364543361473523,0.00498848810437452,637,0.244435917114351,1969,0.755564082885648
"W02000183",0,402,1246,1848,716,106,30,4348,0,0.0924563017479301,0.28656853725851,0.425022999080037,0.164673413063477,0.0243790248390064,0.00689972401103956,1648,0.37902483900644,2700,0.62097516099356
"W02000184",2,84,936,945,368,49,10,2394,0.000835421888053467,0.0350877192982456,0.390977443609023,0.394736842105263,0.153717627401838,0.0204678362573099,0.00417710944026733,1022,0.426900584795322,1372,0.573099415204678
"W02000185",6,75,364,651,291,100,19,1506,0.00398406374501992,0.049800796812749,0.241699867197875,0.432270916334661,0.193227091633466,0.0664010624169987,0.0126162018592297,445,0.295484727755644,1061,0.704515272244356
"W02000186",1,51,1311,1471,548,49,10,3441,0.000290613193839,0.014821272885789,0.380993897122929,0.427492008137169,0.159256030223772,0.014240046498111,0.00290613193839,1363,0.396105783202557,2078,0.603894216797443
"W02000188",1,755,921,1212,570,77,17,3553,0.000281452293836195,0.212496481846327,0.259217562623135,0.341120180129468,0.160427807486631,0.021671826625387,0.00478468899521531,1677,0.471995496763299,1876,0.528004503236701
"W02000189",2,435,1088,1242,366,71,9,3213,0.000622471210706505,0.135387488328665,0.338624338624339,0.38655462184874,0.11391223155929,0.0220977279800809,0.00280112044817927,1525,0.47463429816371,1688,0.52536570183629
"W02000191",4,97,885,1792,778,120,29,3705,0.00107962213225371,0.0261808367071525,0.238866396761134,0.483670715249663,0.209986504723347,0.0323886639676113,0.00782726045883941,986,0.26612685560054,2719,0.73387314439946
"W02000192",1,1460,2747,1799,673,92,23,6795,0.000147167034584253,0.21486387049301,0.404267844002943,0.264753495217071,0.0990434142752024,0.0135393671817513,0.00338484179543782,4208,0.619278881530537,2587,0.380721118469463
"W02000193",3,184,1054,1903,782,127,39,4092,0.000733137829912023,0.0449657869012708,0.257575757575758,0.46505376344086,0.191104594330401,0.0310361681329423,0.00953079178885631,1241,0.30327468230694,2851,0.69672531769306
"W02000194",4,110,472,859,395,81,11,1932,0.0020703933747412,0.056935817805383,0.244306418219462,0.444616977225673,0.204451345755694,0.0419254658385093,0.0056935817805383,586,0.303312629399586,1346,0.696687370600414
"W02000195",1,135,566,814,302,96,33,1947,0.000513610683102209,0.0693374422187981,0.29070364663585,0.418079096045198,0.155110426296867,0.049306625577812,0.0169491525423729,702,0.36055469953775,1245,0.63944530046225
"W02000196",7,65,790,1075,366,73,6,2382,0.00293870696893367,0.0272879932829555,0.331654072208228,0.451301427371956,0.153652392947103,0.0306465155331654,0.00251889168765743,862,0.361880772460118,1520,0.638119227539882
"W02000197",13,174,325,682,541,282,119,2136,0.00608614232209738,0.0814606741573034,0.152153558052434,0.319288389513109,0.253277153558052,0.132022471910112,0.0557116104868914,512,0.239700374531835,1624,0.760299625468165
"W02000198",3,285,705,1276,645,181,47,3142,0.000954805856142584,0.0907065563335455,0.224379376193507,0.406110757479313,0.205283259070656,0.0576066199872693,0.0149586250795672,993,0.316040738383195,2149,0.683959261616805
"W02000200",8,68,562,691,337,122,34,1822,0.00439077936333699,0.0373216245883644,0.308452250274424,0.379253567508233,0.184961580680571,0.0669593852908891,0.0186608122941822,638,0.350164654226125,1184,0.649835345773875
"W02000201",10,43,652,701,281,83,17,1787,0.00559597090095131,0.0240626748740907,0.364857302742026,0.392277560156687,0.157246782316732,0.0464465584778959,0.00951315053161724,705,0.394515948517068,1082,0.605484051482932
"W02000202",4,496,1289,1348,666,161,37,4001,0.000999750062484379,0.123969007748063,0.322169457635591,0.336915771057236,0.166458385403649,0.0402399400149962,0.0092476880779805,1789,0.447138215446138,2212,0.552861784553861
"W02000204",13,55,671,820,213,36,5,1813,0.00717043574186431,0.0303364589078875,0.370104798676227,0.452289023717595,0.117484831770546,0.0198565912851627,0.00275785990071704,739,0.407611693325979,1074,0.592388306674021
"W02000205",3,127,701,715,218,35,8,1807,0.00166021029330382,0.0702822357498616,0.387935805201992,0.39568345323741,0.120641947980077,0.0193691200885446,0.00442722744881018,831,0.459878251245158,976,0.540121748754842
"W02000206",27,136,1135,1215,588,124,26,3251,0.0083051368809597,0.0418332820670563,0.349123346662565,0.373731159643187,0.180867425407567,0.0381421101199631,0.00799753921870194,1298,0.399261765610581,1953,0.600738234389419
"W02000207",1,157,401,582,160,26,5,1332,0.000750750750750751,0.117867867867868,0.301051051051051,0.436936936936937,0.12012012012012,0.0195195195195195,0.00375375375375375,559,0.41966966966967,773,0.58033033033033
"W02000208",30,755,1120,1235,457,86,24,3707,0.00809279741030483,0.203668734826005,0.302131103318047,0.333153493390882,0.12328028055031,0.0231993525762072,0.00647423792824386,1905,0.513892635554357,1802,0.486107364445643
"W02000210",82,71,960,755,247,47,6,2168,0.0378228782287823,0.0327490774907749,0.44280442804428,0.348247232472325,0.113929889298893,0.0216789667896679,0.00276752767527675,1113,0.513376383763838,1055,0.486623616236162
"W02000211",57,132,1179,1298,514,97,18,3295,0.017298937784522,0.0400606980273141,0.357814871016692,0.393930197268589,0.155993930197269,0.0294385432473445,0.00546282245827011,1368,0.415174506828528,1927,0.584825493171472
"W02000212",3,113,1144,932,322,65,15,2594,0.00115651503469545,0.043562066306862,0.441017733230532,0.35929067077872,0.124132613723978,0.0250578257517348,0.00578257517347725,1260,0.485736314572089,1334,0.514263685427911
"W02000213",0,46,624,946,291,65,9,1981,0,0.0232205956587582,0.314992428066633,0.47753659767794,0.146895507319536,0.0328117112569409,0.00454316002019182,670,0.338213023725391,1311,0.661786976274609
"W02000214",3,160,1890,1043,222,21,7,3346,0.000896592946802152,0.0478182904961148,0.564853556485356,0.311715481171548,0.0663478780633592,0.00627615062761506,0.00209205020920502,2053,0.613568439928273,1293,0.386431560071727
"W02000215",95,408,1821,1477,516,71,19,4407,0.0215566144769685,0.0925799863852961,0.413206262763785,0.335148627184025,0.117086453369639,0.0161107329248922,0.00431132289539369,2324,0.52734286362605,2083,0.472657136373951
"W02000216",12,145,485,1208,652,108,26,2636,0.00455235204855842,0.0550075872534143,0.183990895295903,0.458270106221548,0.247344461305008,0.0409711684370258,0.00986342943854325,642,0.243550834597876,1994,0.756449165402124
"W02000217",25,134,826,818,216,62,21,2102,0.0118934348239772,0.0637488106565176,0.392959086584206,0.389153187440533,0.102759276879163,0.0294957183634634,0.00999048525214082,985,0.4686013320647,1117,0.5313986679353
"W02000218",2,122,697,1239,499,107,33,2699,0.000741015190811412,0.0452019266394961,0.258243793997777,0.45905891070767,0.184883290107447,0.0396443127084105,0.0122267506483883,821,0.304186735828084,1878,0.695813264171916
"W02000219",3,131,752,1114,461,88,26,2575,0.00116504854368932,0.050873786407767,0.292038834951456,0.432621359223301,0.179029126213592,0.0341747572815534,0.0100970873786408,886,0.344077669902913,1689,0.655922330097087
"W02000220",3,81,767,1370,577,108,31,2937,0.00102145045965271,0.0275791624106231,0.261150834184542,0.466462376574736,0.196458971739871,0.0367722165474974,0.010554988083078,851,0.289751447054818,2086,0.710248552945182
"W02000221",4,48,727,1132,494,91,28,2524,0.00158478605388273,0.0190174326465927,0.288034865293185,0.448494453248811,0.195721077654517,0.036053882725832,0.0110935023771791,779,0.308637083993661,1745,0.691362916006339
"W02000222",1,28,481,732,337,48,13,1640,0.000609756097560976,0.0170731707317073,0.293292682926829,0.446341463414634,0.205487804878049,0.0292682926829268,0.00792682926829268,510,0.310975609756098,1130,0.689024390243902
"W02000223",33,391,776,701,245,45,21,2212,0.0149186256781193,0.176763110307414,0.350813743218806,0.316907775768535,0.110759493670886,0.0203435804701627,0.00949367088607595,1200,0.54249547920434,1012,0.45750452079566
"W02000224",1,340,959,692,229,42,15,2278,0.000438981562774363,0.149253731343284,0.420983318700615,0.30377524143986,0.100526777875329,0.0184372256365233,0.00658472344161545,1300,0.570676031606672,978,0.429323968393327
"W02000225",4,137,1072,1156,452,89,17,2927,0.00136658694909464,0.0468056030064913,0.366245302357362,0.39494362828835,0.154424325247694,0.0304065596173557,0.0058079945336522,1213,0.414417492312948,1714,0.585582507687052
"W02000226",69,274,1082,1191,372,73,26,3087,0.0223517978620019,0.0887593132491092,0.350502105604146,0.38581146744412,0.120505344995141,0.0236475542597992,0.00842241658568189,1425,0.461613216715258,1662,0.538386783284742
"W02000227",10,333,1461,736,219,45,8,2812,0.00355618776671408,0.118421052631579,0.519559032716927,0.261735419630156,0.0778805120910384,0.0160028449502134,0.00284495021337127,1804,0.641536273115221,1008,0.35846372688478
"W02000228",4,1887,970,793,197,39,16,3906,0.00102406554019457,0.48310291858679,0.248335893497184,0.203020993343574,0.0504352278545827,0.00998463901689708,0.00409626216077829,2861,0.732462877624168,1045,0.267537122375832
"W02000229",7,432,729,784,208,27,2,2189,0.00319780721790772,0.197350388305162,0.333028780264961,0.358154408405665,0.0950205573321151,0.0123343992690726,0.000913659205116492,1168,0.533576975788031,1021,0.466423024211969
"W02000230",0,299,280,730,245,50,12,1616,0,0.185024752475248,0.173267326732673,0.451732673267327,0.151608910891089,0.0309405940594059,0.00742574257425743,579,0.358292079207921,1037,0.641707920792079
"W02000231",14,284,1339,1356,546,91,18,3648,0.00383771929824561,0.0778508771929825,0.367050438596491,0.371710526315789,0.149671052631579,0.0249451754385965,0.00493421052631579,1637,0.448739035087719,2011,0.551260964912281
"W02000232",27,36,799,841,151,23,6,1883,0.0143388210302708,0.0191184280403611,0.424322889006904,0.446627721720659,0.0801911842804036,0.0122145512480085,0.00318640467339352,862,0.457780138077536,1021,0.542219861922464
"W02000233",18,182,1149,647,84,6,2,2088,0.00862068965517241,0.0871647509578544,0.550287356321839,0.309865900383142,0.0402298850574713,0.0028735632183908,0.000957854406130268,1349,0.646072796934866,739,0.353927203065134
"W02000234",25,416,1781,1005,238,29,4,3498,0.00714694110920526,0.118925100057176,0.509148084619783,0.287307032590051,0.0680388793596341,0.0082904516866781,0.00114351057747284,2222,0.635220125786164,1276,0.364779874213837
"W02000235",5,171,816,1599,670,111,21,3393,0.00147362216327734,0.0503978779840849,0.240495137046861,0.471264367816092,0.197465369879163,0.0327144120247569,0.00618921308576481,992,0.292366637194223,2401,0.707633362805777
"W02000236",22,261,704,1066,435,93,24,2605,0.00844529750479846,0.100191938579655,0.270249520153551,0.409213051823416,0.166986564299424,0.035700575815739,0.00921305182341651,987,0.378886756238004,1618,0.621113243761996
"W02000237",1,392,421,555,340,124,33,1866,0.000535905680600214,0.210075026795284,0.22561629153269,0.297427652733119,0.182207931404073,0.0664523043944266,0.0176848874598071,814,0.436227224008574,1052,0.563772775991426
"W02000238",6,487,499,886,380,121,28,2407,0.00249272953884504,0.202326547569589,0.207312006647279,0.368093061902784,0.157872870793519,0.0502700457000415,0.0116327378479435,992,0.412131283755713,1415,0.587868716244287
"W02000239",6,640,478,702,374,176,52,2428,0.00247116968698517,0.263591433278418,0.196869851729819,0.289126853377265,0.154036243822076,0.0724876441515651,0.0214168039538715,1124,0.462932454695222,1304,0.537067545304778
"W02000240",16,232,1021,1272,327,57,11,2936,0.00544959128065395,0.0790190735694823,0.34775204359673,0.433242506811989,0.111376021798365,0.0194141689373297,0.00374659400544959,1269,0.432220708446866,1667,0.567779291553134
"W02000241",5,634,1633,1633,641,103,29,4678,0.00106883283454468,0.135528003420265,0.349080803762292,0.349080803762292,0.137024369388628,0.0220179563916203,0.00619923044035913,2272,0.485677640017101,2406,0.514322359982899
"W02000242",2,485,748,992,303,76,13,2619,0.000763650248186331,0.185185185185185,0.285605192821688,0.37877052310042,0.115693012600229,0.0290187094310806,0.00496372661321115,1235,0.471554028255059,1384,0.528445971744941
"W02000243",37,284,1865,1241,230,29,5,3691,0.010024383635871,0.0769439176374966,0.505283121105392,0.336223245732864,0.062313736114874,0.00785694933622325,0.00135464643727987,2186,0.592251422378759,1505,0.407748577621241
"W02000244",21,438,1462,1270,335,64,25,3615,0.00580912863070539,0.121161825726141,0.404426002766252,0.351313969571231,0.0926694329183956,0.0177040110650069,0.00691562932226833,1921,0.531396957123098,1694,0.468603042876902
"W02000245",7,118,1499,1234,301,39,5,3203,0.00218545113955667,0.0368404620668124,0.467998751170777,0.385263815173275,0.0939743990009366,0.0121760849203871,0.00156103652825476,1624,0.507024664377146,1579,0.492975335622854
"W02000246",4,26,487,712,112,16,4,1361,0.00293901542983101,0.0191036002939015,0.357825128581925,0.523144746509919,0.0822924320352682,0.011756061719324,0.00293901542983101,517,0.379867744305658,844,0.620132255694342
"W02000247",96,245,995,1197,306,83,29,2951,0.0325313453066757,0.0830227041680786,0.337173839376483,0.405625211792613,0.103693663165029,0.0281260589630634,0.00982717722805829,1336,0.452727888851237,1615,0.547272111148763
"W02000248",0,377,1301,2310,760,111,32,4891,0,0.0770803516663259,0.265998773257003,0.472296053976692,0.155387446329994,0.0226947454508281,0.00654262931915764,1678,0.343079124923329,3213,0.656920875076671
"W02000249",15,112,1476,1577,451,72,27,3730,0.00402144772117962,0.0300268096514745,0.395710455764075,0.422788203753351,0.120911528150134,0.0193029490616622,0.00723860589812332,1603,0.429758713136729,2127,0.570241286863271
"W02000250",48,897,1172,1665,547,89,19,4437,0.0108181203515889,0.202163624070318,0.264142438584629,0.37525354969574,0.123281496506649,0.0200585981519044,0.00428217263917061,2117,0.477124183006536,2320,0.522875816993464
"W02000251",91,1920,1631,1286,388,76,15,5407,0.0168300351396338,0.355095246902164,0.301646014425744,0.237839837248012,0.0717588311448123,0.0140558535232107,0.00277418161642316,3642,0.673571296467542,1765,0.326428703532458
"W02000252",5,138,1191,1233,387,90,27,3071,0.00162813415825464,0.0449365027678281,0.387821556496255,0.401497883425594,0.126017583848909,0.0293064148485835,0.00879192445457506,1334,0.434386193422338,1737,0.565613806577662
"W02000253",7,269,567,1123,444,85,23,2518,0.00277998411437649,0.106830818109611,0.225178713264496,0.445988880063542,0.176330420969023,0.0337569499602859,0.00913423351866561,843,0.334789515488483,1675,0.665210484511517
"W02000254",19,166,778,1335,404,74,9,2785,0.00682226211849192,0.059605026929982,0.27935368043088,0.47935368043088,0.145062836624776,0.0265709156193896,0.00323159784560144,963,0.345780969479354,1822,0.654219030520646
"W02000255",12,218,1064,858,300,50,11,2513,0.00477516912057302,0.0867489056904099,0.423398328690808,0.341424592120971,0.119379228014326,0.0198965380023876,0.00437723836052527,1294,0.514922403501791,1219,0.485077596498209
"W02000256",25,342,1111,1921,686,104,39,4228,0.00591296121097446,0.0808893093661306,0.262771996215705,0.454351939451277,0.162251655629139,0.0245979186376537,0.00922421948912015,1478,0.34957426679281,2750,0.65042573320719
"W02000257",3,160,822,1280,429,71,18,2783,0.00107797340998922,0.0574919151994251,0.295364714337046,0.459935321595401,0.154150197628458,0.0255120373697449,0.00646784045993532,985,0.353934602946461,1798,0.646065397053539
"W02000258",2,62,730,1308,415,52,22,2591,0.000771902740254728,0.0239289849478966,0.281744500192976,0.504824392126592,0.160169818602856,0.0200694712466229,0.00849093014280201,794,0.306445387881127,1797,0.693554612118873
"W02000259",3,96,633,1334,498,68,24,2656,0.00112951807228916,0.036144578313253,0.238328313253012,0.502259036144578,0.1875,0.0256024096385542,0.00903614457831325,732,0.275602409638554,1924,0.724397590361446
"W02000260",0,32,500,1094,439,68,19,2152,0,0.0148698884758364,0.232342007434944,0.508364312267658,0.203996282527881,0.0315985130111524,0.00882899628252788,532,0.247211895910781,1620,0.752788104089219
"W02000261",11,74,551,1472,547,84,19,2758,0.00398839738941262,0.0268310369833212,0.199782451051487,0.533720087019579,0.198332124728064,0.0304568527918782,0.00688905003625816,636,0.23060188542422,2122,0.76939811457578
"W02000262",1,60,412,921,423,66,18,1901,0.000526038926880589,0.0315623356128353,0.216728037874803,0.484481851657023,0.222514466070489,0.0347185691741189,0.0094687006838506,473,0.248816412414519,1428,0.751183587585481
"W02000263",16,128,496,987,424,74,26,2151,0.00743840074384007,0.0595072059507206,0.230590423059042,0.458856345885635,0.197117619711762,0.0344026034402603,0.0120874012087401,640,0.297536029753603,1511,0.702463970246397
"W02000264",18,29,531,1226,537,104,42,2487,0.00723763570566948,0.0116606353035786,0.21351025331725,0.492963409730599,0.215922798552473,0.0418174507438681,0.0168878166465621,578,0.232408524326498,1909,0.767591475673502
"W02000265",7,89,855,1552,592,92,23,3210,0.00218068535825545,0.0277258566978193,0.266355140186916,0.483489096573209,0.184423676012461,0.0286604361370717,0.00716510903426791,951,0.296261682242991,2259,0.703738317757009
"W02000266",21,41,848,1287,402,57,16,2672,0.00785928143712575,0.0153443113772455,0.317365269461078,0.481661676646707,0.150449101796407,0.0213323353293413,0.00598802395209581,910,0.340568862275449,1762,0.659431137724551
"W02000267",15,78,537,1151,534,76,26,2417,0.00620604054613157,0.0322714108398842,0.22217625155151,0.476210177906496,0.220935043442284,0.0314439387670666,0.0107571369466281,630,0.260653702937526,1787,0.739346297062474
"W02000268",5,46,618,1508,674,119,26,2996,0.00166889185580774,0.0153538050734312,0.206275033377837,0.503337783711616,0.224966622162884,0.0397196261682243,0.00867823765020027,669,0.223297730307076,2327,0.776702269692924
"W02000269",20,98,596,1382,571,108,26,2801,0.00714030703320243,0.0349875044626919,0.212781149589432,0.493395215994288,0.203855765797929,0.0385576579792931,0.00928239914316316,714,0.254908961085327,2087,0.745091038914673
"W02000270",4,33,480,1180,465,74,11,2247,0.00178015131286159,0.0146862483311081,0.213618157543391,0.52514463729417,0.20694259012016,0.0329327992879395,0.00489541611036938,517,0.230084557187361,1730,0.769915442812639
"W02000271",4,70,571,909,334,53,19,1960,0.00204081632653061,0.0357142857142857,0.291326530612245,0.463775510204082,0.170408163265306,0.0270408163265306,0.00969387755102041,645,0.329081632653061,1315,0.670918367346939
"W02000272",3,122,789,1763,705,110,21,3513,0.00085397096498719,0.0347281525761457,0.224594363791631,0.501850270424139,0.20068317677199,0.031312268716197,0.00597779675491033,914,0.260176487332764,2599,0.739823512667236
"W02000273",16,374,1537,1787,525,60,14,4313,0.00370971481567355,0.0867145838163691,0.35636447948064,0.414328773475539,0.121725017389288,0.0139114305587758,0.00324600046371435,1927,0.446788778112683,2386,0.553211221887317
"W02000274",104,350,955,1163,451,71,33,3127,0.0332587144227694,0.111928365845859,0.3054045410937,0.371921969939239,0.144227694275664,0.0227054685001599,0.0105532459226095,1409,0.450591621362328,1718,0.549408378637672
"W02000275",14,319,769,730,250,47,8,2137,0.00655124005615349,0.14927468413664,0.359850257370145,0.341600374356575,0.116986429574169,0.0219934487599438,0.00374356574637342,1102,0.515676181562939,1035,0.484323818437061
"W02000276",7,450,568,869,221,30,1,2146,0.0032618825722274,0.209692451071761,0.264678471575023,0.404939422180801,0.102982292637465,0.0139794967381174,0.000465983224603914,1025,0.477632805219012,1121,0.522367194780988
"W02000277",9,342,932,964,246,46,11,2550,0.00352941176470588,0.134117647058824,0.365490196078431,0.378039215686275,0.0964705882352941,0.0180392156862745,0.00431372549019608,1283,0.503137254901961,1267,0.496862745098039
"W02000278",19,170,1001,1032,199,33,5,2459,0.00772671817812119,0.0691337942252948,0.407076047173648,0.419682797885319,0.0809272061813745,0.0134200894672631,0.00203334688897926,1190,0.483936559577064,1269,0.516063440422936
"W02000279",15,360,843,1138,358,40,7,2761,0.00543281419775444,0.130387540746106,0.305324157913799,0.41216950380297,0.129663165519739,0.0144875045273452,0.0025353132922854,1218,0.44114451285766,1543,0.55885548714234
"W02000280",72,1031,1220,977,313,45,11,3669,0.0196238757154538,0.281002998092123,0.332515671845189,0.266285091305533,0.0853093485963478,0.0122649223221586,0.00299809212319433,2323,0.633142545652766,1346,0.366857454347234
"W02000281",16,151,980,1014,273,49,9,2492,0.00642054574638844,0.0605939004815409,0.393258426966292,0.406902086677368,0.109550561797753,0.0196629213483146,0.0036115569823435,1147,0.460272873194221,1345,0.539727126805779
"W02000282",27,420,1507,1243,324,51,10,3582,0.00753768844221105,0.117252931323283,0.42071468453378,0.347012841987716,0.0904522613065327,0.0142378559463987,0.00279173646007817,1954,0.545505304299274,1628,0.454494695700726
"W02000284",41,190,1326,1794,524,65,23,3963,0.0103456977037598,0.0479434771637648,0.334595003785011,0.452687358062074,0.132223063335857,0.0164017158718143,0.0058036840777189,1557,0.392884178652536,2406,0.607115821347464
"W02000285",18,144,919,1049,355,74,19,2578,0.00698215671062839,0.0558572536850272,0.356477889837083,0.406904577191621,0.137703646237393,0.0287044220325834,0.0073700543056633,1081,0.419317300232739,1497,0.580682699767262
"W02000286",17,232,1519,1230,311,39,16,3364,0.00505350772889417,0.0689655172413793,0.451545778834721,0.36563614744352,0.0924494649227111,0.0115933412604043,0.00475624256837099,1768,0.525564803804994,1596,0.474435196195006
"W02000287",20,294,1002,1110,411,69,15,2921,0.00684697021567956,0.10065046217049,0.343033207805546,0.380006846970216,0.140705237932215,0.0236220472440945,0.00513522766175967,1316,0.450530640191715,1605,0.549469359808285
"W02000288",21,236,910,1390,449,90,25,3121,0.00672861262415892,0.0756167894905479,0.291573213713553,0.445370073694329,0.143864146107017,0.0288369112463954,0.00801025312399872,1167,0.37391861582826,1954,0.62608138417174
"W02000289",11,305,1041,1136,379,54,18,2944,0.00373641304347826,0.103600543478261,0.353600543478261,0.385869565217391,0.128736413043478,0.0183423913043478,0.00611413043478261,1357,0.4609375,1587,0.5390625
"W02000290",1,159,1429,1170,373,57,22,3211,0.000311429461227032,0.0495172843350981,0.445032700093429,0.364372469635628,0.116163189037683,0.0177514792899408,0.00685144814699471,1589,0.494861413889754,1622,0.505138586110246
"W02000291",1,35,703,1203,457,85,19,2503,0.000399520575309628,0.013983220135837,0.280862964442669,0.480623252097483,0.1825809029165,0.0339592489013184,0.00759089093088294,739,0.295245705153815,1764,0.704754294846185
"W02000292",2,246,627,861,290,44,6,2076,0.000963391136801541,0.11849710982659,0.302023121387283,0.414739884393064,0.139691714836224,0.0211946050096339,0.00289017341040462,875,0.421483622350674,1201,0.578516377649326
"W02000293",0,112,784,1056,472,65,13,2502,0,0.0447641886490807,0.313349320543565,0.422062350119904,0.188649080735412,0.0259792166266986,0.00519584332533973,896,0.358113509192646,1606,0.641886490807354
"W02000294",8,155,556,742,266,53,19,1799,0.00444691495275153,0.0861589772095609,0.309060589216231,0.412451361867704,0.147859922178988,0.0294608115619789,0.0105614230127849,719,0.399666481378544,1080,0.600333518621456
"W02000295",11,371,953,1092,355,70,22,2874,0.00382741823242867,0.129088378566458,0.331593597773138,0.379958246346555,0.123521224773834,0.0243562978427279,0.00765483646485734,1335,0.464509394572025,1539,0.535490605427975
"W02000296",4,110,968,1095,342,42,4,2565,0.00155945419103314,0.0428849902534113,0.377387914230019,0.426900584795322,0.133333333333333,0.016374269005848,0.00155945419103314,1082,0.421832358674464,1483,0.578167641325536
"W02000297",3,88,981,1130,321,52,6,2581,0.00116234017822549,0.0340953118946145,0.380085238279737,0.437814800464936,0.124370399070128,0.0201472297559086,0.00232468035645099,1072,0.415342890352577,1509,0.584657109647423
"W02000298",1,201,898,946,304,40,6,2396,0.000417362270450751,0.083889816360601,0.374791318864775,0.394824707846411,0.126878130217028,0.01669449081803,0.00250417362270451,1100,0.459098497495826,1296,0.540901502504174
"W02000299",16,76,866,885,351,61,11,2266,0.00706090026478376,0.0335392762577229,0.382171226831421,0.390556045895852,0.154898499558694,0.0269196822594881,0.00485436893203883,958,0.422771403353928,1308,0.577228596646072
"W02000300",58,158,1068,1104,352,50,10,2800,0.0207142857142857,0.0564285714285714,0.381428571428571,0.394285714285714,0.125714285714286,0.0178571428571429,0.00357142857142857,1284,0.458571428571429,1516,0.541428571428571
"W02000301",11,372,1021,948,257,58,12,2679,0.00410600970511385,0.138857782754759,0.381112355356476,0.353863381858903,0.0959313176558417,0.0216498693542367,0.00447928331466965,1404,0.524076147816349,1275,0.475923852183651
"W02000302",56,237,1290,1291,403,74,22,3373,0.0166024310702639,0.0702638600652238,0.382448858582864,0.382745330566261,0.11947820930922,0.0219389267714201,0.00652238363474652,1583,0.469315149718352,1790,0.530684850281648
"W02000303",1,281,744,975,411,73,10,2495,0.000400801603206413,0.112625250501002,0.298196392785571,0.390781563126253,0.164729458917836,0.0292585170340681,0.00400801603206413,1026,0.41122244488978,1469,0.58877755511022
"W02000304",37,62,609,815,356,47,16,1942,0.0190525231719876,0.0319258496395469,0.313594232749743,0.41967044284243,0.183316168898043,0.0242018537590113,0.0082389289392379,708,0.364572605561277,1234,0.635427394438723
"W02000305",1,122,704,900,218,25,12,1982,0.000504540867810293,0.0615539858728557,0.355196770938446,0.454086781029263,0.109989909182644,0.0126135216952573,0.00605449041372351,827,0.417255297679112,1155,0.582744702320888
"W02000306",1,63,502,787,282,47,16,1698,0.000588928150765607,0.0371024734982332,0.295641931684335,0.463486454652532,0.166077738515901,0.0276796230859835,0.0094228504122497,566,0.333333333333333,1132,0.666666666666667
"W02000307",2,65,624,1020,381,62,7,2161,0.000925497454881999,0.030078667283665,0.288755205923184,0.47200370198982,0.176307265155021,0.028690421101342,0.003239241092087,691,0.319759370661731,1470,0.680240629338269
"W02000308",66,123,1205,1279,341,40,11,3065,0.0215334420880914,0.0401305057096248,0.393148450244698,0.417292006525285,0.111256117455139,0.0130505709624796,0.00358890701468189,1394,0.454812398042414,1671,0.545187601957586
"W02000309",30,329,841,922,272,39,9,2442,0.0122850122850123,0.134725634725635,0.344389844389844,0.377559377559378,0.111384111384111,0.015970515970516,0.00368550368550369,1200,0.491400491400491,1242,0.508599508599509
"W02000310",1,64,642,617,264,65,17,1670,0.000598802395209581,0.0383233532934132,0.384431137724551,0.369461077844311,0.158083832335329,0.0389221556886228,0.0101796407185629,707,0.423353293413174,963,0.576646706586826
"W02000311",4,354,1653,1298,284,21,6,3620,0.00110497237569061,0.0977900552486188,0.456629834254144,0.358563535911602,0.0784530386740332,0.00580110497237569,0.00165745856353591,2011,0.555524861878453,1609,0.444475138121547
"W02000312",5,256,848,969,263,39,4,2384,0.00209731543624161,0.10738255033557,0.355704697986577,0.406459731543624,0.110318791946309,0.0163590604026846,0.00167785234899329,1109,0.465184563758389,1275,0.534815436241611
"W02000313",6,415,1234,1332,373,61,12,3433,0.00174774249927177,0.120885522866298,0.359452374016895,0.387998834838334,0.108651325371395,0.017768715409263,0.00349548499854355,1655,0.482085639382464,1778,0.517914360617536
"W02000314",11,105,700,747,250,29,5,1848,0.00595238095238095,0.0568181818181818,0.378787878787879,0.404220779220779,0.135281385281385,0.0156926406926407,0.00270562770562771,816,0.441558441558442,1031,0.557900432900433
"W02000315",12,92,621,777,291,38,14,1845,0.00650406504065041,0.0498644986449865,0.336585365853659,0.421138211382114,0.157723577235772,0.0205962059620596,0.00758807588075881,725,0.392953929539295,1120,0.607046070460705
"W02000316",3,126,651,920,242,27,6,1975,0.00151898734177215,0.0637974683544304,0.329620253164557,0.465822784810127,0.12253164556962,0.0136708860759494,0.0030379746835443,780,0.394936708860759,1195,0.60506329113924
"W02000317",54,502,759,902,317,33,3,2570,0.021011673151751,0.195330739299611,0.295330739299611,0.350972762645914,0.123346303501946,0.01284046692607,0.00116731517509728,1315,0.511673151750973,1255,0.488326848249027
"W02000318",3,101,1046,1067,360,48,16,2641,0.0011359333585763,0.0382430897387353,0.396062097690269,0.404013631200303,0.136312003029156,0.0181749337372208,0.00605831124574025,1150,0.43544112078758,1491,0.56455887921242
"W02000319",3,236,946,1221,411,79,12,2908,0.00103163686382393,0.0811554332874828,0.325309491059147,0.419876203576341,0.141334250343879,0.0271664374140303,0.00412654745529574,1185,0.407496561210454,1723,0.592503438789546
"W02000320",55,133,742,1390,526,69,27,2942,0.0186947654656696,0.0452073419442556,0.252209381373216,0.472467709041468,0.178789938817131,0.0234534330387491,0.00917743031951054,930,0.316111488783141,2012,0.683888511216859
"W02000321",1,41,825,1782,681,98,24,3452,0.000289687137891078,0.0118771726535342,0.238991888760139,0.5162224797219,0.197276940903824,0.0283893395133256,0.00695249130938586,867,0.251158748551564,2585,0.748841251448436
"W02000322",2,74,746,1479,516,76,27,2920,0.000684931506849315,0.0253424657534247,0.255479452054794,0.506506849315069,0.176712328767123,0.026027397260274,0.00924657534246575,822,0.281506849315068,2098,0.718493150684931
"W02000323",4,247,822,803,291,34,13,2214,0.001806684733514,0.11156278229449,0.371273712737127,0.362691960252936,0.131436314363144,0.015356820234869,0.00587172538392051,1073,0.484643179765131,1141,0.515356820234869
"W02000324",5,194,901,881,280,56,11,2328,0.00214776632302406,0.0833333333333333,0.387027491408935,0.378436426116838,0.120274914089347,0.0240549828178694,0.00472508591065292,1100,0.472508591065292,1228,0.527491408934708
"W02000325",6,314,1170,862,244,37,7,2640,0.00227272727272727,0.118939393939394,0.443181818181818,0.326515151515152,0.0924242424242424,0.0140151515151515,0.00265151515151515,1490,0.564393939393939,1150,0.435606060606061
"W02000326",18,167,988,1377,537,87,22,3196,0.00563204005006258,0.052252816020025,0.309136420525657,0.430851063829787,0.1680225281602,0.0272215269086358,0.00688360450563204,1173,0.367021276595745,2023,0.632978723404255
"W02000327",1,97,693,771,177,23,5,1767,0.000565930956423316,0.0548953027730617,0.392190152801358,0.436332767402377,0.100169779286927,0.0130164119977363,0.00282965478211658,791,0.447651386530843,976,0.552348613469157
"W02000328",1,169,897,1036,326,45,12,2486,0.000402252614641995,0.0679806918744972,0.36082059533387,0.416733708769107,0.13113435237329,0.0181013676588898,0.00482703137570394,1067,0.429203539823009,1419,0.570796460176991
"W02000329",29,884,944,958,271,33,9,3128,0.00927109974424552,0.282608695652174,0.301790281329923,0.306265984654731,0.0866368286445013,0.0105498721227621,0.0028772378516624,1857,0.593670076726343,1271,0.406329923273657
"W02000330",4,62,1013,1151,315,48,6,2599,0.0015390534821085,0.0238553289726818,0.389765294343978,0.442862639476722,0.121200461716045,0.018468641785302,0.00230858022316275,1079,0.415159676798769,1520,0.584840323201231
"W02000331",45,142,1193,809,144,12,2,2347,0.0191734128674904,0.0605027694929697,0.508308478909246,0.344695355773328,0.0613549211759693,0.00511291009799744,0.000852151682999574,1380,0.587984661269706,967,0.412015338730294
"W02000332",21,663,1419,866,226,28,4,3227,0.00650759219088937,0.20545398202665,0.439727300898668,0.268360706538581,0.0700340873876666,0.00867678958785249,0.00123954136969321,2103,0.651688875116207,1124,0.348311124883793
"W02000333",0,48,759,781,133,6,2,1729,0,0.0277617119722383,0.438982070561018,0.451706188548294,0.0769230769230769,0.00347021399652979,0.00115673799884326,807,0.466743782533256,922,0.533256217466744
"W02000334",3,131,847,693,116,24,6,1820,0.00164835164835165,0.071978021978022,0.465384615384615,0.380769230769231,0.0637362637362637,0.0131868131868132,0.0032967032967033,981,0.539010989010989,839,0.460989010989011
"W02000335",28,640,858,800,230,31,8,2595,0.0107899807321773,0.246628131021195,0.330635838150289,0.308285163776493,0.0886319845857418,0.0119460500963391,0.00308285163776493,1526,0.588053949903661,1069,0.411946050096339
"W02000336",5,461,827,1140,599,159,81,3272,0.0015281173594132,0.140892420537897,0.252750611246944,0.34841075794621,0.183068459657702,0.0485941320293399,0.0247555012224939,1293,0.395171149144254,1979,0.604828850855746
"W02000337",16,317,1296,946,227,41,6,2849,0.00561600561600562,0.111267111267111,0.454896454896455,0.332046332046332,0.0796770796770797,0.0143910143910144,0.00210600210600211,1629,0.571779571779572,1220,0.428220428220428
"W02000338",11,503,819,827,421,207,53,2841,0.0038718760999648,0.1770503343893,0.288278775079197,0.291094684970081,0.148187258007744,0.0728616684266103,0.0186554030271031,1333,0.469200985568462,1508,0.530799014431538
"W02000339",27,824,1887,1250,384,92,32,4496,0.00600533807829181,0.183274021352313,0.41970640569395,0.278024911032028,0.0854092526690391,0.0204626334519573,0.00711743772241993,2738,0.608985765124555,1758,0.391014234875445
"W02000340",7,96,462,677,655,262,110,2269,0.00308505949757602,0.0423093873953283,0.203613926840018,0.298369325694138,0.288673424416042,0.115469369766417,0.0484795063904804,565,0.249008373732922,1704,0.750991626267078
"W02000341",17,241,742,839,509,174,72,2594,0.00655358519660756,0.0929067077872012,0.286044718581342,0.323438704703161,0.196222050886662,0.0670778720123362,0.0277563608326908,1000,0.38550501156515,1594,0.61449498843485
"W02000342",13,178,857,1023,628,278,79,3056,0.00425392670157068,0.0582460732984293,0.280431937172775,0.334751308900524,0.205497382198953,0.0909685863874346,0.0258507853403141,1048,0.342931937172775,2008,0.657068062827225
"W02000343",72,609,1455,1317,363,49,13,3878,0.0185662712738525,0.157039711191336,0.375193398659103,0.339608045384219,0.093604951005673,0.0126353790613718,0.00335224342444559,2136,0.550799381124291,1742,0.449200618875709
"W02000344",37,781,920,859,302,95,37,3031,0.0122071923457605,0.257670735730782,0.303530188056747,0.283404816892115,0.0996370834708017,0.0313427911580337,0.0122071923457605,1738,0.573408116133289,1293,0.426591883866711
"W02000345",76,308,1249,986,191,19,7,2836,0.0267983074753173,0.108603667136812,0.440409026798307,0.347672778561354,0.0673483779971791,0.00669957686882934,0.00246826516220028,1633,0.575811001410437,1203,0.424188998589563
"W02000346",6,416,1137,825,158,23,15,2580,0.00232558139534884,0.161240310077519,0.440697674418605,0.319767441860465,0.0612403100775194,0.00891472868217054,0.00581395348837209,1559,0.604263565891473,1021,0.395736434108527
"W02000347",2,157,988,1155,360,48,16,2726,0.000733675715333822,0.0575935436537051,0.362435803374908,0.423697725605282,0.132061628760088,0.0176082171680117,0.00586940572267058,1147,0.420763022743947,1579,0.579236977256053
"W02000348",0,91,890,1064,392,31,6,2474,0,0.0367825383993533,0.359741309620049,0.430072756669361,0.158447857720291,0.0125303152789006,0.00242522231204527,981,0.396523848019402,1493,0.603476151980598
"W02000349",4,322,1839,1044,190,42,7,3448,0.00116009280742459,0.0933874709976798,0.533352668213457,0.302784222737819,0.0551044083526682,0.0121809744779582,0.00203016241299304,2165,0.627900232018561,1283,0.372099767981439
"W02000350",25,1998,954,944,277,69,32,4299,0.00581530588508956,0.464759246336357,0.221912072575017,0.219585950220982,0.0644335892067923,0.0160502442428472,0.00744359153291463,2977,0.692486624796464,1322,0.307513375203536
"W02000351",0,79,930,1020,258,36,3,2326,0,0.0339638865004299,0.399828030954428,0.438521066208083,0.110920034393809,0.0154772141014617,0.00128976784178848,1009,0.433791917454858,1317,0.566208082545142
"W02000352",1,57,867,1196,349,28,3,2501,0.00039984006397441,0.0227908836465414,0.346661335465814,0.478208716513395,0.139544182327069,0.0111955217912835,0.00119952019192323,925,0.369852059176329,1576,0.630147940823671
"W02000353",9,356,552,1357,432,40,19,2765,0.00325497287522604,0.12875226039783,0.199638336347197,0.490777576853526,0.15623869801085,0.0144665461121157,0.00687160940325497,917,0.331645569620253,1848,0.668354430379747
"W02000354",6,109,841,933,241,27,6,2163,0.00277392510402219,0.0503929727230698,0.388811835413777,0.431345353675451,0.111419325011558,0.0124826629680999,0.00277392510402219,956,0.441978733240869,1207,0.558021266759131
"W02000355",5,771,1111,952,237,25,9,3110,0.00160771704180064,0.247909967845659,0.357234726688103,0.306109324758842,0.0762057877813505,0.00803858520900321,0.00289389067524116,1887,0.606752411575563,1223,0.393247588424437
"W02000356",26,185,1062,767,214,24,4,2282,0.0113935144609991,0.0810692375109553,0.465381244522349,0.336108676599474,0.0937773882559159,0.0105170902716915,0.00175284837861525,1273,0.557843996494303,1009,0.442156003505697
"W02000357",0,89,721,1620,619,99,18,3166,0,0.0281111813013266,0.227732154137713,0.51168667087808,0.195514845230575,0.0312697409981049,0.00568540745420088,810,0.25584333543904,2356,0.74415666456096
"W02000358",10,207,568,941,366,64,10,2166,0.00461680517082179,0.0955678670360111,0.262234533702678,0.434441366574331,0.168975069252078,0.0295475530932595,0.00461680517082179,785,0.362419205909511,1381,0.637580794090489
"W02000359",9,1058,1580,1669,514,78,17,4925,0.00182741116751269,0.214822335025381,0.320812182741117,0.338883248730964,0.104365482233503,0.0158375634517766,0.00345177664974619,2647,0.53746192893401,2278,0.46253807106599
"W02000360",12,162,1074,1616,578,87,37,3566,0.00336511497476164,0.0454290521592821,0.301177790241167,0.453168816601234,0.162086371284352,0.0243970835670219,0.0103757711721817,1248,0.34997195737521,2318,0.65002804262479
"W02000361",66,814,1680,1280,467,57,17,4381,0.0150650536407213,0.185802328235563,0.383474092672906,0.292170737274595,0.106596667427528,0.0130107281442593,0.00388039260442821,2560,0.58434147454919,1821,0.41565852545081
"W02000362",4,620,897,786,210,29,4,2550,0.00156862745098039,0.243137254901961,0.351764705882353,0.308235294117647,0.0823529411764706,0.0113725490196078,0.00156862745098039,1521,0.596470588235294,1029,0.403529411764706
"W02000363",20,187,733,981,343,25,10,2299,0.00869943453675511,0.0813397129186603,0.318834275772075,0.426707264027838,0.14919530230535,0.0108742931709439,0.00434971726837756,940,0.40887342322749,1359,0.59112657677251
"W02000364",138,1362,1563,1083,342,60,26,4574,0.030170529077394,0.29777000437254,0.341714035854832,0.236773065150853,0.074770441626585,0.0131176213379974,0.00568430257979886,3063,0.669654569304766,1511,0.330345430695234
"W02000365",1,403,1920,881,131,16,3,3355,0.00029806259314456,0.120119225037258,0.572280178837556,0.262593144560358,0.0390461997019374,0.00476900149031297,0.000894187779433681,2324,0.692697466467958,1031,0.307302533532042
"W02000366",5,203,1276,705,208,70,25,2492,0.00200642054574639,0.0814606741573034,0.512038523274478,0.282905296950241,0.0834670947030498,0.0280898876404494,0.0100321027287319,1484,0.595505617977528,1008,0.404494382022472
"W02000367",14,699,615,773,199,32,7,2339,0.00598546387345019,0.298845660538692,0.262932877297991,0.330483112441214,0.0850790936297563,0.0136810602821719,0.0029927319367251,1328,0.567764001710133,1011,0.432235998289867
"W02000368",1,45,871,863,77,6,3,1866,0.000535905680600214,0.0241157556270096,0.466773847802787,0.462486602357985,0.0412647374062165,0.00321543408360129,0.00160771704180064,917,0.491425509110397,949,0.508574490889603
"W02000369",66,1329,1469,979,84,11,4,3942,0.0167427701674277,0.337138508371385,0.372653475393201,0.248351090816844,0.0213089802130898,0.00279046169457128,0.00101471334348047,2864,0.726534753932014,1078,0.273465246067986
"W02000370",2,34,536,1033,294,44,5,1948,0.00102669404517454,0.0174537987679671,0.275154004106776,0.530287474332649,0.150924024640657,0.0225872689938398,0.00256673511293634,572,0.293634496919918,1376,0.706365503080082
"W02000371",22,816,1522,1159,262,36,5,3822,0.00575614861329147,0.213500784929356,0.398220826792255,0.303244374672946,0.0685504971219257,0.00941915227629513,0.00130821559392988,2360,0.617477760334903,1462,0.382522239665097
"W02000372",8,716,1042,763,237,52,5,2823,0.00283386468296139,0.253630889125044,0.369110874955721,0.270279844137442,0.0839532412327311,0.018420120439249,0.00177116542685087,1766,0.625575628763727,1057,0.374424371236273
"W02000373",2,174,1250,845,136,22,6,2435,0.00082135523613963,0.0714579055441478,0.513347022587269,0.347022587268994,0.0558521560574949,0.00903490759753593,0.00246406570841889,1426,0.585626283367556,1009,0.414373716632444
"W02000374",1,46,428,738,249,41,9,1512,0.000661375661375661,0.0304232804232804,0.283068783068783,0.488095238095238,0.16468253968254,0.0271164021164021,0.00595238095238095,475,0.314153439153439,1037,0.685846560846561
"W02000375",2,280,1582,712,91,9,1,2677,0.000747104968248039,0.104594695554725,0.590960029884199,0.265969368696302,0.0339932760552858,0.00336197235711617,0.000373552484124019,1864,0.696301830407172,813,0.303698169592828
"W02000376",1,98,1105,883,251,24,4,2366,0.000422654268808115,0.0414201183431953,0.467032967032967,0.373203719357566,0.106086221470837,0.0101437024513948,0.00169061707523246,1204,0.50887573964497,1162,0.49112426035503
"W02000377",24,396,1267,951,84,15,1,2738,0.00876552227903579,0.144631117604091,0.462746530314098,0.347333820306793,0.0306793279766253,0.00547845142439737,0.000365230094959825,1687,0.616143170197224,1051,0.383856829802776
"W02000378",6,124,741,1023,398,42,10,2344,0.00255972696245734,0.052901023890785,0.316126279863481,0.436433447098976,0.169795221843003,0.0179180887372014,0.00426621160409556,871,0.371587030716724,1473,0.628412969283277
"W02000379",37,425,1854,443,40,4,1,2804,0.0131954350927247,0.151569186875892,0.661198288159772,0.157988587731812,0.014265335235378,0.0014265335235378,0.000356633380884451,2316,0.825962910128388,488,0.174037089871612
"W02000380",35,1209,669,808,191,36,7,2955,0.011844331641286,0.409137055837563,0.226395939086294,0.273434856175973,0.0646362098138748,0.0121827411167513,0.00236886632825719,1913,0.647377326565144,1042,0.352622673434856
"W02000381",9,198,1082,1053,205,23,9,2579,0.00348972469949593,0.0767739433889104,0.419542458317177,0.408297789841024,0.0794881737107406,0.00891818534315626,0.00348972469949593,1289,0.499806126405584,1290,0.500193873594416
"W02000382",159,257,1206,855,166,19,7,2669,0.0595728737354815,0.0962907455976021,0.451854627201199,0.32034469838891,0.0621955788684901,0.0071187710753091,0.00262270513300862,1622,0.607718246534283,1047,0.392281753465718
"W02000383",1,131,1216,1153,205,27,5,2738,0.000365230094959825,0.047845142439737,0.444119795471147,0.421110299488678,0.0748721694667641,0.00986121256391527,0.00182615047479912,1348,0.492330168005844,1390,0.507669831994156
"W02000384",2,103,456,705,278,39,12,1595,0.00125391849529781,0.064576802507837,0.2858934169279,0.442006269592476,0.174294670846395,0.0244514106583072,0.00752351097178683,561,0.351724137931035,1034,0.648275862068966
"W02000385",2,49,612,899,297,49,3,1911,0.0010465724751439,0.0256410256410256,0.320251177394035,0.470434327577185,0.15541601255887,0.0256410256410256,0.00156985871271586,663,0.346938775510204,1248,0.653061224489796
"W02000386",0,58,681,1078,406,66,20,2309,0,0.025119099177133,0.294932871372889,0.466868774361195,0.175833694239931,0.0285838025119099,0.0086617583369424,739,0.320051970550022,1570,0.679948029449978
"W02000387",1,47,472,971,289,38,6,1824,0.000548245614035088,0.0257675438596491,0.258771929824561,0.53234649122807,0.15844298245614,0.0208333333333333,0.00328947368421053,520,0.285087719298246,1304,0.714912280701754
"W02000388",1,64,518,906,287,28,11,1815,0.000550964187327824,0.0352617079889807,0.285399449035813,0.499173553719008,0.158126721763085,0.0154269972451791,0.00606060606060606,583,0.321212121212121,1232,0.678787878787879
"W02000389",2,181,1178,1313,337,35,14,3060,0.00065359477124183,0.0591503267973856,0.384967320261438,0.429084967320261,0.110130718954248,0.011437908496732,0.00457516339869281,1361,0.444771241830065,1699,0.555228758169935
"W02000390",2,160,500,756,285,37,5,1745,0.00114613180515759,0.0916905444126074,0.286532951289398,0.43323782234957,0.163323782234957,0.0212034383954155,0.00286532951289398,662,0.379369627507163,1083,0.620630372492837
"W02000391",2,194,861,1333,346,32,11,2779,0.000719683339330694,0.0698092839150774,0.309823677581864,0.479668945663908,0.12450521770421,0.0115149334292911,0.00395825836631882,1057,0.380352644836272,1722,0.619647355163728
"W02000392",4,189,1012,1231,422,79,14,2951,0.00135547272111149,0.0640460860725178,0.342934598441206,0.41714672992206,0.143002372077262,0.0267705862419519,0.00474415452389021,1205,0.408336157234836,1746,0.591663842765164
"W02000393",4,341,1331,994,167,29,1,2867,0.00139518660620858,0.118939658179281,0.464248343215905,0.346703871642832,0.0582490408092082,0.0101151028950122,0.000348796651552145,1676,0.584583188001395,1191,0.415416811998605
"W02000394",0,109,960,2058,539,46,21,3733,0,0.0291990356281811,0.257165818376641,0.551299223144924,0.144387891776051,0.012322528797214,0.00562550227698902,1069,0.286364854004822,2664,0.713635145995178
"W02000395",50,319,855,1141,437,61,7,2870,0.0174216027874564,0.111149825783972,0.297909407665505,0.397560975609756,0.152264808362369,0.0212543554006969,0.0024390243902439,1224,0.426480836236934,1646,0.573519163763066
"W02000396",0,38,752,1818,681,60,25,3374,0,0.011262596324837,0.222880853586248,0.538826318909306,0.201837581505631,0.01778304682869,0.00740960284528749,790,0.234143449911085,2584,0.765856550088915
"W02000397",1,90,1146,987,231,24,5,2484,0.000402576489533011,0.036231884057971,0.461352657004831,0.397342995169082,0.0929951690821256,0.00966183574879227,0.00201288244766506,1237,0.497987117552335,1247,0.502012882447665
"W02000398",15,1061,2006,1751,477,42,10,5362,0.00279746363297277,0.197873927638941,0.374114136516225,0.326557254755688,0.0889593435285341,0.00783289817232376,0.00186497575531518,3082,0.574785527788139,2280,0.425214472211861
"W02000399",33,557,2146,2655,993,116,43,6543,0.00504355800091701,0.0851291456518417,0.327984105150543,0.405777166437414,0.151765245300321,0.017728870548678,0.0065719089102858,2736,0.418156808803301,3807,0.581843191196699
"W02000400",1,189,1072,1573,754,107,28,3724,0.000268528464017186,0.0507518796992481,0.287862513426423,0.422395273899033,0.202470461868958,0.0287325456498389,0.0075187969924812,1262,0.338882921589689,2462,0.661117078410312
"W02000401",17,105,564,1023,430,63,13,2215,0.00767494356659142,0.0474040632054176,0.254627539503386,0.461851015801354,0.194130925507901,0.0284424379232506,0.00586907449209932,686,0.309706546275395,1529,0.690293453724605
"W02000402",79,267,1969,2172,728,69,26,5310,0.0148775894538606,0.0502824858757062,0.370809792843691,0.409039548022599,0.137099811676083,0.0129943502824859,0.00489642184557439,2315,0.435969868173258,2995,0.564030131826742
"W02000403",1,180,1523,1112,218,20,8,3062,0.000326583932070542,0.0587851077726976,0.497387328543436,0.363161332462443,0.0711952971913782,0.00653167864141084,0.00261267145656434,1704,0.556499020248204,1358,0.443500979751796
"W02000404",1,175,1067,1433,493,59,16,3244,0.00030826140567201,0.0539457459926017,0.328914919852035,0.44173859432799,0.151972872996301,0.0181874229346486,0.00493218249075216,1243,0.383168927250308,2001,0.616831072749692
"W02000405",1,42,1454,1142,191,17,9,2856,0.000350140056022409,0.0147058823529412,0.509103641456583,0.399859943977591,0.0668767507002801,0.00595238095238095,0.00315126050420168,1497,0.524159663865546,1359,0.475840336134454
"W02000406",4,1022,1062,1585,558,65,27,4323,0.00092528336803146,0.236409900532038,0.245662734212353,0.366643534582466,0.129077029840389,0.0150358547305112,0.00624566273421235,2088,0.482997918112422,2235,0.517002081887578
"W02000407",12,174,1171,884,154,24,7,2426,0.00494641384995878,0.0717230008244023,0.482687551525144,0.364385820280297,0.0634789777411377,0.00989282769991756,0.00288540807914262,1357,0.559356966199505,1069,0.440643033800495
"W02000408",10,233,1349,1412,456,50,20,3530,0.0028328611898017,0.0660056657223796,0.382152974504249,0.4,0.129178470254958,0.0141643059490085,0.0056657223796034,1592,0.450991501416431,1938,0.549008498583569
"W02000409",2,75,898,860,144,20,5,2004,0.000998003992015968,0.0374251497005988,0.44810379241517,0.429141716566866,0.0718562874251497,0.00998003992015968,0.00249500998003992,975,0.486526946107784,1029,0.513473053892216
"W02000410",1,137,758,1598,538,59,26,3117,0.000320821302534488,0.0439525184472249,0.243182547321142,0.512672441450112,0.172601860763555,0.0189284568495348,0.0083413538658967,896,0.287455887070902,2221,0.712544112929098
"W02000411",0,172,1286,764,113,22,2,2359,0,0.072912250953794,0.545146248410343,0.323866044934294,0.0479016532428995,0.00932598558711318,0.000847816871555744,1458,0.618058499364137,901,0.381941500635863
"W02000412",14,127,989,1025,340,44,12,2551,0.00548804390435124,0.0497843982751862,0.387691101528812,0.401803214425715,0.13328106624853,0.0172481379851039,0.00470403763230106,1130,0.44296354370835,1421,0.55703645629165
"W02000414",11,63,248,623,541,398,132,2016,0.00545634920634921,0.03125,0.123015873015873,0.309027777777778,0.268353174603175,0.197420634920635,0.0654761904761905,322,0.159722222222222,1694,0.840277777777778
"W02000415",3,161,1902,1797,303,63,9,4238,0.000707881075979236,0.037989617744219,0.448796602170835,0.424020764511562,0.0714959886739028,0.0148655025955639,0.00212364322793771,2066,0.487494100991034,2172,0.512505899008966
"W02000416",28,172,735,1470,810,312,119,3646,0.00767964893033461,0.0471749862863412,0.201590784421284,0.403181568842567,0.222161272627537,0.0855732309380143,0.0326385079539221,935,0.256445419637959,2711,0.743554580362041
"W02000417",19,170,1287,1255,785,387,120,4023,0.00472284364901815,0.0422570221227939,0.319910514541387,0.311956251553567,0.19512801391996,0.0961968680089485,0.0298284862043251,1476,0.366890380313199,2547,0.633109619686801
"W02000418",110,410,895,1350,1033,547,208,4553,0.0241598945750055,0.0900505161432023,0.196573687678454,0.296507797056886,0.226883373599824,0.120140566659345,0.0456841642872831,1415,0.310784098396662,3138,0.689215901603338
"W02000419",35,463,1025,1987,684,108,27,4329,0.00808500808500809,0.106953106953107,0.236775236775237,0.458997458997459,0.158004158004158,0.0249480249480249,0.00623700623700624,1523,0.351813351813352,2806,0.648186648186648
"W02000421",28,285,560,1100,1153,510,240,3876,0.00722394220846233,0.0735294117647059,0.144478844169247,0.283797729618163,0.297471620227038,0.131578947368421,0.0619195046439628,873,0.225232198142415,3003,0.774767801857585
"W02000422",169,1786,3138,705,52,6,0,5856,0.0288592896174863,0.304986338797814,0.535860655737705,0.120389344262295,0.00887978142076503,0.00102459016393443,0,5093,0.869706284153005,763,0.130293715846995
"W02000423",17,2064,3536,877,205,11,3,6713,0.00253239982124237,0.307463131237897,0.526739162818412,0.130642037837033,0.0305377625502756,0.00163861164903918,0.000446894086101594,5617,0.836734693877551,1096,0.163265306122449
"W02000424",8,463,483,890,271,56,20,2191,0.00365130077590141,0.211319032405294,0.220447284345048,0.406207211319032,0.12368781378366,0.0255591054313099,0.00912825193975354,954,0.435417617526244,1237,0.564582382473756
"W02000425",10,120,563,868,368,132,51,2112,0.00473484848484848,0.0568181818181818,0.26657196969697,0.410984848484849,0.174242424242424,0.0625,0.0241477272727273,693,0.328125,1419,0.671875
"W02000426",31,98,1125,1378,295,33,7,2967,0.010448264239973,0.0330299966295922,0.379170879676441,0.464442197505898,0.0994270306707112,0.0111223458038423,0.0023592854735423,1254,0.422649140546006,1713,0.577350859453994
"W02000427",4,93,1315,1712,697,157,49,4027,0.000993295257015148,0.0230941147256022,0.32654581574373,0.425130370002483,0.173081698534889,0.0389868388378445,0.0121678668984356,1412,0.350633225726347,2615,0.649366774273653
"W02000428",12,189,719,1367,530,82,14,2913,0.00411946446961895,0.0648815653964985,0.246824579471335,0.469275660830759,0.181943014074837,0.0281496738757295,0.00480604188122211,920,0.315825609337453,1993,0.684174390662547
,1423,26213,23838,13528,5303,1671,898,72875,0.0195265866209262,0.359698113207547,0.327108061749571,0.185632933104631,0.0727684391080617,0.0229296740994854,0.0123224699828473,51474,0.706332761578045,21400,0.293653516295026
