"msoa21","loftins_n","cavitywallins_n","solidwallins_n","cavity_and_loftins_n","cavitywallins_noloftins_n","loftins_nocavitywallins_n","number_of_epcs","loftins_pct","cavitywallins_pct","solidwallins_pct","cavity_and_loftins_pct","cavitywallins_noloftins_pct","loftins_nocavitywallins_pct"
"E02000001",51,239,1400,1,238,50,7146,0.00713685978169605,0.033445284075007,0.195913797928911,0.000139938427092079,0.0333053456479149,0.00699692135460397
"E02000002",415,687,632,130,557,285,2651,0.156544700113165,0.259147491512637,0.238400603545832,0.0490380988306299,0.210109392682007,0.107506601282535
"E02000003",619,503,2260,94,409,525,3707,0.166981386565956,0.135689236579444,0.60965740490963,0.0253574318856218,0.110331804693822,0.141623954680335
"E02000004",327,331,804,97,234,230,1874,0.174493062966916,0.176627534685165,0.429028815368196,0.051760939167556,0.124866595517609,0.12273212379936
"E02000005",503,603,1598,140,463,363,3140,0.160191082802548,0.19203821656051,0.508917197452229,0.0445859872611465,0.147452229299363,0.115605095541401
"E02000007",361,628,1294,94,534,267,3390,0.106489675516224,0.185250737463127,0.381710914454277,0.0277286135693215,0.157522123893805,0.0787610619469027
"E02000008",705,1083,1638,256,827,449,3919,0.179892829803521,0.276346006634345,0.417963766266905,0.0653227864251084,0.211023220209237,0.114570043378413
"E02000009",491,751,995,181,570,310,4122,0.119116933527414,0.182193110140708,0.241387675885492,0.0439107229500243,0.138282387190684,0.0752062105773896
"E02000010",463,473,1613,105,368,358,2847,0.162627327010889,0.166139796276783,0.56656129258869,0.0368809272918862,0.129258868984896,0.125746399719002
"E02000011",441,305,1221,81,224,360,2098,0.210200190657769,0.145376549094376,0.581982840800763,0.0386081982840801,0.106768350810296,0.171591992373689
"E02000012",495,258,1766,51,207,444,2692,0.183878157503715,0.0958395245170877,0.656017830609212,0.0189450222882615,0.0768945022288262,0.164933135215453
"E02000013",434,597,1268,132,465,302,2621,0.165585654330408,0.227775658145746,0.483784814956124,0.0503624570774514,0.177413201068295,0.115223197252957
"E02000014",537,983,996,234,749,303,2972,0.180686406460296,0.330753701211306,0.335127860026918,0.0787348586810229,0.252018842530283,0.101951547779273
"E02000015",334,849,403,126,723,208,3101,0.107707191228636,0.27378265075782,0.129958078039342,0.0406320541760722,0.233150596581748,0.0670751370525637
"E02000016",212,301,725,18,283,194,4851,0.0437023294166151,0.062049062049062,0.149453720882292,0.00371057513914657,0.0583384869099155,0.0399917542774686
"E02000017",609,290,1864,59,231,550,2600,0.234230769230769,0.111538461538462,0.716923076923077,0.0226923076923077,0.0888461538461539,0.211538461538462
"E02000018",432,669,1005,148,521,284,2965,0.145699831365936,0.225632377740304,0.338954468802698,0.0499156829679595,0.175716694772344,0.0957841483979764
"E02000019",359,588,856,150,438,209,3712,0.0967133620689655,0.158405172413793,0.230603448275862,0.0404094827586207,0.117995689655172,0.0563038793103448
"E02000020",485,398,1687,85,313,400,5125,0.0946341463414634,0.0776585365853659,0.329170731707317,0.0165853658536585,0.0610731707317073,0.0780487804878049
"E02000021",503,431,1594,106,325,397,3281,0.153306918622371,0.131362389515392,0.485827491618409,0.0323072234074977,0.0990551661078939,0.120999695214874
"E02000022",111,340,285,28,312,83,5610,0.0197860962566845,0.0606060606060606,0.0508021390374332,0.00499108734402852,0.0556149732620321,0.014795008912656
"E02000023",254,559,256,101,458,153,2802,0.0906495360456817,0.199500356887937,0.0913633119200571,0.03604568165596,0.163454675231977,0.0546038543897216
"E02000024",621,480,2025,101,379,520,3951,0.157175398633257,0.121488230827639,0.5125284738041,0.0255631485699823,0.0959250822576563,0.131612250063275
"E02000025",591,781,989,145,636,446,3461,0.17075989598382,0.225657324472696,0.285755561976307,0.041895405952037,0.183761918520659,0.128864490031783
"E02000026",455,516,734,148,368,307,2037,0.223367697594502,0.253313696612666,0.36033382425135,0.0726558664702995,0.180657830142366,0.150711831124202
"E02000027",471,505,952,102,403,369,3426,0.137478108581436,0.147402218330414,0.277875072971395,0.0297723292469352,0.117629889083479,0.107705779334501
"E02000028",334,495,960,81,414,253,2501,0.133546581367453,0.197920831667333,0.383846461415434,0.0323870451819272,0.165533786485406,0.101159536185526
"E02000029",585,386,1690,73,313,512,3538,0.165347654041832,0.109101187111362,0.477671000565291,0.0206331260599209,0.0884680610514415,0.144714527981911
"E02000030",609,736,708,229,507,380,2867,0.212417160795256,0.256714335542379,0.246948029298919,0.0798744332054412,0.176839902336938,0.132542727589815
"E02000031",430,589,1028,121,468,309,3578,0.120178870877585,0.164617104527669,0.287311347121297,0.03381777529346,0.130799329234209,0.0863610955841252
"E02000032",388,134,1222,40,94,348,1648,0.235436893203884,0.0813106796116505,0.741504854368932,0.0242718446601942,0.0570388349514563,0.211165048543689
"E02000033",542,360,1323,97,263,445,2860,0.18951048951049,0.125874125874126,0.462587412587413,0.0339160839160839,0.091958041958042,0.155594405594406
"E02000034",563,538,1865,88,450,475,3344,0.168361244019139,0.160885167464115,0.557715311004785,0.0263157894736842,0.134569377990431,0.142045454545455
"E02000035",438,1048,1131,173,875,265,4039,0.108442683832632,0.259470165882644,0.280019806882892,0.0428323842535281,0.216637781629116,0.0656102995791037
"E02000036",635,824,1210,212,612,423,3389,0.187370905871939,0.243139569194453,0.357037474181174,0.0625553260548835,0.180584243139569,0.124815579817055
"E02000037",388,677,638,206,471,182,3351,0.115786332438078,0.202029245001492,0.19039092808117,0.0614741868099075,0.140555058191585,0.0543121456281707
"E02000038",581,445,1805,83,362,498,3697,0.157154449553692,0.120367865837165,0.488233703002434,0.0224506356505275,0.0979172301866378,0.134703813903165
"E02000039",403,460,1123,101,359,302,2491,0.16178241670012,0.184664793255721,0.450822962665596,0.0405459654757126,0.144118827780008,0.121236451224408
"E02000040",321,479,763,124,355,197,4793,0.0669726684748592,0.0999374087210515,0.1591904861256,0.0258710619653662,0.0740663467556854,0.041101606509493
"E02000041",418,561,1472,96,465,322,3232,0.129331683168317,0.173576732673267,0.455445544554455,0.0297029702970297,0.143873762376238,0.0996287128712871
"E02000042",580,559,2336,59,500,521,4826,0.120182345627849,0.115830915872358,0.484044757563199,0.0122254455035226,0.103605470368835,0.107956900124327
"E02000043",472,358,1429,118,240,354,2169,0.217611802674043,0.165053019824804,0.658828953434763,0.0544029506685108,0.110650069156293,0.163208852005533
"E02000044",490,744,998,136,608,354,3048,0.160761154855643,0.244094488188976,0.32742782152231,0.0446194225721785,0.199475065616798,0.116141732283465
"E02000045",662,754,1613,152,602,510,4238,0.156205757432751,0.177914110429448,0.380604058518169,0.0358659745162813,0.142048135913167,0.12033978291647
"E02000046",402,283,1911,27,256,375,3069,0.130987292277615,0.0922124470511567,0.622678396871945,0.00879765395894428,0.0834147930922124,0.122189638318671
"E02000047",604,902,1001,190,712,414,4586,0.131705189707806,0.19668556476232,0.218273004797209,0.0414304404709987,0.155255124291321,0.0902747492368077
"E02000048",434,526,1393,81,445,353,3605,0.120388349514563,0.145908460471567,0.386407766990291,0.0224687933425798,0.123439667128988,0.0979195561719834
"E02000049",151,1441,269,92,1349,59,4003,0.0377217087184612,0.359980014988758,0.0671996002997752,0.0229827629278041,0.336997252060954,0.014738945790657
"E02000050",506,606,1664,79,527,427,3942,0.128361237950279,0.153729071537291,0.422120750887874,0.0200405885337392,0.133688483003551,0.10832064941654
"E02000051",405,727,1780,67,660,338,4028,0.100546176762661,0.180486593843098,0.441906653426018,0.0166335650446872,0.163853028798411,0.0839126117179742
"E02000052",664,490,2333,66,424,598,4509,0.147261033488578,0.108671545797294,0.517409625194056,0.0146373918829009,0.0940341539143934,0.132623641605678
"E02000054",422,383,1334,64,319,358,3000,0.140666666666667,0.127666666666667,0.444666666666667,0.0213333333333333,0.106333333333333,0.119333333333333
"E02000055",430,698,2379,42,656,388,5305,0.0810556079170594,0.131573986804901,0.448444863336475,0.00791705937794534,0.123656927426956,0.073138548539114
"E02000056",604,429,1783,104,325,500,2926,0.206425153793575,0.146616541353383,0.609364319890636,0.0355434039644566,0.111073137388927,0.170881749829118
"E02000057",311,231,1709,32,199,279,2906,0.107019958706125,0.0794907088781831,0.588093599449415,0.0110116999311769,0.0684790089470062,0.0960082587749484
"E02000058",616,376,2646,72,304,544,3823,0.161130002615747,0.0983520795187026,0.692126602144912,0.0188333769291133,0.0795187025895893,0.142296625686634
"E02000059",439,516,1490,57,459,382,5740,0.0764808362369338,0.0898954703832753,0.259581881533101,0.00993031358885017,0.0799651567944251,0.0665505226480836
"E02000060",486,372,2176,62,310,424,3984,0.121987951807229,0.0933734939759036,0.546184738955823,0.0155622489959839,0.0778112449799197,0.106425702811245
"E02000061",420,351,2062,44,307,376,4166,0.100816130580893,0.0842534805568891,0.494959193470955,0.0105616898703793,0.0736917906865098,0.0902544407105137
"E02000062",363,281,1358,54,227,309,3068,0.118318122555411,0.0915906127770535,0.442633637548892,0.0176010430247718,0.0739895697522816,0.100717079530639
"E02000063",431,596,699,145,451,286,2874,0.149965205288796,0.207376478775226,0.24321503131524,0.0504523312456507,0.156924147529576,0.0995128740431454
"E02000064",241,426,1254,44,382,197,3113,0.0774172823642788,0.136845486668808,0.402826855123675,0.0141342756183746,0.122711211050434,0.0632830067459043
"E02000065",360,322,24,78,244,282,2594,0.138781804163454,0.124132613723978,0.00925212027756361,0.0300693909020817,0.0940632228218967,0.108712413261372
"E02000066",270,384,349,100,284,170,4107,0.0657414170927684,0.0934989043097151,0.0849768687606525,0.0243486729973216,0.0691502313123935,0.0413927440954468
"E02000067",512,583,1420,95,488,417,4067,0.125891320383575,0.143348905827391,0.349151708876322,0.0233587410867962,0.119990164740595,0.102532579296779
"E02000068",426,247,928,75,172,351,3436,0.123981373690338,0.0718859138533178,0.270081490104773,0.0218277066356228,0.050058207217695,0.102153667054715
"E02000069",420,550,769,139,411,281,2682,0.156599552572707,0.205070842654735,0.286726323639075,0.0518269947800149,0.15324384787472,0.104772557792692
"E02000070",461,527,1181,138,389,323,2238,0.205987488829312,0.235478105451296,0.527703306523682,0.0616621983914209,0.173815907059875,0.144325290437891
"E02000071",355,195,1326,37,158,318,2224,0.159622302158273,0.0876798561151079,0.596223021582734,0.016636690647482,0.0710431654676259,0.142985611510791
"E02000072",628,537,729,145,392,483,5243,0.119778752622544,0.102422277322144,0.139042532901011,0.0276559221819569,0.0747663551401869,0.0921228304405874
"E02000073",553,786,1312,160,626,393,2492,0.221910112359551,0.315409309791332,0.526484751203852,0.0642054574638844,0.251203852327448,0.157704654895666
"E02000074",497,427,502,138,289,359,3373,0.147346575748592,0.126593536910762,0.14882893566558,0.0409131337088645,0.0856804032018974,0.106433442039727
"E02000075",489,453,1169,124,329,365,1943,0.251672671127123,0.233144621718991,0.601646937725167,0.0638188368502316,0.16932578486876,0.187853834276891
"E02000077",340,949,649,185,764,155,2157,0.157626332869726,0.439962911451089,0.300880853036625,0.0857672693555865,0.354195642095503,0.07185906351414
"E02000078",499,404,1412,126,278,373,2126,0.234713076199436,0.19002822201317,0.664158043273753,0.0592662276575729,0.130761994355597,0.175446848541863
"E02000079",529,412,1553,94,318,435,3548,0.149098083427283,0.116121758737317,0.437711386696731,0.0264937993235626,0.0896279594137542,0.12260428410372
"E02000080",463,477,1647,83,394,380,2828,0.163719943422914,0.168670438472419,0.582390381895332,0.0293493635077793,0.139321074964639,0.134370579915134
"E02000081",517,514,900,150,364,367,2494,0.207297514033681,0.206094627105052,0.360866078588613,0.0601443464314354,0.145950280673617,0.147153167602245
"E02000082",459,344,1579,70,274,389,2190,0.20958904109589,0.157077625570776,0.721004566210046,0.0319634703196347,0.125114155251142,0.177625570776256
"E02000083",740,1033,1085,286,747,454,4140,0.178743961352657,0.24951690821256,0.26207729468599,0.0690821256038647,0.180434782608696,0.109661835748792
"E02000084",646,604,1600,187,417,459,2911,0.221916867055995,0.207488835451735,0.549639299209894,0.0642390930951563,0.143249742356579,0.157677773960838
"E02000085",422,385,1464,107,278,315,2231,0.189152846257284,0.172568354997759,0.656207978484984,0.0479605558045719,0.124607799193187,0.141192290452712
"E02000086",418,288,1083,82,206,336,1849,0.226068144943213,0.155759870200108,0.585722011898323,0.0443482963764197,0.111411573823688,0.181719848566793
"E02000087",596,636,863,213,423,383,2644,0.225416036308623,0.24054462934947,0.326399394856278,0.0805597579425113,0.159984871406959,0.144856278366112
"E02000088",499,415,1158,131,284,368,1969,0.2534281361097,0.21076688674454,0.588115794819705,0.0665312341289995,0.144235652615541,0.186896901980701
"E02000089",425,229,1295,66,163,359,1916,0.221816283924843,0.119519832985386,0.675887265135699,0.034446764091858,0.0850730688935282,0.187369519832985
"E02000090",603,1175,1159,235,940,368,4149,0.145336225596529,0.283200771270186,0.279344420342251,0.0566401542540371,0.226560617016148,0.0886960713424922
"E02000091",550,870,1189,170,700,380,3851,0.142820046741106,0.225915346663204,0.308750973773046,0.0441443780836146,0.18177096857959,0.0986756686574916
"E02000092",505,593,467,188,405,317,2558,0.197419859265051,0.23182173573104,0.182564503518374,0.073494917904613,0.158326817826427,0.123924941360438
"E02000093",487,744,941,205,539,282,3127,0.155740326191238,0.237927726255197,0.300927406459866,0.0655580428525744,0.172369683402622,0.0901822833386633
"E02000094",396,480,1004,120,360,276,2890,0.137024221453287,0.166089965397924,0.347404844290657,0.041522491349481,0.124567474048443,0.0955017301038062
"E02000095",426,487,1377,79,408,347,2332,0.182675814751286,0.208833619210978,0.590480274442539,0.0338765008576329,0.174957118353345,0.148799313893654
"E02000096",361,208,1096,51,157,310,1752,0.206050228310502,0.118721461187215,0.625570776255708,0.0291095890410959,0.0896118721461187,0.176940639269406
"E02000097",422,353,1329,91,262,331,2064,0.204457364341085,0.171027131782946,0.643895348837209,0.0440891472868217,0.126937984496124,0.160368217054264
"E02000098",389,709,598,155,554,234,2514,0.154733492442323,0.282020684168656,0.237867939538584,0.0616547334924423,0.220365950676213,0.0930787589498807
"E02000099",383,254,1056,51,203,332,2249,0.170297910182303,0.11293908403735,0.469542018674967,0.0226767452200978,0.0902623388172521,0.147621164962205
"E02000100",275,251,919,57,194,218,1593,0.17263025737602,0.157564344005022,0.576898932831136,0.0357815442561205,0.121782799748901,0.1368487131199
"E02000101",316,605,989,87,518,229,2992,0.105614973262032,0.202205882352941,0.330548128342246,0.0290775401069519,0.173128342245989,0.0765374331550802
"E02000102",455,312,1411,50,262,405,2503,0.181781861765881,0.124650419496604,0.563723531761886,0.0199760287654814,0.104674390731123,0.1618058330004
"E02000103",375,410,1325,54,356,321,3010,0.124584717607973,0.136212624584718,0.440199335548173,0.0179401993355482,0.118272425249169,0.106644518272425
"E02000104",315,361,864,66,295,249,2056,0.153210116731518,0.175583657587549,0.420233463035019,0.0321011673151751,0.143482490272374,0.121108949416342
"E02000105",451,442,1209,87,355,364,2733,0.165020124405415,0.161727039882913,0.442371020856202,0.0318331503841932,0.129893889498719,0.133186974021222
"E02000106",616,484,2368,80,404,536,3946,0.156107450582869,0.122655854029397,0.600101368474404,0.020273694880892,0.102382159148505,0.135833755701977
"E02000107",599,192,3064,16,176,583,4297,0.139399581103095,0.0446823365138469,0.71305562020014,0.00372352804282057,0.0409588084710263,0.135676053060275
"E02000108",289,244,885,52,192,237,1850,0.156216216216216,0.131891891891892,0.478378378378378,0.0281081081081081,0.103783783783784,0.128108108108108
"E02000110",434,185,1718,28,157,406,2682,0.161819537658464,0.0689783743475019,0.640566741237882,0.0104399701715138,0.0585384041759881,0.15137956748695
"E02000111",452,690,1031,157,533,295,2875,0.157217391304348,0.24,0.358608695652174,0.0546086956521739,0.185391304347826,0.102608695652174
"E02000112",394,312,1518,65,247,329,4074,0.0967108492881689,0.0765832106038292,0.37260677466863,0.0159548355424644,0.0606283750613648,0.0807560137457045
"E02000113",339,516,976,52,464,287,2724,0.124449339207048,0.18942731277533,0.358296622613803,0.0190895741556534,0.170337738619677,0.105359765051395
"E02000114",522,147,2610,12,135,510,3804,0.137223974763407,0.0386435331230284,0.686119873817035,0.00315457413249211,0.0354889589905363,0.134069400630915
"E02000115",250,372,1859,12,360,238,3713,0.067330999192028,0.100188526797738,0.50067330999192,0.00323188796121734,0.0969566388365203,0.0640991112308107
"E02000116",483,130,1829,23,107,460,3168,0.152462121212121,0.0410353535353535,0.577335858585859,0.00726010101010101,0.0337752525252525,0.14520202020202
"E02000117",579,296,2482,41,255,538,4340,0.133410138248848,0.0682027649769585,0.571889400921659,0.00944700460829493,0.0587557603686636,0.123963133640553
"E02000118",395,291,1406,56,235,339,3148,0.125476493011436,0.0924396442185515,0.446632782719187,0.0177890724269377,0.0746505717916137,0.107687420584498
"E02000119",158,99,686,3,96,155,4483,0.0352442560785188,0.0220834262770466,0.153022529556101,0.000669194735668079,0.0214142315413785,0.0345750613428508
"E02000120",377,214,2926,6,208,371,4304,0.087592936802974,0.0497211895910781,0.679832713754647,0.00139405204460967,0.0483271375464684,0.0861988847583643
"E02000121",376,347,1135,54,293,322,3584,0.104910714285714,0.0968191964285714,0.316685267857143,0.0150669642857143,0.0817522321428571,0.08984375
"E02000122",384,209,1704,29,180,355,2619,0.146620847651775,0.0798014509354716,0.650630011454754,0.0110729285987018,0.0687285223367698,0.135547919053074
"E02000123",820,221,4285,26,195,794,6037,0.135829054165976,0.0366075865496107,0.709789630611231,0.0043067748881895,0.0323008116614212,0.131522279277787
"E02000124",563,145,2773,18,127,545,4230,0.133096926713948,0.0342789598108747,0.655555555555556,0.00425531914893617,0.0300236406619385,0.128841607565012
"E02000125",546,69,2734,12,57,534,3279,0.16651418115279,0.0210430009149131,0.833790789874962,0.00365965233302836,0.0173833485818847,0.162854528819762
"E02000126",68,182,608,2,180,66,3393,0.0200412614205718,0.053639846743295,0.179192455054524,0.000589448865310934,0.0530503978779841,0.0194518125552608
"E02000127",509,896,664,224,672,285,3124,0.162932138284251,0.286811779769526,0.212548015364917,0.0717029449423816,0.215108834827145,0.0912291933418694
"E02000128",512,546,1206,124,422,388,2432,0.210526315789474,0.224506578947368,0.495888157894737,0.0509868421052632,0.173519736842105,0.159539473684211
"E02000130",576,258,2235,52,206,524,3517,0.163775945408018,0.0733579755473415,0.635484788171737,0.0147853284048905,0.058572647142451,0.148990617003128
"E02000131",442,693,2737,59,634,383,5454,0.081041437477081,0.127062706270627,0.501833516685002,0.0108177484415108,0.116244957829116,0.0702236890355702
"E02000132",451,1316,1078,116,1200,335,5631,0.0800923459421062,0.233706268868762,0.191440241520156,0.0206002486236903,0.213106020245072,0.0594920973184159
"E02000133",658,1062,779,309,753,349,3736,0.176124197002141,0.284261241970021,0.208511777301927,0.0827087794432548,0.201552462526767,0.0934154175588865
"E02000134",693,900,2604,128,772,565,5538,0.125135427952329,0.162513542795233,0.470205850487541,0.0231130371975442,0.139400505597689,0.102022390754785
"E02000135",526,656,1723,94,562,432,4593,0.11452209884607,0.142826039625517,0.375136076638363,0.020465926409754,0.122360113215763,0.0940561724363161
"E02000136",413,515,348,186,329,227,1873,0.220501868659904,0.274959957287774,0.185798184730379,0.0993059263214095,0.175654030966364,0.121195942338494
"E02000137",424,1020,1118,142,878,282,3482,0.121769098219414,0.292935094773119,0.321079839172889,0.0407811602527283,0.252153934520391,0.0809879379666858
"E02000138",402,1247,1005,121,1126,281,4197,0.09578270192995,0.297116988324994,0.239456754824875,0.0288301167500596,0.268286871574934,0.0669525851798904
"E02000139",554,242,1750,59,183,495,3021,0.183382985766303,0.0801059251903343,0.579278384640847,0.0195299569678914,0.0605759682224429,0.163853028798411
"E02000140",452,535,770,163,372,289,2655,0.170244821092279,0.2015065913371,0.290018832391714,0.0613935969868173,0.140112994350282,0.108851224105461
"E02000141",464,237,1863,26,211,438,2942,0.157715839564922,0.0805574439157036,0.633242692046227,0.008837525492862,0.0717199184228416,0.14887831407206
"E02000142",459,489,1241,93,396,366,2916,0.157407407407407,0.167695473251029,0.425582990397805,0.0318930041152263,0.135802469135802,0.125514403292181
"E02000144",549,795,1497,157,638,392,4230,0.129787234042553,0.187943262411348,0.353900709219858,0.0371158392434988,0.150827423167849,0.0926713947990544
"E02000145",583,616,678,206,410,377,3017,0.193238316208154,0.204176334106729,0.224726549552536,0.0682797480941332,0.135896586012595,0.124958568114021
"E02000146",511,370,1813,74,296,437,3804,0.134332281808623,0.0972660357518402,0.476603575184017,0.019453207150368,0.0778128286014721,0.114879074658254
"E02000147",430,622,900,149,473,281,2401,0.179092044981258,0.259058725531029,0.374843815077051,0.0620574760516451,0.197001249479384,0.117034568929613
"E02000148",464,456,887,137,319,327,2112,0.21969696969697,0.215909090909091,0.419981060606061,0.0648674242424242,0.151041666666667,0.154829545454545
"E02000149",551,634,1071,174,460,377,2792,0.197349570200573,0.227077363896848,0.383595988538682,0.0623209169054441,0.164756446991404,0.135028653295129
"E02000150",446,207,1200,52,155,394,2458,0.181448331977217,0.0842148087876322,0.48820179007323,0.0211554109031733,0.0630593978844589,0.160292921074044
"E02000151",487,357,1235,131,226,356,2007,0.24265072247135,0.177877428998505,0.615346287992028,0.0652715495764823,0.112605879422023,0.177379172894868
"E02000152",314,363,800,103,260,211,2572,0.122083981337481,0.141135303265941,0.31104199066874,0.0400466562986003,0.101088646967341,0.0820373250388803
"E02000153",389,518,839,145,373,244,1859,0.209252286175363,0.278644432490586,0.451317912856374,0.0779989241527703,0.200645508337816,0.131253362022593
"E02000154",515,506,1141,145,361,370,3264,0.157781862745098,0.155024509803922,0.349571078431373,0.0444240196078431,0.110600490196078,0.113357843137255
"E02000155",636,631,993,207,424,429,2340,0.271794871794872,0.26965811965812,0.424358974358974,0.0884615384615385,0.181196581196581,0.183333333333333
"E02000156",687,405,1946,123,282,564,3440,0.199709302325581,0.117732558139535,0.565697674418605,0.0357558139534884,0.0819767441860465,0.163953488372093
"E02000157",641,926,629,320,606,321,2307,0.277850021673169,0.401387082791504,0.272648461205028,0.138708279150412,0.262678803641092,0.139141742522757
"E02000158",485,751,465,236,515,249,2187,0.221764974851395,0.343392775491541,0.212620027434842,0.107910379515318,0.235482395976223,0.113854595336077
"E02000159",459,591,754,188,403,271,2171,0.21142330723169,0.272224781206817,0.347305389221557,0.0865960386918471,0.18562874251497,0.124827268539843
"E02000160",422,418,1094,115,303,307,2162,0.195189639222942,0.193339500462535,0.506012950971323,0.0531914893617021,0.140148011100833,0.14199814986124
"E02000161",607,805,505,251,554,356,2394,0.253550543024227,0.33625730994152,0.2109440267335,0.10484544695071,0.23141186299081,0.148705096073517
"E02000162",499,708,500,204,504,295,2512,0.198646496815287,0.281847133757962,0.199044585987261,0.0812101910828025,0.200636942675159,0.117436305732484
"E02000163",508,635,569,201,434,307,2180,0.23302752293578,0.291284403669725,0.261009174311927,0.0922018348623853,0.199082568807339,0.140825688073394
"E02000165",518,861,117,280,581,238,2023,0.256055363321799,0.42560553633218,0.0578348986653485,0.13840830449827,0.28719723183391,0.117647058823529
"E02000166",208,223,1603,24,199,184,2633,0.0789973414356248,0.0846942650968477,0.608811241929358,0.0091150778579567,0.075579187238891,0.0698822635776681
"E02000167",349,241,2406,27,214,322,3420,0.102046783625731,0.0704678362573099,0.703508771929825,0.00789473684210526,0.0625730994152047,0.0941520467836257
"E02000168",298,146,2043,7,139,291,3243,0.0918902251002159,0.0450200431699044,0.629972247918594,0.00215849522047487,0.0428615479494295,0.089731729879741
"E02000169",271,152,1816,18,134,253,3319,0.081651099728834,0.0457969267851763,0.547152756854474,0.00542332027719193,0.0403736065079843,0.0762277794516421
"E02000170",332,93,2663,16,77,316,3760,0.0882978723404255,0.0247340425531915,0.708244680851064,0.00425531914893617,0.0204787234042553,0.0840425531914894
"E02000171",269,177,2021,7,170,262,3072,0.0875651041666667,0.0576171875,0.657877604166667,0.00227864583333333,0.0553385416666667,0.0852864583333333
"E02000172",145,305,1220,14,291,131,3674,0.0394665215024496,0.083015786608601,0.332063146434404,0.00381056069678824,0.0792052259118127,0.0356559608056614
"E02000173",175,223,2235,11,212,164,3989,0.0438706442717473,0.055903735271998,0.560290799699173,0.00275758335422412,0.0531461519177739,0.0411130609175232
"E02000174",232,197,2246,4,193,228,3239,0.0716270453843779,0.0608212411238036,0.693423896264279,0.00123494905835134,0.0595862920654523,0.0703920963260266
"E02000175",333,357,2733,9,348,324,4908,0.0678484107579462,0.0727383863080685,0.556845965770171,0.00183374083129584,0.0709046454767726,0.0660146699266504
"E02000176",207,144,2395,3,141,204,3274,0.0632254123396457,0.0439828955406231,0.731521075137447,0.000916310323762981,0.0430665852168601,0.0623091020158827
"E02000177",139,524,1684,3,521,136,3699,0.0375777237091106,0.141659908083266,0.455258177885915,0.0008110300081103,0.140848878075155,0.0367666937010003
"E02000178",299,344,2701,19,325,280,4652,0.0642734307824592,0.0739466895958727,0.58061049011178,0.00408426483233018,0.0698624247635426,0.060189165950129
"E02000179",96,459,1274,8,451,88,2660,0.0360902255639098,0.172556390977444,0.478947368421053,0.00300751879699248,0.169548872180451,0.0330827067669173
"E02000180",193,207,1735,11,196,182,3745,0.0515353805073431,0.0552736982643525,0.46328437917223,0.00293724966622163,0.0523364485981308,0.0485981308411215
"E02000181",238,162,2948,7,155,231,3873,0.0614510715207849,0.0418280402788536,0.761167053963336,0.00180738445649367,0.0400206558223599,0.0596436870642912
"E02000182",131,475,1794,24,451,107,3683,0.0355688297583492,0.128970947597068,0.487102905240293,0.0065164268259571,0.122454520771111,0.0290524029323921
"E02000183",204,381,1902,18,363,186,3759,0.0542697525937749,0.101356743814844,0.505985634477255,0.00478850758180367,0.0965682362330407,0.0494812450119713
"E02000184",169,314,1280,14,300,155,4287,0.039421506881269,0.0732446932586891,0.298577093538605,0.00326568696057849,0.0699790062981106,0.0361558199206905
"E02000185",116,325,1681,6,319,110,4011,0.0289204687110446,0.081027175268013,0.419097481924707,0.00149588631264024,0.0795312889553727,0.0274245823984044
"E02000186",178,271,1990,7,264,171,4104,0.0433723196881092,0.0660331384015595,0.484892787524366,0.0017056530214425,0.064327485380117,0.0416666666666667
"E02000187",80,220,1306,2,218,78,4915,0.0162767039674466,0.0447609359104781,0.265717192268566,0.000406917599186165,0.044354018311292,0.0158697863682604
"E02000188",33,430,586,7,423,26,2956,0.0111637347767253,0.145466847090663,0.198240866035183,0.0023680649526387,0.143098782138024,0.0087956698240866
"E02000191",65,131,2051,0,131,65,3388,0.019185360094451,0.0386658795749705,0.605371900826446,0,0.0386658795749705,0.019185360094451
"E02000192",73,313,1650,2,311,71,3887,0.0187805505531258,0.0805248263442243,0.424491896063802,0.000514535631592488,0.0800102907126319,0.0182660149215333
"E02000193",94,205,2090,1,204,93,4699,0.0200042562247287,0.0436263034688232,0.444775484145563,0.000212811236433284,0.0434134922323899,0.0197914449882954
"E02000194",436,910,1757,141,769,295,4431,0.0983976529000226,0.205371248025276,0.39652448657188,0.031821259309411,0.173549988715865,0.0665763935906116
"E02000195",448,457,1572,73,384,375,2733,0.163922429564581,0.167215514087084,0.575192096597146,0.0267105744603,0.140504939626784,0.137211855104281
"E02000196",366,97,1332,21,76,345,2248,0.162811387900356,0.0431494661921708,0.592526690391459,0.00934163701067616,0.0338078291814947,0.15346975088968
"E02000197",481,205,1845,43,162,438,2820,0.170567375886525,0.0726950354609929,0.654255319148936,0.0152482269503546,0.0574468085106383,0.15531914893617
"E02000198",497,388,1934,49,339,448,3354,0.148181276088253,0.115682766845558,0.576624925462135,0.0146094215861658,0.101073345259392,0.133571854502087
"E02000199",495,136,2072,29,107,466,2684,0.184426229508197,0.0506706408345753,0.771982116244411,0.0108047690014903,0.0398658718330849,0.173621460506706
"E02000200",430,565,2049,63,502,367,4008,0.107285429141717,0.140968063872255,0.51122754491018,0.0157185628742515,0.125249500998004,0.0915668662674651
"E02000201",493,460,1847,62,398,431,4226,0.116658778987222,0.108849976336962,0.437056318031235,0.0146710837671557,0.094178892569806,0.101987695220066
"E02000202",459,117,1897,23,94,436,2508,0.183014354066986,0.0466507177033493,0.756379585326954,0.00917065390749601,0.0374800637958533,0.17384370015949
"E02000203",437,312,1830,42,270,395,2875,0.152,0.108521739130435,0.636521739130435,0.0146086956521739,0.0939130434782609,0.137391304347826
"E02000204",512,157,1863,35,122,477,2725,0.187889908256881,0.0576146788990826,0.683669724770642,0.0128440366972477,0.0447706422018349,0.175045871559633
"E02000206",557,470,2504,76,394,481,4552,0.122363796133568,0.103251318101933,0.550087873462214,0.0166959578207381,0.0865553602811951,0.10566783831283
"E02000207",535,442,1489,100,342,435,3393,0.157677571470675,0.130268199233716,0.438844680223991,0.0294724432655467,0.10079575596817,0.128205128205128
"E02000208",443,428,1588,49,379,394,4335,0.102191464821223,0.0987312572087659,0.366320645905421,0.0113033448673587,0.0874279123414071,0.0908881199538639
"E02000209",541,248,1577,40,208,501,2749,0.196798835940342,0.0902146234994543,0.57366315023645,0.0145507457257184,0.0756638777737359,0.182248090214623
"E02000210",495,198,1896,39,159,456,2991,0.165496489468405,0.0661985957873621,0.633901705115346,0.0130391173520562,0.0531594784353059,0.152457372116349
"E02000211",439,499,829,74,425,365,2394,0.183375104427736,0.20843776106934,0.346282372598162,0.0309106098579783,0.177527151211362,0.152464494569758
"E02000212",362,275,1562,57,218,305,3320,0.109036144578313,0.0828313253012048,0.470481927710843,0.0171686746987952,0.0656626506024096,0.0918674698795181
"E02000213",473,479,2027,59,420,414,6217,0.0760817114363841,0.0770468071417082,0.326041499115329,0.00949010776902043,0.0675566993726878,0.0665916036673637
"E02000214",342,87,1209,20,67,322,1648,0.20752427184466,0.0527912621359223,0.733616504854369,0.0121359223300971,0.0406553398058252,0.195388349514563
"E02000215",608,717,3065,56,661,552,6100,0.099672131147541,0.117540983606557,0.502459016393443,0.00918032786885246,0.108360655737705,0.0904918032786885
"E02000216",399,1230,403,190,1040,209,3103,0.128585240090235,0.396390589751853,0.129874315178859,0.0612310667096358,0.335159523042217,0.0673541733805994
"E02000217",500,407,2017,41,366,459,5746,0.0870170553428472,0.0708318830490776,0.351026801253046,0.00713539853811347,0.0636964845109641,0.0798816568047337
"E02000218",269,460,561,84,376,185,1667,0.161367726454709,0.275944811037792,0.336532693461308,0.0503899220155969,0.225554889022196,0.110977804439112
"E02000219",457,483,1008,136,347,321,2130,0.214553990610329,0.226760563380282,0.473239436619718,0.063849765258216,0.162910798122066,0.150704225352113
"E02000221",454,595,1162,98,497,356,3765,0.12058432934927,0.158034528552457,0.30863213811421,0.0260292164674635,0.132005312084993,0.0945551128818061
"E02000222",480,437,1762,90,347,390,3619,0.132633324122686,0.120751588836695,0.486874827300359,0.0248687482730036,0.0958828405636916,0.107764575849682
"E02000223",215,508,91,78,430,137,2080,0.103365384615385,0.244230769230769,0.04375,0.0375,0.206730769230769,0.0658653846153846
"E02000224",494,438,1948,87,351,407,3390,0.145722713864307,0.129203539823009,0.574631268436578,0.0256637168141593,0.10353982300885,0.120058997050147
"E02000225",315,593,147,150,443,165,1979,0.159171298635675,0.299646286003032,0.0742799393633148,0.0757958564931784,0.223850429509853,0.0833754421424962
"E02000226",502,853,343,284,569,218,1884,0.266454352441614,0.45276008492569,0.182059447983015,0.150743099787686,0.302016985138004,0.115711252653928
"E02000227",845,1913,465,523,1390,322,3869,0.218402688033083,0.494443008529336,0.120186094598087,0.135177048332903,0.359265960196433,0.0832256397001809
"E02000228",511,746,594,214,532,297,2286,0.223534558180227,0.326334208223972,0.259842519685039,0.0936132983377078,0.232720909886264,0.12992125984252
"E02000229",339,531,89,135,396,204,2015,0.168238213399504,0.263523573200993,0.0441687344913151,0.0669975186104218,0.196526054590571,0.101240694789082
"E02000230",639,730,1282,186,544,453,4612,0.138551604509974,0.158282740676496,0.277970511708586,0.0403295750216826,0.117953165654814,0.0982220294882914
"E02000231",496,420,850,165,255,331,2695,0.18404452690167,0.155844155844156,0.315398886827458,0.0612244897959184,0.0946196660482375,0.122820037105751
"E02000232",360,526,225,185,341,175,1665,0.216216216216216,0.315915915915916,0.135135135135135,0.111111111111111,0.204804804804805,0.105105105105105
"E02000233",395,463,830,133,330,262,2078,0.190086621751684,0.222810394610202,0.399422521655438,0.0640038498556304,0.158806544754572,0.126082771896054
"E02000234",507,620,834,171,449,336,3715,0.136473755047106,0.166890982503365,0.224495289367429,0.0460296096904441,0.120861372812921,0.0904441453566622
"E02000235",414,619,517,169,450,245,2206,0.187669990933817,0.280598368087035,0.234360834088849,0.0766092475067996,0.203989120580236,0.111060743427017
"E02000236",441,395,1038,122,273,319,2434,0.181183237469187,0.16228430566968,0.42645850451931,0.0501232539030403,0.112161051766639,0.131059983566146
"E02000237",551,664,552,226,438,325,2232,0.246863799283154,0.297491039426523,0.247311827956989,0.101254480286738,0.196236559139785,0.145609318996416
"E02000238",469,566,1316,163,403,306,4075,0.115092024539877,0.138895705521472,0.322944785276074,0.04,0.0988957055214724,0.0750920245398773
"E02000239",408,375,1298,76,299,332,2214,0.184281842818428,0.169376693766938,0.586269196025294,0.034327009936766,0.135049683830172,0.149954832881662
"E02000240",608,1032,627,287,745,321,3428,0.177362893815636,0.301050175029172,0.182905484247375,0.0837222870478413,0.21732788798133,0.0936406067677946
"E02000241",412,390,1086,98,292,314,2090,0.197129186602871,0.186602870813397,0.519617224880383,0.0468899521531101,0.139712918660287,0.150239234449761
"E02000242",298,331,793,90,241,208,1762,0.169125993189557,0.187854710556186,0.45005675368899,0.0510783200908059,0.13677639046538,0.118047673098751
"E02000243",481,578,1107,133,445,348,3072,0.156575520833333,0.188151041666667,0.3603515625,0.0432942708333333,0.144856770833333,0.11328125
"E02000244",437,1047,763,254,793,183,2942,0.148538409245411,0.35588035350102,0.259347382732835,0.0863358259687288,0.269544527532291,0.0622025832766825
"E02000245",400,1246,217,208,1038,192,3485,0.114777618364419,0.357532281205165,0.0622668579626973,0.0596843615494978,0.297847919655667,0.0550932568149211
"E02000246",447,972,480,200,772,247,2749,0.162604583484904,0.353583121134958,0.174608948708621,0.0727537286285922,0.280829392506366,0.0898508548563114
"E02000247",500,1066,625,228,838,272,3525,0.141843971631206,0.302411347517731,0.177304964539007,0.0646808510638298,0.237730496453901,0.0771631205673759
"E02000248",368,921,1089,147,774,221,3403,0.108139876579489,0.270643549808992,0.320011754334411,0.0431971789597414,0.227446370849251,0.0649426976197473
"E02000249",370,309,1220,59,250,311,2377,0.155658392932268,0.129995793016407,0.513251998317207,0.0248212031973075,0.1051745898191,0.13083718973496
"E02000250",372,550,1091,115,435,257,2080,0.178846153846154,0.264423076923077,0.524519230769231,0.0552884615384615,0.209134615384615,0.123557692307692
"E02000251",288,305,1137,67,238,221,1676,0.171837708830549,0.181980906921241,0.678400954653938,0.0399761336515513,0.14200477326969,0.131861575178998
"E02000252",490,467,1504,76,391,414,5865,0.0835464620630861,0.0796248934356351,0.256436487638534,0.0129582267689685,0.0666666666666667,0.0705882352941176
"E02000253",486,845,566,168,677,318,3061,0.158771643253839,0.276053577262333,0.184906893172166,0.0548840248284874,0.221169552433845,0.103887618425351
"E02000254",259,225,1226,44,181,215,1728,0.149884259259259,0.130208333333333,0.709490740740741,0.025462962962963,0.10474537037037,0.124421296296296
"E02000255",449,1169,1279,133,1036,316,3675,0.122176870748299,0.318095238095238,0.348027210884354,0.0361904761904762,0.281904761904762,0.0859863945578231
"E02000256",401,644,1982,28,616,373,4407,0.0909916042659406,0.146131154980712,0.449739051508963,0.00635352847742228,0.13977762650329,0.0846380757885183
"E02000258",334,371,1531,65,306,269,2593,0.128808330119553,0.143077516390282,0.590435788661782,0.0250674893945237,0.118010026995758,0.103740840725029
"E02000259",404,256,1272,61,195,343,2042,0.197845249755142,0.125367286973555,0.622918707149853,0.0298726738491675,0.0954946131243879,0.167972575905975
"E02000260",286,477,1149,85,392,201,2369,0.120726044744618,0.201350780920219,0.485014774166315,0.0358801181933305,0.165470662726889,0.0848459265512875
"E02000261",407,572,1822,115,457,292,5461,0.0745284746383446,0.104742721113349,0.333638527742172,0.0210584142098517,0.0836843069034975,0.0534700604284929
"E02000262",405,174,2463,25,149,380,4537,0.0892660348247741,0.0383513334802733,0.542869737712145,0.00551024906325766,0.0328410844170157,0.0837557857615164
"E02000263",448,333,1952,67,266,381,3739,0.119818133190693,0.0890612463225461,0.522064723188018,0.0179192297405723,0.0711420165819738,0.10189890345012
"E02000264",388,379,1964,39,340,349,3759,0.103218941207768,0.100824687416866,0.522479382814578,0.0103750997605746,0.0904495876562916,0.0928438414471934
"E02000265",688,280,2362,54,226,634,5361,0.12833426599515,0.0522290617422123,0.440589442268234,0.0100727476217124,0.0421563141204999,0.118261518373438
"E02000266",503,784,578,160,624,343,4240,0.118632075471698,0.184905660377358,0.136320754716981,0.0377358490566038,0.147169811320755,0.0808962264150943
"E02000267",449,265,1711,50,215,399,3362,0.133551457465794,0.0788221296847115,0.508923259964307,0.0148720999405116,0.0639500297441999,0.118679357525283
"E02000268",531,457,2068,84,373,447,3478,0.152673950546291,0.13139735480161,0.594594594594595,0.0241518113858539,0.107245543415756,0.128522139160437
"E02000269",479,172,2124,19,153,460,2923,0.163872733492987,0.0588436537803626,0.726650701334246,0.00650017105713308,0.0523434827232296,0.157372562435854
"E02000270",203,470,1079,17,453,186,5044,0.0402458366375892,0.0931800158604282,0.213917525773196,0.00337034099920698,0.0898096748612213,0.0368754956383822
"E02000271",399,65,2072,11,54,388,2827,0.141139016625398,0.0229925716307039,0.732932437212593,0.00389105058365759,0.0191015210470463,0.13724796604174
"E02000272",353,169,1340,31,138,322,1840,0.191847826086957,0.0918478260869565,0.728260869565217,0.0168478260869565,0.075,0.175
"E02000275",324,300,1061,54,246,270,2437,0.132950348789495,0.123102174805088,0.435371358227329,0.0221583914649159,0.100943783340172,0.110791957324579
"E02000276",479,190,1769,35,155,444,2770,0.172924187725632,0.0685920577617329,0.638628158844765,0.0126353790613718,0.055956678700361,0.16028880866426
"E02000277",399,457,1439,83,374,316,2400,0.16625,0.190416666666667,0.599583333333333,0.0345833333333333,0.155833333333333,0.131666666666667
"E02000278",483,783,1087,135,648,348,3279,0.147301006404392,0.238792314730101,0.331503507166819,0.0411710887465691,0.197621225983532,0.106129917657823
"E02000279",658,528,1388,102,426,556,4774,0.13782991202346,0.110599078341014,0.290741516547968,0.0213657310431504,0.0892333472978634,0.11646418098031
"E02000280",489,501,1486,111,390,378,2842,0.172061928219564,0.176284306826179,0.522871217452498,0.0390570021111893,0.137227304714989,0.133004926108374
"E02000281",530,774,966,211,563,319,3363,0.15759738328873,0.230151650312221,0.287243532560214,0.0627415997621172,0.167410050550104,0.0948557835266131
"E02000282",450,763,1343,85,678,365,3562,0.126333520494104,0.21420550252667,0.377035373385738,0.0238629983155531,0.190342504211117,0.102470522178551
"E02000283",494,424,1703,95,329,399,2572,0.192068429237947,0.164852255054432,0.662130637636081,0.0369362363919129,0.127916018662519,0.155132192846034
"E02000284",556,654,1396,124,530,432,3311,0.167925098157656,0.197523406825732,0.421624886741166,0.0374509211718514,0.160072485653881,0.130474176985805
"E02000285",349,181,1276,46,135,303,1714,0.203617269544924,0.105600933488915,0.744457409568261,0.0268378063010502,0.0787631271878646,0.176779463243874
"E02000286",537,1146,698,195,951,342,4051,0.132559861762528,0.282893112811651,0.172303135028388,0.0481362626511972,0.234756850160454,0.0844235991113305
"E02000287",394,615,761,152,463,242,2974,0.132481506388702,0.206792199058507,0.255884330867518,0.0511096166778749,0.155682582380632,0.0813718897108272
"E02000288",652,801,1665,171,630,481,4243,0.153664859769031,0.18878152250766,0.392411029931652,0.0403016733443318,0.148479849163328,0.1133631864247
"E02000289",361,641,532,180,461,181,1665,0.216816816816817,0.384984984984985,0.31951951951952,0.108108108108108,0.276876876876877,0.108708708708709
"E02000290",348,320,657,92,228,256,2934,0.118609406952965,0.10906612133606,0.223926380368098,0.0313565098841172,0.0777096114519427,0.087252897068848
"E02000291",601,952,1562,118,834,483,4594,0.130822812363953,0.207226817588158,0.340008707009142,0.0256856769699608,0.181541140618198,0.105137135393992
"E02000292",584,244,2402,48,196,536,2987,0.195513893538668,0.0816873116839638,0.804151322397054,0.0160696350853699,0.0656176765985939,0.179444258453298
"E02000293",362,322,977,52,270,310,1864,0.194206008583691,0.17274678111588,0.524141630901288,0.0278969957081545,0.144849785407725,0.166309012875536
"E02000294",466,691,1415,145,546,321,2568,0.181464174454829,0.269080996884735,0.55101246105919,0.0564641744548287,0.212616822429907,0.125
"E02000295",355,607,1074,104,503,251,2837,0.12513218188227,0.213958406767712,0.37856891082129,0.0366584420162143,0.177299964751498,0.0884737398660557
"E02000296",589,986,1393,161,825,428,4368,0.134844322344322,0.225732600732601,0.318910256410256,0.0368589743589744,0.188873626373626,0.097985347985348
"E02000297",534,219,1686,68,151,466,2602,0.205226748654881,0.0841660261337433,0.647963105303613,0.0261337432744043,0.058032282859339,0.179093005380477
"E02000298",441,218,1626,51,167,390,2230,0.197757847533632,0.0977578475336323,0.72914798206278,0.0228699551569507,0.0748878923766816,0.174887892376682
"E02000299",573,295,2320,54,241,519,3381,0.169476486246673,0.0872522922212363,0.686187518485655,0.0159716060337178,0.0712806861875185,0.153504880212955
"E02000300",493,269,1821,72,197,421,2846,0.173225579761068,0.0945186226282502,0.639845397048489,0.0252986647926915,0.0692199578355587,0.147926914968377
"E02000301",527,537,1531,105,432,422,3872,0.136105371900826,0.138688016528926,0.395402892561983,0.0271177685950413,0.111570247933884,0.108987603305785
"E02000302",475,407,1449,82,325,393,2399,0.1979991663193,0.169654022509379,0.604001667361401,0.0341809087119633,0.135473113797416,0.163818257607336
"E02000303",475,403,1684,78,325,397,2959,0.160527205136871,0.136194660358229,0.569111186211558,0.0263602568435282,0.109834403514701,0.134166948293342
"E02000304",404,201,1439,52,149,352,2061,0.196021348859777,0.0975254730713246,0.698204754973314,0.0252304706453178,0.0722950024260068,0.170790878214459
"E02000305",601,201,2348,24,177,577,3286,0.182897139379184,0.0611685940353013,0.714546561168594,0.00730371272063299,0.0538648813146683,0.175593426658551
"E02000306",249,377,949,39,338,210,3395,0.0733431516936672,0.111045655375552,0.279528718703976,0.0114874815905744,0.0995581737849779,0.0618556701030928
"E02000307",516,161,2292,34,127,482,2634,0.195899772209567,0.0611237661351557,0.870159453302961,0.0129081245254366,0.0482156416097191,0.182991647684131
"E02000308",409,415,1482,74,341,335,3011,0.135835270674195,0.137827964131518,0.492195283958818,0.0245765526403188,0.113251411491199,0.111258718033876
"E02000309",671,347,2489,60,287,611,4361,0.153863792708094,0.0795689062141711,0.570740655812887,0.0137583123136895,0.0658105939004815,0.140105480394405
"E02000311",564,340,1708,86,254,478,3116,0.181001283697047,0.109114249037227,0.54813863928113,0.027599486521181,0.0815147625160462,0.153401797175866
"E02000312",654,265,2980,23,242,631,4515,0.14485049833887,0.0586932447397564,0.660022148394241,0.00509413067552602,0.0535991140642303,0.139756367663344
"E02000313",185,639,55,87,552,98,2654,0.0697061039939714,0.24076865109269,0.020723436322532,0.0327807083647325,0.207987942727958,0.0369253956292389
"E02000314",410,227,13,56,171,354,4520,0.0907079646017699,0.0502212389380531,0.00287610619469027,0.0123893805309735,0.0378318584070796,0.0783185840707965
"E02000315",381,691,384,174,517,207,3112,0.122429305912596,0.222043701799486,0.123393316195373,0.0559125964010283,0.166131105398458,0.0665167095115681
"E02000317",179,405,713,33,372,146,2416,0.0740894039735099,0.167632450331126,0.295115894039735,0.013658940397351,0.153973509933775,0.0604304635761589
"E02000318",457,234,1990,35,199,422,3062,0.149248856956238,0.0764206401045069,0.649902024820379,0.011430437622469,0.0649902024820379,0.137818419333769
"E02000319",385,164,1472,25,139,360,3974,0.0968797181680926,0.0412682435832914,0.370407649723201,0.00629089079013588,0.0349773527931555,0.0905888273779567
"E02000320",290,200,1334,26,174,264,2047,0.141670737664875,0.0977039570102589,0.651685393258427,0.0127015144113337,0.0850024425989253,0.128969223253542
"E02000321",217,275,712,36,239,181,2415,0.0898550724637681,0.113871635610766,0.294824016563147,0.0149068322981366,0.0989648033126294,0.0749482401656315
"E02000323",327,278,1794,35,243,292,4769,0.0685678339274481,0.0582931432166073,0.376179492556091,0.00733906479345775,0.0509540784231495,0.0612287691339904
"E02000324",236,244,1066,29,215,207,2549,0.0925853275794429,0.095723813260102,0.418203216947823,0.0113770105923892,0.0843468026677128,0.0812083169870537
"E02000326",347,127,1581,17,110,330,2822,0.122962437987243,0.0450035435861091,0.560240963855422,0.00602409638554217,0.038979447200567,0.116938341601701
"E02000327",129,329,530,28,301,101,2771,0.046553590761458,0.118729700469145,0.19126669072537,0.0101046553590761,0.108625045110069,0.0364489354023818
"E02000328",302,206,1518,23,183,279,2903,0.104030313468825,0.0709610747502584,0.522907337237341,0.00792283844299001,0.0630382363072683,0.0961074750258353
"E02000329",319,283,1029,88,195,231,1802,0.177025527192009,0.157047724750277,0.571032186459489,0.048834628190899,0.108213096559378,0.12819089900111
"E02000331",304,399,815,69,330,235,2836,0.107193229901269,0.140691114245416,0.28737658674189,0.0243300423131171,0.116361071932299,0.0828631875881523
"E02000332",392,500,1401,97,403,295,2437,0.160853508411982,0.205170291341814,0.574887156339762,0.0398030365203119,0.165367254821502,0.12105047189167
"E02000333",300,401,1766,41,360,259,2889,0.103842159916926,0.138802353755625,0.611284181377639,0.0141917618553133,0.124610591900312,0.089650398061613
"E02000334",275,406,751,102,304,173,1952,0.140881147540984,0.207991803278689,0.384733606557377,0.0522540983606557,0.155737704918033,0.0886270491803279
"E02000335",335,184,1296,42,142,293,1696,0.19752358490566,0.108490566037736,0.764150943396226,0.0247641509433962,0.0837264150943396,0.172759433962264
"E02000337",291,227,843,66,161,225,2112,0.137784090909091,0.107481060606061,0.399147727272727,0.03125,0.0762310606060606,0.106534090909091
"E02000339",336,168,1193,33,135,303,1874,0.179295624332978,0.0896478121664888,0.636606189967983,0.0176093916755603,0.0720384204909285,0.161686232657417
"E02000340",371,435,1195,75,360,296,2680,0.138432835820896,0.162313432835821,0.44589552238806,0.0279850746268657,0.134328358208955,0.11044776119403
"E02000341",287,456,361,113,343,174,2242,0.128010704727922,0.203389830508475,0.161016949152542,0.0504014272970562,0.152988403211418,0.0776092774308653
"E02000342",307,225,863,71,154,236,2026,0.151530108588351,0.111056268509378,0.425962487660415,0.0350444225074037,0.0760118460019743,0.116485686080948
"E02000343",337,403,600,113,290,224,1998,0.168668668668669,0.201701701701702,0.3003003003003,0.0565565565565566,0.145145145145145,0.112112112112112
"E02000344",361,301,1119,65,236,296,1811,0.199337382661513,0.166206515737162,0.61789066813915,0.0358917725013805,0.130314743235781,0.163445610160133
"E02000345",245,361,1459,19,342,226,2694,0.0909428359317001,0.134001484780995,0.541573867854491,0.00705270972531552,0.126948775055679,0.0838901262063846
"E02000346",30,304,1065,2,302,28,5108,0.00587314017227878,0.0595144870790916,0.208496476115897,0.000391542678151919,0.0591229444009397,0.00548159749412686
"E02000347",215,202,1514,15,187,200,2605,0.0825335892514395,0.0775431861804223,0.581190019193858,0.00575815738963532,0.071785028790787,0.0767754318618042
"E02000348",195,288,1680,21,267,174,2865,0.0680628272251309,0.100523560209424,0.586387434554974,0.00732984293193717,0.0931937172774869,0.0607329842931937
"E02000350",377,121,2708,7,114,370,3813,0.0988722790453711,0.031733543141883,0.710201940729085,0.001835824809861,0.029897718332022,0.0970364542355101
"E02000351",264,251,2172,10,241,254,4351,0.0606757067340841,0.0576878878418754,0.499195587221328,0.00229832222477591,0.0553895656170995,0.0583773845093082
"E02000352",150,263,1256,12,251,138,2454,0.0611246943765281,0.107171964140179,0.511817440912795,0.00488997555012225,0.102281988590057,0.0562347188264059
"E02000353",365,146,1962,5,141,360,3154,0.11572606214331,0.046290424857324,0.622067216233354,0.0015852885225111,0.0447051363348129,0.114140773620799
"E02000354",280,317,2052,23,294,257,4051,0.0691187361145396,0.0782522833868181,0.506541594667983,0.00567761046655147,0.0725746729202666,0.0634411256479882
"E02000355",395,84,2436,9,75,386,3116,0.126765083440308,0.0269576379974326,0.781771501925546,0.00288831835686778,0.0240693196405648,0.12387676508344
"E02000356",262,197,1942,12,185,250,3027,0.0865543442352164,0.0650809382226627,0.641559299636604,0.00396432111000991,0.0611166171126528,0.0825900231252065
"E02000357",71,263,729,17,246,54,2154,0.0329619312906221,0.122098421541318,0.338440111420613,0.00789229340761374,0.114206128133705,0.0250696378830084
"E02000358",412,361,2851,57,304,355,5022,0.0820390282755874,0.0718837116686579,0.567702110712863,0.0113500597371565,0.0605336519315014,0.0706889685384309
"E02000359",262,168,1468,17,151,245,2279,0.114962702939886,0.0737165423431329,0.644142167617376,0.00745941202281702,0.0662571303203159,0.107503290917069
"E02000360",187,237,2647,26,211,161,4703,0.0397618541356581,0.0503933659366362,0.562832234743781,0.00552838613650861,0.0448649798001276,0.0342334679991495
"E02000361",267,252,2059,27,225,240,3775,0.0707284768211921,0.0667549668874172,0.545430463576159,0.0071523178807947,0.0596026490066225,0.0635761589403974
"E02000362",264,282,646,31,251,233,3110,0.084887459807074,0.0906752411575563,0.207717041800643,0.00996784565916399,0.0807073954983923,0.07491961414791
"E02000363",120,405,1247,21,384,99,3813,0.03147128245476,0.106215578284815,0.327039076842381,0.00550747442958301,0.100708103855232,0.025963808025177
"E02000364",307,299,2106,13,286,294,4066,0.0755041810132809,0.073536645351697,0.517953762911953,0.00319724545007378,0.0703393999016232,0.0723069355632071
"E02000366",249,200,1581,13,187,236,2797,0.0890239542366822,0.0715051841258491,0.565248480514837,0.00464783696818019,0.0668573471576689,0.084376117268502
"E02000367",219,397,1604,33,364,186,4972,0.0440466613032985,0.079847144006436,0.32260659694288,0.00663716814159292,0.0732099758648431,0.0374094931617056
"E02000368",185,697,944,106,591,79,3438,0.0538103548574753,0.202734147760326,0.274578243164631,0.0308318789994183,0.171902268760908,0.022978475858057
"E02000369",76,568,1236,10,558,66,6266,0.012128949888286,0.0906479412703479,0.197255027130546,0.001595914458985,0.0890520268113629,0.010533035429301
"E02000370",73,419,1054,13,406,60,4011,0.0181999501371229,0.104462727499377,0.262777362253802,0.00324108701072052,0.101221640488656,0.0149588631264024
"E02000372",460,545,1950,168,377,292,6733,0.0683202138719739,0.0809446012178821,0.289618297935541,0.0249517302836774,0.0559928709342047,0.0433684835882965
"E02000373",133,212,2060,75,137,58,2762,0.0481535119478639,0.0767559739319334,0.745836350470673,0.0271542360608255,0.0496017378711079,0.0209992758870384
"E02000374",346,404,1463,133,271,213,2505,0.13812375249501,0.16127744510978,0.584031936127745,0.0530938123752495,0.108183632734531,0.0850299401197605
"E02000375",223,128,1767,8,120,215,3805,0.0586070959264126,0.0336399474375821,0.464388961892247,0.00210249671484888,0.0315374507227332,0.0565045992115637
"E02000376",258,170,2426,8,162,250,3502,0.0736721873215306,0.0485436893203883,0.692747001713307,0.00228440890919475,0.0462592804111936,0.0713877784123358
"E02000377",301,121,2601,8,113,293,3652,0.082420591456736,0.0331325301204819,0.712212486308872,0.00219058050383352,0.0309419496166484,0.0802300109529025
"E02000378",165,379,2607,7,372,158,3717,0.0443906376109766,0.101963949421577,0.70137207425343,0.00188323917137476,0.100080710250202,0.0425073984396018
"E02000379",248,290,1377,9,281,239,3236,0.0766378244746601,0.0896168108776267,0.425525339925834,0.00278121137206428,0.0868355995055624,0.0738566131025958
"E02000380",250,138,1938,7,131,243,2603,0.0960430272762197,0.0530157510564733,0.744525547445255,0.00268920476373415,0.0503265462927391,0.0933538225124856
"E02000381",216,137,2918,13,124,203,4322,0.0499768625636279,0.0316982878297085,0.675150393336418,0.0030078667283665,0.028690421101342,0.0469689958352614
"E02000382",196,208,1889,13,195,183,3196,0.0613266583229036,0.065081351689612,0.591051314142678,0.00406758448060075,0.0610137672090113,0.0572590738423029
"E02000383",146,260,2978,2,258,144,4699,0.0310704405192594,0.0553309214726538,0.633751862098319,0.000425622472866567,0.0549052989997872,0.0306448180463928
"E02000384",180,332,2167,9,323,171,4208,0.0427756653992395,0.0788973384030418,0.514971482889734,0.00213878326996198,0.0767585551330798,0.0406368821292776
"E02000385",147,58,2863,1,57,146,3370,0.043620178041543,0.0172106824925816,0.849554896142433,0.00029673590504451,0.0169139465875371,0.0433234421364985
"E02000386",147,755,1859,23,732,124,3888,0.0378086419753086,0.194187242798354,0.478137860082305,0.0059156378600823,0.188271604938272,0.0318930041152263
"E02000387",233,458,1323,36,422,197,2503,0.0930882940471434,0.18298042349181,0.528565721134638,0.0143827407111466,0.168597682780663,0.0787055533359968
"E02000388",326,250,2751,20,230,306,5015,0.0650049850448654,0.0498504486540379,0.548554336989033,0.00398803589232303,0.0458624127617149,0.0610169491525424
"E02000389",352,340,2202,21,319,331,4001,0.0879780054986253,0.0849787553111722,0.550362409397651,0.00524868782804299,0.0797300674831292,0.0827293176705824
"E02000390",289,265,2251,12,253,277,3199,0.0903407314785871,0.0828383869959362,0.703657392935292,0.00375117224132541,0.0790872147546108,0.0865895592372616
"E02000391",284,321,2192,13,308,271,3712,0.0765086206896552,0.0864762931034483,0.59051724137931,0.00350215517241379,0.0829741379310345,0.0730064655172414
"E02000392",343,132,3407,7,125,336,4569,0.0750711315386299,0.0288903479973736,0.745677391114029,0.00153206390895163,0.027358284088422,0.0735390676296783
"E02000393",296,62,2330,11,51,285,2927,0.101127434233003,0.0211820977109669,0.796036897847626,0.00375811411001025,0.0174239836009566,0.0973693201229928
"E02000394",249,168,1571,9,159,240,6984,0.0356529209621993,0.0240549828178694,0.224942726231386,0.00128865979381443,0.022766323024055,0.0343642611683849
"E02000395",207,208,2042,7,201,200,2980,0.0694630872483221,0.0697986577181208,0.685234899328859,0.0023489932885906,0.0674496644295302,0.0671140939597315
"E02000396",259,60,1858,6,54,253,2939,0.0881252126573664,0.0204151071793127,0.63218781898605,0.00204151071793127,0.0183735964613814,0.0860837019394352
"E02000397",461,442,2254,16,426,445,3674,0.125476320087099,0.120304844855743,0.613500272182907,0.00435492651061513,0.115949918345128,0.121121393576483
"E02000398",358,722,1398,48,674,310,3256,0.10995085995086,0.221744471744472,0.429361179361179,0.0147420147420147,0.207002457002457,0.0952088452088452
"E02000400",311,235,1439,30,205,281,2814,0.110518834399431,0.0835110163468372,0.51137171286425,0.0106609808102345,0.0728500355366027,0.0998578535891969
"E02000401",356,596,1007,129,467,227,2473,0.143954710877477,0.241002830570158,0.407197735543874,0.052163364334816,0.188839466235342,0.0917913465426607
"E02000402",298,226,1340,28,198,270,2451,0.121583027335781,0.0922072623419013,0.54671562627499,0.0114239086087311,0.0807833537331701,0.11015911872705
"E02000403",486,158,2305,14,144,472,3143,0.154629335030226,0.0502704422526249,0.733375755647471,0.0044543429844098,0.0458160992682151,0.150174992045816
"E02000404",328,267,1333,32,235,296,2322,0.141257536606374,0.114987080103359,0.574074074074074,0.0137812230835487,0.101205857019811,0.127476313522825
"E02000405",358,76,1605,10,66,348,2026,0.17670286278381,0.0375123395853899,0.792201382033564,0.00493583415597236,0.0325765054294176,0.171767028627838
"E02000406",374,76,2140,7,69,367,2497,0.149779735682819,0.0304365238285943,0.857028434120945,0.00280336403684421,0.0276331597917501,0.146976371645975
"E02000407",471,146,2129,17,129,454,3125,0.15072,0.04672,0.68128,0.00544,0.04128,0.14528
"E02000408",323,328,1264,33,295,290,3039,0.106284962158605,0.107930240210596,0.415926291543271,0.0108588351431392,0.0970714050674564,0.0954261270154656
"E02000409",229,109,905,12,97,217,2285,0.100218818380744,0.0477024070021882,0.396061269146608,0.00525164113785558,0.0424507658643326,0.0949671772428884
"E02000410",331,94,1980,9,85,322,2727,0.121378804547121,0.0344701136780345,0.726072607260726,0.0033003300330033,0.0311697836450312,0.118078474514118
"E02000411",374,473,1333,39,434,335,6300,0.0593650793650794,0.0750793650793651,0.211587301587302,0.00619047619047619,0.0688888888888889,0.0531746031746032
"E02000412",266,240,1543,9,231,257,4107,0.0647674701728756,0.058436815193572,0.375700024348673,0.00219138056975895,0.056245434623813,0.0625760896031166
"E02000413",332,198,1651,18,180,314,2836,0.117066290550071,0.0698166431593794,0.582157968970381,0.00634696755994358,0.0634696755994358,0.110719322990127
"E02000414",490,71,2240,17,54,473,2611,0.187667560321716,0.0271926464955956,0.857908847184987,0.00651091535810034,0.0206817311374952,0.181156644963615
"E02000415",434,128,1899,13,115,421,2745,0.158105646630237,0.0466302367941712,0.691803278688525,0.00473588342440801,0.0418943533697632,0.153369763205829
"E02000416",268,219,1623,17,202,251,4024,0.0666003976143141,0.0544234592445328,0.403330019880716,0.00422465208747515,0.0501988071570577,0.062375745526839
"E02000417",336,149,1752,20,129,316,2697,0.124582869855395,0.0552465702632555,0.649610678531702,0.00741564701520208,0.0478309232480534,0.117167222840193
"E02000418",313,66,1416,7,59,306,1936,0.161673553719008,0.0340909090909091,0.731404958677686,0.00361570247933884,0.0304752066115702,0.158057851239669
"E02000419",498,154,2863,17,137,481,4284,0.11624649859944,0.0359477124183007,0.668300653594771,0.00396825396825397,0.0319794584500467,0.112278244631186
"E02000420",412,271,1800,40,231,372,3564,0.115600448933782,0.0760381593714927,0.505050505050505,0.0112233445566779,0.0648148148148148,0.104377104377104
"E02000421",302,424,1387,25,399,277,3423,0.0882267017236342,0.123867952088811,0.405200116856559,0.00730353491089687,0.116564417177914,0.0809231668127374
"E02000422",361,327,1527,30,297,331,2858,0.12631210636809,0.114415675297411,0.534289713086074,0.0104968509447166,0.103918824352694,0.115815255423373
"E02000423",444,129,2002,22,107,422,2549,0.174185955276579,0.0506080816006277,0.785406041584935,0.00863083562181247,0.0419772459788152,0.165555119654767
"E02000424",353,97,2131,11,86,342,3084,0.114461738002594,0.0314526588845655,0.690985732814527,0.00356679636835279,0.0278858625162127,0.110894941634241
"E02000425",271,195,1444,23,172,248,2088,0.129789272030651,0.0933908045977011,0.691570881226054,0.0110153256704981,0.0823754789272031,0.118773946360153
"E02000426",254,370,1518,45,325,209,2682,0.0947054436987323,0.137956748695004,0.565995525727069,0.0167785234899329,0.121178225205071,0.0779269202087994
"E02000427",416,72,2251,5,67,411,3027,0.137429798480344,0.0237859266600595,0.743640568219359,0.00165180046250413,0.0221341261975553,0.135777998017839
"E02000428",306,345,1544,26,319,280,3162,0.0967741935483871,0.109108159392789,0.488298545224541,0.00822264389626818,0.100885515496521,0.0885515496521189
"E02000429",245,591,1528,17,574,228,3330,0.0735735735735736,0.177477477477477,0.458858858858859,0.0051051051051051,0.172372372372372,0.0684684684684685
"E02000430",330,153,2422,7,146,323,3742,0.088188134687333,0.0408872260823089,0.647247461250668,0.00187065740245858,0.0390165686798503,0.0863174772848744
"E02000431",352,365,2294,27,338,325,3357,0.104855525767054,0.108728030980042,0.683348227584152,0.00804289544235925,0.100685135537682,0.0968126303246947
"E02000432",301,90,2305,7,83,294,2825,0.106548672566372,0.031858407079646,0.815929203539823,0.00247787610619469,0.0293805309734513,0.104070796460177
"E02000433",416,1127,500,210,917,206,3489,0.119231871596446,0.323015190599026,0.143307537976498,0.060189165950129,0.262826024648897,0.059042705646317
"E02000434",349,835,932,134,701,215,3474,0.100460564191134,0.240356937248129,0.268278641335636,0.0385722510074842,0.201784686240645,0.06188831318365
"E02000435",391,611,474,136,475,255,2354,0.166100254885302,0.259558198810535,0.201359388275276,0.0577740016992353,0.2017841971113,0.108326253186066
"E02000436",322,359,594,92,267,230,1418,0.227080394922426,0.253173483779972,0.418899858956276,0.0648801128349788,0.188293370944993,0.162200282087447
"E02000437",481,577,1181,141,436,340,2525,0.19049504950495,0.228514851485149,0.467722772277228,0.0558415841584158,0.172673267326733,0.134653465346535
"E02000438",452,752,716,167,585,285,2593,0.174315464712688,0.29001156961049,0.276128037022754,0.0644041650597763,0.225607404550713,0.109911299652912
"E02000439",348,776,795,183,593,165,2697,0.129032258064516,0.287727104189841,0.294771968854283,0.067853170189099,0.219873934000742,0.0611790878754171
"E02000440",425,686,873,161,525,264,2097,0.202670481640439,0.327134000953743,0.416309012875536,0.0767763471626133,0.25035765379113,0.125894134477825
"E02000441",398,547,745,112,435,286,2420,0.164462809917355,0.22603305785124,0.307851239669421,0.0462809917355372,0.179752066115702,0.118181818181818
"E02000442",340,377,1222,92,285,248,1945,0.174807197943445,0.193830334190231,0.62827763496144,0.0473007712082262,0.146529562982005,0.127506426735219
"E02000443",545,358,1976,90,268,455,3474,0.156879677605066,0.103051237766264,0.568796776050662,0.0259067357512953,0.0771445020149683,0.130972941853771
"E02000444",356,538,906,121,417,235,1910,0.186387434554974,0.281675392670157,0.47434554973822,0.0633507853403141,0.218324607329843,0.12303664921466
"E02000445",517,355,1973,64,291,453,3961,0.130522595304216,0.0896238323655642,0.49810653875284,0.0161575359757637,0.0734662963898006,0.114365059328452
"E02000447",352,225,1123,48,177,304,2065,0.17046004842615,0.108958837772397,0.543825665859564,0.0232445520581114,0.0857142857142857,0.147215496368039
"E02000448",394,473,1087,107,366,287,2370,0.166244725738397,0.19957805907173,0.458649789029536,0.0451476793248945,0.154430379746835,0.121097046413502
"E02000449",346,352,973,78,274,268,1816,0.190528634361233,0.193832599118943,0.53579295154185,0.0429515418502203,0.150881057268722,0.147577092511013
"E02000451",387,196,1142,65,131,322,1654,0.23397823458283,0.118500604594921,0.690447400241838,0.0392986698911729,0.0792019347037485,0.194679564691657
"E02000452",536,224,2066,44,180,492,4788,0.111946532999165,0.0467836257309941,0.431495405179616,0.00918964076858814,0.037593984962406,0.102756892230576
"E02000453",457,249,1544,53,196,404,2785,0.164093357271095,0.0894075403949731,0.554398563734291,0.0190305206463196,0.0703770197486535,0.145062836624776
"E02000454",402,313,976,104,209,298,1745,0.230372492836676,0.179369627507163,0.559312320916905,0.0595988538681948,0.119770773638968,0.170773638968481
"E02000455",436,517,1283,69,448,367,5923,0.0736113456018909,0.0872868478811413,0.216613202768867,0.0116495019415837,0.0756373459395577,0.0619618436603073
"E02000456",444,231,1420,53,178,391,2151,0.206415620641562,0.107391910739191,0.660158066015807,0.0246397024639702,0.0827522082752208,0.181775918177592
"E02000457",360,264,1015,64,200,296,2271,0.158520475561427,0.116248348745046,0.446939674152356,0.028181417877587,0.0880669308674593,0.13033905768384
"E02000459",432,312,1162,68,244,364,3466,0.12463935372187,0.0900173110213503,0.335256780150029,0.0196191575302943,0.070398153491056,0.105020196191575
"E02000460",284,325,750,78,247,206,2469,0.115026326447955,0.131632239773188,0.303766707168894,0.031591737545565,0.100040502227623,0.0834345889023896
"E02000461",325,525,1088,83,442,242,2652,0.122549019607843,0.197963800904977,0.41025641025641,0.0312971342383107,0.166666666666667,0.0912518853695324
"E02000462",366,220,1256,49,171,317,1987,0.184197282335179,0.110719677906392,0.632108706592854,0.0246602918973327,0.0860593860090589,0.159536990437846
"E02000463",431,278,1359,60,218,371,2088,0.206417624521073,0.133141762452107,0.650862068965517,0.028735632183908,0.104406130268199,0.177681992337165
"E02000464",356,413,301,132,281,224,2299,0.154849934754241,0.179643323183993,0.130926489778164,0.0574162679425837,0.122227055241409,0.0974336668116572
"E02000465",438,535,624,152,383,286,2851,0.153630305156086,0.187653454928095,0.218870571729218,0.0533146264468608,0.134338828481235,0.100315678709225
"E02000466",467,446,839,136,310,331,2453,0.190379127598859,0.181818181818182,0.342030167142275,0.0554423155320016,0.12637586628618,0.134936812066857
"E02000467",411,817,761,149,668,262,3909,0.105141980046048,0.209004860578153,0.194678946022001,0.0381171655154771,0.170887695062676,0.0670248145305705
"E02000468",492,547,1041,150,397,342,2422,0.203137902559868,0.225846407927333,0.429810074318745,0.0619322873658134,0.163914120561519,0.141205615194055
"E02000469",358,548,450,142,406,216,2192,0.163321167883212,0.25,0.20529197080292,0.0647810218978102,0.18521897810219,0.0985401459854015
"E02000470",546,364,1367,84,280,462,3550,0.153802816901408,0.102535211267606,0.385070422535211,0.0236619718309859,0.0788732394366197,0.130140845070423
"E02000471",483,300,1476,80,220,403,2022,0.238872403560831,0.148367952522255,0.729970326409496,0.039564787339268,0.108803165182987,0.199307616221563
"E02000472",571,395,1716,112,283,459,2634,0.216780561883068,0.149962034927866,0.651480637813212,0.0425208807896735,0.107441154138193,0.174259681093394
"E02000473",613,461,1637,127,334,486,3217,0.190550202051601,0.143301212309605,0.508859185576624,0.0394777743239043,0.103823437985701,0.151072427727697
"E02000474",516,485,1440,121,364,395,3150,0.163809523809524,0.153968253968254,0.457142857142857,0.0384126984126984,0.115555555555556,0.125396825396825
"E02000475",497,527,1474,115,412,382,3480,0.142816091954023,0.151436781609195,0.423563218390805,0.0330459770114943,0.118390804597701,0.109770114942529
"E02000476",385,526,1382,68,458,317,5184,0.074266975308642,0.101466049382716,0.266589506172839,0.0131172839506173,0.0883487654320988,0.0611496913580247
"E02000477",557,290,1840,85,205,472,2719,0.204854726002207,0.106656859139389,0.676719382125782,0.031261493196028,0.0753953659433615,0.173593232806179
"E02000478",390,377,565,135,242,255,1550,0.251612903225806,0.243225806451613,0.364516129032258,0.0870967741935484,0.156129032258065,0.164516129032258
"E02000479",534,301,1840,68,233,466,3774,0.141494435612083,0.0797562268150503,0.487546369899311,0.018018018018018,0.0617382087970323,0.123476417594065
"E02000480",588,442,1939,79,363,509,4922,0.119463632669646,0.0898008939455506,0.393945550589191,0.0160503860219423,0.0737505079236083,0.103413246647704
"E02000481",464,485,1141,127,358,337,2296,0.202090592334495,0.211236933797909,0.496951219512195,0.0553135888501742,0.155923344947735,0.146777003484321
"E02000482",343,235,1143,75,160,268,1724,0.198955916473318,0.13631090487239,0.662993039443155,0.0435034802784223,0.0928074245939675,0.155452436194896
"E02000483",441,579,1377,60,519,381,3162,0.139468690702087,0.183111954459203,0.435483870967742,0.0189753320683112,0.164136622390892,0.120493358633776
"E02000484",418,246,1179,76,170,342,2292,0.182373472949389,0.107329842931937,0.514397905759162,0.0331588132635253,0.0741710296684119,0.149214659685864
"E02000485",509,541,1474,103,438,406,2789,0.182502689135891,0.193976335604159,0.528504840444604,0.0369307995697383,0.157045536034421,0.145571889566153
"E02000486",445,204,1469,41,163,404,2096,0.212309160305344,0.0973282442748092,0.700858778625954,0.0195610687022901,0.0777671755725191,0.192748091603053
"E02000487",361,138,1393,44,94,317,1692,0.213356973995272,0.0815602836879433,0.823286052009456,0.0260047281323877,0.0555555555555556,0.187352245862884
"E02000488",496,369,845,143,226,353,2202,0.225249772933697,0.167574931880109,0.383742052679382,0.0649409627611263,0.102633969118983,0.16030881017257
"E02000489",428,619,778,170,449,258,2519,0.169908693926161,0.245732433505359,0.308852719333069,0.0674870980547836,0.178245335450576,0.102421595871378
"E02000490",477,698,846,193,505,284,2462,0.19374492282697,0.283509341998375,0.343623070674249,0.078391551584078,0.205117790414297,0.115353371242892
"E02000491",473,498,1048,127,371,346,4690,0.100852878464819,0.106183368869936,0.223454157782516,0.0270788912579957,0.0791044776119403,0.073773987206823
"E02000492",448,432,732,152,280,296,1892,0.236786469344609,0.228329809725159,0.386892177589852,0.080338266384778,0.147991543340381,0.156448202959831
"E02000493",329,244,1159,51,193,278,2238,0.147006255585344,0.109025915996425,0.517873100983021,0.0227882037533512,0.0862377122430742,0.124218051831993
"E02000494",520,1004,430,261,743,259,2772,0.187590187590188,0.362193362193362,0.155122655122655,0.0941558441558442,0.268037518037518,0.0934343434343434
"E02000495",765,961,1595,214,747,551,4221,0.181236673773987,0.227671167969675,0.377872542051647,0.050698886519782,0.176972281449893,0.130537787254205
"E02000496",498,535,458,143,392,355,2499,0.199279711884754,0.214085634253701,0.183273309323729,0.0572228891556623,0.156862745098039,0.142056822729092
"E02000497",572,698,769,239,459,333,3114,0.183686576750161,0.224149004495825,0.246949261400128,0.0767501605651895,0.147398843930636,0.106936416184971
"E02000498",422,489,544,138,351,284,2113,0.199716043539991,0.231424514907714,0.257453857075248,0.065309985802177,0.166114529105537,0.134406057737814
"E02000499",496,564,881,162,402,334,2173,0.228255867464335,0.259549010584445,0.405430280717901,0.0745513115508514,0.184997699033594,0.153704555913484
"E02000500",516,529,999,143,386,373,2811,0.183564567769477,0.188189256492351,0.355389541088581,0.0508715759516186,0.137317680540733,0.132692991817858
"E02000501",488,470,1127,133,337,355,2468,0.19773095623987,0.190437601296596,0.456645056726094,0.0538897893030794,0.136547811993517,0.143841166936791
"E02000502",548,601,1100,140,461,408,3306,0.165759225650333,0.181790683605566,0.332728372655777,0.0423472474289171,0.139443436176649,0.123411978221416
"E02000503",404,250,1636,47,203,357,2331,0.173316173316173,0.107250107250107,0.701844701844702,0.0201630201630202,0.0870870870870871,0.153153153153153
"E02000504",449,609,686,190,419,259,2177,0.206247129076711,0.279742765273312,0.315112540192926,0.0872760679834635,0.192466697289848,0.118971061093248
"E02000506",408,611,520,166,445,242,2330,0.175107296137339,0.262231759656652,0.223175965665236,0.0712446351931331,0.190987124463519,0.103862660944206
"E02000507",366,307,1316,91,216,275,2141,0.170948155067725,0.143390938813638,0.614666043904717,0.0425035030359645,0.100887435777674,0.128444652031761
"E02000508",453,657,753,123,534,330,4777,0.0948293908310655,0.137534017165585,0.157630311911241,0.0257483776428721,0.111785639522713,0.0690810131881934
"E02000509",446,508,1050,110,398,336,3740,0.119251336898396,0.135828877005348,0.280748663101604,0.0294117647058824,0.106417112299465,0.0898395721925134
"E02000510",439,382,1181,119,263,320,2735,0.160511882998172,0.139670932358318,0.43180987202925,0.0435100548446069,0.0961608775137111,0.117001828153565
"E02000511",447,668,1163,173,495,274,2727,0.163916391639164,0.244957829116245,0.426475980931426,0.0634396773010634,0.181518151815182,0.1004767143381
"E02000512",448,544,878,142,402,306,2791,0.160515944106055,0.194912217843067,0.314582586886421,0.05087782156933,0.144034396273737,0.109638122536725
"E02000513",570,760,492,220,540,350,2958,0.192697768762677,0.256930358350237,0.16632860040568,0.0743745774171738,0.182555780933063,0.118323191345504
"E02000514",452,1079,598,267,812,185,2589,0.174584781769023,0.416763229045964,0.230977211278486,0.103128621089224,0.31363460795674,0.0714561606797992
"E02000515",875,767,748,198,569,677,5774,0.151541392448909,0.132836854866644,0.129546241773467,0.0342916522341531,0.0985452026324905,0.117249740214756
"E02000516",439,655,519,159,496,280,2327,0.188654920498496,0.281478298238075,0.223033949290933,0.0683283197249678,0.213149978513107,0.120326600773528
"E02000517",474,636,1084,167,469,307,3213,0.147525676937442,0.197945845004669,0.337379396202926,0.0519763460939932,0.145969498910675,0.0955493308434485
"E02000518",480,417,1225,122,295,358,2871,0.167189132706374,0.145245559038662,0.426680599094392,0.0424939045628701,0.102751654475792,0.124695228143504
"E02000519",411,538,796,129,409,282,2482,0.165592264302981,0.216760676873489,0.320709105560032,0.0519742143432716,0.164786462530218,0.11361804995971
"E02000520",574,826,1193,228,598,346,5036,0.113979348689436,0.164019062748213,0.236894360603654,0.04527402700556,0.118745035742653,0.0687053216838761
"E02000521",465,650,819,149,501,316,4449,0.104517869184086,0.146100247246572,0.184086311530681,0.0334906720611373,0.112609575185435,0.071027197122949
"E02000522",476,608,770,155,453,321,3283,0.14498933901919,0.18519646664636,0.23454157782516,0.047212915016753,0.137983551629607,0.0977764240024368
"E02000523",408,684,1027,159,525,249,4734,0.0861850443599493,0.144486692015209,0.216941275876637,0.0335868187579214,0.110899873257288,0.0525982256020279
"E02000524",553,873,731,216,657,337,2892,0.191217150760719,0.301867219917012,0.252766251728907,0.0746887966804979,0.227178423236515,0.116528354080221
"E02000525",602,1125,670,292,833,310,3255,0.18494623655914,0.345622119815668,0.205837173579109,0.0897081413210445,0.255913978494624,0.0952380952380952
"E02000526",540,152,2435,21,131,519,3439,0.157022390229718,0.0441988950276243,0.708054667054376,0.00610642628671125,0.0380924687409131,0.150915963943007
"E02000529",299,499,812,71,428,228,2428,0.123146622734761,0.205518945634267,0.334431630971993,0.0292421746293245,0.176276771004942,0.0939044481054366
"E02000530",271,408,266,96,312,175,1856,0.146012931034483,0.219827586206897,0.143318965517241,0.0517241379310345,0.168103448275862,0.0942887931034483
"E02000531",449,382,1585,57,325,392,4968,0.090378421900161,0.0768921095008051,0.319041867954911,0.0114734299516908,0.0654186795491143,0.0789049919484702
"E02000532",437,371,1633,70,301,367,3222,0.135630043451272,0.115145872129112,0.506828057107387,0.0217256362507759,0.0934202358783364,0.113904407200497
"E02000533",410,381,2014,73,308,337,3359,0.122060136945519,0.113426615064007,0.599583209288479,0.0217326585293242,0.0916939565346829,0.100327478416195
"E02000534",403,502,1062,107,395,296,2870,0.140418118466899,0.174912891986063,0.370034843205575,0.0372822299651568,0.137630662020906,0.103135888501742
"E02000535",354,391,1116,93,298,261,2082,0.170028818443804,0.187800192122959,0.536023054755043,0.0446685878962536,0.143131604226705,0.12536023054755
"E02000536",388,562,1127,155,407,233,2918,0.132967786154901,0.192597669636737,0.386223440712817,0.0531185743660041,0.139479095270733,0.0798492117888965
"E02000537",379,479,1271,97,382,282,2422,0.156482246077622,0.197770437654831,0.524772914946325,0.0400495458298927,0.157720891824938,0.116432700247729
"E02000538",282,452,809,86,366,196,2397,0.117647058823529,0.188569044639132,0.337505214851898,0.0358781810596579,0.152690863579474,0.0817688777638715
"E02000539",503,302,1454,59,243,444,4398,0.114370168258299,0.0686675761709868,0.330604820372897,0.0134151887221464,0.0552523874488404,0.100954979536153
"E02000540",388,383,1481,49,334,339,4587,0.0845868759537824,0.0834968388925224,0.322868977545237,0.0106823632003488,0.0728144756921735,0.0739045127534336
"E02000541",261,359,894,70,289,191,2537,0.102877414268821,0.141505715411904,0.352384706346078,0.0275916436736303,0.113914071738274,0.0752857705951912
"E02000542",345,505,1174,74,431,271,3823,0.0902432644520011,0.132095213183364,0.307088673816375,0.0193565262882553,0.112738686895109,0.0708867381637457
"E02000543",498,342,1764,79,263,419,5446,0.0914432611090709,0.0627983841351451,0.323907455012853,0.014506059493206,0.048292324641939,0.0769372016158649
"E02000544",394,487,875,118,369,276,2013,0.195727769498261,0.241927471435668,0.434674615002484,0.0586189766517635,0.183308494783905,0.137108792846498
"E02000545",322,378,674,56,322,266,3144,0.102417302798982,0.120229007633588,0.214376590330789,0.0178117048346056,0.102417302798982,0.0846055979643766
"E02000546",407,294,990,91,203,316,2584,0.15750773993808,0.113777089783282,0.38312693498452,0.0352167182662539,0.0785603715170279,0.122291021671827
"E02000547",501,747,1240,172,575,329,3185,0.157299843014129,0.234536891679749,0.389324960753532,0.0540031397174254,0.180533751962323,0.103296703296703
"E02000548",522,603,431,183,420,339,3230,0.161609907120743,0.186687306501548,0.13343653250774,0.056656346749226,0.130030959752322,0.104953560371517
"E02000549",552,575,1507,150,425,402,3636,0.151815181518152,0.158140814081408,0.414466446644664,0.0412541254125413,0.116886688668867,0.110561056105611
"E02000550",418,525,619,152,373,266,3424,0.122079439252336,0.153329439252336,0.180782710280374,0.044392523364486,0.10893691588785,0.0776869158878505
"E02000551",413,599,726,146,453,267,3054,0.135232481990832,0.196136214800262,0.237721021611002,0.0478061558611657,0.148330058939096,0.087426326129666
"E02000552",519,448,684,129,319,390,3091,0.167906826269816,0.144936913620188,0.221287609187965,0.0417340666450987,0.103202846975089,0.126172759624717
"E02000553",333,467,821,112,355,221,2046,0.162756598240469,0.228250244379277,0.401270772238514,0.0547409579667644,0.173509286412512,0.108015640273705
"E02000554",249,442,2060,19,423,230,3917,0.0635690579525147,0.112841460301251,0.525912688281848,0.00485065100842481,0.107990809292826,0.0587184069440899
"E02000555",344,454,1722,12,442,332,3643,0.0944276695031567,0.124622563821027,0.47268734559429,0.00329398847104035,0.121328575349986,0.0911336810321164
"E02000556",449,280,3278,25,255,424,5252,0.0854912414318355,0.0533130236100533,0.624143183549124,0.00476009139375476,0.0485529322162986,0.0807311500380807
"E02000557",297,771,1912,27,744,270,4359,0.0681348933241569,0.176875430144529,0.438632713925212,0.00619408121128699,0.170681348933242,0.0619408121128699
"E02000558",151,481,1294,5,476,146,3775,0.04,0.127417218543046,0.342781456953642,0.00132450331125828,0.126092715231788,0.0386754966887417
"E02000559",302,145,1948,8,137,294,4241,0.0712096203725536,0.0341900495166234,0.459325630747465,0.00188634755953784,0.0323037019570856,0.0693232728130158
"E02000560",306,367,1891,37,330,269,4008,0.0763473053892216,0.0915668662674651,0.471806387225549,0.0092315369261477,0.0823353293413174,0.0671157684630738
"E02000561",312,57,2210,5,52,307,3050,0.102295081967213,0.0186885245901639,0.724590163934426,0.00163934426229508,0.0170491803278689,0.100655737704918
"E02000562",224,364,2053,23,341,201,3414,0.0656121851200937,0.106619800820152,0.601347393087288,0.0067369654364382,0.0998828353837141,0.0588752196836555
"E02000563",173,523,1972,14,509,159,3938,0.0439309294057897,0.132808532249873,0.500761808024378,0.00355510411376333,0.12925342813611,0.0403758252920264
"E02000564",229,360,2162,11,349,218,6505,0.0352036894696387,0.0553420445810915,0.332359723289777,0.00169100691775557,0.0536510376633359,0.0335126825518832
"E02000565",172,243,2052,4,239,168,3175,0.0541732283464567,0.0765354330708661,0.646299212598425,0.00125984251968504,0.0752755905511811,0.0529133858267717
"E02000566",321,173,2223,9,164,312,3778,0.0849655902593965,0.0457914240338804,0.588406564319746,0.00238221281101112,0.0434092112228692,0.0825833774483854
"E02000567",339,327,2944,7,320,332,4864,0.0696957236842105,0.0672286184210526,0.605263157894737,0.00143914473684211,0.0657894736842105,0.0682565789473684
"E02000568",208,935,782,73,862,135,4839,0.0429840876214094,0.193221740028932,0.161603637115106,0.0150857615209754,0.178135978507956,0.027898326100434
"E02000569",221,547,2391,34,513,187,4404,0.0501816530426885,0.124205267938238,0.54291553133515,0.00772025431425976,0.116485013623978,0.0424613987284287
"E02000570",321,236,2661,14,222,307,4262,0.0753167526982637,0.0553730642890662,0.624354763022055,0.00328484279680901,0.0520882214922572,0.0720319099014547
"E02000571",176,313,1643,18,295,158,3946,0.0446021287379625,0.0793208312214901,0.41637100861632,0.00456158134820071,0.0747592498732894,0.0400405473897618
"E02000572",127,497,849,30,467,97,3200,0.0396875,0.1553125,0.2653125,0.009375,0.1459375,0.0303125
"E02000573",289,264,2655,13,251,276,5688,0.0508087201125176,0.0464135021097046,0.466772151898734,0.00228551336146273,0.0441279887482419,0.0485232067510548
"E02000574",190,169,1892,13,156,177,3957,0.0480161738690927,0.0427091230730351,0.478140005054334,0.00328531715946424,0.0394238059135709,0.0447308567096285
"E02000575",119,399,1988,3,396,116,6937,0.0171543895055499,0.0575176589303734,0.286579212916246,0.000432463600980251,0.0570851953293931,0.0167219259045697
"E02000576",24,492,1012,0,492,24,6751,0.00355502888460969,0.0728780921344986,0.149903717967708,0,0.0728780921344986,0.00355502888460969
"E02000577",128,781,605,46,735,82,3397,0.0376803061524875,0.229908743008537,0.178098322048867,0.0135413600235502,0.216367382984987,0.0241389461289373
"E02000578",154,162,997,44,118,110,1854,0.0830636461704423,0.087378640776699,0.537756202804746,0.0237324703344121,0.0636461704422869,0.0593311758360302
"E02000579",282,248,2225,20,228,262,3374,0.0835803200948429,0.0735032602252519,0.659454653230587,0.00592768227622999,0.0675755779490219,0.0776526378186129
"E02000580",222,325,2848,44,281,178,4017,0.0552651232262883,0.0809061488673139,0.708986806074185,0.0109534478466517,0.0699527010206622,0.0443116753796365
"E02000581",94,1006,959,18,988,76,2828,0.0332390381895332,0.355728429985856,0.339108910891089,0.00636492220650637,0.349363507779349,0.0268741159830269
"E02000582",155,195,3121,9,186,146,4358,0.0355667737494263,0.0447452960073428,0.716154199173933,0.00206516750803121,0.0426801284993116,0.0335016062413951
"E02000583",232,237,2624,10,227,222,3597,0.0644981929385599,0.0658882402001668,0.729496802891298,0.00278009452321379,0.063108145676953,0.0617180984153461
"E02000584",175,237,3140,5,232,170,4464,0.0392025089605735,0.0530913978494624,0.703405017921147,0.00112007168458781,0.0519713261648745,0.0380824372759857
"E02000585",143,400,2560,13,387,130,4029,0.0354926780838918,0.0992802184164805,0.635393397865475,0.00322660709853562,0.0960536113179449,0.0322660709853562
"E02000586",196,104,3339,6,98,190,4662,0.042042042042042,0.0223080223080223,0.716216216216216,0.00128700128700129,0.021021021021021,0.0407550407550408
"E02000587",157,116,2999,5,111,152,4207,0.0373187544568576,0.0275730924649394,0.712859519847873,0.00118849536486808,0.0263845971000713,0.0361302590919895
"E02000588",255,353,4490,22,331,233,6174,0.0413022351797862,0.0571752510528021,0.727243278263686,0.00356333009394234,0.0536119209588597,0.0377389050858439
"E02000589",134,170,3586,0,170,134,5553,0.0241311003061408,0.0306140824779399,0.645777057446425,0,0.0306140824779399,0.0241311003061408
"E02000590",112,175,3268,3,172,109,4656,0.0240549828178694,0.037585910652921,0.701890034364261,0.000644329896907216,0.0369415807560137,0.0234106529209622
"E02000591",35,187,2584,0,187,35,5076,0.00689519306540583,0.0368400315208826,0.509062253743105,0,0.0368400315208826,0.00689519306540583
"E02000592",182,84,3295,3,81,179,4611,0.0394708306224246,0.0182173064411191,0.714595532422468,0.000650618087182824,0.0175666883539362,0.0388202125352418
"E02000593",99,169,3643,2,167,97,4989,0.0198436560432953,0.0338745239526959,0.730206454199238,0.000400881940268591,0.0334736420124273,0.0194427741030267
"E02000594",154,192,2999,9,183,145,4186,0.0367892976588629,0.0458671763019589,0.716435738174869,0.00215002388915432,0.0437171524128046,0.0346392737697086
"E02000595",213,336,3027,8,328,205,4288,0.0496735074626866,0.0783582089552239,0.705923507462687,0.00186567164179104,0.0764925373134328,0.0478078358208955
"E02000596",194,171,2892,5,166,189,4083,0.0475140827822679,0.0418809698750918,0.708302718589273,0.00122458976242959,0.0406563801126623,0.0462894930198384
"E02000597",171,661,1442,26,635,145,3533,0.0484007925275969,0.187093121992641,0.408151712425701,0.00735918482875743,0.179733937163883,0.0410416076988395
"E02000598",424,224,1115,58,166,366,2240,0.189285714285714,0.1,0.497767857142857,0.0258928571428571,0.0741071428571429,0.163392857142857
"E02000599",393,557,671,156,401,237,2121,0.185289957567185,0.262611975483263,0.316360207449316,0.0735502121640736,0.189061763319189,0.111739745403112
"E02000600",326,957,1270,87,870,239,3730,0.0873994638069705,0.25656836461126,0.340482573726542,0.0233243967828418,0.233243967828418,0.0640750670241287
"E02000601",335,556,1705,52,504,283,5337,0.0627693460745737,0.104178377365561,0.319467865842233,0.00974330148023234,0.0944350758853288,0.0530260445943414
"E02000602",416,419,1624,59,360,357,4769,0.0872300272593835,0.0878590899559656,0.34053260641644,0.0123715663661145,0.0754875235898511,0.074858460893269
"E02000603",487,261,1355,52,209,435,3352,0.145286396181384,0.0778639618138425,0.404236276849642,0.0155131264916468,0.0623508353221957,0.129773269689737
"E02000604",502,423,1744,68,355,434,3479,0.144294337453291,0.121586662834148,0.501293475136533,0.0195458465076171,0.102040816326531,0.124748490945674
"E02000605",493,431,1441,110,321,383,2678,0.184092606422704,0.160941000746826,0.538088125466766,0.041075429424944,0.119865571321882,0.14301717699776
"E02000606",482,997,2120,105,892,377,6009,0.0802130138126144,0.165917789981694,0.352804127142619,0.017473789316026,0.148444000665668,0.0627392244965884
"E02000607",376,438,1316,91,347,285,2375,0.158315789473684,0.184421052631579,0.554105263157895,0.0383157894736842,0.146105263157895,0.12
"E02000608",364,553,1920,79,474,285,3963,0.09184960888216,0.139540751955589,0.48448145344436,0.0199343931365127,0.119606358819076,0.0719152157456472
"E02000609",362,533,1130,99,434,263,2319,0.15610176800345,0.229840448469168,0.48727899956878,0.0426908150064683,0.187149633462699,0.113410952996981
"E02000610",445,1156,1407,137,1019,308,4659,0.0955140588109036,0.248121914573943,0.301996136509981,0.0294054518136939,0.218716462760249,0.0661086069972097
"E02000611",322,260,1218,46,214,276,1721,0.187100522951772,0.151074956420686,0.707728065078443,0.0267286461359675,0.124346310284718,0.160371876815805
"E02000612",436,467,1093,126,341,310,2231,0.195428059166293,0.209323173464814,0.489914836396235,0.0564769161810847,0.152846257283729,0.138951142985208
"E02000613",492,500,1616,86,414,406,3202,0.153653966271081,0.156152404747033,0.504684572142411,0.0268582136164897,0.129294191130543,0.126795752654591
"E02000614",490,334,1607,63,271,427,3286,0.149117468046257,0.101643335362142,0.489044430919051,0.0191722458916616,0.0824710894704808,0.129945222154595
"E02000615",418,531,1033,125,406,293,2287,0.182772190642763,0.232181897682554,0.45168342807171,0.0546567555749891,0.177525142107564,0.128115435067774
"E02000616",295,421,891,102,319,193,1734,0.170126874279123,0.242791234140715,0.513840830449827,0.0588235294117647,0.18396770472895,0.111303344867359
"E02000617",506,626,612,154,472,352,2944,0.171875,0.212635869565217,0.207880434782609,0.0523097826086957,0.160326086956522,0.119565217391304
"E02000619",139,489,1298,29,460,110,4423,0.0314266335066697,0.110558444494687,0.293465973321275,0.00655663576757857,0.104001808727108,0.0248699977390911
"E02000620",178,181,2628,8,173,170,6090,0.0292282430213465,0.0297208538587849,0.431527093596059,0.0013136288998358,0.0284072249589491,0.0279146141215107
"E02000621",254,240,2414,4,236,250,8112,0.0313116370808679,0.029585798816568,0.29758382642998,0.000493096646942801,0.0290927021696252,0.0308185404339251
"E02000622",291,424,2086,27,397,264,3871,0.0751743735468871,0.109532420563162,0.538878842676311,0.00697494187548437,0.102557478687678,0.0681994316714027
"E02000623",122,436,1697,11,425,111,3392,0.0359669811320755,0.128537735849057,0.500294811320755,0.00324292452830189,0.125294811320755,0.0327240566037736
"E02000624",210,355,1945,38,317,172,4851,0.0432900432900433,0.0731807874665018,0.400948258091115,0.00783343640486498,0.0653473510616368,0.0354566068851783
"E02000625",200,904,2055,11,893,189,4406,0.0453926463912846,0.205174761688606,0.466409441670449,0.00249659555152065,0.202678166137086,0.042896050839764
"E02000626",229,702,1409,15,687,214,3688,0.0620932754880694,0.190347071583514,0.38204989154013,0.00406724511930586,0.186279826464208,0.0580260303687636
"E02000627",297,278,2229,21,257,276,4235,0.0701298701298701,0.0656434474616293,0.526328217237308,0.00495867768595041,0.0606847697756789,0.0651711924439197
"E02000628",210,773,1363,88,685,122,4940,0.0425101214574899,0.156477732793522,0.275910931174089,0.0178137651821862,0.138663967611336,0.0246963562753036
"E02000629",381,337,2686,22,315,359,4922,0.0774075579032913,0.0684681023973994,0.545713124746038,0.00446972775294596,0.0639983746444535,0.0729378301503454
"E02000630",267,230,2339,38,192,229,4293,0.0621942697414396,0.0535755881667831,0.544840437922199,0.008851618914512,0.0447239692522711,0.0533426508269276
"E02000631",491,130,2871,26,104,465,4092,0.119990224828935,0.0317693059628543,0.701612903225806,0.00635386119257087,0.0254154447702835,0.113636363636364
"E02000632",568,177,3457,13,164,555,5004,0.113509192645883,0.0353717026378897,0.690847322142286,0.00259792166266986,0.0327737809752198,0.110911270983213
"E02000633",283,435,1959,24,411,259,4452,0.0635669362084456,0.0977088948787062,0.440026954177898,0.00539083557951483,0.0923180592991914,0.0581761006289308
"E02000634",215,484,1682,55,429,160,3629,0.0592449710664095,0.133370074400661,0.463488564342794,0.0151556902728024,0.118214384127859,0.0440892807936071
"E02000635",388,248,2096,17,231,371,4825,0.0804145077720207,0.05139896373057,0.43440414507772,0.00352331606217617,0.0478756476683938,0.0768911917098446
"E02000636",432,148,2341,26,122,406,3633,0.118909991742362,0.0407376823561795,0.644371043214974,0.00715661987338288,0.0335810624827966,0.111753371868979
"E02000637",490,177,3040,10,167,480,3928,0.124745417515275,0.045061099796334,0.773930753564155,0.00254582484725051,0.0425152749490835,0.122199592668024
"E02000638",331,530,1835,38,492,293,4514,0.0733274257864422,0.117412494461675,0.406513070447497,0.00841825431989366,0.108994240141781,0.0649091714665485
"E02000639",176,273,1962,28,245,148,3971,0.0443213296398892,0.0687484260891463,0.494082095190128,0.00705112062452783,0.0616973054646185,0.0372702090153614
"E02000640",522,169,2992,27,142,495,4120,0.126699029126214,0.0410194174757282,0.72621359223301,0.00655339805825243,0.0344660194174757,0.120145631067961
"E02000641",112,556,1531,19,537,93,3439,0.03256760686246,0.161674905495784,0.445187554521663,0.00552486187845304,0.156150043617331,0.027042744984007
"E02000642",530,631,2395,93,538,437,4083,0.129806514817536,0.154543228018614,0.586578496203772,0.0227773695811903,0.131765858437423,0.107029145236346
"E02000643",612,224,2866,25,199,587,4281,0.142957252978276,0.0523242233123102,0.669469750058398,0.00583975706610605,0.0464844662462042,0.13711749591217
"E02000644",467,223,2622,24,199,443,3761,0.124169103961712,0.0592927412922095,0.697155011964903,0.00638128157404945,0.0529114597181601,0.117787822387663
"E02000645",668,424,2821,55,369,613,4552,0.146748681898067,0.0931458699472759,0.619727592267135,0.0120826010544815,0.0810632688927944,0.134666080843585
"E02000646",378,323,2596,33,290,345,4138,0.0913484775253746,0.0780570323827936,0.627356210729821,0.00797486708554857,0.070082165297245,0.083373610439826
"E02000647",557,367,1705,63,304,494,3331,0.167217051936355,0.110177123986791,0.511858300810567,0.0189132392674872,0.0912638847193035,0.148303812668868
"E02000648",442,631,1701,108,523,334,3737,0.118276692534118,0.168852020337169,0.455177950227455,0.0289001873160289,0.13995183302114,0.0893765052180894
"E02000649",605,401,3757,44,357,561,6169,0.0980710001621008,0.0650024315124007,0.60901280596531,0.00713243637542551,0.0578699951369752,0.0909385637866753
"E02000650",499,402,2004,67,335,432,3680,0.135597826086957,0.109239130434783,0.544565217391304,0.0182065217391304,0.0910326086956522,0.117391304347826
"E02000651",465,188,2448,25,163,440,3491,0.133199656258952,0.053852764250931,0.701231738756803,0.00716127184187912,0.0466914924090518,0.126038384417072
"E02000652",407,67,1611,5,62,402,2452,0.165986949429038,0.0273246329526917,0.657014681892333,0.00203915171288744,0.0252854812398042,0.16394779771615
"E02000653",220,235,517,11,224,209,5604,0.0392576730906495,0.0419343326195575,0.0922555317630264,0.00196288365453248,0.039971448965025,0.0372947894361171
"E02000654",149,273,858,21,252,128,3924,0.0379714576962283,0.0695718654434251,0.218654434250765,0.00535168195718654,0.0642201834862385,0.0326197757390418
"E02000655",395,408,986,48,360,347,3945,0.100126742712294,0.103422053231939,0.249936628643853,0.0121673003802281,0.091254752851711,0.0879594423320659
"E02000657",442,254,2430,30,224,412,4323,0.102243812167476,0.0587554938699977,0.562109646079112,0.00693962526023595,0.0518158686097617,0.0953041869072403
"E02000658",320,157,1939,30,127,290,3184,0.100502512562814,0.0493090452261307,0.608982412060301,0.00942211055276382,0.0398869346733668,0.0910804020100503
"E02000659",325,374,1573,37,337,288,4133,0.0786353738204694,0.0904911686426325,0.380595209291072,0.00895233486571498,0.0815388337769175,0.0696830389547544
"E02000660",329,157,2065,16,141,313,3973,0.082808960483262,0.0395167379813743,0.519758368990687,0.0040271834885477,0.0354895544928266,0.0787817769947143
"E02000661",379,471,1765,86,385,293,3195,0.118622848200313,0.147417840375587,0.552425665101721,0.0269170579029734,0.120500782472613,0.0917057902973396
"E02000662",355,139,1779,21,118,334,3003,0.118215118215118,0.0462870462870463,0.592407592407592,0.00699300699300699,0.0392940392940393,0.111222111222111
"E02000663",398,93,1994,4,89,394,2609,0.152548869298582,0.0356458413185128,0.764277500958222,0.00153315446531238,0.0341126868532005,0.151015714833269
"E02000665",449,320,1808,55,265,394,3376,0.132997630331754,0.0947867298578199,0.535545023696682,0.0162914691943128,0.0784952606635071,0.116706161137441
"E02000666",427,227,1596,48,179,379,2625,0.162666666666667,0.0864761904761905,0.608,0.0182857142857143,0.0681904761904762,0.144380952380952
"E02000667",423,131,1701,38,93,385,2219,0.190626408292023,0.0590356016223524,0.766561514195584,0.0171248310049572,0.0419107706173952,0.173501577287066
"E02000668",427,380,1315,72,308,355,2527,0.168975069252078,0.150375939849624,0.520379897111199,0.0284922833399288,0.121883656509695,0.140482785912149
"E02000669",418,103,2167,11,92,407,3708,0.112729234088457,0.0277777777777778,0.584412081984897,0.00296655879180151,0.0248112189859763,0.109762675296656
"E02000670",504,147,2041,26,121,478,3079,0.163689509581033,0.0477427736278012,0.662877557648587,0.00844430009743423,0.039298473530367,0.155245209483599
"E02000671",571,270,2429,45,225,526,3671,0.155543448651594,0.0735494415690548,0.661672568782348,0.0122582402615091,0.0612912013075456,0.143285208390084
"E02000672",466,325,2377,22,303,444,4469,0.104273886775565,0.0727232042962632,0.531886328037592,0.0049228015215932,0.0678004027746699,0.0993510852539718
"E02000673",405,434,2090,52,382,353,3532,0.114665911664779,0.122876557191393,0.591732729331823,0.014722536806342,0.108154020385051,0.0999433748584371
"E02000674",481,91,2270,12,79,469,2773,0.173458348359178,0.0328164442841688,0.818608005769924,0.00432744320230797,0.0284890010818608,0.16913090515687
"E02000675",477,586,1420,95,491,382,3083,0.154719429127473,0.190074602659747,0.460590334090172,0.0308141420694129,0.159260460590334,0.12390528705806
"E02000676",476,172,2374,22,150,454,3252,0.146371463714637,0.0528905289052891,0.730012300123001,0.00676506765067651,0.0461254612546125,0.139606396063961
"E02000677",409,104,1846,20,84,389,2620,0.156106870229008,0.0396946564885496,0.704580152671756,0.00763358778625954,0.0320610687022901,0.148473282442748
"E02000678",360,628,442,168,460,192,2283,0.157687253613666,0.275076653526062,0.193604905825668,0.0735873850197109,0.201489268506351,0.0840998685939553
"E02000679",360,450,1485,60,390,300,3320,0.108433734939759,0.135542168674699,0.447289156626506,0.0180722891566265,0.117469879518072,0.0903614457831325
"E02000680",268,461,1357,64,397,204,3005,0.0891846921797005,0.153410981697171,0.451580698835275,0.0212978369384359,0.132113144758735,0.0678868552412646
"E02000681",432,658,964,134,524,298,3079,0.1403052939266,0.213705748619682,0.313088665151023,0.0435206235790841,0.170185125040598,0.0967846703475154
"E02000682",377,344,1525,79,265,298,2969,0.126978780734254,0.115863927248232,0.513640956551027,0.0266082856180532,0.0892556416301785,0.100370495116201
"E02000683",330,526,1020,79,447,251,2860,0.115384615384615,0.183916083916084,0.356643356643357,0.0276223776223776,0.156293706293706,0.0877622377622378
"E02000685",397,822,1312,121,701,276,3524,0.112656072644722,0.233257661748014,0.372304199772985,0.0343359818388195,0.198921679909194,0.0783200908059024
"E02000686",278,484,859,85,399,193,3004,0.09254327563249,0.161118508655127,0.28595206391478,0.0282956058588549,0.132822902796272,0.0642476697736351
"E02000687",463,306,1949,50,256,413,3286,0.140900791235545,0.0931223371880706,0.593122337188071,0.0152160681679854,0.0779062690200852,0.125684723067559
"E02000689",374,148,1747,40,108,334,4437,0.0842911877394636,0.0333558710840658,0.393734505296371,0.00901510029299076,0.0243407707910751,0.0752760874464728
"E02000690",333,566,629,128,438,205,2122,0.156927426955702,0.266729500471254,0.296418473138549,0.060320452403393,0.206409048067861,0.0966069745523091
"E02000691",381,298,1914,31,267,350,3117,0.12223291626564,0.0956047481552775,0.614051973051011,0.00994546037856914,0.0856592877767084,0.112287455887071
"E02000692",409,789,1870,82,707,327,4390,0.0931662870159453,0.179726651480638,0.425968109339408,0.0186788154897494,0.161047835990888,0.0744874715261959
"E02000693",651,240,2354,39,201,612,4661,0.139669598798541,0.0514910963312594,0.505041836515769,0.00836730315382965,0.0431237931774297,0.131302295644711
"E02000694",698,325,2546,79,246,619,4261,0.163811311898615,0.0762731753109599,0.597512321051396,0.0185402487678949,0.057732926543065,0.14527106313072
"E02000695",485,110,1911,34,76,451,2492,0.1946227929374,0.0441412520064205,0.76685393258427,0.0136436597110754,0.0304975922953451,0.180979133226324
"E02000696",673,461,1425,130,331,543,3421,0.196726103478515,0.134755919321836,0.416544869921076,0.0380005846243788,0.0967553346974569,0.158725518854136
"E02000697",540,386,2135,53,333,487,4167,0.129589632829374,0.0926325893928486,0.512359011279098,0.0127189824814015,0.0799136069114471,0.116870650347972
"E02000698",514,625,1525,121,504,393,3110,0.165273311897106,0.20096463022508,0.490353697749196,0.0389067524115756,0.162057877813505,0.126366559485531
"E02000699",549,296,2135,65,231,484,3328,0.164963942307692,0.0889423076923077,0.641526442307692,0.01953125,0.0694110576923077,0.145432692307692
"E02000700",503,471,890,103,368,400,3721,0.135178715399086,0.126578876646063,0.239183015318463,0.027680730986294,0.0988981456597689,0.107497984412792
"E02000701",408,240,1315,56,184,352,2729,0.149505313301576,0.0879443019421033,0.481861487724441,0.0205203371198241,0.0674239648222792,0.128984976181752
"E02000702",424,268,1114,53,215,371,3339,0.126984126984127,0.0802635519616652,0.333632824198862,0.0158730158730159,0.0643905360886493,0.111111111111111
"E02000703",375,169,1590,36,133,339,2284,0.164185639229422,0.0739929947460595,0.69614711033275,0.0157618213660245,0.058231173380035,0.148423817863398
"E02000704",452,715,1972,65,650,387,3909,0.115630596060374,0.182911230493732,0.504476848298798,0.0166282936812484,0.166282936812484,0.0990023023791251
"E02000705",493,241,1483,67,174,426,2578,0.191233514352211,0.0934833204034135,0.575252133436773,0.025989138867339,0.0674941815360745,0.165244375484872
"E02000706",339,350,1338,33,317,306,3769,0.0899442823029981,0.0928628283364288,0.355001326611833,0.00875563810029185,0.0841071902361369,0.0811886442027063
"E02000707",281,181,873,44,137,237,2281,0.123191582639193,0.079351161771153,0.382726874177992,0.0192897851819377,0.0600613765892153,0.103901797457256
"E02000708",503,227,1705,53,174,450,2691,0.186919360832404,0.0843552582683017,0.633593459680416,0.0196952805648458,0.064659977703456,0.167224080267559
"E02000709",444,178,1388,39,139,405,1850,0.24,0.0962162162162162,0.75027027027027,0.0210810810810811,0.0751351351351351,0.218918918918919
"E02000710",447,438,1352,78,360,369,3241,0.137920394939833,0.135143474236347,0.41715519901265,0.0240666460968837,0.111076828139463,0.11385374884295
"E02000711",553,942,830,221,721,332,3672,0.150599128540305,0.256535947712418,0.2260348583878,0.0601851851851852,0.196350762527233,0.0904139433551198
"E02000712",523,856,800,184,672,339,3277,0.159597192554165,0.261214525480623,0.244125724748245,0.0561489166920964,0.205065608788526,0.103448275862069
"E02000713",436,451,1126,125,326,311,1884,0.231422505307856,0.239384288747346,0.597664543524416,0.066348195329087,0.173036093418259,0.165074309978769
"E02000714",397,405,1610,72,333,325,2763,0.143684401013391,0.146579804560261,0.582699963807456,0.0260586319218241,0.120521172638436,0.117625769091567
"E02000715",454,183,1525,45,138,409,2352,0.193027210884354,0.0778061224489796,0.648384353741497,0.0191326530612245,0.0586734693877551,0.173894557823129
"E02000716",405,192,1600,23,169,382,2274,0.178100263852243,0.0844327176781003,0.703605980650836,0.0101143359718558,0.0743183817062445,0.167985927880387
"E02000717",501,269,1483,85,184,416,2521,0.198730662435541,0.106703689012297,0.588258627528758,0.0337167790559302,0.0729869099563665,0.165013883379611
"E02000718",295,229,941,30,199,265,2337,0.126230209670518,0.0979888746255884,0.40265297389816,0.0128369704749679,0.0851519041506204,0.11339323919555
"E02000719",408,479,1519,71,408,337,3082,0.132381570408825,0.155418559377028,0.492861778066191,0.0230369889682025,0.132381570408825,0.109344581440623
"E02000720",405,74,1752,17,57,388,1982,0.204339051463169,0.0373360242179617,0.883955600403633,0.00857719475277497,0.0287588294651867,0.195761856710394
"E02000721",448,261,1979,13,248,435,3062,0.146309601567603,0.0852384062704115,0.646309601567603,0.00424559111691705,0.0809928151534944,0.142064010450686
"E02000722",369,407,1588,45,362,324,3167,0.11651405115251,0.128512788127566,0.501420903062835,0.0142090306283549,0.114303757499211,0.102305020524155
"E02000723",502,116,2167,34,82,468,2514,0.199681782020684,0.0461416070007955,0.861972951471758,0.0135242641209228,0.0326173428798727,0.186157517899761
"E02000724",514,110,2004,25,85,489,2329,0.220695577501073,0.047230571060541,0.860455130957492,0.0107342206955775,0.0364963503649635,0.209961356805496
"E02000725",438,457,1281,98,359,340,4747,0.0922688013482199,0.0962713292605856,0.269854645038972,0.0206446176532547,0.0756267116073309,0.0716241836949652
"E02000727",392,199,1686,23,176,369,2269,0.172763331864257,0.0877038342882327,0.743058616130454,0.0101366240634641,0.0775672102247686,0.162626707800793
"E02000728",502,161,1947,32,129,470,2222,0.225922592259226,0.0724572457245725,0.876237623762376,0.0144014401440144,0.0580558055805581,0.211521152115212
"E02000729",372,177,1458,38,139,334,2079,0.178932178932179,0.0851370851370851,0.701298701298701,0.0182780182780183,0.0668590668590669,0.160654160654161
"E02000730",471,100,1875,21,79,450,2315,0.203455723542117,0.0431965442764579,0.809935205183585,0.00907127429805616,0.0341252699784017,0.19438444924406
"E02000731",583,229,2215,27,202,556,3342,0.174446439257929,0.0685218432076601,0.662776780371035,0.00807899461400359,0.0604428485936565,0.166367444643926
"E02000732",326,307,1140,32,275,294,2874,0.113430758524704,0.106819763395964,0.396659707724426,0.011134307585247,0.0956854558107168,0.102296450939457
"E02000733",445,913,972,105,808,340,3301,0.134807634050288,0.276582853680703,0.294456225386247,0.0318085428657982,0.244774310814905,0.10299909118449
"E02000734",340,357,902,86,271,254,2482,0.136986301369863,0.143835616438356,0.363416599516519,0.0346494762288477,0.109186140209508,0.102336825141015
"E02000735",421,267,1453,42,225,379,2561,0.164388910581804,0.104256149941429,0.567356501366654,0.0163998438110113,0.0878563061304178,0.147989066770793
"E02000736",428,422,1669,56,366,372,2569,0.166601790579992,0.164266251459712,0.64966913195796,0.0217983651226158,0.142467886337096,0.144803425457376
"E02000737",508,429,1803,52,377,456,3097,0.164029706167259,0.138521149499516,0.582176299644818,0.0167904423635777,0.121730707135938,0.147239263803681
"E02000738",527,165,2017,25,140,502,2771,0.190184049079755,0.0595452905088416,0.727896066402021,0.00902201371346084,0.0505232767953807,0.181162035366294
"E02000739",397,415,1153,59,356,338,2600,0.152692307692308,0.159615384615385,0.443461538461538,0.0226923076923077,0.136923076923077,0.13
"E02000740",270,397,903,65,332,205,2744,0.098396501457726,0.144679300291545,0.329081632653061,0.0236880466472303,0.120991253644315,0.0747084548104956
"E02000741",461,289,1951,42,247,419,2683,0.171822586656728,0.107715244129706,0.727171077152441,0.0156541185240403,0.0920611256056653,0.156168468132687
"E02000742",451,192,1753,28,164,423,2457,0.183557183557184,0.0781440781440781,0.713471713471713,0.0113960113960114,0.0667480667480667,0.172161172161172
"E02000743",351,835,840,85,750,266,4141,0.0847621347500604,0.201642115431055,0.202849553248008,0.0205264428881913,0.181115672542864,0.0642356918618691
"E02000744",446,300,2011,30,270,416,3624,0.123068432671082,0.0827814569536424,0.554911699779249,0.00827814569536424,0.0745033112582782,0.114790286975717
"E02000745",540,460,443,137,323,403,3002,0.179880079946702,0.153231179213857,0.147568287808128,0.0456362425049967,0.107594936708861,0.134243837441706
"E02000746",366,377,44,144,233,222,4138,0.0884485258579024,0.0911068148864186,0.0106331561140648,0.0347994200096665,0.0563073948767521,0.0536491058482359
"E02000747",216,612,396,75,537,141,8558,0.0252395419490535,0.0715120355223183,0.0462724935732648,0.00876372984342136,0.0627483056788969,0.0164758121056322
"E02000748",556,395,15,148,247,408,2252,0.246891651865009,0.175399644760213,0.0066607460035524,0.0657193605683837,0.109680284191829,0.181172291296625
"E02000749",359,998,508,181,817,178,3313,0.108361002112889,0.3012375490492,0.15333534560821,0.0546332629037126,0.246604286145487,0.053727739209176
"E02000751",539,868,1412,143,725,396,3379,0.159514649304528,0.256880733944954,0.41787511097958,0.0423202130807931,0.214560520864161,0.117194436223735
"E02000752",495,615,434,147,468,348,2987,0.165718111817877,0.205892199531302,0.145296283896887,0.0492132574489454,0.156678942082357,0.116504854368932
"E02000753",330,562,523,93,469,237,1904,0.173319327731092,0.295168067226891,0.27468487394958,0.0488445378151261,0.246323529411765,0.124474789915966
"E02000754",405,353,1188,65,288,340,2056,0.196984435797665,0.171692607003891,0.577821011673152,0.0316147859922179,0.140077821011673,0.165369649805447
"E02000755",391,346,736,98,248,293,1702,0.22972972972973,0.203290246768508,0.432432432432432,0.0575793184488837,0.145710928319624,0.172150411280846
"E02000756",844,667,1950,165,502,679,4532,0.186231244483672,0.147175639894086,0.43027360988526,0.0364077669902913,0.110767872903795,0.14982347749338
"E02000757",574,776,1884,111,665,463,4835,0.118717683557394,0.160496380558428,0.389658738366081,0.0229576008273009,0.137538779731127,0.0957600827300931
"E02000758",349,314,729,88,226,261,1769,0.197286602600339,0.177501413227812,0.412097230073488,0.0497456189937818,0.127755794234031,0.147540983606557
"E02000759",715,479,2521,75,404,640,4136,0.172872340425532,0.115812379110251,0.609526112185687,0.0181334622823985,0.097678916827853,0.154738878143133
"E02000760",398,380,1142,70,310,328,2187,0.181984453589392,0.173754000914495,0.52217649748514,0.0320073159579332,0.141746684956562,0.149977137631459
"E02000762",321,150,1139,31,119,290,1582,0.202907711757269,0.0948166877370417,0.719974715549937,0.0195954487989886,0.0752212389380531,0.183312262958281
"E02000763",365,522,865,109,413,256,2112,0.17282196969697,0.247159090909091,0.409564393939394,0.0516098484848485,0.195549242424242,0.121212121212121
"E02000764",705,653,2758,67,586,638,5051,0.139576321520491,0.129281330429618,0.546030489012077,0.0132647000593942,0.116016630370224,0.126311621461097
"E02000765",366,228,1099,49,179,317,1986,0.18429003021148,0.114803625377644,0.55337361530715,0.0246727089627392,0.0901309164149043,0.159617321248741
"E02000767",380,254,1221,48,206,332,2305,0.164859002169197,0.110195227765727,0.529718004338395,0.020824295010846,0.0893709327548807,0.144034707158351
"E02000768",279,296,1022,39,257,240,1603,0.174048658764816,0.184653774173425,0.637554585152838,0.024329382407985,0.16032439176544,0.149719276356831
"E02000770",442,378,1295,60,318,382,2031,0.217626784835057,0.186115214180207,0.637616937469227,0.0295420974889217,0.156573116691285,0.188084687346135
"E02000772",375,193,1453,32,161,343,2338,0.160393498716852,0.0825491873396065,0.621471343028229,0.0136869118905047,0.0688622754491018,0.146706586826347
"E02000773",410,117,1275,33,84,377,2389,0.171619924654667,0.0489744663038928,0.533696107157807,0.0138133110087903,0.0351611552951026,0.157806613645877
"E02000774",405,103,1718,20,83,385,2248,0.180160142348754,0.0458185053380783,0.76423487544484,0.00889679715302491,0.0369217081850534,0.17126334519573
"E02000776",376,96,1485,14,82,362,1864,0.201716738197425,0.0515021459227468,0.796673819742489,0.00751072961373391,0.0439914163090129,0.194206008583691
"E02000777",217,305,900,19,286,198,1693,0.12817483756645,0.180153573538098,0.531600708800945,0.0112226816302422,0.168930891907856,0.116952155936208
"E02000779",598,126,2497,14,112,584,3272,0.182762836185819,0.0385085574572127,0.763141809290954,0.00427872860635697,0.0342298288508557,0.178484107579462
"E02000781",741,412,2435,109,303,632,3407,0.217493395949516,0.12092750220135,0.714705019078368,0.0319929556794834,0.0889345465218667,0.185500440270032
"E02000782",538,188,1491,38,150,500,3925,0.137070063694268,0.0478980891719745,0.379872611464968,0.00968152866242038,0.0382165605095541,0.127388535031847
"E02000783",335,135,897,13,122,322,2092,0.160133843212237,0.0645315487571702,0.428776290630975,0.00621414913957935,0.0583173996175908,0.153919694072658
"E02000784",469,381,2038,59,322,410,3883,0.120782899819727,0.0981200103013134,0.524851918619624,0.0151944372907546,0.0829255730105588,0.105588462528972
"E02000785",610,555,2493,65,490,545,3893,0.156691497559723,0.1425635756486,0.640380169535063,0.0166966349858721,0.125866940662728,0.13999486257385
"E02000786",553,556,2904,57,499,496,4768,0.115981543624161,0.116610738255034,0.609060402684564,0.0119546979865772,0.104656040268456,0.104026845637584
"E02000787",579,324,2325,37,287,542,5041,0.114858163062884,0.0642729617139456,0.461218012299147,0.00733981352906169,0.056933148184884,0.107518349533823
"E02000788",461,223,2376,40,183,421,3326,0.138604930847865,0.0670475045099218,0.714371617558629,0.0120264582080577,0.0550210463018641,0.126578472639808
"E02000789",391,406,1572,50,356,341,2963,0.131960850489369,0.13702328720891,0.530543368207897,0.0168747890651367,0.120148498143773,0.115086061424232
"E02000790",349,203,1594,37,166,312,2538,0.137509850275808,0.0799842395587076,0.628053585500394,0.0145784081954295,0.0654058313632782,0.122931442080378
"E02000791",346,383,2129,19,364,327,3524,0.0981838819523269,0.108683314415437,0.604143019296254,0.00539160045402951,0.103291713961407,0.0927922814982974
"E02000792",344,332,1783,50,282,294,2964,0.116059379217274,0.112010796221323,0.601551956815115,0.0168690958164642,0.0951417004048583,0.0991902834008097
"E02000793",445,426,1269,110,316,335,2293,0.194068905364152,0.185782817269952,0.553423462712604,0.0479720889664195,0.137810728303532,0.146096816397732
"E02000794",395,301,1364,70,231,325,2417,0.163425734381465,0.12453454695904,0.564335953661564,0.028961522548614,0.0955730244104261,0.134464211832851
"E02000795",352,404,958,100,304,252,1988,0.177062374245473,0.203219315895372,0.481891348088531,0.0503018108651912,0.152917505030181,0.126760563380282
"E02000796",544,518,1569,129,389,415,3084,0.176394293125811,0.167963683527886,0.50875486381323,0.0418287937743191,0.126134889753567,0.134565499351492
"E02000797",459,256,2091,51,205,408,3547,0.129405131096701,0.0721736678883564,0.589512263884973,0.0143783478996335,0.0577953199887229,0.115026783197068
"E02000798",564,467,2198,106,361,458,3548,0.158962795941375,0.131623449830891,0.619503945885006,0.0298759864712514,0.101747463359639,0.129086809470124
"E02000799",298,428,934,80,348,218,2002,0.148851148851149,0.213786213786214,0.466533466533467,0.03996003996004,0.173826173826174,0.108891108891109
"E02000800",310,467,580,120,347,190,1619,0.19147621988882,0.288449660284126,0.358245830759728,0.0741198270537369,0.214329833230389,0.117356392835083
"E02000801",283,328,1428,42,286,241,2895,0.0977547495682211,0.113298791018998,0.493264248704663,0.0145077720207254,0.0987910189982729,0.0832469775474957
"E02000802",365,499,1222,98,401,267,2664,0.137012012012012,0.187312312312312,0.458708708708709,0.0367867867867868,0.150525525525526,0.100225225225225
"E02000803",640,999,627,256,743,384,3380,0.189349112426035,0.295562130177515,0.185502958579882,0.0757396449704142,0.219822485207101,0.113609467455621
"E02000804",431,502,1426,103,399,328,2887,0.149289920332525,0.173882923449948,0.493938344302044,0.0356771735365431,0.138205749913405,0.113612746795982
"E02000805",505,806,1569,131,675,374,4558,0.110794207985959,0.176831943835015,0.34422992540588,0.0287406757349715,0.148091268100044,0.0820535322509873
"E02000806",575,492,1629,106,386,469,3486,0.164945496270797,0.141135972461274,0.467297762478485,0.0304073436603557,0.110728628800918,0.134538152610442
"E02000807",390,227,297,53,174,337,4280,0.0911214953271028,0.0530373831775701,0.069392523364486,0.0123831775700935,0.0406542056074766,0.0787383177570093
"E02000808",89,230,1481,17,213,72,6746,0.0131930032611918,0.0340942780907204,0.2195375037059,0.00252001185887934,0.0315742662318411,0.0106729914023125
"E02000810",140,301,965,25,276,115,5193,0.0269593683805122,0.0579626420181013,0.185827074908531,0.00481417292509147,0.0531484690930098,0.0221451954554208
"E02000812",115,373,1591,30,343,85,4894,0.0234981610134859,0.0762157744176543,0.325091949325705,0.00612995504699632,0.0700858193706579,0.0173682059664896
"E02000813",101,305,1141,14,291,87,4421,0.022845510065596,0.0689889165347207,0.258086405790545,0.00316670436552816,0.0658222121691925,0.0196788057000679
"E02000814",297,280,346,42,238,255,5166,0.0574912891986063,0.0542005420054201,0.0669763840495548,0.00813008130081301,0.046070460704607,0.0493612078977933
"E02000815",51,162,1072,0,162,51,4848,0.010519801980198,0.0334158415841584,0.221122112211221,0,0.0334158415841584,0.010519801980198
"E02000816",334,410,512,29,381,305,4262,0.0783669638667292,0.0961989676208353,0.120131393711872,0.00680431722196152,0.0893946503988738,0.0715626466447677
"E02000817",231,310,163,63,247,168,2585,0.0893617021276596,0.119922630560928,0.0630560928433269,0.0243713733075435,0.0955512572533849,0.0649903288201161
"E02000818",232,439,1370,78,361,154,4752,0.0488215488215488,0.0923821548821549,0.288299663299663,0.0164141414141414,0.0759680134680135,0.0324074074074074
"E02000819",253,386,806,35,351,218,3089,0.0819035286500486,0.124959533829718,0.260925865976044,0.0113305276788605,0.113629006150858,0.0705730009711881
"E02000820",216,361,1173,58,303,158,4275,0.0505263157894737,0.0844444444444444,0.274385964912281,0.0135672514619883,0.0708771929824561,0.0369590643274854
"E02000821",159,171,1065,18,153,141,2559,0.0621336459554514,0.0668229777256741,0.416178194607268,0.00703399765533412,0.05978898007034,0.0550996483001172
"E02000822",255,220,1662,27,193,228,3232,0.0788985148514851,0.0680693069306931,0.514232673267327,0.0083539603960396,0.0597153465346535,0.0705445544554455
"E02000823",181,348,1217,22,326,159,3078,0.0588044184535413,0.113060428849903,0.39538661468486,0.00714749837556855,0.105912930474334,0.0516569200779727
"E02000824",123,312,1053,12,300,111,3333,0.0369036903690369,0.0936093609360936,0.315931593159316,0.0036003600360036,0.09000900090009,0.0333033303330333
"E02000825",99,398,202,8,390,91,3457,0.0286375470060746,0.115128724327452,0.0584321666184553,0.00231414521261209,0.112814579114839,0.0263234017934625
"E02000826",209,274,1255,30,244,179,3460,0.0604046242774566,0.0791907514450867,0.36271676300578,0.00867052023121387,0.0705202312138728,0.0517341040462428
"E02000827",159,322,1879,28,294,131,4161,0.0382119682768565,0.0773852439317472,0.451574140831531,0.00672915164623888,0.0706560922855083,0.0314828166306176
"E02000828",235,307,1170,16,291,219,3308,0.0710399032648126,0.0928053204353083,0.353688029020556,0.00483675937122128,0.0879685610640871,0.0662031438935913
"E02000829",422,417,1788,51,366,371,4371,0.0965454129489819,0.0954015099519561,0.409059711736445,0.0116678105696637,0.0837336993822924,0.0848776023793182
"E02000830",471,320,2132,41,279,430,3862,0.121957534955981,0.0828586224754014,0.552045572242362,0.0106162610046608,0.0722423614707405,0.111341273951321
"E02000831",468,207,2404,24,183,444,4180,0.111961722488038,0.0495215311004785,0.57511961722488,0.00574162679425837,0.0437799043062201,0.10622009569378
"E02000832",412,545,1559,82,463,330,3824,0.107740585774059,0.142520920502092,0.407688284518828,0.0214435146443515,0.121077405857741,0.0862970711297071
"E02000833",200,545,1111,68,477,132,2434,0.0821692686935086,0.223911257189811,0.45645028759244,0.0279375513557929,0.195973705834018,0.0542317173377157
"E02000834",538,168,2977,18,150,520,4446,0.121007647323437,0.0377867746288799,0.669590643274854,0.00404858299595142,0.0337381916329285,0.116959064327485
"E02000835",351,133,1757,14,119,337,2636,0.133156297420334,0.0504552352048558,0.666540212443096,0.00531107738998483,0.045144157814871,0.127845220030349
"E02000836",589,135,2535,19,116,570,3243,0.181621954979957,0.0416281221091582,0.78168362627197,0.00585877274128893,0.0357693493678693,0.175763182238668
"E02000837",582,239,1940,41,198,541,2701,0.215475749722325,0.0884857460199926,0.718252499074417,0.0151795631247686,0.073306182895224,0.200296186597556
"E02000838",508,367,2445,53,314,455,3793,0.133930925388874,0.0967571842868442,0.644608489322436,0.0139731083575007,0.0827840759293435,0.119957817031374
"E02000839",395,1130,1126,196,934,199,3320,0.118975903614458,0.340361445783133,0.339156626506024,0.0590361445783133,0.281325301204819,0.0599397590361446
"E02000840",427,746,262,154,592,273,2740,0.155839416058394,0.272262773722628,0.0956204379562044,0.0562043795620438,0.216058394160584,0.0996350364963504
"E02000841",394,842,322,228,614,166,2622,0.150266971777269,0.321128909229596,0.12280701754386,0.0869565217391304,0.234172387490465,0.0633104500381388
"E02000842",379,251,1365,57,194,322,2023,0.187345526445872,0.124073158675235,0.674740484429066,0.0281759762728621,0.0958971824023727,0.15916955017301
"E02000843",526,403,881,86,317,440,4227,0.124438135793707,0.0953394842678022,0.208422048734327,0.0203453986278685,0.0749940856399338,0.104092737165839
"E02000844",434,399,1090,83,316,351,2606,0.166538756715272,0.15310821181888,0.418265541059094,0.0318495778971604,0.121258633921719,0.134689178818112
"E02000845",428,289,1536,63,226,365,3089,0.138556167044351,0.0935577856911622,0.497248300420848,0.0203949498219489,0.0731628358692133,0.118161217222402
"E02000846",352,379,1109,89,290,263,2105,0.167220902612827,0.180047505938242,0.526840855106888,0.0422802850356295,0.137767220902613,0.124940617577197
"E02000847",496,501,1359,122,379,374,2855,0.173730297723292,0.175481611208406,0.47600700525394,0.0427320490367776,0.132749562171629,0.130998248686515
"E02000848",395,271,1362,54,217,341,2013,0.196224540486836,0.134624937903626,0.676602086438152,0.0268256333830104,0.107799304520616,0.169398907103825
"E02000849",373,428,1173,46,382,327,2477,0.150585385547033,0.172789664917239,0.473556721840937,0.0185708518368995,0.154218813080339,0.132014533710133
"E02000850",638,491,1478,128,363,510,2998,0.212808539026017,0.163775850567045,0.492995330220147,0.0426951300867245,0.12108072048032,0.170113408939293
"E02000851",351,600,1226,67,533,284,5751,0.0610328638497653,0.104329681794471,0.213180316466701,0.0116501478003825,0.092679533994088,0.0493827160493827
"E02000852",423,433,1574,59,374,364,2761,0.153205360376675,0.156827236508511,0.570083303151032,0.0213690691778341,0.135458167330677,0.131836291198841
"E02000853",379,445,1384,76,369,303,2696,0.140578635014837,0.165059347181009,0.513353115727003,0.0281899109792285,0.13686943620178,0.112388724035608
"E02000854",405,400,1365,75,325,330,2590,0.156370656370656,0.154440154440154,0.527027027027027,0.028957528957529,0.125482625482625,0.127413127413127
"E02000855",488,454,1212,129,325,359,2435,0.20041067761807,0.186447638603696,0.497741273100616,0.0529774127310062,0.13347022587269,0.147433264887064
"E02000856",522,494,1577,66,428,456,3415,0.15285505124451,0.144655929721816,0.461786237188873,0.0193265007320644,0.125329428989751,0.133528550512445
"E02000857",450,1705,894,226,1479,224,4364,0.103116406966086,0.390696608615949,0.204857928505958,0.0517873510540788,0.33890925756187,0.0513290559120073
"E02000858",367,473,497,70,403,297,3081,0.119117169750081,0.153521583901331,0.161311262577085,0.0227198961376177,0.130801687763713,0.0963972736124635
"E02000859",409,777,1075,114,663,295,3017,0.13556513092476,0.25754060324826,0.356314219423268,0.0377858800132582,0.219754723235002,0.0977792509115015
"E02000860",356,986,703,117,869,239,4630,0.076889848812095,0.212958963282937,0.151835853131749,0.0252699784017279,0.187688984881209,0.0516198704103672
"E02000861",411,452,963,136,316,275,1944,0.21141975308642,0.232510288065844,0.49537037037037,0.0699588477366255,0.162551440329218,0.141460905349794
"E02000863",360,356,563,119,237,241,1614,0.223048327137546,0.220570012391574,0.348822800495663,0.073729863692689,0.146840148698885,0.149318463444857
"E02000864",108,541,453,24,517,84,4794,0.0225281602002503,0.11284939507718,0.0944931163954944,0.00500625782227785,0.107843137254902,0.0175219023779725
"E02000865",110,298,847,31,267,79,2755,0.0399274047186933,0.108166969147005,0.307441016333938,0.0112522686025408,0.0969147005444646,0.0286751361161524
"E02000866",261,514,1679,23,491,238,3920,0.0665816326530612,0.131122448979592,0.428316326530612,0.00586734693877551,0.125255102040816,0.0607142857142857
"E02000867",213,569,953,79,490,134,6065,0.0351195383347073,0.0938169826875515,0.157131079967024,0.0130255564715581,0.0807914262159934,0.0220939818631492
"E02000868",72,417,1029,4,413,68,2872,0.0250696378830084,0.145194986072423,0.358286908077994,0.00139275766016713,0.143802228412256,0.0236768802228412
"E02000869",120,437,868,20,417,100,2475,0.0484848484848485,0.176565656565657,0.350707070707071,0.00808080808080808,0.168484848484848,0.0404040404040404
"E02000870",113,358,988,36,322,77,2228,0.0507181328545781,0.160682226211849,0.443447037701975,0.0161579892280072,0.144524236983842,0.0345601436265709
"E02000871",132,362,652,49,313,83,5314,0.0248400451637185,0.0681219420398946,0.122694768535943,0.00922092585622883,0.0589010161836658,0.0156191193074897
"E02000872",91,244,867,7,237,84,3976,0.022887323943662,0.0613682092555332,0.218058350100604,0.00176056338028169,0.0596076458752515,0.0211267605633803
"E02000873",76,604,632,22,582,54,3067,0.0247799152266058,0.196935115748288,0.206064558200196,0.0071731333550701,0.189761982393218,0.0176067818715357
"E02000874",87,184,996,10,174,77,2421,0.0359355638166047,0.0760016522098306,0.411400247831475,0.00413052457662123,0.0718711276332094,0.0318050392399835
"E02000875",141,608,609,41,567,100,5981,0.0235746530680488,0.101655241598395,0.101822437719445,0.00685504096304966,0.0948002006353453,0.0167196121049992
"E02000876",138,413,1191,28,385,110,3268,0.0422276621787026,0.126376988984088,0.364443084455324,0.00856793145654835,0.11780905752754,0.0336597307221542
"E02000877",80,901,675,14,887,66,5654,0.014149274849664,0.15935620799434,0.11938450654404,0.00247612309869119,0.156880084895649,0.0116731517509728
"E02000878",154,344,1863,24,320,130,5465,0.0281793229643184,0.0629460201280878,0.340896614821592,0.00439158279963403,0.0585544373284538,0.0237877401646844
"E02000879",126,485,853,42,443,84,3051,0.0412979351032448,0.158964274008522,0.279580465421173,0.0137659783677483,0.145198295640774,0.0275319567354966
"E02000880",81,335,875,14,321,67,3065,0.0264274061990212,0.109298531810767,0.285481239804241,0.00456769983686786,0.104730831973899,0.0218597063621533
"E02000881",167,805,355,110,695,57,5225,0.0319617224880383,0.154066985645933,0.0679425837320574,0.0210526315789474,0.133014354066986,0.0109090909090909
"E02000882",166,331,560,64,267,102,3638,0.045629466739967,0.0909840571742716,0.153930731170973,0.0175920835623969,0.0733919736118747,0.0280373831775701
"E02000883",102,469,382,20,449,82,3447,0.0295909486510009,0.136060342326661,0.110821003771395,0.0058021467943139,0.130258195532347,0.023788801856687
"E02000884",104,244,1315,13,231,91,7696,0.0135135135135135,0.0317047817047817,0.170867983367983,0.00168918918918919,0.0300155925155925,0.0118243243243243
"E02000885",45,321,480,11,310,34,2331,0.0193050193050193,0.137709137709138,0.205920205920206,0.00471900471900472,0.132990132990133,0.0145860145860146
"E02000886",79,274,504,6,268,73,4430,0.0178329571106095,0.0618510158013544,0.113769751693002,0.00135440180586907,0.0604966139954853,0.0164785553047404
"E02000887",117,1102,865,48,1054,69,4482,0.0261044176706827,0.245872378402499,0.192994199018295,0.0107095046854083,0.235162873717091,0.0153949129852744
"E02000888",60,289,674,11,278,49,3964,0.0151362260343088,0.0729061553985873,0.170030272452069,0.00277497477295661,0.0701311806256307,0.0123612512613522
"E02000889",184,399,498,42,357,142,5913,0.0311178758667343,0.067478437341451,0.0842212075088787,0.00710299340436327,0.0603754439370878,0.024014882462371
"E02000890",139,320,937,28,292,111,3425,0.0405839416058394,0.0934306569343066,0.273576642335766,0.00817518248175183,0.0852554744525547,0.0324087591240876
"E02000893",227,263,227,24,239,203,3572,0.0635498320268757,0.0736282194848824,0.0635498320268757,0.00671892497200448,0.0669092945128779,0.0568309070548712
"E02000894",352,180,565,60,120,292,5474,0.0643039824625502,0.0328827183047132,0.103215199123128,0.0109609061015711,0.0219218122031421,0.0533430763609792
"E02000895",516,538,987,147,391,369,2824,0.18271954674221,0.190509915014164,0.349504249291785,0.0520538243626062,0.138456090651558,0.130665722379603
"E02000896",588,560,1685,77,483,511,3316,0.177322074788902,0.168878166465621,0.508142340168878,0.0232207478890229,0.145657418576598,0.154101326899879
"E02000897",456,703,949,167,536,289,2942,0.154996600951734,0.238953093133922,0.322569680489463,0.0567641060503059,0.182188987083617,0.0982324949014276
"E02000898",443,393,1028,72,321,371,2684,0.1650521609538,0.146423248882265,0.38301043219076,0.0268256333830104,0.119597615499255,0.13822652757079
"E02000899",443,229,1702,27,202,416,2618,0.169213139801375,0.0874713521772345,0.650114591291062,0.0103132161955691,0.0771581359816654,0.158899923605806
"E02000900",439,264,1336,42,222,397,2443,0.179697093737208,0.108063855914859,0.546868604175194,0.0171919770773639,0.0908718788374949,0.162505116659844
"E02000901",499,381,1779,61,320,438,3144,0.158715012722646,0.12118320610687,0.565839694656489,0.0194020356234097,0.101781170483461,0.139312977099237
"E02000902",474,217,1540,47,170,427,3170,0.149526813880126,0.0684542586750789,0.485804416403785,0.0148264984227129,0.0536277602523659,0.134700315457413
"E02000903",454,270,1602,55,215,399,3371,0.13467813705132,0.0800949273212696,0.4752299021062,0.0163156333432216,0.0637792939780481,0.118362503708098
"E02000904",470,138,1819,32,106,438,2771,0.169613857813064,0.0498015156983039,0.656441717791411,0.0115481775532299,0.038253338145074,0.158065680259834
"E02000905",637,160,2484,32,128,605,3465,0.183838383838384,0.0461760461760462,0.716883116883117,0.00923520923520924,0.0369408369408369,0.174603174603175
"E02000906",603,148,2561,30,118,573,3449,0.174833285010148,0.0429109886923746,0.742534067845752,0.00869817338358945,0.0342128153087852,0.166135111626558
"E02000907",427,622,1802,45,577,382,4931,0.0865950111539242,0.126140742242953,0.365443114986818,0.00912593794362198,0.117014804299331,0.0774690732103022
"E02000908",737,390,2394,72,318,665,6531,0.112846424743531,0.0597152044097382,0.366559485530547,0.0110243454294901,0.048690858980248,0.101822079314041
"E02000909",519,324,2140,44,280,475,3615,0.14356846473029,0.0896265560165975,0.591977869986169,0.0121715076071923,0.0774550484094053,0.131396957123098
"E02000910",678,319,2724,59,260,619,4663,0.145399957109157,0.0684108942740725,0.584173279004932,0.012652798627493,0.0557580956465795,0.132747158481664
"E02000911",791,233,3172,29,204,762,5761,0.13730255164034,0.0404443672973442,0.550598854365562,0.00503384829022739,0.0354105190071168,0.132268703350113
"E02000912",582,297,1685,69,228,513,2865,0.203141361256545,0.103664921465969,0.588132635253054,0.0240837696335079,0.0795811518324607,0.179057591623037
"E02000913",532,203,2021,51,152,481,2698,0.197183098591549,0.075240919199407,0.749073387694589,0.0189028910303929,0.0563380281690141,0.178280207561156
"E02000914",478,209,2248,22,187,456,4150,0.115180722891566,0.0503614457831325,0.541686746987952,0.00530120481927711,0.0450602409638554,0.109879518072289
"E02000915",452,266,2306,27,239,425,3129,0.144455097475232,0.0850111856823266,0.736976669862576,0.00862895493767977,0.0763822307446469,0.135826142537552
"E02000916",710,107,2778,22,85,688,4157,0.170796247293721,0.0257397161414482,0.668270387298533,0.00529227808515757,0.0204474380562906,0.165503969208564
"E02000917",662,183,2926,28,155,634,3938,0.16810563737938,0.0464702894870493,0.743016759776536,0.00711020822752666,0.0393600812595226,0.160995429151854
"E02000918",467,258,1736,55,203,412,3751,0.124500133297787,0.0687816582244735,0.462809917355372,0.0146627565982405,0.054118901626233,0.109837376699547
"E02000919",615,132,2673,23,109,592,3283,0.187328662808407,0.0402071276271703,0.814194334450198,0.0070057873895827,0.0332013402375876,0.180322875418824
"E02000920",498,325,1818,49,276,449,4250,0.117176470588235,0.0764705882352941,0.427764705882353,0.0115294117647059,0.0649411764705882,0.105647058823529
"E02000921",612,385,1939,77,308,535,4023,0.152125279642058,0.0956997265722098,0.48197862291822,0.019139945314442,0.0765597812577678,0.132985334327616
"E02000922",678,257,2857,62,195,616,3841,0.176516532153085,0.0669096589429836,0.743816714397292,0.0161416297839104,0.0507680291590732,0.160374902369175
"E02000923",154,296,1674,11,285,143,3844,0.0400624349635796,0.077003121748179,0.435483870967742,0.00286160249739854,0.0741415192507804,0.0372008324661811
"E02000925",197,247,1410,11,236,186,3210,0.0613707165109034,0.0769470404984424,0.439252336448598,0.00342679127725857,0.0735202492211838,0.0579439252336449
"E02000926",181,531,1422,11,520,170,7424,0.0243803879310345,0.0715247844827586,0.191540948275862,0.00148168103448276,0.0700431034482759,0.0228987068965517
"E02000927",385,252,2026,60,192,325,3122,0.123318385650224,0.0807174887892377,0.648942985265855,0.0192184497117233,0.0614990390775144,0.104099935938501
"E02000928",422,191,2505,25,166,397,3629,0.116285478093139,0.0526315789473684,0.69027280242491,0.0068889501240011,0.0457426288233673,0.109396527969137
"E02000929",175,472,471,70,402,105,3559,0.0491711154818769,0.132621522899691,0.132340545096937,0.0196684461927508,0.11295307670694,0.0295026692891262
"E02000930",536,284,3110,33,251,503,4971,0.107825387246027,0.0571313618990143,0.625628646147656,0.00663850331925166,0.0504928585797626,0.101186883926775
"E02000931",519,59,3046,12,47,507,3698,0.140346133044889,0.0159545700378583,0.8236884802596,0.00324499729583559,0.0127095727420227,0.137101135749054
"E02000932",407,162,2724,6,156,401,8883,0.0458178543284926,0.0182370820668693,0.306653157716987,0.000675447483958122,0.0175616345829112,0.0451424068445345
"E02000933",311,815,1647,71,744,240,3940,0.0789340101522843,0.206852791878173,0.418020304568528,0.0180203045685279,0.188832487309645,0.0609137055837563
"E02000934",484,484,2758,74,410,410,5214,0.0928270042194093,0.0928270042194093,0.528960490985807,0.014192558496356,0.0786344457230533,0.0786344457230533
"E02000935",93,343,151,60,283,33,2234,0.0416293643688451,0.153536257833483,0.067591763652641,0.026857654431513,0.12667860340197,0.0147717099373321
"E02000936",200,1098,1647,54,1044,146,5159,0.0387672029463074,0.212831944175228,0.319247916262842,0.010467144795503,0.202364799379725,0.0283000581508044
"E02000937",401,233,2089,40,193,361,3168,0.126578282828283,0.0735479797979798,0.659406565656566,0.0126262626262626,0.0609217171717172,0.11395202020202
"E02000938",242,775,1235,103,672,139,4282,0.0565156468939748,0.180990191499299,0.288416627744045,0.0240541802895843,0.156936011209715,0.0324614666043905
"E02000939",359,94,1969,13,81,346,2618,0.137127578304049,0.0359052711993888,0.752100840336134,0.00496562261268144,0.0309396485867074,0.132161955691367
"E02000940",243,178,1541,26,152,217,4804,0.0505828476269775,0.037052456286428,0.320774354704413,0.00541215653621982,0.0316402997502082,0.0451706910907577
"E02000941",582,260,3109,54,206,528,4417,0.131763640479964,0.0588634820013584,0.703871405931628,0.0122254924156667,0.0466379895856916,0.119538148064297
"E02000942",397,322,2416,29,293,368,3752,0.105810234541578,0.0858208955223881,0.643923240938166,0.00772921108742004,0.078091684434968,0.0980810234541578
"E02000943",402,237,2595,19,218,383,4407,0.0912185159972771,0.0537780803267529,0.588835942818244,0.00431132289539369,0.0494667574313592,0.0869071931018834
"E02000944",109,706,522,45,661,64,2860,0.0381118881118881,0.246853146853147,0.182517482517483,0.0157342657342657,0.231118881118881,0.0223776223776224
"E02000945",165,370,589,39,331,126,2815,0.0586145648312611,0.131438721136767,0.209236234458259,0.013854351687389,0.117584369449378,0.0447602131438721
"E02000946",379,242,1919,32,210,347,3202,0.118363522798251,0.075577763897564,0.599312929419113,0.00999375390381012,0.0655840099937539,0.108369768894441
"E02000947",458,271,2729,19,252,439,4181,0.109543171490074,0.0648170294187993,0.652714661564219,0.00454436737622578,0.0602726620425735,0.104998804113848
"E02000948",658,302,2659,44,258,614,5027,0.130893176845037,0.060075591804257,0.528943703998409,0.0087527352297593,0.0513228565744977,0.122140441615277
"E02000949",478,196,2844,30,166,448,4940,0.0967611336032389,0.0396761133603239,0.575708502024291,0.00607287449392713,0.0336032388663968,0.0906882591093117
"E02000950",198,907,833,79,828,119,3114,0.0635838150289017,0.291265253692999,0.267501605651895,0.0253692999357739,0.265895953757225,0.0382145150931278
"E02000951",324,147,1936,25,122,299,3006,0.107784431137725,0.0489021956087824,0.644045242847638,0.0083166999334664,0.040585495675316,0.0994677312042582
"E02000952",307,175,1733,18,157,289,2626,0.116907844630617,0.0666412795125666,0.65993907083016,0.00685453160700685,0.0597867479055598,0.11005331302361
"E02000953",306,194,1809,26,168,280,3292,0.0929526123936816,0.0589307411907655,0.54951397326853,0.00789793438639125,0.0510328068043742,0.0850546780072904
"E02000954",407,76,1651,19,57,388,2147,0.189566837447601,0.0353982300884956,0.768979972054029,0.00884955752212389,0.0265486725663717,0.180717279925477
"E02000955",325,65,1945,13,52,312,2481,0.13099556630391,0.0261991132607819,0.783958081418783,0.00523982265215639,0.0209592906086256,0.125755743651753
"E02000956",383,153,2232,25,128,358,3425,0.111824817518248,0.0446715328467153,0.651678832116788,0.0072992700729927,0.0373722627737226,0.104525547445255
"E02000957",582,173,2947,16,157,566,4928,0.118100649350649,0.0351055194805195,0.598011363636364,0.00324675324675325,0.0318587662337662,0.114853896103896
"E02000958",413,248,1758,30,218,383,2482,0.166398066075745,0.0999194198227236,0.708299758259468,0.0120870265914585,0.0878323932312651,0.154311039484287
"E02000959",404,157,2156,19,138,385,3104,0.130154639175258,0.0505798969072165,0.694587628865979,0.00612113402061856,0.0444587628865979,0.124033505154639
"E02000960",111,439,2204,7,432,104,3481,0.0318873886814134,0.12611318586613,0.633151393277794,0.00201091640333238,0.124102269462798,0.029876472278081
"E02000961",224,404,2635,18,386,206,4541,0.0493283417749394,0.0889671878440872,0.580268663290024,0.00396388460691478,0.0850033032371724,0.0453644571680247
"E02000962",84,490,2701,11,479,73,5350,0.0157009345794393,0.091588785046729,0.504859813084112,0.00205607476635514,0.0895327102803738,0.0136448598130841
"E02000963",369,254,2341,16,238,353,3878,0.0951521402784941,0.0654976792160908,0.60366168127901,0.00412583806085611,0.0613718411552347,0.091026302217638
"E02000964",357,435,3391,14,421,343,5412,0.0659645232815965,0.0803769401330377,0.626570583887657,0.00258684405025868,0.077790096082779,0.0633776792313378
"E02000965",174,113,3293,1,112,173,4246,0.0409797456429581,0.026613283089967,0.77555346208196,0.00023551577955723,0.0263777673104098,0.0407442298634009
"E02000966",213,338,3244,15,323,198,4645,0.0458557588805167,0.0727664155005382,0.698385360602799,0.00322927879440258,0.0695371367061356,0.0426264800861141
"E02000967",93,145,2808,5,140,88,4653,0.0199871050934881,0.0311626907371588,0.603481624758221,0.00107457554266065,0.0300881151944982,0.0189125295508274
"E02000968",105,544,1955,10,534,95,6107,0.0171933846405764,0.0890781070902243,0.320124447355494,0.00163746520386442,0.0874406418863599,0.015555919436712
"E02000969",41,632,542,7,625,34,3360,0.012202380952381,0.188095238095238,0.161309523809524,0.00208333333333333,0.186011904761905,0.0101190476190476
"E02000970",263,249,4356,5,244,258,7428,0.0354065697361335,0.0335218093699515,0.586429725363489,0.000673128702207862,0.0328486806677437,0.0347334410339257
"E02000971",159,214,3945,1,213,158,5876,0.0270592239618788,0.0364193328795099,0.671375085091899,0.000170183798502383,0.0362491490810075,0.0268890401633764
"E02000972",140,293,2982,0,293,140,7041,0.0198835392699901,0.0416134071864792,0.423519386450788,0,0.0416134071864792,0.0198835392699901
"E02000973",207,301,3827,7,294,200,5650,0.0366371681415929,0.0532743362831858,0.677345132743363,0.00123893805309735,0.0520353982300885,0.0353982300884956
"E02000974",139,676,2603,6,670,133,6840,0.0203216374269006,0.0988304093567251,0.380555555555556,0.00087719298245614,0.097953216374269,0.0194444444444444
"E02000975",124,267,3265,4,263,120,5270,0.0235294117647059,0.0506641366223909,0.61954459203036,0.000759013282732448,0.0499051233396584,0.0227703984819734
"E02000976",154,523,3439,10,513,144,6244,0.0246636771300448,0.0837604099935939,0.550768737988469,0.00160153747597694,0.0821588725176169,0.0230621396540679
"E02000977",155,342,3798,2,340,153,7850,0.0197452229299363,0.0435668789808917,0.483821656050955,0.000254777070063694,0.043312101910828,0.0194904458598726
"E02000978",226,279,3613,9,270,217,5467,0.0413389427473934,0.0510334735686848,0.660874336930675,0.0016462410828608,0.049387232485824,0.0396927016645326
"E02000979",61,146,2079,1,145,60,6128,0.00995430809399478,0.0238250652741514,0.339262402088773,0.000163185378590078,0.0236618798955614,0.0097911227154047
"E02000980",42,541,1956,2,539,40,5194,0.00808625336927224,0.104158644589911,0.376588371197536,0.000385059684251059,0.10377358490566,0.00770119368502118
"E02000981",235,59,3722,3,56,232,5102,0.0460603684829479,0.0115640925127401,0.729517836142689,0.000588004704037632,0.0109760878087025,0.0454723637789102
"E02000982",93,397,1736,5,392,88,5256,0.0176940639269406,0.0755327245053272,0.330289193302892,0.000951293759512938,0.0745814307458143,0.0167427701674277
"E02000983",71,2174,1182,1,2173,70,5432,0.0130706921944035,0.400220913107511,0.21759941089838,0.000184094256259205,0.400036818851252,0.0128865979381443
"E02000984",445,441,415,149,292,296,2293,0.194068905364152,0.192324465765373,0.18098560837331,0.0649803750545137,0.127344090710859,0.129088530309638
"E02000985",535,565,260,207,358,328,2279,0.234752084247477,0.247915752523036,0.114085125054849,0.0908293111013602,0.157086441421676,0.143922773146117
"E02000986",644,782,378,264,518,380,3094,0.208144796380091,0.252747252747253,0.122171945701357,0.0853264382676147,0.167420814479638,0.122818358112476
"E02000987",577,761,568,238,523,339,3172,0.181904161412358,0.239911727616646,0.17906683480454,0.075031525851198,0.164880201765448,0.10687263556116
"E02000988",555,793,433,211,582,344,3263,0.170088875268158,0.243027888446215,0.132699969353356,0.0646644192460925,0.178363469200123,0.105424456022066
"E02000989",649,606,203,239,367,410,2595,0.25009633911368,0.233526011560694,0.0782273603082852,0.0921001926782274,0.141425818882466,0.157996146435453
"E02000990",535,778,299,229,549,306,3197,0.167344385361276,0.243353143572099,0.0935251798561151,0.0716296527994995,0.171723490772599,0.0957147325617767
"E02000991",558,971,211,278,693,280,2613,0.213547646383467,0.371603520857252,0.0807500956754688,0.106391121316494,0.265212399540758,0.107156525066973
"E02000992",414,470,213,170,300,244,2067,0.200290275761974,0.227382680212869,0.103047895500726,0.0822447992259313,0.145137880986938,0.118045476536043
"E02000993",362,438,180,105,333,257,3196,0.113266583229036,0.137046307884856,0.0563204005006258,0.0328535669586984,0.104192740926158,0.0804130162703379
"E02000994",571,729,447,194,535,377,3300,0.173030303030303,0.220909090909091,0.135454545454545,0.0587878787878788,0.162121212121212,0.114242424242424
"E02000995",544,717,194,205,512,339,2761,0.197030061571894,0.259688518652662,0.070264396957624,0.074248460702644,0.185440057950018,0.12278160086925
"E02000996",466,338,86,109,229,357,2909,0.160192506015813,0.116191130972843,0.0295634238569955,0.0374699209350292,0.0787212100378137,0.122722585080784
"E02000997",402,555,163,165,390,237,2594,0.15497301464919,0.213955281418658,0.0628373168851195,0.0636083269082498,0.150346954510409,0.0913646877409406
"E02000998",714,1339,737,345,994,369,3999,0.17854463615904,0.334833708427107,0.184296074018505,0.086271567891973,0.248562140535134,0.0922730682670668
"E02000999",423,495,224,94,401,329,4419,0.0957230142566191,0.112016293279022,0.0506902014030324,0.0212717809459154,0.090744512333107,0.0744512333107038
"E02001000",633,1252,562,305,947,328,3904,0.162141393442623,0.320696721311475,0.143954918032787,0.078125,0.242571721311475,0.0840163934426229
"E02001001",544,888,206,258,630,286,2957,0.183970240108218,0.300304362529591,0.0696652012174501,0.0872505918160298,0.213053770713561,0.096719648292188
"E02001002",513,737,100,195,542,318,2924,0.175444596443228,0.252051983584131,0.0341997264021888,0.0666894664842681,0.185362517099863,0.10875512995896
"E02001003",507,574,112,209,365,298,2134,0.237582005623243,0.268978444236176,0.0524835988753515,0.0979381443298969,0.171040299906279,0.139643861293346
"E02001004",447,654,180,139,515,308,2561,0.174541194845763,0.255368996485748,0.0702850449043343,0.0542756735650137,0.201093322920734,0.12026552128075
"E02001005",531,840,271,206,634,325,3636,0.146039603960396,0.231023102310231,0.0745324532453245,0.0566556655665567,0.174367436743674,0.0893839383938394
"E02001006",473,741,172,192,549,281,2247,0.210502892745883,0.32977303070761,0.0765465064530485,0.0854472630173565,0.244325767690254,0.125055629728527
"E02001007",676,657,146,214,443,462,2957,0.228610077781535,0.222184646601285,0.0493743659113967,0.0723706459249239,0.149814000676361,0.156239431856611
"E02001008",382,484,154,121,363,261,2431,0.157136980666392,0.199095022624434,0.0633484162895928,0.0497737556561086,0.149321266968326,0.107363225010284
"E02001009",449,664,200,191,473,258,2932,0.153137789904502,0.226466575716235,0.0682128240109141,0.0651432469304229,0.161323328785812,0.0879945429740791
"E02001010",442,717,264,181,536,261,2450,0.180408163265306,0.29265306122449,0.107755102040816,0.0738775510204082,0.218775510204082,0.106530612244898
"E02001011",471,678,219,191,487,280,3512,0.134111617312073,0.193052391799544,0.0623576309794989,0.0543849658314351,0.138667425968109,0.0797266514806378
"E02001012",416,612,93,171,441,245,2249,0.184971098265896,0.272120942641174,0.0413517118719431,0.0760337927967986,0.196087149844375,0.108937305469097
"E02001013",417,427,50,137,290,280,1909,0.218438973284442,0.223677317967522,0.0261917234154007,0.071765322158198,0.151911995809324,0.146673651126244
"E02001014",480,613,411,142,471,338,3497,0.137260509007721,0.17529310837861,0.117529310837861,0.0406062339147841,0.134686874463826,0.0966542750929368
"E02001015",567,838,225,228,610,339,3766,0.150557620817844,0.222517259691981,0.0597450876261285,0.0605416887944769,0.161975570897504,0.090015932023367
"E02001016",437,322,50,90,232,347,2772,0.157647907647908,0.116161616161616,0.018037518037518,0.0324675324675325,0.0836940836940837,0.125180375180375
"E02001017",615,785,187,259,526,356,3410,0.180351906158358,0.230205278592375,0.0548387096774194,0.0759530791788856,0.15425219941349,0.104398826979472
"E02001018",441,410,160,143,267,298,2254,0.195652173913043,0.18189884649512,0.0709849157054126,0.0634427684117125,0.118456078083407,0.132209405501331
"E02001019",590,529,1257,153,376,437,3537,0.166808029403449,0.149561775515974,0.355385920271416,0.0432569974554707,0.106304778060503,0.123551031947979
"E02001020",412,485,170,171,314,241,1742,0.236509758897819,0.27841561423651,0.0975889781859931,0.0981630309988519,0.180252583237658,0.138346727898967
"E02001021",483,444,659,130,314,353,2273,0.212494500659921,0.195336559612846,0.289925208974923,0.0571931368235812,0.138143422789265,0.15530136383634
"E02001022",426,650,366,176,474,250,2800,0.152142857142857,0.232142857142857,0.130714285714286,0.0628571428571429,0.169285714285714,0.0892857142857143
"E02001023",248,495,82,91,404,157,1897,0.130732735898788,0.260938323668951,0.0432261465471798,0.0479704797047971,0.212967843964154,0.0827622561939905
"E02001024",556,674,437,244,430,312,2419,0.229847044233154,0.278627532038032,0.180653162463828,0.100868127325341,0.177759404712691,0.128978916907813
"E02001025",441,607,492,157,450,284,3593,0.122738658502644,0.168939604787086,0.136932925132202,0.0436960757027554,0.125243529084331,0.0790425827998887
"E02001026",584,1163,1327,217,946,367,4728,0.123519458544839,0.245981387478849,0.280668358714044,0.0458967851099831,0.200084602368866,0.0776226734348562
"E02001027",487,757,859,181,576,306,3160,0.154113924050633,0.239556962025316,0.271835443037975,0.0572784810126582,0.182278481012658,0.0968354430379747
"E02001028",507,543,39,201,342,306,1941,0.261205564142195,0.279752704791345,0.0200927357032458,0.10355486862442,0.176197836166924,0.157650695517774
"E02001029",406,683,439,169,514,237,2758,0.147208121827411,0.247643219724438,0.159173313995649,0.061276287164612,0.186366932559826,0.0859318346627991
"E02001030",348,394,135,126,268,222,1767,0.196943972835314,0.222976796830787,0.0764006791171477,0.0713073005093379,0.151669496321449,0.125636672325976
"E02001031",357,581,221,172,409,185,2596,0.137519260400616,0.223805855161787,0.0851309707241911,0.0662557781201849,0.157550077041602,0.0712634822804314
"E02001032",466,730,166,220,510,246,2471,0.188587616349656,0.295426952650749,0.0671792796438689,0.0890327802509106,0.206394172399838,0.0995548360987455
"E02001033",364,564,230,167,397,197,2513,0.144846796657382,0.224432948666932,0.0915240748109829,0.0664544369279745,0.157978511738957,0.0783923597294071
"E02001034",531,1322,384,263,1059,268,4394,0.120846609012289,0.300864815657715,0.0873918980427856,0.0598543468365954,0.24101046882112,0.0609922621756941
"E02001035",374,616,98,172,444,202,1938,0.192982456140351,0.317853457172343,0.0505675954592363,0.0887512899896801,0.229102167182663,0.104231166150671
"E02001036",421,703,151,190,513,231,2862,0.147099930118798,0.245632424877708,0.0527603074772886,0.06638714185884,0.179245283018868,0.0807127882599581
"E02001037",433,999,217,257,742,176,2316,0.186960276338515,0.431347150259067,0.0936960276338515,0.110967184801382,0.320379965457686,0.075993091537133
"E02001038",395,760,275,196,564,199,2531,0.156064796523113,0.300276570525484,0.108652706440142,0.0774397471355196,0.222836823389964,0.0786250493875938
"E02001039",362,534,25,146,388,216,3120,0.116025641025641,0.171153846153846,0.00801282051282051,0.0467948717948718,0.124358974358974,0.0692307692307692
"E02001040",359,811,129,186,625,173,1987,0.180674383492703,0.408152994464016,0.0649219929542023,0.0936084549572219,0.314544539506794,0.0870659285354806
"E02001041",456,1070,508,235,835,221,3120,0.146153846153846,0.342948717948718,0.162820512820513,0.0753205128205128,0.267628205128205,0.0708333333333333
"E02001042",304,689,283,163,526,141,2730,0.111355311355311,0.252380952380952,0.103663003663004,0.0597069597069597,0.192673992673993,0.0516483516483516
"E02001043",312,568,122,155,413,157,2049,0.152269399707174,0.277208394338702,0.0595412396290874,0.0756466569058077,0.201561737432894,0.0766227428013665
"E02001044",422,983,399,240,743,182,2238,0.188561215370867,0.43923145665773,0.17828418230563,0.107238605898123,0.331992850759607,0.0813226094727435
"E02001045",415,704,252,176,528,239,3203,0.129566031845145,0.21979394317827,0.07867624102404,0.0549484857945676,0.164845457383703,0.0746175460505776
"E02001046",489,845,348,207,638,282,4074,0.120029455081001,0.207412862052037,0.085419734904271,0.0508100147275405,0.156602847324497,0.069219440353461
"E02001047",370,673,123,146,527,224,3915,0.0945083014048531,0.171902937420179,0.0314176245210728,0.0372924648786718,0.134610472541507,0.0572158365261814
"E02001048",354,1004,244,178,826,176,3125,0.11328,0.32128,0.07808,0.05696,0.26432,0.05632
"E02001049",466,735,275,197,538,269,3236,0.144004944375773,0.227132262051916,0.0849814585908529,0.0608776266996292,0.166254635352287,0.0831273176761434
"E02001050",459,943,1094,169,774,290,3555,0.129113924050633,0.265260196905767,0.307735583684951,0.0475386779184248,0.217721518987342,0.0815752461322082
"E02001051",590,1258,1126,255,1003,335,3606,0.163616195230172,0.348863006100943,0.312257348863006,0.0707154742096506,0.278147531891292,0.0929007210205214
"E02001052",740,1270,1397,249,1021,491,4683,0.158018364296391,0.271193679265428,0.298313047191971,0.0531710442024343,0.218022635062994,0.104847320093957
"E02001053",485,823,742,117,706,368,4854,0.099917593737124,0.169550885867326,0.15286361763494,0.0241038318912237,0.145447053976102,0.0758137618459003
"E02001055",483,865,508,179,686,304,3916,0.123340143003064,0.220888661899898,0.129724208375894,0.0457099080694586,0.175178753830439,0.0776302349336057
"E02001056",407,999,518,167,832,240,3387,0.120165338057278,0.294951284322409,0.15293770298199,0.0493061706524948,0.245645113669914,0.070859167404783
"E02001059",463,883,848,151,732,312,5561,0.0832584067613739,0.158784391296529,0.152490559251933,0.0271533896781154,0.131631001618414,0.0561050170832584
"E02001061",523,832,1479,145,687,378,5236,0.0998854087089381,0.158899923605806,0.282467532467532,0.0276928953399542,0.131207028265852,0.072192513368984
"E02001062",203,256,75,39,217,164,4111,0.0493797129652153,0.062271953296035,0.0182437363171978,0.00948674288494284,0.0527852104110922,0.0398929700802724
"E02001063",167,147,59,29,118,138,4018,0.0415629666500747,0.0365853658536585,0.0146839223494276,0.00721752115480338,0.0293678446988552,0.0343454454952713
"E02001064",377,602,351,114,488,263,4701,0.080195703041906,0.128057860029781,0.0746649649010849,0.0242501595405233,0.103807700489258,0.0559455435013827
"E02001065",690,1241,1869,286,955,404,4262,0.161895823557015,0.291177850774284,0.438526513374003,0.0671046457062412,0.224073205068043,0.0947911778507743
"E02001066",567,799,1907,124,675,443,4718,0.120178041543027,0.16935142009326,0.404196693514201,0.0262823230182281,0.143069097075032,0.0938957185247986
"E02001067",450,1067,835,167,900,283,4852,0.0927452596867271,0.219909315746084,0.172093981863149,0.0344187963726298,0.185490519373454,0.0583264633140973
"E02001068",432,665,1438,114,551,318,4730,0.0913319238900634,0.140591966173362,0.304016913319239,0.0241014799154334,0.116490486257928,0.06723044397463
"E02001069",722,1338,2562,217,1121,505,5110,0.141291585127202,0.261839530332681,0.501369863013699,0.0424657534246575,0.219373776908023,0.098825831702544
"E02001070",364,929,833,135,794,229,3987,0.091296714321545,0.233007273639328,0.208929019312767,0.0338600451467269,0.199147228492601,0.0574366691748182
"E02001072",424,1022,1458,147,875,277,4367,0.0970918250515228,0.234027936798718,0.333867643691321,0.0336615525532402,0.200366384245477,0.0634302724982826
"E02001073",490,1093,1549,186,907,304,3814,0.128474042999476,0.286575773466177,0.406135291033036,0.048767697954903,0.237808075511274,0.0797063450445726
"E02001074",474,1534,610,240,1294,234,4048,0.117094861660079,0.37895256916996,0.150691699604743,0.0592885375494071,0.319664031620553,0.0578063241106719
"E02001075",594,946,2035,166,780,428,3627,0.163771712158809,0.260821615660325,0.561069754618142,0.0457678522194651,0.21505376344086,0.118003859939344
"E02001076",478,942,1223,175,767,303,3663,0.130494130494131,0.257166257166257,0.333879333879334,0.0477750477750478,0.209391209391209,0.0827190827190827
"E02001077",387,659,1137,115,544,272,2763,0.140065146579805,0.238508867173362,0.411509229098806,0.0416214259862468,0.196887441187115,0.0984437205935577
"E02001078",575,1079,1195,235,844,340,3508,0.163911060433295,0.307582668187001,0.340649942987457,0.0669897377423033,0.240592930444698,0.096921322690992
"E02001079",531,591,510,188,403,343,3268,0.162484700122399,0.180844553243574,0.156058751529988,0.0575275397796818,0.123317013463892,0.104957160342717
"E02001080",546,949,1205,206,743,340,3925,0.139108280254777,0.241783439490446,0.307006369426752,0.052484076433121,0.189299363057325,0.086624203821656
"E02001081",399,645,947,133,512,266,2521,0.158270527568425,0.255850852836176,0.375644585481952,0.0527568425228084,0.203094010313368,0.105513685045617
"E02001082",396,793,1020,152,641,244,3089,0.12819682745225,0.256717384266753,0.330203949498219,0.0492068630624798,0.207510521204273,0.0789899643897702
"E02001083",460,531,1405,81,450,379,4851,0.0948258091115234,0.109461966604824,0.289631003916718,0.0166975881261596,0.0927643784786642,0.0781282209853638
"E02001084",455,865,623,202,663,253,3122,0.145739910313901,0.27706598334401,0.199551569506726,0.0647021140294683,0.212363869314542,0.0810377962844331
"E02001085",431,406,147,112,294,319,2610,0.165134099616858,0.155555555555556,0.0563218390804598,0.042911877394636,0.11264367816092,0.122222222222222
"E02001086",285,549,309,87,462,198,2807,0.101531884574279,0.195582472390452,0.110081938012113,0.0309939437121482,0.164588528678304,0.0705379408621304
"E02001087",562,1090,1123,211,879,351,4276,0.131431244153414,0.254911131898971,0.262628624883068,0.0493451824134705,0.2055659494855,0.0820860617399439
"E02001088",522,496,292,112,384,410,4615,0.113109425785482,0.107475622968581,0.0632719393282774,0.0242686890574215,0.0832069339111593,0.0888407367280607
"E02001089",348,888,239,182,706,166,2808,0.123931623931624,0.316239316239316,0.0851139601139601,0.0648148148148148,0.251424501424501,0.0591168091168091
"E02001090",359,521,470,125,396,234,3041,0.118053271950016,0.171325221966458,0.154554422887208,0.0411048997040447,0.130220322262414,0.0769483722459717
"E02001091",485,505,162,147,358,338,4091,0.118552921046199,0.123441701295527,0.0395991200195551,0.0359325348325593,0.0875091664629675,0.0826203862136397
"E02001092",457,812,346,143,669,314,4431,0.103136989392914,0.183254344391785,0.0780862107876326,0.0322726246896863,0.150981719702099,0.0708643647032273
"E02001093",355,514,289,98,416,257,4848,0.0732260726072607,0.106023102310231,0.0596122112211221,0.0202145214521452,0.0858085808580858,0.0530115511551155
"E02001094",373,584,227,95,489,278,5266,0.0708317508545385,0.110900113938473,0.0431067223699202,0.0180402582605393,0.0928598556779339,0.0527914925939992
"E02001095",562,669,276,135,534,427,4496,0.125,0.148798932384342,0.0613879003558719,0.0300266903914591,0.118772241992883,0.0949733096085409
"E02001096",429,544,126,159,385,270,3648,0.117598684210526,0.149122807017544,0.0345394736842105,0.0435855263157895,0.105537280701754,0.0740131578947368
"E02001097",467,431,112,134,297,333,3988,0.117101303911735,0.108074222668004,0.0280842527582748,0.0336008024072217,0.0744734202607824,0.0835005015045135
"E02001098",452,420,180,158,262,294,1934,0.233712512926577,0.217166494312306,0.093071354705274,0.0816959669079628,0.135470527404343,0.152016546018614
"E02001099",413,612,459,158,454,255,2231,0.185118780815778,0.274316450022411,0.205737337516809,0.0708202599731062,0.203496190049305,0.114298520842671
"E02001100",378,623,291,173,450,205,1928,0.196058091286307,0.323132780082988,0.150933609958506,0.0897302904564315,0.233402489626556,0.106327800829876
"E02001101",362,544,102,156,388,206,1635,0.221406727828746,0.332721712538226,0.0623853211009174,0.0954128440366973,0.237308868501529,0.125993883792049
"E02001102",402,502,162,163,339,239,1980,0.203030303030303,0.253535353535354,0.0818181818181818,0.0823232323232323,0.171212121212121,0.120707070707071
"E02001103",288,209,586,61,148,227,1687,0.170717249555424,0.123888559573207,0.347362181387078,0.036158861885003,0.0877296976882039,0.134558387670421
"E02001104",319,358,184,117,241,202,2113,0.150970184571699,0.169427354472314,0.0870799810695693,0.0553715097018457,0.114055844770469,0.0955986748698533
"E02001105",318,490,83,122,368,196,1968,0.161585365853659,0.248983739837398,0.0421747967479675,0.0619918699186992,0.186991869918699,0.0995934959349594
"E02001106",417,754,168,173,581,244,2531,0.164757013038325,0.297905966021335,0.0663769261161596,0.0683524298696167,0.229553536151719,0.096404583168708
"E02001107",402,704,142,185,519,217,2058,0.19533527696793,0.342079689018465,0.0689990281827016,0.0898931000971817,0.252186588921283,0.105442176870748
"E02001108",302,485,350,120,365,182,2179,0.138595686094539,0.222579164754475,0.160624139513538,0.0550711335474989,0.167508031206976,0.0835245525470399
"E02001109",491,777,475,202,575,289,3081,0.159363842908147,0.252190847127556,0.154170723790977,0.0655631288542681,0.186627718273288,0.0938007140538786
"E02001110",412,287,754,105,182,307,2122,0.194156456173421,0.135249764373233,0.355325164938737,0.0494816211121583,0.0857681432610745,0.144674835061263
"E02001111",387,656,235,109,547,278,3679,0.105191628159826,0.178309323185648,0.0638760532753466,0.0296276162000544,0.148681706985594,0.0755640119597717
"E02001112",328,398,32,118,280,210,1723,0.190365641323273,0.230992455020313,0.0185722576900754,0.0684852002321532,0.16250725478816,0.12188044109112
"E02001113",441,748,358,181,567,260,2425,0.181855670103093,0.308453608247423,0.147628865979381,0.074639175257732,0.233814432989691,0.107216494845361
"E02001114",345,668,170,161,507,184,3212,0.107409713574097,0.207970112079701,0.0529265255292653,0.0501245330012453,0.157845579078456,0.0572851805728518
"E02001115",385,443,447,127,316,258,2035,0.189189189189189,0.217690417690418,0.21965601965602,0.0624078624078624,0.155282555282555,0.126781326781327
"E02001116",567,932,521,272,660,295,2432,0.233141447368421,0.383223684210526,0.214226973684211,0.111842105263158,0.271381578947368,0.121299342105263
"E02001117",375,307,506,92,215,283,1982,0.18920282542886,0.15489404641776,0.255297679112008,0.0464177598385469,0.108476286579213,0.142785065590313
"E02001118",401,476,456,129,347,272,1938,0.206914344685243,0.245614035087719,0.235294117647059,0.0665634674922601,0.179050567595459,0.140350877192982
"E02001119",579,921,483,196,725,383,2487,0.232810615199035,0.370325693606755,0.194209891435464,0.0788098110172899,0.291515882589465,0.154000804181745
"E02001121",375,738,298,168,570,207,2531,0.148162781509285,0.291584354010273,0.117740023706045,0.0663769261161596,0.225207427894113,0.0817858553931252
"E02001123",390,371,246,100,271,290,2606,0.149654643131236,0.142363775901765,0.0943975441289332,0.0383729854182655,0.1039907904835,0.11128165771297
"E02001124",308,635,211,133,502,175,2479,0.124243646631706,0.256151674062122,0.0851149657119806,0.0536506655909641,0.202501008471158,0.0705929810407422
"E02001125",416,786,160,209,577,207,2497,0.166599919903885,0.314777733279936,0.0640768922707249,0.0837004405286344,0.231077292751302,0.0828994793752503
"E02001126",468,715,322,203,512,265,4062,0.115214180206795,0.176021664204825,0.0792712949286066,0.0499753815854259,0.126046282619399,0.0652387986213688
"E02001127",323,514,231,126,388,197,2523,0.128022195798652,0.203725723345224,0.0915576694411415,0.0499405469678954,0.153785176377329,0.078081648830757
"E02001128",509,1018,364,269,749,240,2821,0.180432470755051,0.360864941510103,0.129032258064516,0.0953562566465792,0.265508684863524,0.0850762141084722
"E02001129",420,939,430,234,705,186,2998,0.140093395597065,0.31320880587058,0.14342895263509,0.0780520346897932,0.235156771180787,0.0620413609072715
"E02001130",286,389,132,96,293,190,1800,0.158888888888889,0.216111111111111,0.0733333333333333,0.0533333333333333,0.162777777777778,0.105555555555556
"E02001131",326,446,76,118,328,208,1600,0.20375,0.27875,0.0475,0.07375,0.205,0.13
"E02001132",464,551,751,164,387,300,2730,0.16996336996337,0.201831501831502,0.275091575091575,0.0600732600732601,0.141758241758242,0.10989010989011
"E02001133",362,447,284,135,312,227,1934,0.18717683557394,0.231127197518097,0.146845915201655,0.0698035160289555,0.161323681489142,0.117373319544984
"E02001134",382,430,355,133,297,249,1919,0.199062011464304,0.224075039082856,0.184992183428869,0.0693069306930693,0.154768108389786,0.129755080771235
"E02001135",512,575,130,129,446,383,3505,0.146077032810271,0.164051355206847,0.0370898716119829,0.0368045649072753,0.127246790299572,0.109272467902996
"E02001136",518,607,322,167,440,351,3077,0.168345791355216,0.197270068248294,0.104647383815405,0.054273643158921,0.142996425089373,0.114072148196295
"E02001137",337,350,301,108,242,229,1839,0.183251767264818,0.190320826536161,0.163675910821098,0.0587275693311582,0.131593257205003,0.12452419793366
"E02001138",545,460,308,124,336,421,2654,0.205350414468726,0.173323285606631,0.116051243406179,0.0467219291635268,0.126601356443105,0.1586284853052
"E02001139",508,689,302,194,495,314,3108,0.163449163449163,0.221685971685972,0.0971685971685972,0.0624195624195624,0.159266409266409,0.101029601029601
"E02001140",412,600,342,153,447,259,2892,0.142461964038728,0.20746887966805,0.118257261410788,0.0529045643153527,0.154564315352697,0.0895573997233748
"E02001141",690,1057,623,233,824,457,5852,0.117908407382092,0.180622009569378,0.106459330143541,0.0398154477101846,0.140806561859193,0.078092959671907
"E02001142",413,485,132,147,338,266,1801,0.229317046085508,0.26929483620211,0.0732926152137701,0.0816213214880622,0.187673514714048,0.147695724597446
"E02001143",539,693,310,172,521,367,3738,0.144194756554307,0.185393258426966,0.0829320492241841,0.0460139111824505,0.139379347244516,0.0981808453718566
"E02001144",440,380,454,121,259,319,2316,0.189982728842832,0.164075993091537,0.196027633851468,0.0522452504317789,0.111830742659758,0.137737478411054
"E02001145",466,428,425,132,296,334,2191,0.212688270196257,0.195344591510726,0.193975353719763,0.0602464628023733,0.135098128708352,0.152441807393884
"E02001146",537,642,552,173,469,364,3001,0.178940353215595,0.213928690436521,0.183938687104299,0.0576474508497168,0.156281239586804,0.121292902365878
"E02001147",565,455,181,104,351,461,4555,0.12403951701427,0.0998902305159166,0.0397365532381998,0.0228320526893524,0.0770581778265642,0.101207464324918
"E02001148",733,887,335,278,609,455,4070,0.18009828009828,0.217936117936118,0.0823095823095823,0.0683046683046683,0.14963144963145,0.111793611793612
"E02001149",712,741,660,198,543,514,4909,0.145039722957833,0.150947239763699,0.134446934202485,0.0403340802607456,0.110613159502954,0.104705642697087
"E02001150",491,1079,118,194,885,297,3398,0.144496762801648,0.317539729252501,0.0347263095938788,0.0570924072984108,0.260447321954091,0.0874043555032372
"E02001151",542,806,511,195,611,347,3330,0.162762762762763,0.242042042042042,0.153453453453453,0.0585585585585586,0.183483483483483,0.104204204204204
"E02001152",529,747,115,195,552,334,4005,0.132084893882647,0.186516853932584,0.0287141073657928,0.048689138576779,0.137827715355805,0.0833957553058677
"E02001153",556,537,102,108,429,448,5034,0.110448947159317,0.106674612634088,0.0202622169249106,0.0214541120381406,0.0852205005959476,0.088994835121176
"E02001154",709,943,179,262,681,447,3921,0.180821219076766,0.24049987248151,0.0456516194848253,0.066819688854884,0.173680183626626,0.114001530221882
"E02001155",477,734,272,213,521,264,3120,0.152884615384615,0.23525641025641,0.0871794871794872,0.0682692307692308,0.166987179487179,0.0846153846153846
"E02001156",611,821,74,264,557,347,2899,0.210762331838565,0.283201103828907,0.0255260434632632,0.0910658847878579,0.192135219041049,0.119696447050707
"E02001157",546,529,198,249,280,297,4204,0.129876308277831,0.125832540437678,0.0470980019029496,0.0592293054234063,0.0666032350142721,0.0706470028544244
"E02001158",466,508,305,205,303,261,2996,0.155540720961282,0.169559412550067,0.101802403204272,0.0684245660881175,0.101134846461949,0.0871161548731642
"E02001159",332,375,237,118,257,214,3342,0.0993417115499701,0.112208258527828,0.0709156193895871,0.0353081986834231,0.0769000598444046,0.064033512866547
"E02001160",438,370,90,181,189,257,3225,0.135813953488372,0.114728682170543,0.027906976744186,0.0561240310077519,0.0586046511627907,0.0796899224806202
"E02001161",316,633,197,153,480,163,2347,0.134639965913933,0.269706007669365,0.083936940775458,0.0651896037494674,0.204516403919898,0.0694503621644653
"E02001162",415,569,236,155,414,260,2520,0.16468253968254,0.225793650793651,0.0936507936507937,0.0615079365079365,0.164285714285714,0.103174603174603
"E02001163",585,911,378,266,645,319,3891,0.150346954510409,0.234130043690568,0.0971472629144179,0.0683628887175533,0.165767154973015,0.0819840657928553
"E02001164",346,461,179,136,325,210,2976,0.116263440860215,0.154905913978495,0.0601478494623656,0.0456989247311828,0.109206989247312,0.0705645161290323
"E02001165",358,680,391,183,497,175,2401,0.149104539775094,0.283215326947105,0.162848812994586,0.0762182423990004,0.206997084548105,0.0728862973760933
"E02001166",328,712,459,119,593,209,2353,0.139396515087123,0.30259243518912,0.195070123246919,0.0505737356566086,0.252018699532512,0.0888227794305142
"E02001167",299,764,494,122,642,177,2949,0.101390301797219,0.259070871481858,0.167514411664971,0.0413699559172601,0.217700915564598,0.0600203458799593
"E02001168",571,855,471,264,591,307,4099,0.13930226884606,0.208587460356184,0.114906074652354,0.0644059526713833,0.144181507684801,0.0748963161746767
"E02001169",505,565,193,163,402,342,3150,0.16031746031746,0.179365079365079,0.0612698412698413,0.0517460317460317,0.127619047619048,0.108571428571429
"E02001170",487,870,416,239,631,248,3136,0.155293367346939,0.277423469387755,0.13265306122449,0.0762117346938776,0.201211734693878,0.0790816326530612
"E02001171",245,438,98,116,322,129,1779,0.137717818999438,0.246205733558179,0.0550871275997752,0.0652051714446318,0.181000562113547,0.0725126475548061
"E02001173",332,621,707,98,523,234,4360,0.0761467889908257,0.14243119266055,0.162155963302752,0.0224770642201835,0.119954128440367,0.0536697247706422
"E02001174",343,659,889,131,528,212,1987,0.172622043281329,0.331655762455964,0.447408152994464,0.0659285354806241,0.26572722697534,0.106693507800705
"E02001175",503,618,589,287,331,216,3083,0.163152773272786,0.200454103146286,0.19104768083036,0.0930911449886474,0.107362958157639,0.0700616282841388
"E02001176",584,739,1179,176,563,408,5353,0.109097702223052,0.138053427984308,0.220250326919484,0.0328787595740706,0.105174668410237,0.0762189426489819
"E02001177",645,1011,1234,215,796,430,6248,0.103233034571063,0.161811779769526,0.197503201024328,0.0344110115236876,0.127400768245839,0.0688220230473752
"E02001179",421,733,1145,152,581,269,3666,0.114839061647572,0.199945444626296,0.312329514457174,0.0414620840152755,0.15848336061102,0.0733769776322968
"E02001180",53,104,565,10,94,43,3233,0.0163934426229508,0.0321682647695639,0.174760284565419,0.00309310238168883,0.029075162387875,0.013300340241262
"E02001181",265,371,359,95,276,170,2632,0.100683890577508,0.140957446808511,0.136398176291793,0.0360942249240122,0.104863221884498,0.0645896656534954
"E02001182",315,459,923,86,373,229,3517,0.08956497014501,0.130508956497014,0.262439579186807,0.0244526585157805,0.106056297981234,0.0651123116292295
"E02001183",419,662,1185,137,525,282,3239,0.129360913862303,0.204384069157147,0.365853658536585,0.0422970052485335,0.162087063908614,0.0870639086137697
"E02001185",608,738,198,275,463,333,3450,0.176231884057971,0.213913043478261,0.0573913043478261,0.0797101449275362,0.134202898550725,0.0965217391304348
"E02001186",628,944,654,308,636,320,4292,0.146318732525629,0.219944082013048,0.15237651444548,0.0717614165890028,0.148182665424045,0.0745573159366263
"E02001187",470,674,446,199,475,271,2280,0.206140350877193,0.295614035087719,0.195614035087719,0.087280701754386,0.208333333333333,0.118859649122807
"E02001188",458,669,721,172,497,286,3322,0.137868753762794,0.201384708007225,0.217037928958459,0.0517760385310054,0.149608669476219,0.0860927152317881
"E02001189",533,908,421,286,622,247,2588,0.205950540958269,0.350850077279753,0.162673879443586,0.110510046367852,0.240340030911901,0.0954404945904173
"E02001190",263,791,432,92,699,171,3059,0.0859758090879372,0.258581235697941,0.141222621771821,0.0300751879699248,0.228506047728016,0.0559006211180124
"E02001191",321,423,260,133,290,188,1824,0.175986842105263,0.231907894736842,0.142543859649123,0.0729166666666667,0.158991228070175,0.103070175438596
"E02001192",470,875,678,212,663,258,2644,0.177760968229955,0.330937972768533,0.25642965204236,0.0801815431164902,0.250756429652042,0.0975794251134644
"E02001193",410,689,910,158,531,252,2750,0.149090909090909,0.250545454545455,0.330909090909091,0.0574545454545455,0.193090909090909,0.0916363636363636
"E02001194",427,715,368,177,538,250,2212,0.193037974683544,0.323236889692586,0.166365280289331,0.0800180831826401,0.243218806509946,0.113019891500904
"E02001195",512,747,297,227,520,285,2459,0.208214721431476,0.303782025213501,0.120780805205368,0.0923139487596584,0.211468076453843,0.115900772671818
"E02001196",519,762,350,231,531,288,2565,0.20233918128655,0.297076023391813,0.1364522417154,0.0900584795321637,0.207017543859649,0.112280701754386
"E02001197",341,629,253,169,460,172,1880,0.181382978723404,0.334574468085106,0.134574468085106,0.0898936170212766,0.24468085106383,0.0914893617021277
"E02001198",478,563,157,162,401,316,2959,0.161541061169314,0.190266982088543,0.0530584656978709,0.0547482257519432,0.1355187563366,0.106792835417371
"E02001199",584,888,566,260,628,324,2815,0.207460035523979,0.315452930728242,0.201065719360568,0.0923623445825933,0.223090586145648,0.115097690941385
"E02001200",308,650,1305,123,527,185,4363,0.0705936282374513,0.148980059592024,0.299106119642448,0.0281916112766445,0.120788448315379,0.0424020169608068
"E02001201",334,592,383,149,443,185,1911,0.174777603349032,0.309785452642595,0.200418628990058,0.0779696493982208,0.231815803244375,0.0968079539508111
"E02001202",378,847,1789,142,705,236,3191,0.118458163585083,0.265434033218427,0.560639298025697,0.0445001566906926,0.220933876527734,0.0739580068943905
"E02001203",383,463,404,130,333,253,1707,0.224370240187463,0.271236086701816,0.236672524897481,0.0761570005858231,0.195079086115993,0.14821323960164
"E02001204",515,1073,997,255,818,260,2837,0.181529784984138,0.378216425801903,0.351427564328516,0.0898836799436024,0.288332745858301,0.0916461050405358
"E02001205",455,823,765,191,632,264,3334,0.136472705458908,0.246850629874025,0.229454109178164,0.0572885422915417,0.189562087582483,0.0791841631673665
"E02001206",452,686,211,192,494,260,2564,0.176287051482059,0.267550702028081,0.0822932917316693,0.0748829953198128,0.192667706708268,0.101404056162246
"E02001207",444,574,90,206,368,238,2066,0.214908034849952,0.27783155856728,0.0435624394966118,0.0997095837366893,0.178121974830591,0.115198451113262
"E02001208",518,800,459,247,553,271,3007,0.172264715663452,0.266045892916528,0.152643831060858,0.0821416694379781,0.18390422347855,0.0901230462254739
"E02001209",466,973,1130,198,775,268,2973,0.156744029599731,0.32727884291961,0.38008745375042,0.0665993945509586,0.260679448368651,0.0901446350487723
"E02001210",340,492,127,149,343,191,2358,0.144189991518236,0.208651399491094,0.0538592027141645,0.0631891433418151,0.145462256149279,0.0810008481764207
"E02001211",371,648,144,194,454,177,1994,0.186058174523571,0.324974924774323,0.0722166499498496,0.0972918756268806,0.227683049147442,0.0887662988966901
"E02001212",303,340,72,106,234,197,2207,0.137290439510648,0.154055278658813,0.0326234707748074,0.0480289986406887,0.106026280018124,0.0892614408699592
"E02001213",652,1280,723,324,956,328,3589,0.181666202284759,0.356645305098913,0.201448871551964,0.0902758428531624,0.266369462245751,0.0913903594315965
"E02001214",459,735,123,225,510,234,2412,0.190298507462687,0.304726368159204,0.0509950248756219,0.0932835820895522,0.211442786069652,0.0970149253731343
"E02001215",388,488,332,151,337,237,1899,0.204318062137967,0.256977356503423,0.174828857293312,0.0795155344918378,0.177461822011585,0.12480252764613
"E02001216",434,653,150,189,464,245,2280,0.190350877192982,0.28640350877193,0.0657894736842105,0.0828947368421053,0.203508771929825,0.107456140350877
"E02001217",450,777,695,203,574,247,2840,0.158450704225352,0.273591549295775,0.244718309859155,0.0714788732394366,0.202112676056338,0.0869718309859155
"E02001218",403,518,52,183,335,220,1858,0.216899892357374,0.278794402583423,0.0279870828848224,0.0984930032292788,0.180301399354144,0.118406889128095
"E02001219",417,516,34,197,319,220,1440,0.289583333333333,0.358333333333333,0.0236111111111111,0.136805555555556,0.221527777777778,0.152777777777778
"E02001220",321,474,49,141,333,180,1636,0.196210268948655,0.289731051344743,0.0299511002444988,0.0861858190709046,0.203545232273839,0.110024449877751
"E02001221",320,450,44,155,295,165,1521,0.210387902695595,0.29585798816568,0.0289283366206443,0.101906640368179,0.193951347797502,0.108481262327416
"E02001222",422,531,24,177,354,245,1745,0.241833810888252,0.304297994269341,0.0137535816618911,0.101432664756447,0.202865329512894,0.140401146131805
"E02001223",561,693,60,241,452,320,1952,0.287397540983607,0.355020491803279,0.0307377049180328,0.123463114754098,0.23155737704918,0.163934426229508
"E02001224",479,520,157,196,324,283,1686,0.284104389086595,0.308422301304864,0.0931198102016607,0.116251482799526,0.192170818505338,0.16785290628707
"E02001225",481,679,183,225,454,256,2187,0.219935985368084,0.310470964791952,0.083676268861454,0.102880658436214,0.207590306355738,0.11705532693187
"E02001226",418,571,64,187,384,231,2370,0.176371308016878,0.240928270042194,0.0270042194092827,0.0789029535864979,0.162025316455696,0.0974683544303798
"E02001227",390,478,81,146,332,244,1511,0.258107213765718,0.316346790205162,0.0536068828590338,0.0966247518199868,0.219722038385175,0.161482461945731
"E02001228",399,499,100,184,315,215,2361,0.168996188055909,0.21135112240576,0.0423549343498518,0.0779330792037272,0.133418043202033,0.0910631088521813
"E02001229",650,485,1599,113,372,537,3879,0.167568961072441,0.125032224800206,0.412219644238206,0.0291312193864398,0.0959010054137664,0.138437741686002
"E02001230",266,348,64,101,247,165,1701,0.156378600823045,0.204585537918871,0.0376249265138154,0.0593768371546149,0.145208700764256,0.0970017636684303
"E02001231",383,393,183,130,263,253,2242,0.170829616413916,0.175289919714541,0.0816235504014273,0.0579839429081178,0.117305976806423,0.112845673505798
"E02001232",420,693,385,158,535,262,3232,0.129950495049505,0.214418316831683,0.119121287128713,0.0488861386138614,0.165532178217822,0.0810643564356436
"E02001233",388,471,233,118,353,270,2811,0.138029171113483,0.167556029882604,0.0828886517253646,0.0419779437922448,0.125578086090359,0.096051227321238
"E02001234",430,826,308,201,625,229,3174,0.135475740390674,0.260239445494644,0.0970384373030876,0.0633270321361059,0.196912413358538,0.0721487082545684
"E02001235",387,758,334,189,569,198,2654,0.145817633760362,0.285606631499623,0.125847776940467,0.0712132629992464,0.214393368500377,0.0746043707611153
"E02001236",360,428,202,121,307,239,2623,0.137247426610751,0.163171940526115,0.0770110560426992,0.0461303850552802,0.117041555470835,0.0911170415554708
"E02001237",393,394,512,116,278,277,2881,0.136410968413745,0.136758070114544,0.177716070808747,0.0402637972926067,0.0964942728219368,0.0961471711211385
"E02001238",408,536,354,124,412,284,2662,0.153268219383922,0.201352366641623,0.132982719759579,0.0465815176558978,0.154770848985725,0.106686701728024
"E02001239",495,758,358,212,546,283,3488,0.141915137614679,0.217316513761468,0.102637614678899,0.0607798165137615,0.156536697247706,0.0811353211009174
"E02001240",314,665,361,140,525,174,2151,0.145978614597861,0.309158530915853,0.167828916782892,0.0650860065086006,0.244072524407252,0.0808926080892608
"E02001241",458,1015,611,214,801,244,4448,0.102967625899281,0.228192446043165,0.137365107913669,0.0481115107913669,0.180080935251799,0.0548561151079137
"E02001242",294,560,170,145,415,149,2500,0.1176,0.224,0.068,0.058,0.166,0.0596
"E02001243",508,828,371,233,595,275,3213,0.158107687519452,0.257703081232493,0.115468409586057,0.0725178960473078,0.185185185185185,0.0855897914721444
"E02001244",346,477,135,142,335,204,1486,0.232839838492598,0.320995962314939,0.0908479138627187,0.0955585464333782,0.225437415881561,0.137281292059219
"E02001245",438,956,301,176,780,262,3377,0.129700917974534,0.283091501332544,0.0891323660053302,0.0521172638436482,0.230974237488895,0.0775836541308854
"E02001246",376,449,85,106,343,270,2704,0.13905325443787,0.166050295857988,0.0314349112426036,0.0392011834319527,0.126849112426035,0.0998520710059172
"E02001247",358,607,339,136,471,222,2942,0.121685927940177,0.206322229775663,0.115227736233855,0.0462270564242012,0.160095173351462,0.0754588715159755
"E02001248",516,773,385,174,599,342,4863,0.10610734114744,0.158955377339091,0.0791692370964425,0.0357803824799506,0.12317499485914,0.0703269586674892
"E02001249",421,831,384,199,632,222,2722,0.154665686994857,0.305290227773696,0.141072740631888,0.0731080088170463,0.23218221895665,0.0815576781778104
"E02001250",361,452,222,138,314,223,1961,0.184089750127486,0.230494645588985,0.113207547169811,0.0703722590515043,0.160122386537481,0.113717491075982
"E02001251",455,343,902,89,254,366,2322,0.195951765719208,0.147717484926787,0.388458225667528,0.0383290267011197,0.109388458225668,0.157622739018088
"E02001252",509,784,201,251,533,258,2224,0.22886690647482,0.352517985611511,0.0903776978417266,0.112859712230216,0.239658273381295,0.116007194244604
"E02001253",299,456,288,113,343,186,1724,0.173433874709977,0.264501160092807,0.167053364269142,0.0655452436194896,0.198955916473318,0.107888631090487
"E02001254",283,385,73,106,279,177,1796,0.157572383073497,0.214365256124722,0.0406458797327394,0.0590200445434298,0.155345211581292,0.0985523385300668
"E02001255",212,265,89,39,226,173,3491,0.0607275852191349,0.0759094815239186,0.0254941277570897,0.0111715840733314,0.0647378974505872,0.0495560011458035
"E02001256",526,1038,674,216,822,310,3877,0.135671911271602,0.267732783079701,0.17384575702863,0.0557131802940418,0.212019602785659,0.07995873097756
"E02001257",485,762,211,189,573,296,3463,0.140051978053711,0.220040427375108,0.0609298296274906,0.0545769563961883,0.16546347097892,0.0854750216575224
"E02001258",510,775,357,239,536,271,2427,0.210135970333745,0.319324268644417,0.147095179233622,0.0984754841367944,0.220848784507623,0.111660486196951
"E02001259",547,905,1423,150,755,397,6009,0.09103012148444,0.150607422200033,0.236811449492428,0.0249625561657514,0.125644866034282,0.0660675653186886
"E02001260",332,826,102,204,622,128,1930,0.172020725388601,0.427979274611399,0.0528497409326425,0.105699481865285,0.322279792746114,0.0663212435233161
"E02001261",473,1183,1001,256,927,217,3580,0.132122905027933,0.330446927374302,0.279608938547486,0.0715083798882682,0.258938547486034,0.0606145251396648
"E02001262",386,861,621,185,676,201,2507,0.153968887116075,0.343438372556841,0.247706422018349,0.0737933785400878,0.269644994016753,0.0801755085759872
"E02001263",391,896,334,201,695,190,2317,0.168752697453604,0.386706948640483,0.144151920586966,0.0867501078981441,0.299956840742339,0.0820025895554597
"E02001264",403,914,272,235,679,168,2652,0.151960784313725,0.344645550527903,0.102564102564103,0.0886123680241327,0.256033182503771,0.0633484162895928
"E02001265",421,953,209,211,742,210,2417,0.174182871328093,0.394290442697559,0.0864708316094332,0.0872983036822507,0.306992139015308,0.086884567645842
"E02001266",296,988,499,139,849,157,2587,0.114418245071511,0.381909547738693,0.192887514495555,0.0537301894085814,0.328179358330112,0.06068805566293
"E02001267",417,764,1020,141,623,276,2988,0.139558232931727,0.255689424364123,0.34136546184739,0.0471887550200803,0.208500669344043,0.0923694779116466
"E02001268",364,777,333,193,584,171,1935,0.188113695090439,0.401550387596899,0.172093023255814,0.0997416020671835,0.301808785529716,0.0883720930232558
"E02001269",486,1003,996,212,791,274,3161,0.153748813666561,0.31730465042708,0.315090161341348,0.067067383739323,0.250237266687757,0.0866814299272382
"E02001270",513,933,1176,206,727,307,3422,0.149912331969608,0.272647574517826,0.343658679135009,0.0601987142022209,0.212448860315605,0.0897136177673875
"E02001271",386,742,219,170,572,216,2183,0.176820888685295,0.339899221255153,0.100320659642694,0.0778744846541457,0.262024736601008,0.0989464040311498
"E02001272",519,909,693,235,674,284,2647,0.196071023800529,0.343407631280695,0.261805817907065,0.0887797506611258,0.254627880619569,0.107291273139403
"E02001273",546,921,1425,167,754,379,4322,0.126330402591393,0.21309578898658,0.329708468301712,0.0386395187413235,0.174456270245257,0.0876908838500694
"E02001274",426,739,150,187,552,239,2117,0.201228153046764,0.349078885214927,0.0708549834671705,0.0883325460557393,0.260746339159188,0.112895606991025
"E02001275",499,548,76,165,383,334,3580,0.139385474860335,0.153072625698324,0.0212290502793296,0.0460893854748603,0.106983240223464,0.0932960893854749
"E02001276",421,825,230,191,634,230,2571,0.163749513807857,0.320886814469078,0.0894593543368339,0.074290159471023,0.246596654998055,0.0894593543368339
"E02001277",406,633,57,132,501,274,3272,0.124083129584352,0.193459657701712,0.0174205378973105,0.0403422982885086,0.153117359413203,0.0837408312958435
"E02001278",445,780,231,233,547,212,2526,0.176167854315123,0.308788598574822,0.0914489311163895,0.0922406967537609,0.216547901821061,0.0839271575613618
"E02001279",416,842,132,234,608,182,2022,0.205736894164194,0.416419386745796,0.0652818991097923,0.115727002967359,0.300692383778437,0.0900098911968348
"E02001280",428,754,137,199,555,229,2795,0.153130590339893,0.269767441860465,0.0490161001788909,0.0711985688729875,0.198568872987478,0.0819320214669052
"E02001281",400,694,281,189,505,211,2117,0.188946622579121,0.327822390174776,0.132735002361833,0.0892772791686349,0.238545111006141,0.0996693434104865
"E02001282",516,793,1351,166,627,350,3838,0.134445023449713,0.206618030224075,0.352006253256905,0.0432516935904117,0.163366336633663,0.0911933298593017
"E02001283",517,613,577,181,432,336,4005,0.129088639200999,0.153058676654182,0.144069912609238,0.0451935081148564,0.107865168539326,0.0838951310861423
"E02001284",536,887,854,236,651,300,2559,0.209456819069949,0.346619773348964,0.333724110980852,0.0922235248143806,0.254396248534584,0.117233294255569
"E02001285",523,608,964,157,451,366,2885,0.181282495667244,0.210745233968804,0.334142114384749,0.054419410745234,0.15632582322357,0.12686308492201
"E02001286",567,835,152,271,564,296,2435,0.232854209445585,0.342915811088296,0.0624229979466119,0.11129363449692,0.231622176591376,0.121560574948665
"E02001287",353,376,141,112,264,241,2424,0.145627062706271,0.155115511551155,0.0581683168316832,0.0462046204620462,0.108910891089109,0.0994224422442244
"E02001288",426,514,211,151,363,275,2985,0.142713567839196,0.172194304857621,0.0706867671691792,0.0505862646566164,0.121608040201005,0.0921273031825796
"E02001289",663,685,147,259,426,404,2899,0.228699551569507,0.236288375301828,0.0507071403932391,0.0893411521214212,0.146947223180407,0.139358399448086
"E02001290",310,302,252,95,207,215,1937,0.160041300980898,0.155911202891069,0.130098089829633,0.0490449148167269,0.106866288074342,0.110996386164171
"E02001291",428,577,118,184,393,244,2537,0.168703192747339,0.227433977138352,0.0465116279069767,0.0725266062278281,0.154907370910524,0.0961765865195112
"E02001292",490,921,566,243,678,247,2985,0.164154103852596,0.308542713567839,0.189614740368509,0.0814070351758794,0.22713567839196,0.0827470686767169
"E02001293",294,282,167,84,198,210,1884,0.156050955414013,0.14968152866242,0.0886411889596603,0.0445859872611465,0.105095541401274,0.111464968152866
"E02001294",543,1350,975,287,1063,256,3592,0.151169265033408,0.375835189309577,0.271436525612472,0.0798997772828508,0.295935412026726,0.0712694877505568
"E02001295",362,531,598,109,422,253,3233,0.111970306217136,0.164243736467677,0.184967522424992,0.0337148159604083,0.130528920507269,0.0782554902567275
"E02001296",372,316,100,93,223,279,3158,0.117796073464218,0.100063331222293,0.0316656111462951,0.0294490183660545,0.0706143128562381,0.0883470550981634
"E02001297",359,515,217,137,378,222,2348,0.152896081771721,0.219335604770017,0.0924190800681431,0.0583475298126065,0.160988074957411,0.0945485519591141
"E02001298",370,539,447,124,415,246,2844,0.130098452883263,0.189521800281294,0.157172995780591,0.0436005625879044,0.14592123769339,0.0864978902953586
"E02001299",472,608,700,168,440,304,3374,0.139893301719028,0.180201541197392,0.20746887966805,0.0497925311203319,0.13040901007706,0.0901007705986959
"E02001300",461,762,588,201,561,260,2907,0.158582731338149,0.262125902992776,0.202270381836945,0.0691434468524252,0.192982456140351,0.0894392844857241
"E02001301",411,684,490,143,541,268,4017,0.102315160567588,0.170276325616131,0.121981578292258,0.0355987055016181,0.134677620114513,0.0667164550659696
"E02001302",414,349,276,115,234,299,2504,0.165335463258786,0.139376996805112,0.110223642172524,0.045926517571885,0.0934504792332268,0.119408945686901
"E02001303",419,373,103,132,241,287,3237,0.129440840284214,0.11523015137473,0.0318195860364535,0.0407784986098239,0.0744516527649058,0.0886623416743899
"E02001304",776,1070,445,327,743,449,3969,0.195515243134291,0.269589317208365,0.112118921642731,0.0823885109599395,0.187200806248425,0.113126732174351
"E02001305",534,561,227,196,365,338,2432,0.219572368421053,0.230674342105263,0.0933388157894737,0.0805921052631579,0.150082236842105,0.138980263157895
"E02001306",436,327,73,129,198,307,1774,0.245772266065389,0.184329199549042,0.0411499436302142,0.07271702367531,0.111612175873732,0.173055242390079
"E02001307",662,493,30,188,305,474,2903,0.228039958663452,0.169824319669308,0.0103341370995522,0.064760592490527,0.105063727178781,0.163279366172925
"E02001308",375,542,403,159,383,216,2058,0.182215743440233,0.263362487852284,0.195821185617104,0.0772594752186589,0.186103012633625,0.104956268221574
"E02001309",433,826,580,189,637,244,3271,0.132375420360746,0.252522164475696,0.177315805564048,0.057780495261388,0.194741669214308,0.074594925099358
"E02001310",504,621,648,154,467,350,3724,0.135338345864662,0.166756176154672,0.174006444683136,0.0413533834586466,0.125402792696026,0.093984962406015
"E02001311",507,661,661,155,506,352,2912,0.174107142857143,0.226991758241758,0.226991758241758,0.053228021978022,0.173763736263736,0.120879120879121
"E02001312",462,672,383,156,516,306,2829,0.163308589607635,0.237539766702015,0.135383527748321,0.0551431601272534,0.182396606574761,0.108165429480382
"E02001313",430,472,113,123,349,307,3042,0.141354372123603,0.155161078238001,0.037146614069691,0.0404339250493097,0.114727153188692,0.100920447074293
"E02001314",412,429,72,166,263,246,2093,0.19684663162924,0.204968944099379,0.0344003822264692,0.0793119923554706,0.125656951743908,0.11753463927377
"E02001315",455,608,191,198,410,257,3468,0.131199538638985,0.175317185697809,0.0550749711649366,0.0570934256055363,0.118223760092272,0.0741061130334487
"E02001316",539,1128,1309,273,855,266,3582,0.150474595198213,0.314907872696817,0.365438302624232,0.076214405360134,0.238693467336683,0.0742601898380793
"E02001317",369,529,255,140,389,229,3258,0.113259668508287,0.162369551872314,0.078268876611418,0.0429711479435236,0.119398403928791,0.0702885205647637
"E02001318",409,504,191,172,332,237,2469,0.165654110976104,0.204131227217497,0.0773592547590117,0.0696638315107331,0.134467395706764,0.0959902794653706
"E02001319",489,958,396,224,734,265,3421,0.142940660625548,0.28003507746273,0.115755627009646,0.0654779304296989,0.214557147033031,0.0774627301958492
"E02001320",491,685,427,187,498,304,2653,0.185073501696193,0.258198266113833,0.160949868073879,0.0704862419901998,0.187712024123634,0.114587259705993
"E02001321",468,479,202,155,324,313,2213,0.21147763217352,0.216448260280163,0.0912788070492544,0.070040668775418,0.146407591504745,0.141436963398102
"E02001322",463,730,348,217,513,246,2169,0.213462425080682,0.336560627017059,0.160442600276625,0.100046104195482,0.236514522821577,0.113416320885201
"E02001323",456,595,174,208,387,248,2983,0.152866242038217,0.199463627220919,0.058330539725109,0.06972846128059,0.129735165940329,0.0831377807576266
"E02001324",491,635,398,181,454,310,2910,0.16872852233677,0.218213058419244,0.136769759450172,0.0621993127147766,0.156013745704467,0.106529209621993
"E02001325",510,390,122,152,238,358,3166,0.161086544535692,0.123183828174352,0.0385344283006949,0.0480101073910297,0.0751737207833228,0.113076437144662
"E02001326",458,502,275,156,346,302,2864,0.159916201117318,0.175279329608939,0.0960195530726257,0.0544692737430168,0.120810055865922,0.105446927374302
"E02001327",491,317,30,89,228,402,4092,0.119990224828935,0.0774682306940371,0.00733137829912024,0.0217497556207234,0.0557184750733138,0.0982404692082111
"E02001328",480,472,160,136,336,344,3477,0.138050043140638,0.135749209088295,0.0460166810468795,0.0391141788898476,0.0966350301984469,0.0989358642507909
"E02001329",462,481,231,99,382,363,3828,0.120689655172414,0.125653082549634,0.0603448275862069,0.0258620689655172,0.099791013584117,0.0948275862068965
"E02001330",597,510,181,155,355,442,4231,0.141101394469393,0.120538879697471,0.042779484755377,0.036634365398251,0.08390451429922,0.104467029071142
"E02001331",717,393,309,121,272,596,4558,0.157305835892936,0.0862220272049144,0.0677928916191312,0.0265467310223782,0.0596752961825362,0.130759104870557
"E02001332",453,391,51,169,222,284,3862,0.11729673744174,0.101242879337131,0.0132055929570171,0.0437597099948213,0.0574831693423097,0.0735370274469187
"E02001333",529,512,911,113,399,416,5653,0.0935786308154962,0.0905713780293649,0.161153369892093,0.0199893861666372,0.0705819918627278,0.073589244648859
"E02001334",458,386,623,124,262,334,3885,0.117889317889318,0.0993564993564994,0.16036036036036,0.0319176319176319,0.0674388674388674,0.085971685971686
"E02001335",331,439,206,106,333,225,2766,0.119667389732466,0.158712942877802,0.0744757772957339,0.0383224873463485,0.120390455531453,0.0813449023861171
"E02001336",531,422,563,121,301,410,3960,0.134090909090909,0.106565656565657,0.142171717171717,0.0305555555555556,0.076010101010101,0.103535353535354
"E02001337",388,311,161,109,202,279,2115,0.183451536643026,0.147044917257683,0.0761229314420804,0.0515366430260047,0.0955082742316785,0.131914893617021
"E02001338",344,379,713,89,290,255,2425,0.141855670103093,0.156288659793814,0.294020618556701,0.0367010309278351,0.119587628865979,0.105154639175258
"E02001339",410,293,151,76,217,334,2792,0.146848137535817,0.104942693409742,0.0540830945558739,0.0272206303724928,0.0777220630372493,0.119627507163324
"E02001340",356,480,1325,101,379,255,2692,0.132243684992571,0.178306092124814,0.492199108469539,0.037518573551263,0.140787518573551,0.0947251114413076
"E02001341",558,417,254,113,304,445,3441,0.162162162162162,0.121185701830863,0.0738157512351061,0.032839290903807,0.0883464109270561,0.129322871258355
"E02001342",321,374,435,93,281,228,2229,0.144010767160162,0.167788245850157,0.195154777927322,0.0417227456258412,0.126065500224316,0.10228802153432
"E02001343",363,391,265,108,283,255,2782,0.130481667864845,0.140546369518332,0.095255212077642,0.0388209920920201,0.101725377426312,0.0916606757728253
"E02001344",269,203,161,81,122,188,2184,0.123168498168498,0.092948717948718,0.0737179487179487,0.0370879120879121,0.0558608058608059,0.0860805860805861
"E02001345",211,234,85,51,183,160,1405,0.150177935943061,0.166548042704626,0.0604982206405694,0.0362989323843416,0.130249110320285,0.113879003558719
"E02001346",482,426,425,141,285,341,3459,0.139346631974559,0.123156981786644,0.122867880890431,0.0407632263660017,0.0823937554206418,0.0985834056085574
"E02001347",346,527,316,112,415,234,2527,0.136921250494658,0.208547685001979,0.125049465769687,0.0443213296398892,0.164226355362089,0.0925999208547685
"E02001348",563,249,1959,54,195,509,2518,0.223590150913423,0.0988880063542494,0.777998411437649,0.0214455917394758,0.0774424146147736,0.202144559173948
"E02001349",553,235,1710,53,182,500,2640,0.209469696969697,0.0890151515151515,0.647727272727273,0.0200757575757576,0.0689393939393939,0.189393939393939
"E02001350",400,303,274,60,243,340,3109,0.128658732711483,0.0974589900289482,0.0881312319073657,0.0192988099067224,0.0781601801222258,0.10935992280476
"E02001351",504,644,421,176,468,328,2988,0.168674698795181,0.215528781793842,0.140896921017403,0.0589022757697456,0.156626506024096,0.109772423025435
"E02001352",469,326,1570,71,255,398,3346,0.140167364016736,0.0974297668858338,0.469216975493126,0.0212193664076509,0.0762104004781829,0.118947997609085
"E02001353",425,154,19,60,94,365,1882,0.225823591923486,0.0818278427205101,0.0100956429330499,0.0318809776833156,0.0499468650371945,0.19394261424017
"E02001354",504,388,275,107,281,397,3275,0.153893129770992,0.118473282442748,0.083969465648855,0.0326717557251908,0.0858015267175573,0.121221374045802
"E02001355",585,325,2171,69,256,516,3305,0.177004538577912,0.0983358547655068,0.656883509833585,0.0208774583963691,0.0774583963691377,0.156127080181543
"E02001356",309,404,109,110,294,199,3229,0.095695261690926,0.125116135026324,0.033756580984825,0.0340662743883555,0.0910498606379684,0.0616289873025705
"E02001357",516,516,93,141,375,375,2595,0.198843930635838,0.198843930635838,0.0358381502890173,0.0543352601156069,0.144508670520231,0.144508670520231
"E02001358",640,491,3144,85,406,555,3704,0.172786177105832,0.13255939524838,0.848812095032397,0.0229481641468683,0.109611231101512,0.149838012958963
"E02001359",268,271,91,75,196,193,1608,0.166666666666667,0.168532338308458,0.056592039800995,0.0466417910447761,0.121890547263682,0.120024875621891
"E02001360",662,702,1774,124,578,538,5120,0.129296875,0.137109375,0.346484375,0.02421875,0.112890625,0.105078125
"E02001361",447,417,1416,87,330,360,3396,0.131625441696113,0.122791519434629,0.416961130742049,0.0256183745583039,0.0971731448763251,0.106007067137809
"E02001362",461,782,460,181,601,280,2671,0.172594533882441,0.292774241856982,0.172220142268813,0.0677648820666417,0.225009359790341,0.104829651815799
"E02001363",393,368,396,84,284,309,3261,0.120515179392824,0.112848819380558,0.121435142594296,0.0257589696412144,0.0870898497393438,0.0947562097516099
"E02001364",439,252,1782,58,194,381,3027,0.145028080607863,0.0832507433102081,0.588701684836472,0.0191608853650479,0.0640898579451602,0.125867195242815
"E02001365",846,458,3893,104,354,742,4754,0.177955405973917,0.0963399242742953,0.81888935633151,0.0218763146823727,0.0744636095919226,0.156079091291544
"E02001366",724,509,2756,91,418,633,4240,0.170754716981132,0.120047169811321,0.65,0.0214622641509434,0.0985849056603774,0.149292452830189
"E02001367",470,516,1159,117,399,353,2895,0.162348877374784,0.178238341968912,0.400345423143351,0.0404145077720207,0.137823834196891,0.121934369602763
"E02001368",459,469,101,79,390,380,4490,0.102227171492205,0.10445434298441,0.0224944320712695,0.0175946547884187,0.0868596881959911,0.0846325167037862
"E02001369",335,613,183,69,544,266,4822,0.0694732476150975,0.127125673994193,0.0379510576524264,0.0143094151804231,0.11281625881377,0.0551638324346744
"E02001370",531,428,1044,110,318,421,4183,0.126942385847478,0.102318909873297,0.249581639971312,0.0262969160889314,0.0760219937843653,0.100645469758546
"E02001371",269,422,219,97,325,172,2447,0.109930527176134,0.172456068655497,0.0894973436861463,0.0396403759705762,0.13281569268492,0.0702901512055578
"E02001372",348,458,528,100,358,248,2183,0.159413650939075,0.209803023362345,0.2418689876317,0.0458085203847916,0.163994502977554,0.113605130554283
"E02001373",686,429,2716,85,344,601,3945,0.173891001267427,0.108745247148289,0.688466413181242,0.0215462610899873,0.0871989860583016,0.15234474017744
"E02001374",667,341,3425,58,283,609,5173,0.128938720278368,0.0659191958244732,0.66209162961531,0.0112120626329016,0.0547071331915716,0.117726657645467
"E02001375",526,538,1642,105,433,421,2921,0.180075316672372,0.18418349880178,0.562136254707292,0.0359465936323177,0.148236905169463,0.144128723040055
"E02001376",787,589,3230,116,473,671,5269,0.149364205731638,0.111785917631429,0.613019548301385,0.0220155627253748,0.0897703549060543,0.127348643006263
"E02001377",501,308,1822,56,252,445,5396,0.0928465530022239,0.0570793180133432,0.33765752409192,0.0103780578206079,0.0467012601927354,0.082468495181616
"E02001378",442,573,1078,109,464,333,3304,0.133777239709443,0.173426150121065,0.326271186440678,0.0329903147699758,0.14043583535109,0.100786924939467
"E02001380",374,514,919,131,383,243,2161,0.173068024062934,0.237852845904674,0.425266080518279,0.0606200832947709,0.177232762609903,0.112447940768163
"E02001381",811,610,3348,142,468,669,5161,0.157140089130014,0.118194148420849,0.648711490021314,0.0275140476651812,0.0906801007556675,0.129626041464832
"E02001382",309,376,628,104,272,205,1633,0.189222290263319,0.230251071647275,0.384568279240661,0.063686466625842,0.166564605021433,0.125535823637477
"E02001383",352,335,1683,77,258,275,6035,0.0583264291632146,0.0555095277547639,0.27887323943662,0.0127589063794532,0.0427506213753107,0.0455675227837614
"E02001384",775,348,3430,71,277,704,4600,0.168478260869565,0.0756521739130435,0.745652173913044,0.0154347826086957,0.0602173913043478,0.15304347826087
"E02001385",492,426,1865,51,375,441,4419,0.111337406653089,0.0964019008825526,0.42204118578864,0.011541072640869,0.0848608282416836,0.09979633401222
"E02001386",412,350,90,94,256,318,3553,0.115958345060512,0.0985083028426682,0.0253307064452575,0.0264565156206023,0.0720517872220659,0.0895018294399099
"E02001387",421,411,1455,71,340,350,2195,0.191799544419134,0.187243735763098,0.662870159453303,0.0323462414578588,0.154897494305239,0.159453302961276
"E02001388",613,91,2425,21,70,592,2974,0.206119704102219,0.0305985205110962,0.815400134498991,0.00706119704102219,0.023537323470074,0.199058507061197
"E02001389",319,358,2384,36,322,283,5071,0.0629067245119306,0.0705975152829817,0.470124235850917,0.00709919148097022,0.0634983238020114,0.0558075330309604
"E02001390",526,301,1764,79,222,447,4936,0.106564019448947,0.0609805510534846,0.357374392220421,0.0160048622366289,0.0449756888168558,0.0905591572123177
"E02001391",248,347,44,87,260,161,1860,0.133333333333333,0.186559139784946,0.0236559139784946,0.0467741935483871,0.139784946236559,0.0865591397849462
"E02001392",340,524,387,164,360,176,2059,0.165128703254007,0.254492472073822,0.18795531811559,0.0796503156872268,0.174842156386595,0.08547838756678
"E02001393",334,614,549,145,469,189,1905,0.175328083989501,0.322309711286089,0.288188976377953,0.0761154855643045,0.246194225721785,0.0992125984251968
"E02001394",452,430,2222,53,377,399,4279,0.105632157046039,0.100490768871232,0.519280205655527,0.0123860715120355,0.0881046973591961,0.0932460855340033
"E02001395",316,291,1233,54,237,262,1809,0.174682144831399,0.160862354892206,0.681592039800995,0.0298507462686567,0.131011608623549,0.144831398562742
"E02001396",538,293,1874,59,234,479,3982,0.135107985936715,0.0735811150175791,0.470617780010045,0.0148166750376695,0.0587644399799096,0.120291310899046
"E02001397",445,852,782,111,741,334,3551,0.125316812165587,0.239932413404675,0.220219656434807,0.031258800337933,0.208673613066742,0.0940580118276542
"E02001398",450,203,1547,33,170,417,3268,0.137698898408813,0.0621175030599755,0.473378212974296,0.0100979192166463,0.0520195838433293,0.127600979192166
"E02001399",360,329,1080,93,236,267,1819,0.197910940076965,0.180868609125893,0.593732820230896,0.051126992853216,0.129741616272677,0.146783947223749
"E02001400",357,529,533,86,443,271,2818,0.126685592618879,0.187721788502484,0.189141234918382,0.0305180979418027,0.157203690560681,0.0961674946770759
"E02001401",423,516,497,156,360,267,2695,0.1569573283859,0.191465677179963,0.184415584415584,0.0578849721706865,0.133580705009276,0.0990723562152134
"E02001402",401,475,1226,82,393,319,3375,0.118814814814815,0.140740740740741,0.363259259259259,0.0242962962962963,0.116444444444444,0.0945185185185185
"E02001403",402,194,1596,44,150,358,3123,0.128722382324688,0.0621197566442523,0.51104707012488,0.0140890169708614,0.048030739673391,0.114633365353826
"E02001404",404,339,719,76,263,328,3388,0.119244391971665,0.100059031877214,0.212219598583235,0.0224321133412042,0.0776269185360094,0.0968122786304604
"E02001405",590,733,790,165,568,425,4739,0.124498839417599,0.154673981852712,0.166701835830344,0.0348174720405149,0.119856509812197,0.0896813673770838
"E02001406",599,688,319,227,461,372,2434,0.246096959737058,0.28266228430567,0.131059983566146,0.0932621199671323,0.189400164338537,0.152834839769926
"E02001407",395,415,97,130,285,265,1693,0.233313644418193,0.245126993502658,0.0572947430596574,0.0767867690490254,0.168340224453633,0.156526875369167
"E02001408",365,490,185,147,343,218,1467,0.248807089297887,0.334014996591684,0.126107702794819,0.100204498977505,0.233810497614179,0.148602590320382
"E02001409",650,1008,241,241,767,409,3959,0.164182874463248,0.254609749936853,0.0608739580702198,0.0608739580702198,0.193735791866633,0.103308916393029
"E02001410",372,663,88,160,503,212,2148,0.173184357541899,0.308659217877095,0.0409683426443203,0.074487895716946,0.234171322160149,0.0986964618249535
"E02001411",332,528,102,121,407,211,2035,0.163144963144963,0.259459459459459,0.0501228501228501,0.0594594594594595,0.2,0.103685503685504
"E02001412",517,1048,609,243,805,274,3172,0.162988650693569,0.330390920554855,0.191992433795712,0.0766078184110971,0.253783102143758,0.0863808322824716
"E02001413",597,662,296,200,462,397,3048,0.195866141732283,0.217191601049869,0.0971128608923885,0.0656167979002625,0.151574803149606,0.130249343832021
"E02001414",341,449,62,158,291,183,1503,0.226879574184963,0.298735861610113,0.0412508316699933,0.105123087159015,0.193612774451098,0.121756487025948
"E02001415",316,503,90,98,405,218,2704,0.116863905325444,0.186020710059172,0.0332840236686391,0.0362426035502959,0.149778106508876,0.0806213017751479
"E02001416",311,854,287,99,755,212,2957,0.105174163003044,0.288806222522827,0.0970578288806223,0.0334798782549882,0.255326344267839,0.0716942847480555
"E02001417",518,947,1104,165,782,353,4104,0.126218323586745,0.230750487329435,0.269005847953216,0.0402046783625731,0.190545808966862,0.0860136452241715
"E02001418",394,582,264,128,454,266,3184,0.123743718592965,0.182788944723618,0.0829145728643216,0.0402010050251256,0.142587939698492,0.0835427135678392
"E02001419",395,1254,791,183,1071,212,4738,0.0833685099197974,0.264668636555509,0.166948079358379,0.0386238919375264,0.226044744617982,0.044744617982271
"E02001420",614,874,366,218,656,396,4804,0.127810158201499,0.181931723563697,0.0761865112406328,0.0453788509575354,0.136552872606162,0.0824313072439634
"E02001421",592,1448,1124,288,1160,304,4360,0.135779816513761,0.332110091743119,0.257798165137615,0.0660550458715596,0.26605504587156,0.0697247706422018
"E02001422",305,855,116,116,739,189,3199,0.0953422944670209,0.267271022194436,0.0362613316661457,0.0362613316661457,0.23100969052829,0.0590809628008753
"E02001423",381,550,139,156,394,225,2171,0.175495163519116,0.253339474896361,0.0640257945647167,0.0718562874251497,0.181483187471211,0.103638876093966
"E02001425",748,1054,334,284,770,464,3890,0.192287917737789,0.270951156812339,0.0858611825192802,0.0730077120822622,0.197943444730077,0.119280205655527
"E02001426",287,517,270,142,375,145,1813,0.158301158301158,0.285162713734142,0.14892443463872,0.078323221180364,0.206839492553778,0.0799779371207943
"E02001427",518,750,289,157,593,361,4418,0.117247623358986,0.169760072430964,0.0654142145767315,0.0355364418288818,0.134223630602082,0.0817111815301041
"E02001428",315,367,108,112,255,203,1460,0.215753424657534,0.251369863013699,0.073972602739726,0.0767123287671233,0.174657534246575,0.139041095890411
"E02001429",496,704,75,219,485,277,2316,0.214162348877375,0.303972366148532,0.0323834196891192,0.094559585492228,0.209412780656304,0.119602763385147
"E02001430",477,955,192,296,659,181,2295,0.207843137254902,0.416122004357298,0.0836601307189542,0.128976034858388,0.287145969498911,0.0788671023965142
"E02001431",492,1181,179,245,936,247,3826,0.128593831677993,0.308677469942499,0.0467851542080502,0.0640355462624151,0.244641923680084,0.0645582854155776
"E02001432",674,2230,1451,353,1877,321,6007,0.112202430497753,0.37123356084568,0.241551523222907,0.0587647744298319,0.312468786415848,0.0534376560679208
"E02001433",422,1192,139,284,908,138,2441,0.172879967226546,0.488324457189676,0.0569438754608767,0.116345759934453,0.371978697255223,0.0565342072920934
"E02001434",434,1256,219,310,946,124,2417,0.179561439801407,0.519652461729417,0.0906081919735209,0.128258171286719,0.391394290442698,0.0513032685146876
"E02001435",574,1800,716,372,1428,202,3643,0.15756244853143,0.494098270656053,0.196541312105408,0.102113642602251,0.391984628053802,0.0554488059291793
"E02001436",558,1229,148,323,906,235,4000,0.1395,0.30725,0.037,0.08075,0.2265,0.05875
"E02001437",629,1637,384,355,1282,274,4092,0.153714565004888,0.400048875855327,0.093841642228739,0.0867546432062561,0.313294232649071,0.0669599217986315
"E02001438",421,1028,98,296,732,125,2155,0.195359628770302,0.477030162412993,0.0454756380510441,0.137354988399072,0.339675174013921,0.0580046403712297
"E02001439",370,697,84,180,517,190,2462,0.150284321689683,0.283103168155971,0.0341186027619821,0.0731112916328188,0.209991876523152,0.0771730300568643
"E02001440",393,544,38,182,362,211,1630,0.241104294478528,0.333742331288344,0.0233128834355828,0.111656441717791,0.222085889570552,0.129447852760736
"E02001441",388,524,61,194,330,194,1711,0.22676797194623,0.3062536528346,0.0356516656925774,0.113383985973115,0.192869666861485,0.113383985973115
"E02001442",378,573,215,211,362,167,2017,0.187407040158651,0.28408527516113,0.10659395141299,0.104610808130887,0.179474467030243,0.082796232027764
"E02001443",393,486,74,179,307,214,1538,0.255526657997399,0.315994798439532,0.0481144343302991,0.116384915474642,0.199609882964889,0.139141742522757
"E02001444",372,499,79,186,313,186,2025,0.183703703703704,0.24641975308642,0.0390123456790123,0.0918518518518519,0.154567901234568,0.0918518518518519
"E02001445",395,550,118,168,382,227,1909,0.206914614981666,0.288108957569408,0.0618124672603457,0.0880041906757465,0.200104766893662,0.118910424305919
"E02001446",394,576,106,186,390,208,2033,0.193802262666011,0.283325135268077,0.0521396950319725,0.0914904082636498,0.191834727004427,0.102311854402361
"E02001447",382,497,99,167,330,215,2203,0.173399909214707,0.225601452564685,0.0449387199273718,0.0758057194734453,0.149795733091239,0.0975941897412619
"E02001448",363,539,526,139,400,224,2024,0.179347826086957,0.266304347826087,0.259881422924901,0.0686758893280632,0.197628458498024,0.110671936758893
"E02001449",593,900,318,257,643,336,3107,0.190859349855166,0.289668490505311,0.102349533311876,0.0827164467331831,0.206952043772127,0.108142903121983
"E02001450",422,908,665,179,729,243,2916,0.144718792866941,0.311385459533608,0.228052126200274,0.0613854595336077,0.25,0.0833333333333333
"E02001451",348,420,35,102,318,246,2256,0.154255319148936,0.186170212765957,0.0155141843971631,0.0452127659574468,0.140957446808511,0.109042553191489
"E02001452",491,695,66,194,501,297,2783,0.176428314768236,0.249730506647503,0.0237154150197628,0.0697089471793029,0.1800215594682,0.106719367588933
"E02001453",415,790,729,168,622,247,2432,0.170641447368421,0.324835526315789,0.299753289473684,0.0690789473684211,0.255756578947368,0.1015625
"E02001454",380,481,157,154,327,226,2077,0.182956186807896,0.231584015406837,0.0755897929706307,0.0741454020221473,0.157438613384689,0.108810784785749
"E02001455",325,400,374,117,283,208,1946,0.167009249743063,0.205549845837616,0.192189105858171,0.0601233299075026,0.145426515930113,0.10688591983556
"E02001456",440,571,1184,145,426,295,2556,0.172143974960876,0.22339593114241,0.463223787167449,0.0567292644757433,0.166666666666667,0.115414710485133
"E02001457",440,352,46,111,241,329,2836,0.155148095909732,0.124118476727786,0.0162200282087447,0.0391396332863188,0.0849788434414669,0.116008462623413
"E02001458",513,249,1865,47,202,466,2839,0.180697428672068,0.0877069390630504,0.656921451215217,0.0165551250440296,0.0711518140190208,0.164142303628038
"E02001459",342,565,495,110,455,232,2311,0.147987884032886,0.244482907832107,0.214192990047598,0.0475984422327997,0.196884465599308,0.100389441800087
"E02001460",442,501,1159,104,397,338,3755,0.117709720372836,0.133422103861518,0.308655126498003,0.0276964047936085,0.105725699067909,0.0900133155792277
"E02001461",307,572,461,139,433,168,2441,0.125768127816469,0.234330192544039,0.188857025809095,0.0569438754608767,0.177386317083163,0.068824252355592
"E02001462",465,349,1666,67,282,398,3680,0.126358695652174,0.0948369565217391,0.452717391304348,0.0182065217391304,0.0766304347826087,0.108152173913043
"E02001463",355,357,409,77,280,278,2751,0.129043984005816,0.129770992366412,0.148673209741912,0.0279898218829517,0.101781170483461,0.101054162122864
"E02001464",536,397,2127,58,339,478,3553,0.1508584294962,0.111736560652969,0.598649028989586,0.0163242330424993,0.09541232761047,0.134534196453701
"E02001465",398,444,1065,82,362,316,4190,0.0949880668257757,0.105966587112172,0.25417661097852,0.0195704057279236,0.0863961813842482,0.075417661097852
"E02001466",606,292,2066,62,230,544,3666,0.165302782324059,0.0796508456082924,0.563557010365521,0.0169121658483361,0.0627386797599564,0.148390616475723
"E02001467",543,212,1927,41,171,502,3495,0.155364806866953,0.0606580829756795,0.551359084406295,0.0117310443490701,0.0489270386266094,0.143633762517883
"E02001468",626,124,1956,37,87,589,2765,0.226401446654611,0.0448462929475588,0.707414104882459,0.0133815551537071,0.0314647377938517,0.213019891500904
"E02001469",542,372,1321,75,297,467,2517,0.21533571712356,0.147794994040524,0.524831148192292,0.0297973778307509,0.117997616209774,0.185538339292809
"E02001470",665,162,1873,46,116,619,2341,0.284066638188808,0.0692011960700555,0.800085433575395,0.01964972234088,0.0495514737291756,0.264416915847928
"E02001471",645,164,1728,28,136,617,3290,0.196048632218845,0.0498480243161094,0.525227963525836,0.00851063829787234,0.0413373860182371,0.187537993920973
"E02001472",350,569,362,103,466,247,2387,0.146627565982405,0.238374528697109,0.151654796816087,0.0431503979891077,0.195224130708002,0.103477167993297
"E02001473",507,180,1933,42,138,465,2744,0.184766763848396,0.065597667638484,0.704446064139942,0.0153061224489796,0.0502915451895044,0.169460641399417
"E02001474",520,230,1481,35,195,485,3698,0.140616549486209,0.0621957815035154,0.400486749594375,0.00946457544618713,0.0527312060573283,0.131151974040022
"E02001475",293,495,209,78,417,215,2974,0.0985205110961668,0.166442501681237,0.070275722932078,0.0262273032952253,0.140215198386012,0.0722932078009415
"E02001476",494,251,1777,50,201,444,4192,0.117843511450382,0.0598759541984733,0.423902671755725,0.0119274809160305,0.0479484732824427,0.105916030534351
"E02001477",415,241,811,36,205,379,3628,0.11438809261301,0.0664277839029769,0.223539140022051,0.00992282249173098,0.0565049614112459,0.104465270121279
"E02001478",487,560,746,117,443,370,3104,0.156894329896907,0.180412371134021,0.240335051546392,0.0376932989690722,0.142719072164948,0.119201030927835
"E02001479",315,272,405,83,189,232,1702,0.185076380728555,0.159811985898942,0.237955346650999,0.0487661574618096,0.111045828437133,0.136310223266745
"E02001480",593,313,1654,67,246,526,2917,0.203291052451148,0.107302022625986,0.567020911895783,0.0229688035653068,0.0843332190606788,0.180322248885842
"E02001481",365,216,1539,40,176,325,2906,0.125602202339986,0.0743289745354439,0.529593943565038,0.0137646249139711,0.0605643496214728,0.111837577426015
"E02001482",617,250,2035,34,216,583,5422,0.113795647362597,0.0461084470675028,0.375322759129472,0.00627074880118038,0.0398376982663224,0.107524898561416
"E02001483",441,424,552,144,280,297,2198,0.200636942675159,0.192902638762511,0.251137397634213,0.0655141037306642,0.127388535031847,0.135122838944495
"E02001484",468,405,451,114,291,354,2938,0.15929203539823,0.13784887678693,0.153505786249149,0.0388019060585432,0.0990469707283867,0.120490129339687
"E02001485",343,348,195,81,267,262,2601,0.131872356785852,0.133794694348328,0.0749711649365629,0.0311418685121107,0.102652825836217,0.100730488273741
"E02001486",439,443,1628,75,368,364,3955,0.110998735777497,0.112010113780025,0.411630847029077,0.0189633375474083,0.0930467762326169,0.0920353982300885
"E02001487",774,284,3147,48,236,726,4751,0.162913070932435,0.059776889075984,0.662386865922964,0.0101031361818565,0.0496737528941276,0.152809934750579
"E02001488",571,256,2148,52,204,519,3379,0.168984906777153,0.0757620597810003,0.635691032849956,0.0153891683930157,0.0603728913879846,0.153595738384137
"E02001489",470,492,441,151,341,319,2348,0.200170357751278,0.20954003407155,0.187819420783646,0.0643100511073254,0.145229982964225,0.135860306643952
"E02001490",404,390,268,118,272,286,2114,0.191106906338694,0.184484389782403,0.126773888363292,0.0558183538315989,0.128666035950804,0.135288552507096
"E02001491",477,679,135,169,510,308,3240,0.147222222222222,0.209567901234568,0.0416666666666667,0.0521604938271605,0.157407407407407,0.0950617283950617
"E02001492",559,431,1463,93,338,466,3199,0.174742106908409,0.134729603000938,0.457330415754923,0.029071584870272,0.105658018130666,0.145670522038137
"E02001493",562,260,1941,48,212,514,4523,0.124253813840371,0.0574839708158302,0.429139951359717,0.010612425381384,0.0468715454344462,0.113641388458987
"E02001494",412,510,456,145,365,267,2079,0.198172198172198,0.245310245310245,0.219336219336219,0.0697450697450697,0.175565175565176,0.128427128427128
"E02001495",400,201,1517,39,162,361,3043,0.131449227735787,0.066053236937233,0.498521196187972,0.0128162997042392,0.0532369372329938,0.118632928031548
"E02001496",316,298,474,87,211,229,1822,0.173435784851811,0.163556531284303,0.260153677277717,0.0477497255762898,0.115806805708013,0.125686059275521
"E02001497",457,227,1702,36,191,421,3271,0.139712626108224,0.0693977376948945,0.520330174258636,0.0110058086212168,0.0583919290736778,0.128706817487007
"E02001498",353,449,1169,85,364,268,2163,0.163199260286639,0.207582061950994,0.540453074433657,0.039297272306981,0.168284789644013,0.123901987979658
"E02001499",438,471,490,156,315,282,1933,0.226590791515779,0.243662700465598,0.253491981376099,0.0807035695809622,0.162959130884635,0.145887221934816
"E02001500",417,458,762,133,325,284,2291,0.182016586643387,0.19991270187691,0.332605848974247,0.0580532518550851,0.141859450021825,0.123963334788302
"E02001501",385,399,909,114,285,271,2279,0.16893374286968,0.175076788064941,0.398859148749451,0.0500219394471259,0.125054848617815,0.118911803422554
"E02001502",453,367,1307,80,287,373,3614,0.125345877144438,0.101549529607084,0.361649142224682,0.0221361372440509,0.0794133923630326,0.103209739900387
"E02001503",499,485,894,135,350,364,2953,0.168980697595665,0.164239756180156,0.302742973247545,0.0457162207924145,0.118523535387741,0.123264476803251
"E02001504",394,374,232,105,269,289,1850,0.212972972972973,0.202162162162162,0.125405405405405,0.0567567567567568,0.145405405405405,0.156216216216216
"E02001505",285,283,812,65,218,220,2511,0.113500597371565,0.112704101951414,0.323377140581442,0.0258861011549184,0.0868180007964954,0.0876144962166468
"E02001506",575,670,630,209,461,366,2585,0.222437137330754,0.259187620889749,0.243713733075435,0.0808510638297872,0.178336557059961,0.141586073500967
"E02001507",341,346,249,105,241,236,1748,0.195080091533181,0.197940503432494,0.142448512585812,0.0600686498855835,0.137871853546911,0.135011441647597
"E02001508",509,412,662,121,291,388,2898,0.175638371290545,0.142167011732229,0.228433402346446,0.0417529330572809,0.100414078674948,0.133885438233264
"E02001509",342,293,299,83,210,259,2707,0.126339120797931,0.108237901736239,0.110454377539712,0.0306612486147026,0.0775766531215368,0.0956778721832287
"E02001510",313,243,509,58,185,255,2203,0.142078983204721,0.110304130730822,0.231048570131639,0.0263277349069451,0.0839763958238765,0.115751248297776
"E02001511",339,280,325,90,190,249,2231,0.151949798296728,0.125504258180188,0.145674585387719,0.0403406544150605,0.0851636037651277,0.111609143881667
"E02001512",408,462,401,136,326,272,3057,0.133464180569185,0.151128557409225,0.131174353941773,0.0444880601897285,0.106640497219496,0.088976120379457
"E02001513",389,435,245,123,312,266,2516,0.154610492845787,0.172893481717011,0.0973767885532591,0.0488871224165342,0.124006359300477,0.105723370429253
"E02001514",358,229,222,64,165,294,3195,0.112050078247261,0.0716744913928013,0.0694835680751174,0.0200312989045383,0.0516431924882629,0.092018779342723
"E02001515",376,349,108,76,273,300,4154,0.0905151661049591,0.0840154068367838,0.025999037072701,0.0182956186807896,0.0657197881559942,0.0722195474241695
"E02001516",303,301,471,65,236,238,2385,0.127044025157233,0.126205450733753,0.19748427672956,0.0272536687631027,0.0989517819706499,0.09979035639413
"E02001517",413,403,159,108,295,305,2804,0.147289586305278,0.143723252496434,0.0567047075606277,0.0385164051355207,0.105206847360913,0.108773181169757
"E02001518",620,660,766,182,478,438,4096,0.1513671875,0.1611328125,0.18701171875,0.04443359375,0.11669921875,0.10693359375
"E02001519",367,344,190,98,246,269,3157,0.116249604054482,0.108964206525182,0.0601837187203041,0.0310421286031042,0.0779220779220779,0.0852074754513779
"E02001520",577,565,418,164,401,413,4105,0.140560292326431,0.137637028014616,0.101827040194884,0.0399512789281364,0.0976857490864799,0.100609013398295
"E02001521",1203,774,3228,225,549,978,5873,0.204835688745105,0.13178954537715,0.549633917929508,0.0383109143538226,0.0934786310233271,0.166524774391282
"E02001522",433,474,516,100,374,333,4006,0.108087868197703,0.118322516225662,0.128806789815277,0.0249625561657514,0.0933599600599101,0.0831253120319521
"E02001523",509,327,870,108,219,401,2701,0.188448722695298,0.121066271751203,0.322102924842651,0.0399851906701222,0.0810810810810811,0.148463532025176
"E02001524",323,299,467,81,218,242,2183,0.147961520842877,0.136967475950527,0.213925790196977,0.0371049015116812,0.0998625744388456,0.110856619331196
"E02001525",552,385,1191,99,286,453,3618,0.15257048092869,0.106412382531786,0.329187396351575,0.027363184079602,0.0790491984521835,0.125207296849088
"E02001526",212,194,168,51,143,161,2782,0.0762041696621136,0.0697340043134436,0.0603882099209202,0.0183321351545651,0.0514018691588785,0.0578720345075485
"E02001527",314,206,256,62,144,252,2178,0.144168962350781,0.0945821854912764,0.117539026629936,0.0284664830119376,0.0661157024793388,0.115702479338843
"E02001528",676,521,865,154,367,522,4138,0.163363943934268,0.125906234896085,0.209038182696955,0.0372160463992267,0.0886901884968584,0.126147897535041
"E02001529",541,497,474,131,366,410,3965,0.136443883984868,0.125346784363178,0.119546027742749,0.0330390920554855,0.0923076923076923,0.103404791929382
"E02001530",512,461,1190,136,325,376,3555,0.144022503516174,0.129676511954993,0.334739803094233,0.0382559774964838,0.0914205344585091,0.105766526019691
"E02001531",420,361,976,85,276,335,3477,0.120793787748059,0.103825136612022,0.280701754385965,0.0244463618061547,0.0793787748058671,0.0963474259419039
"E02001532",513,495,773,130,365,383,3874,0.132421270005163,0.127774909654104,0.199535363964894,0.0335570469798658,0.0942178626742385,0.0988642230252968
"E02001533",382,336,403,84,252,298,3013,0.126783936276137,0.111516760703618,0.133753733820113,0.0278791901759044,0.0836375705277132,0.0989047461002323
"E02001534",402,349,599,93,256,309,3957,0.101592115238817,0.0881981298963861,0.151377306039929,0.023502653525398,0.0646954763709881,0.0780894617134193
"E02001535",301,283,527,77,206,224,2373,0.126843657817109,0.119258322798146,0.222081753055204,0.0324483775811209,0.0868099452170249,0.0943952802359882
"E02001536",558,459,924,130,329,428,3378,0.165186500888099,0.135879218472469,0.273534635879218,0.0384843102427472,0.0973949082297217,0.126702190645352
"E02001537",430,331,740,95,236,335,3241,0.132675100277692,0.10212897253934,0.228324591175563,0.029311940759025,0.0728170317803147,0.103363159518667
"E02001538",440,453,323,140,313,300,3087,0.142533203757694,0.146744412050535,0.104632329122125,0.0453514739229025,0.101392938127632,0.0971817298347911
"E02001539",295,374,219,86,288,209,2212,0.133363471971067,0.169077757685353,0.099005424954792,0.038878842676311,0.130198915009042,0.0944846292947559
"E02001540",672,578,1076,175,403,497,4511,0.148969186433163,0.128131234759477,0.238528042562625,0.0387940589669696,0.0893371757925072,0.110175127466194
"E02001541",543,412,713,114,298,429,3921,0.138485080336649,0.105075235909207,0.181841366998215,0.0290742157612854,0.0760010201479215,0.109410864575363
"E02001542",360,338,477,80,258,280,2626,0.137090632140137,0.128712871287129,0.181645087585682,0.0304645849200305,0.0982482863670982,0.106626047220107
"E02001543",517,440,939,130,310,387,3255,0.158832565284178,0.135176651305684,0.288479262672811,0.0399385560675883,0.0952380952380952,0.11889400921659
"E02001544",404,448,294,95,353,309,2869,0.140815615196933,0.156151969327292,0.102474729871035,0.033112582781457,0.123039386545835,0.107703032415476
"E02001545",431,360,145,103,257,328,2696,0.15986646884273,0.13353115727003,0.0537833827893175,0.0382047477744807,0.095326409495549,0.121661721068249
"E02001546",390,357,317,111,246,279,2492,0.156500802568218,0.143258426966292,0.127207062600321,0.0445425361155698,0.0987158908507223,0.111958266452648
"E02001547",544,489,1229,161,328,383,4125,0.131878787878788,0.118545454545455,0.297939393939394,0.039030303030303,0.0795151515151515,0.0928484848484848
"E02001548",475,290,1771,59,231,416,3751,0.126632897893895,0.0773127166089043,0.472140762463343,0.0157291388962943,0.06158357771261,0.110903758997601
"E02001549",310,328,204,85,243,225,1970,0.157360406091371,0.166497461928934,0.103553299492386,0.0431472081218274,0.123350253807107,0.114213197969543
"E02001550",312,263,309,65,198,247,2881,0.10829573064908,0.0912877473099618,0.107254425546685,0.0225616105518917,0.0687261367580701,0.0857341200971885
"E02001551",399,264,1399,68,196,331,2306,0.173026886383348,0.11448395490026,0.606678230702515,0.0294882914137034,0.0849956634865568,0.143538594969644
"E02001552",329,288,229,76,212,253,3215,0.102332814930016,0.0895800933125972,0.0712286158631415,0.0236391912908243,0.0659409020217729,0.0786936236391913
"E02001553",486,436,720,136,300,350,3971,0.122387307982876,0.109796021153362,0.181314530345001,0.034248300176278,0.0755477209770839,0.0881390078065978
"E02001554",265,238,376,54,184,211,1732,0.153002309468822,0.137413394919169,0.217090069284065,0.0311778290993072,0.106235565819861,0.121824480369515
"E02001555",331,263,56,78,185,253,1709,0.193680514921006,0.15389116442364,0.0327677004095963,0.0456407255705091,0.10825043885313,0.148039789350497
"E02001556",382,416,586,122,294,260,3064,0.12467362924282,0.135770234986945,0.191253263707572,0.0398172323759791,0.0959530026109661,0.0848563968668407
"E02001557",853,369,2694,76,293,777,3991,0.213730894512653,0.0924580305687798,0.675018792282636,0.0190428464044099,0.0734151841643698,0.194688048108244
"E02001558",383,279,419,86,193,297,1916,0.199895615866388,0.145615866388309,0.218684759916493,0.0448851774530271,0.100730688935282,0.155010438413361
"E02001559",407,458,450,113,345,294,2229,0.18259309107223,0.205473306415433,0.201884253028264,0.050695379093764,0.154777927321669,0.131897711978466
"E02001560",972,375,3390,89,286,883,6470,0.150231839258114,0.0579598145285935,0.523956723338485,0.0137557959814529,0.0442040185471406,0.136476043276662
"E02001561",354,152,1412,27,125,327,3098,0.114267269205939,0.0490639122014203,0.455777921239509,0.00871530019367334,0.0403486120077469,0.105551969012266
"E02001562",327,336,101,102,234,225,2105,0.155344418052257,0.159619952494062,0.0479809976247031,0.0484560570071259,0.111163895486936,0.106888361045131
"E02001563",476,481,199,163,318,313,2630,0.180988593155894,0.182889733840304,0.0756653992395437,0.0619771863117871,0.120912547528517,0.119011406844106
"E02001564",442,282,206,109,173,333,2498,0.176941553242594,0.1128903122498,0.0824659727782226,0.0436349079263411,0.0692554043234588,0.133306645316253
"E02001565",360,237,40,98,139,262,3258,0.110497237569061,0.072744014732965,0.0122774708410068,0.0300798035604665,0.0426642111724985,0.0804174340085942
"E02001566",516,358,1082,111,247,405,4419,0.116768499660557,0.0810138040280606,0.244851776420005,0.0251188051595384,0.0558949988685223,0.0916496945010183
"E02001567",502,494,668,140,354,362,3543,0.141687835167937,0.139429861699125,0.18854078464578,0.0395145357042055,0.0999153259949196,0.102173299463731
"E02001568",317,256,721,68,188,249,3264,0.0971200980392157,0.0784313725490196,0.220894607843137,0.0208333333333333,0.0575980392156863,0.0762867647058824
"E02001569",567,284,1703,77,207,490,3898,0.145459209851206,0.0728578758337609,0.436890713186249,0.0197537198563366,0.0531041559774243,0.125705489994869
"E02001570",341,279,426,61,218,280,3270,0.104281345565749,0.0853211009174312,0.130275229357798,0.0186544342507645,0.0666666666666667,0.0856269113149847
"E02001571",371,329,600,107,222,264,1994,0.186058174523571,0.164994984954865,0.300902708124373,0.0536609829488465,0.111334002006018,0.132397191574724
"E02001572",379,436,563,100,336,279,3166,0.119709412507896,0.137713202779533,0.177826910928617,0.0315855969677827,0.10612760581175,0.0881238155401137
"E02001573",385,307,412,78,229,307,2453,0.15695067264574,0.125152874031798,0.167957602935181,0.0317977986139421,0.0933550754178557,0.125152874031798
"E02001574",300,193,70,55,138,245,1892,0.158562367864693,0.102008456659619,0.0369978858350951,0.0290697674418605,0.072938689217759,0.129492600422833
"E02001575",409,529,850,122,407,287,3449,0.118585097129603,0.153377790663961,0.246448245868368,0.0353725717599304,0.11800521890403,0.0832125253696724
"E02001576",368,233,381,67,166,301,2829,0.130081300813008,0.0823612583951926,0.134676564156946,0.023683280311064,0.0586779780841287,0.106398020501944
"E02001577",433,363,374,119,244,314,2224,0.194694244604317,0.163219424460432,0.168165467625899,0.0535071942446043,0.109712230215827,0.141187050359712
"E02001578",428,483,656,117,366,311,3988,0.107321965897693,0.12111334002006,0.164493480441324,0.0293380140421264,0.0917753259779338,0.0779839518555667
"E02001579",478,314,797,65,249,413,3625,0.131862068965517,0.0866206896551724,0.219862068965517,0.0179310344827586,0.0686896551724138,0.113931034482759
"E02001580",504,325,654,107,218,397,2839,0.177527298344487,0.114476928495949,0.230362803804156,0.0376893272278971,0.0767876012680521,0.13983797111659
"E02001581",280,205,230,61,144,219,2040,0.137254901960784,0.100490196078431,0.112745098039216,0.0299019607843137,0.0705882352941176,0.107352941176471
"E02001582",426,338,147,116,222,310,2475,0.172121212121212,0.136565656565657,0.0593939393939394,0.0468686868686869,0.0896969696969697,0.125252525252525
"E02001583",317,281,678,76,205,241,2062,0.153734238603298,0.13627546071775,0.328806983511154,0.0368574199806014,0.0994180407371484,0.116876818622696
"E02001584",422,299,609,98,201,324,2191,0.1926061159288,0.136467366499315,0.277955271565495,0.0447284345047923,0.091738931994523,0.147877681424007
"E02001585",350,220,737,55,165,295,2808,0.124643874643875,0.0783475783475783,0.262464387464387,0.0195868945868946,0.0587606837606838,0.10505698005698
"E02001586",501,465,399,107,358,394,3370,0.1486646884273,0.137982195845697,0.11839762611276,0.0317507418397626,0.106231454005935,0.116913946587537
"E02001587",323,261,232,74,187,249,2307,0.140008669267447,0.113133940182055,0.100563502384049,0.0320762895535327,0.0810576506285219,0.107932379713914
"E02001588",352,245,75,85,160,267,2148,0.163873370577281,0.114059590316574,0.0349162011173184,0.0395716945996276,0.074487895716946,0.124301675977654
"E02001589",408,288,137,104,184,304,2573,0.158569762922658,0.111931597357171,0.0532452390205985,0.0404197434900894,0.0715118538670812,0.118150019432569
"E02001590",331,282,146,79,203,252,2449,0.135157207023275,0.115149040424663,0.0596161698652511,0.032258064516129,0.0828909759085341,0.102899142507146
"E02001591",358,411,992,77,334,281,2801,0.127811495894323,0.14673330953231,0.35415922884684,0.0274901820778293,0.119243127454481,0.100321313816494
"E02001592",527,441,349,147,294,380,2609,0.201993100804906,0.16903027980069,0.133767727098505,0.05634342660023,0.11268685320046,0.145649674204676
"E02001593",483,270,1251,67,203,416,3156,0.153041825095057,0.0855513307984791,0.39638783269962,0.0212294043092522,0.0643219264892269,0.131812420785805
"E02001594",418,343,1259,58,285,360,3784,0.11046511627907,0.0906448202959831,0.332716701902748,0.0153276955602537,0.0753171247357294,0.0951374207188161
"E02001595",520,479,125,152,327,368,2645,0.196597353497164,0.18109640831758,0.0472589792060491,0.0574669187145558,0.123629489603025,0.139130434782609
"E02001596",464,399,75,137,262,327,2684,0.172876304023845,0.148658718330849,0.0279433681073025,0.051043219076006,0.0976154992548435,0.121833084947839
"E02001597",536,486,1111,149,337,387,3732,0.143622722400857,0.130225080385852,0.297695605573419,0.039924973204716,0.0903001071811361,0.103697749196141
"E02001598",499,470,137,156,314,343,2807,0.177769861061632,0.167438546490916,0.048806555040969,0.0555753473459209,0.111863199144995,0.122194513715711
"E02001600",632,675,398,207,468,425,3276,0.192918192918193,0.206043956043956,0.121489621489621,0.0631868131868132,0.142857142857143,0.12973137973138
"E02001602",475,439,297,138,301,337,2687,0.176777074804615,0.163379233345739,0.110532192035728,0.0513583922590249,0.112020841086714,0.12541868254559
"E02001603",379,327,160,85,242,294,2509,0.151056197688322,0.130330809087286,0.063770426464727,0.0338780390593862,0.0964527700278996,0.117178158628936
"E02001604",456,358,404,92,266,364,4826,0.094488188976378,0.0741815167840862,0.0837132200580191,0.0190634065478657,0.0551181102362205,0.0754247824285122
"E02001605",382,268,390,68,200,314,2958,0.129141311697093,0.0906017579445571,0.13184584178499,0.0229885057471264,0.0676132521974307,0.106152805949966
"E02001606",513,456,487,132,324,381,2940,0.174489795918367,0.155102040816327,0.165646258503401,0.0448979591836735,0.110204081632653,0.129591836734694
"E02001607",537,456,175,142,314,395,2660,0.20187969924812,0.171428571428571,0.0657894736842105,0.0533834586466165,0.118045112781955,0.148496240601504
"E02001608",422,397,357,132,265,290,2381,0.177236455270895,0.166736665266695,0.149937001259975,0.0554388912221756,0.111297774044519,0.121797564048719
"E02001609",537,485,275,154,331,383,2443,0.219811706917724,0.198526401964797,0.112566516577978,0.0630372492836676,0.13548915268113,0.156774457634056
"E02001610",538,341,368,113,228,425,2944,0.182744565217391,0.115828804347826,0.125,0.038383152173913,0.077445652173913,0.144361413043478
"E02001611",351,428,339,106,322,245,2675,0.131214953271028,0.16,0.126728971962617,0.0396261682242991,0.120373831775701,0.091588785046729
"E02001612",257,209,388,66,143,191,1869,0.137506688068486,0.111824505082932,0.207597645799893,0.0353130016051364,0.0765115034777956,0.102193686463349
"E02001613",603,460,455,147,313,456,3248,0.185652709359606,0.141625615763547,0.140086206896552,0.0452586206896552,0.0963669950738916,0.140394088669951
"E02001614",558,486,497,150,336,408,3189,0.174976481655691,0.152398871119473,0.155848228284729,0.0470366886171214,0.105362182502352,0.12793979303857
"E02001615",373,407,468,106,301,267,2130,0.175117370892019,0.191079812206573,0.219718309859155,0.0497652582159624,0.14131455399061,0.125352112676056
"E02001616",252,228,253,61,167,191,2299,0.109612875163114,0.0991735537190083,0.110047846889952,0.0265332753371031,0.0726402783819052,0.0830795998260113
"E02001617",118,150,353,30,120,88,2076,0.0568400770712909,0.0722543352601156,0.170038535645472,0.0144508670520231,0.0578034682080925,0.0423892100192678
"E02001618",364,292,506,74,218,290,3139,0.115960496973558,0.0930232558139535,0.161197833705002,0.0235743867473718,0.0694488690665817,0.0923861102261867
"E02001619",316,309,412,74,235,242,3329,0.0949234004205467,0.092820666866927,0.123760889155903,0.0222288975668369,0.0705917693000901,0.0726945028537098
"E02001620",205,201,529,34,167,171,2587,0.0792423656745265,0.0776961731735601,0.204483958252802,0.0131426362582141,0.064553536915346,0.0660997294163123
"E02001621",208,179,237,50,129,158,2332,0.0891938250428816,0.0767581475128645,0.101629502572899,0.0214408233276158,0.0553173241852487,0.0677530017152659
"E02001622",408,468,668,73,395,335,3290,0.124012158054711,0.142249240121581,0.203039513677812,0.0221884498480243,0.120060790273556,0.101823708206687
"E02001623",340,222,377,68,154,272,2881,0.118014578271434,0.0770565775772301,0.130857341200972,0.0236029156542867,0.0534536619229434,0.0944116626171468
"E02001624",612,371,763,120,251,492,3334,0.183563287342531,0.11127774445111,0.228854229154169,0.0359928014397121,0.0752849430113977,0.147570485902819
"E02001625",198,300,170,60,240,138,2566,0.0771628994544037,0.116913484021824,0.0662509742790335,0.0233826968043648,0.0935307872174591,0.053780202650039
"E02001626",424,295,781,67,228,357,1765,0.240226628895184,0.1671388101983,0.442492917847025,0.0379603399433428,0.129178470254958,0.202266288951841
"E02001627",609,312,1336,93,219,516,2558,0.23807662236122,0.121970289288507,0.522283033620016,0.0363565285379202,0.0856137607505864,0.201720093823299
"E02001628",462,253,747,69,184,393,1962,0.235474006116208,0.1289500509684,0.380733944954128,0.0351681957186544,0.0937818552497452,0.200305810397554
"E02001629",316,330,474,68,262,248,2447,0.129137719656723,0.134859011033919,0.193706579485084,0.0277891295463833,0.107069881487536,0.101348590110339
"E02001630",952,531,1275,133,398,819,2851,0.333917923535602,0.186250438442652,0.447211504735181,0.0466502981410032,0.139600140301649,0.287267625394598
"E02001631",565,322,971,94,228,471,2663,0.212166729252722,0.120916259857304,0.364626361246714,0.0352985354862937,0.0856177243710101,0.176868193766429
"E02001632",1071,387,1635,108,279,963,4983,0.214930764599639,0.0776640577965081,0.328115593016255,0.0216736905478627,0.0559903672486454,0.193257074051776
"E02001633",351,391,286,108,283,243,2302,0.152476107732407,0.169852302345786,0.124239791485665,0.0469157254561251,0.122936576889661,0.105560382276281
"E02001634",1046,445,1974,127,318,919,3890,0.268894601542416,0.11439588688946,0.50745501285347,0.0326478149100257,0.0817480719794344,0.236246786632391
"E02001635",232,325,264,78,247,154,2337,0.0992725716730851,0.139067180145486,0.112965340179718,0.0333761232349166,0.105691056910569,0.0658964484381686
"E02001636",482,456,981,63,393,419,4275,0.112748538011696,0.106666666666667,0.229473684210526,0.0147368421052632,0.0919298245614035,0.0980116959064327
"E02001637",408,180,662,30,150,378,2699,0.151167098925528,0.0666913671730271,0.245276028158577,0.0111152278621712,0.0555761393108559,0.140051871063357
"E02001638",903,175,1788,49,126,854,2344,0.385238907849829,0.0746587030716724,0.762798634812287,0.0209044368600683,0.0537542662116041,0.364334470989761
"E02001639",715,354,1402,99,255,616,2558,0.279515246286161,0.138389366692729,0.548084440969507,0.0387021110242377,0.099687255668491,0.240813135261923
"E02001640",785,305,1710,57,248,728,3274,0.239767868051313,0.0931582162492364,0.522296884544899,0.0174098961514966,0.0757483200977398,0.222357971899817
"E02001642",450,620,795,112,508,338,3336,0.134892086330935,0.185851318944844,0.238309352517986,0.0335731414868106,0.152278177458034,0.101318944844125
"E02001643",285,547,237,118,429,167,1838,0.155059847660501,0.297606093579978,0.128944504896627,0.0642002176278564,0.233405875952122,0.0908596300326442
"E02001646",802,430,1689,116,314,686,2957,0.271220831924248,0.145417653026716,0.571187013865404,0.03922894825837,0.106188704768346,0.231991883665878
"E02001647",252,326,159,80,246,172,1896,0.132911392405063,0.171940928270042,0.0838607594936709,0.0421940928270042,0.129746835443038,0.0907172995780591
"E02001648",429,562,814,79,483,350,2374,0.180707666385847,0.236731255265375,0.342881213142376,0.0332771693344566,0.203454085930918,0.14743049705139
"E02001649",467,359,268,86,273,381,5154,0.0906092355452076,0.0696546371750097,0.0519984478075281,0.016686069072565,0.0529685681024447,0.0739231664726426
"E02001650",585,212,1272,46,166,539,4180,0.139952153110048,0.0507177033492823,0.304306220095694,0.0110047846889952,0.0397129186602871,0.128947368421053
"E02001651",380,611,237,150,461,230,2157,0.176170607324988,0.283263792304126,0.109874826147427,0.0695410292072323,0.213722763096894,0.106629578117756
"E02001652",1141,230,2227,77,153,1064,5925,0.192573839662447,0.0388185654008439,0.375864978902954,0.0129957805907173,0.0258227848101266,0.17957805907173
"E02001653",202,230,269,60,170,142,3291,0.0613795199027651,0.0698875721665147,0.0817380735338803,0.0182315405651778,0.051656031601337,0.0431479793375874
"E02001654",276,226,266,55,171,221,1902,0.145110410094637,0.11882229232387,0.139852786540484,0.0289169295478444,0.0899053627760252,0.116193480546793
"E02001655",307,302,292,82,220,225,2804,0.109486447931526,0.107703281027104,0.10413694721826,0.029243937232525,0.0784593437945792,0.0802425106990014
"E02001656",895,518,1492,141,377,754,2985,0.299832495812395,0.173534338358459,0.499832495812395,0.0472361809045226,0.126298157453936,0.252596314907873
"E02001657",821,680,1164,190,490,631,2814,0.291755508173419,0.241648898365316,0.4136460554371,0.0675195451314854,0.174129353233831,0.224235963041933
"E02001658",157,123,342,22,101,135,1894,0.0828933474128828,0.0649419218585005,0.180570221752904,0.0116156282998944,0.0533262935586061,0.0712777191129884
"E02001659",310,222,476,61,161,249,2655,0.116760828625235,0.0836158192090395,0.179284369114878,0.0229755178907721,0.0606403013182674,0.0937853107344633
"E02001660",1117,592,2047,172,420,945,3871,0.288555928700594,0.152932058899509,0.528803926633945,0.0444329630586412,0.108499095840868,0.244122965641953
"E02001661",425,619,966,118,501,307,3288,0.129257907542579,0.188260340632603,0.293795620437956,0.0358880778588808,0.152372262773723,0.0933698296836983
"E02001662",342,462,375,109,353,233,2570,0.133073929961089,0.179766536964981,0.14591439688716,0.0424124513618677,0.137354085603113,0.0906614785992218
"E02001663",872,366,1664,111,255,761,2823,0.308891250442791,0.129649309245484,0.589443854055969,0.0393198724760893,0.0903294367693943,0.269571377966702
"E02001664",188,396,236,71,325,117,2057,0.0913952357802625,0.192513368983957,0.1147301895965,0.0345162858531842,0.157997083130773,0.0568789499270783
"E02001665",552,898,428,222,676,330,2795,0.197495527728086,0.32128801431127,0.153130590339893,0.0794275491949911,0.241860465116279,0.118067978533095
"E02001666",221,168,318,42,126,179,1759,0.125639567936327,0.0955088118249005,0.180784536668562,0.0238772029562251,0.0716316088686754,0.101762364980102
"E02001669",704,684,1298,183,501,521,3107,0.226585130350821,0.220148052784036,0.417766334084326,0.0588992597360798,0.161248793047956,0.167685870614741
"E02001670",163,215,329,46,169,117,2287,0.0712724092697857,0.0940096195889812,0.143856580673371,0.020113686051596,0.0738959335373852,0.0511587232181898
"E02001671",281,247,57,60,187,221,1835,0.153133514986376,0.134604904632153,0.0310626702997275,0.0326975476839237,0.101907356948229,0.120435967302452
"E02001672",262,362,107,102,260,160,1877,0.139584443260522,0.19286094832179,0.0570058604155567,0.0543420351624933,0.138518913159297,0.0852424080980288
"E02001673",262,130,122,35,95,227,1442,0.181692094313454,0.0901525658807212,0.0846047156726768,0.0242718446601942,0.065880721220527,0.157420249653259
"E02001674",430,695,282,167,528,263,2807,0.153188457427859,0.247595297470609,0.100463127894549,0.0594941218382615,0.188101175632348,0.0936943355895974
"E02001675",501,484,91,144,340,357,3034,0.165128543177324,0.159525379037574,0.0299934080421885,0.047462096242584,0.11206328279499,0.11766644693474
"E02001676",270,558,172,118,440,152,1672,0.161483253588517,0.333732057416268,0.102870813397129,0.0705741626794258,0.263157894736842,0.0909090909090909
"E02001678",627,934,391,261,673,366,3374,0.18583283935981,0.276822762299941,0.115886188500296,0.0773562537048014,0.199466508595139,0.108476585655009
"E02001679",258,285,211,66,219,192,2512,0.102707006369427,0.113455414012739,0.0839968152866242,0.0262738853503185,0.0871815286624204,0.0764331210191083
"E02001680",162,146,473,25,121,137,2784,0.0581896551724138,0.0524425287356322,0.169899425287356,0.00897988505747126,0.0434626436781609,0.0492097701149425
"E02001681",425,616,223,162,454,263,2395,0.177453027139875,0.257202505219207,0.0931106471816284,0.0676409185803758,0.189561586638831,0.109812108559499
"E02001682",315,335,415,84,251,231,3371,0.0934440818748146,0.0993770394541679,0.123108869771581,0.0249184218332839,0.074458617620884,0.0685256600415307
"E02001683",403,521,788,103,418,300,3154,0.127774254914394,0.165187064045656,0.249841471147749,0.0326569435637286,0.132530120481928,0.0951173113506658
"E02001684",308,453,693,75,378,233,3119,0.0987495992305226,0.145238858608528,0.222186598268676,0.0240461686437961,0.121192689964732,0.0747034305867265
"E02001685",299,342,483,70,272,229,3123,0.095741274415626,0.109510086455331,0.154658981748319,0.0224143451809158,0.0870957412744156,0.0733269292347102
"E02001686",316,312,395,81,231,235,2175,0.145287356321839,0.143448275862069,0.181609195402299,0.0372413793103448,0.106206896551724,0.108045977011494
"E02001688",194,264,222,48,216,146,3699,0.0524466071911327,0.0713706407137064,0.0600162206001622,0.0129764801297648,0.0583941605839416,0.0394701270613679
"E02001689",552,578,1688,115,463,437,3326,0.165965123271197,0.173782321106434,0.507516536380036,0.034576067348166,0.139206253758268,0.131389055923031
"E02001690",312,526,598,107,419,205,2538,0.122931442080378,0.207249802994484,0.235618597320725,0.0421591804570528,0.165090622537431,0.0807722616233255
"E02001691",715,627,2864,100,527,615,4300,0.166279069767442,0.145813953488372,0.666046511627907,0.0232558139534884,0.122558139534884,0.143023255813953
"E02001692",296,194,292,38,156,258,2271,0.13033905768384,0.0854249229414355,0.128577719066491,0.0167327168648173,0.0686922060766182,0.113606340819022
"E02001693",254,265,434,59,206,195,2058,0.123420796890185,0.128765792031098,0.210884353741497,0.0286686103012634,0.100097181729835,0.0947521865889213
"E02001694",322,383,344,95,288,227,1972,0.163286004056795,0.19421906693712,0.174442190669371,0.0481744421906694,0.14604462474645,0.115111561866126
"E02001695",234,158,32,50,108,184,1745,0.134097421203438,0.0905444126074499,0.0183381088825215,0.0286532951289398,0.06189111747851,0.105444126074499
"E02001696",321,276,55,57,219,264,3121,0.102851650112144,0.0884331944889458,0.0176225568727972,0.0182633771227171,0.0701698173662288,0.0845882729894265
"E02001697",362,555,657,102,453,260,2557,0.141572154868987,0.217051231912397,0.256941728588189,0.0398904966757919,0.177160735236605,0.101681658193195
"E02001698",294,375,112,94,281,200,1921,0.153045288912025,0.195210827693909,0.0583029672045809,0.0489328474752733,0.146277980218636,0.104112441436752
"E02001699",258,233,46,41,192,217,2211,0.116689280868385,0.105382180009046,0.020805065581185,0.018543645409317,0.0868385345997286,0.0981456354590683
"E02001700",366,428,211,108,320,258,3129,0.116970278044104,0.136784915308405,0.0674336848833493,0.0345158197507191,0.102269095557686,0.0824544582933845
"E02001701",284,353,423,85,268,199,1878,0.15122470713525,0.187965921192758,0.225239616613419,0.0452609158679446,0.142705005324814,0.105963791267306
"E02001702",260,311,276,34,277,226,2847,0.091324200913242,0.109237794169301,0.0969441517386723,0.0119423955040393,0.0972953986652617,0.0793818054092027
"E02001703",188,233,152,42,191,146,1555,0.120900321543408,0.14983922829582,0.0977491961414791,0.0270096463022508,0.122829581993569,0.0938906752411576
"E02001704",240,757,131,45,712,195,2629,0.0912894636744009,0.287942183339673,0.0498288322556105,0.0171167744389502,0.270825408900723,0.0741726892354507
"E02001706",226,291,82,68,223,158,2672,0.0845808383233533,0.108907185628743,0.030688622754491,0.0254491017964072,0.0834580838323353,0.0591317365269461
"E02001707",362,431,465,102,329,260,2686,0.134772896500372,0.160461653015637,0.173119880863738,0.0379746835443038,0.122486969471333,0.0967982129560685
"E02001709",404,708,82,134,574,270,3896,0.103696098562628,0.181724845995893,0.021047227926078,0.034394250513347,0.147330595482546,0.0693018480492813
"E02001710",363,571,270,92,479,271,3798,0.0955766192733017,0.150342285413375,0.0710900473933649,0.0242232754081095,0.126119010005266,0.0713533438651922
"E02001711",289,628,212,116,512,173,4378,0.0660118775696665,0.143444495203289,0.048423937871174,0.0264961169483783,0.116948378254911,0.0395157606212883
"E02001712",490,684,1221,127,557,363,3598,0.136186770428016,0.190105614230128,0.339355197331851,0.0352973874374653,0.154808226792663,0.10088938299055
"E02001713",552,700,1280,159,541,393,3797,0.145377929944693,0.184356070582038,0.337108243350013,0.0418751646036344,0.142480905978404,0.103502765341059
"E02001714",305,456,167,98,358,207,2934,0.103953646898432,0.155419222903885,0.0569188820722563,0.0334014996591684,0.122017723244717,0.0705521472392638
"E02001715",391,937,351,158,779,233,4163,0.0939226519337017,0.225078068700456,0.0843141964929138,0.0379533989911122,0.187124669709344,0.0559692529425895
"E02001718",161,247,91,44,203,117,2452,0.0656606851549755,0.100734094616639,0.0371125611745514,0.0179445350734095,0.08278955954323,0.0477161500815661
"E02001719",336,693,266,122,571,214,2726,0.123257520176082,0.254218635363169,0.0975788701393984,0.0447542186353632,0.209464416727806,0.078503301540719
"E02001720",793,400,2452,72,328,721,3644,0.21761800219539,0.109769484083425,0.672886937431394,0.0197585071350165,0.0900109769484083,0.197859495060373
"E02001721",367,613,535,104,509,263,4301,0.085328993257382,0.142524994187398,0.124389676819344,0.0241804231574053,0.118344571029993,0.0611485700999767
"E02001722",360,379,180,89,290,271,3403,0.105789009697326,0.111372318542463,0.0528945048486629,0.0261533940640611,0.0852189244784014,0.0796356156332648
"E02001723",279,392,145,84,308,195,2403,0.116104868913858,0.163129421556388,0.060341240116521,0.034956304619226,0.128173116937162,0.0811485642946317
"E02001724",818,554,2524,71,483,747,4258,0.192108971348051,0.130108031939878,0.592766557069046,0.0166744950681071,0.113433536871771,0.175434476279944
"E02001725",792,1047,3073,155,892,637,5117,0.154778190345906,0.204612077389095,0.600547195622435,0.0302911862419386,0.174320891147157,0.124487004103967
"E02001726",464,594,167,143,451,321,3819,0.121497774286462,0.15553809897879,0.0437287247970673,0.0374443571615606,0.11809374181723,0.0840534171249018
"E02001727",266,719,489,82,637,184,3249,0.0818713450292398,0.221298861188058,0.15050784856879,0.0252385349338258,0.196060326254232,0.056632810095414
"E02001728",452,648,270,151,497,301,3237,0.13963546493667,0.200185356811863,0.0834105653382762,0.0466481309854804,0.153537225826382,0.0929873339511894
"E02001729",735,1092,3107,133,959,602,5049,0.145573380867499,0.216280451574569,0.615369380075262,0.0263418498712616,0.189938601703308,0.119231530996237
"E02001732",158,362,139,62,300,96,2313,0.0683095546908776,0.156506701253783,0.0600951145698227,0.0268050151318634,0.12970168612192,0.0415045395590143
"E02001734",289,645,614,89,556,200,3443,0.0839384257914609,0.187336625036306,0.178332849259367,0.0258495498112112,0.161487075225094,0.0580888759802498
"E02001735",199,374,423,57,317,142,2540,0.0783464566929134,0.147244094488189,0.166535433070866,0.0224409448818898,0.124803149606299,0.0559055118110236
"E02001737",200,381,255,42,339,158,2623,0.0762485703393061,0.145253526496378,0.0972169271826153,0.0160121997712543,0.129241326725124,0.0602363705680518
"E02001738",191,334,80,54,280,137,1706,0.111957796014068,0.1957796014068,0.0468933177022274,0.0316529894490035,0.164126611957796,0.0803048065650645
"E02001739",287,367,187,69,298,218,2814,0.101990049751244,0.130419331911869,0.066453447050462,0.0245202558635394,0.10589907604833,0.0774697938877043
"E02001740",235,491,217,93,398,142,1589,0.147891755821271,0.308999370673379,0.136563876651982,0.0585273757079924,0.250471994965387,0.0893643801132788
"E02001741",346,456,187,123,333,223,3103,0.111504995165968,0.146954560103126,0.0602642603931679,0.0396390589751853,0.107315501127941,0.0718659361907831
"E02001742",213,390,41,90,300,123,1868,0.114025695931478,0.208779443254818,0.021948608137045,0.0481798715203426,0.160599571734475,0.0658458244111349
"E02001743",515,610,1506,126,484,389,2912,0.176854395604396,0.209478021978022,0.51717032967033,0.0432692307692308,0.166208791208791,0.133585164835165
"E02001744",223,337,198,67,270,156,3224,0.0691687344913151,0.104528535980149,0.0614143920595533,0.0207816377171216,0.0837468982630273,0.0483870967741935
"E02001745",170,263,68,41,222,129,2402,0.070774354704413,0.109492089925062,0.0283097418817652,0.0170691090757702,0.0924229808492923,0.0537052456286428
"E02001746",374,577,475,115,462,259,2834,0.13196894848271,0.203599153140438,0.167607621736062,0.0405786873676782,0.163020465772759,0.0913902611150318
"E02001747",316,320,340,76,244,240,1993,0.158554942298043,0.160561966884094,0.17059708981435,0.0381334671349724,0.122428499749122,0.120421475163071
"E02001748",161,253,47,43,210,118,3220,0.05,0.0785714285714286,0.0145962732919255,0.0133540372670807,0.0652173913043478,0.0366459627329193
"E02001749",208,541,287,71,470,137,2507,0.0829676904666933,0.215795771838851,0.114479457518947,0.0283207020343039,0.187475069804547,0.0546469884323893
"E02001750",201,346,74,51,295,150,2358,0.0852417302798982,0.146734520780322,0.0313825275657337,0.0216284987277354,0.125106022052587,0.0636132315521628
"E02001751",256,310,227,67,243,189,2549,0.100431541781091,0.121616320125539,0.0890545311887014,0.0262848175755198,0.0953315025500196,0.0741467242055708
"E02001752",242,252,66,69,183,173,2327,0.103996562097121,0.108293940696175,0.0283626987537602,0.0296519123334766,0.0786420283626987,0.0743446497636442
"E02001753",360,383,1255,43,340,317,2993,0.120280654861343,0.127965252255262,0.419311727363849,0.0143668559973271,0.113598396257935,0.105913798864016
"E02001754",349,710,1162,141,569,208,2346,0.148763853367434,0.302642796248934,0.495311167945439,0.0601023017902813,0.242540494458653,0.0886615515771526
"E02001755",291,425,244,80,345,211,3499,0.0831666190340097,0.121463275221492,0.0697342097742212,0.0228636753358102,0.0985995998856816,0.0603029436981995
"E02001756",216,294,569,33,261,183,3947,0.0547251076767165,0.0744869521155308,0.14416012161135,0.00836078033949835,0.0661261717760324,0.0463643273372181
"E02001757",265,261,93,73,188,192,1975,0.134177215189873,0.132151898734177,0.0470886075949367,0.0369620253164557,0.0951898734177215,0.0972151898734177
"E02001758",211,277,36,55,222,156,1738,0.121403912543153,0.159378596087457,0.0207134637514384,0.0316455696202532,0.127733026467204,0.0897583429228999
"E02001759",446,660,1694,104,556,342,3463,0.128790066416402,0.19058619693907,0.48917123881028,0.0300317643661565,0.160554432572914,0.0987583020502455
"E02001760",365,504,316,92,412,273,3517,0.103781632072789,0.143303952232016,0.0898493033835655,0.026158657947114,0.117145294284902,0.0776229741256753
"E02001761",183,277,67,58,219,125,1852,0.0988120950323974,0.149568034557235,0.0361771058315335,0.031317494600432,0.118250539956803,0.0674946004319654
"E02001762",230,309,23,74,235,156,2637,0.087220326128176,0.117178612059158,0.0087220326128176,0.0280621918847175,0.0891164201744407,0.0591581342434585
"E02001763",247,334,108,69,265,178,2530,0.0976284584980237,0.13201581027668,0.0426877470355731,0.0272727272727273,0.104743083003953,0.0703557312252964
"E02001764",371,469,815,79,390,292,3962,0.0936395759717314,0.118374558303887,0.20570418980313,0.0199394245330641,0.0984351337708228,0.0737001514386673
"E02001765",288,353,644,67,286,221,3595,0.0801112656467316,0.098191933240612,0.17913769123783,0.0186369958275382,0.0795549374130737,0.0614742698191933
"E02001766",410,675,1377,102,573,308,3505,0.1169757489301,0.192582025677603,0.392867332382311,0.0291012838801712,0.163480741797432,0.0878744650499287
"E02001767",372,506,1066,99,407,273,3091,0.120349401488192,0.163701067615658,0.344872209640893,0.0320284697508897,0.131672597864769,0.0883209317373018
"E02001768",441,629,1273,118,511,323,3377,0.130589280426414,0.186259994077584,0.376961800414569,0.0349422564406278,0.151317737636956,0.0956470239857862
"E02001769",542,729,1268,148,581,394,4556,0.118964003511853,0.160008779631255,0.278314310798946,0.0324846356453029,0.127524143985953,0.0864793678665496
"E02001770",497,834,971,175,659,322,2679,0.185516983949235,0.311310190369541,0.362448674878686,0.0653228816722658,0.245987308697275,0.120194102276969
"E02001771",300,365,114,75,290,225,2615,0.11472275334608,0.139579349904398,0.0435946462715105,0.0286806883365201,0.110898661567878,0.0860420650095602
"E02001772",309,526,495,111,415,198,2123,0.145548751766368,0.247762600094206,0.233160621761658,0.0522845030617051,0.195478097032501,0.0932642487046632
"E02001773",295,288,147,76,212,219,1478,0.199594046008119,0.194857916102842,0.0994587280108254,0.0514208389715832,0.143437077131258,0.148173207036536
"E02001774",233,475,622,74,401,159,2627,0.0886943281309479,0.180814617434336,0.236771983250856,0.028169014084507,0.152645603349829,0.0605253140464408
"E02001775",220,225,214,36,189,184,2254,0.0976042590949423,0.0998225377107365,0.0949423247559893,0.0159716060337178,0.0838509316770186,0.0816326530612245
"E02001776",376,581,743,80,501,296,4053,0.0927707870713052,0.143350604490501,0.183320996792499,0.0197384653343203,0.123612139156181,0.0730323217369849
"E02001777",297,383,477,87,296,210,2690,0.110408921933086,0.142379182156134,0.177323420074349,0.0323420074349442,0.11003717472119,0.0780669144981413
"E02001778",347,731,670,136,595,211,2704,0.128328402366864,0.270340236686391,0.247781065088757,0.0502958579881657,0.220044378698225,0.0780325443786982
"E02001779",205,382,132,54,328,151,2473,0.082895268904165,0.154468257177517,0.0533764658309745,0.0218358269308532,0.132632430246664,0.0610594419733118
"E02001780",279,388,101,68,320,211,2765,0.100904159132007,0.140325497287523,0.0365280289330922,0.0245931283905967,0.115732368896926,0.0763110307414105
"E02001781",208,656,11,64,592,144,2689,0.0773521755299368,0.243956861286724,0.00409074005206396,0.0238006693938267,0.220156191892897,0.0535515061361101
"E02001782",320,310,91,65,245,255,3929,0.0814456604734029,0.0789004835836091,0.023161109697124,0.01654364978366,0.0623568337999491,0.0649020106897429
"E02001783",265,387,49,54,333,211,3149,0.0841536995871705,0.122896157510321,0.0155604953953636,0.0171483010479517,0.105747856462369,0.0670053985392188
"E02001784",203,684,33,89,595,114,2589,0.078408651989185,0.264194669756663,0.0127462340672074,0.0343762070297412,0.229818462726922,0.0440324449594438
"E02001785",394,534,163,113,421,281,3267,0.120599938781757,0.163452708907254,0.0498928680746863,0.03458830731558,0.128864401591674,0.0860116314661769
"E02001786",418,470,26,106,364,312,2773,0.150739271547061,0.169491525423729,0.00937612693833394,0.0382257482870537,0.131265777136675,0.112513523260007
"E02001787",218,625,79,93,532,125,1928,0.113070539419087,0.324170124481328,0.0409751037344398,0.0482365145228216,0.275933609958506,0.0648340248962656
"E02001788",341,408,185,109,299,232,2165,0.157505773672055,0.188452655889146,0.0854503464203233,0.0503464203233256,0.13810623556582,0.10715935334873
"E02001789",305,302,140,91,211,214,1561,0.195387572069186,0.193465727098014,0.0896860986547085,0.0582959641255605,0.135169762972454,0.137091607943626
"E02001790",223,312,183,56,256,167,1994,0.111835506519559,0.156469408224674,0.0917753259779338,0.0280842527582748,0.128385155466399,0.0837512537612839
"E02001791",226,356,56,99,257,127,1394,0.162123385939742,0.255380200860832,0.0401721664275466,0.0710186513629842,0.184361549497848,0.0911047345767575
"E02001792",445,585,133,188,397,257,2134,0.208528584817245,0.274133083411434,0.0623242736644799,0.0880974695407685,0.186035613870665,0.120431115276476
"E02001793",392,537,73,113,424,279,4037,0.0971018082734704,0.133019568986871,0.0180827347039881,0.0279910824869953,0.105028486499876,0.0691107257864751
"E02001794",374,306,144,72,234,302,3685,0.101492537313433,0.0830393487109905,0.0390773405698779,0.0195386702849389,0.0635006784260516,0.0819538670284939
"E02001795",579,759,334,226,533,353,3469,0.166906889593543,0.218795041798789,0.0962813490919573,0.0651484577688095,0.15364658402998,0.101758431824733
"E02001796",558,1206,539,241,965,317,3962,0.140837960625947,0.304391721352852,0.136042402826855,0.0608278647147905,0.243563856638062,0.080010095911156
"E02001797",243,203,180,48,155,195,1879,0.129324108568387,0.10803618946248,0.0957956359765833,0.0255455029270889,0.0824906865353912,0.103778605641299
"E02001798",401,304,70,93,211,308,3038,0.131994733377222,0.100065832784727,0.0230414746543779,0.0306122448979592,0.0694535878867676,0.101382488479263
"E02001799",422,834,124,95,739,327,4375,0.0964571428571429,0.190628571428571,0.0283428571428571,0.0217142857142857,0.168914285714286,0.0747428571428571
"E02001800",187,330,108,58,272,129,2589,0.0722286597141754,0.127462340672074,0.0417149478563152,0.02240247199691,0.105059868675164,0.0498261877172654
"E02001801",609,805,508,258,547,351,2400,0.25375,0.335416666666667,0.211666666666667,0.1075,0.227916666666667,0.14625
"E02001802",284,227,48,53,174,231,3310,0.0858006042296073,0.0685800604229607,0.0145015105740181,0.016012084592145,0.0525679758308157,0.0697885196374622
"E02001803",715,1113,1676,254,859,461,5650,0.126548672566372,0.196991150442478,0.296637168141593,0.0449557522123894,0.152035398230088,0.0815929203539823
"E02001804",231,211,69,53,158,178,2322,0.0994832041343669,0.090869939707149,0.0297157622739018,0.0228251507321275,0.0680447889750215,0.0766580534022395
"E02001805",460,485,186,155,330,305,1818,0.253025302530253,0.266776677667767,0.102310231023102,0.0852585258525853,0.181518151815182,0.167766776677668
"E02001806",959,1022,776,287,735,672,5226,0.183505549177191,0.195560658247225,0.148488327592805,0.0549177190968236,0.140642939150402,0.128587830080367
"E02001807",311,632,83,95,537,216,3280,0.0948170731707317,0.192682926829268,0.0253048780487805,0.0289634146341463,0.163719512195122,0.0658536585365854
"E02001808",651,668,306,239,429,412,2056,0.316634241245136,0.324902723735409,0.148832684824903,0.11624513618677,0.208657587548638,0.200389105058366
"E02001809",209,339,69,87,252,122,2223,0.094017094017094,0.152496626180837,0.0310391363022942,0.039136302294197,0.11336032388664,0.054880791722897
"E02001810",360,280,41,73,207,287,2953,0.121909922113105,0.094818828310193,0.0138841855739925,0.0247206230951575,0.0700982052150356,0.0971892990179478
"E02001811",330,271,160,71,200,259,3918,0.0842266462480858,0.0691679428279734,0.0408371618172537,0.0181214905564063,0.0510464522715671,0.0661051556916794
"E02001812",672,696,281,229,467,443,2808,0.239316239316239,0.247863247863248,0.100071225071225,0.0815527065527065,0.166310541310541,0.157763532763533
"E02001813",517,297,117,70,227,447,4288,0.120569029850746,0.0692630597014925,0.027285447761194,0.0163246268656716,0.0529384328358209,0.104244402985075
"E02001814",293,338,94,89,249,204,2208,0.132699275362319,0.153079710144928,0.0425724637681159,0.0403079710144928,0.112771739130435,0.0923913043478261
"E02001815",355,695,58,115,580,240,3173,0.11188150015758,0.219035612984557,0.0182792310116609,0.0362433028679483,0.182792310116609,0.0756381972896313
"E02001816",292,255,273,62,193,230,3175,0.0919685039370079,0.0803149606299213,0.0859842519685039,0.0195275590551181,0.0607874015748031,0.0724409448818898
"E02001817",392,326,199,107,219,285,2679,0.146323254945875,0.121687196715192,0.0742814483016051,0.0399402762224711,0.0817469204927212,0.106382978723404
"E02001818",397,436,109,83,353,314,3746,0.105979711692472,0.116390816871329,0.0290977042178324,0.0221569674319274,0.094233849439402,0.0838227442605446
"E02001819",363,448,77,124,324,239,2338,0.155260906757913,0.191616766467066,0.0329341317365269,0.0530367835757057,0.13857998289136,0.102224123182207
"E02001820",288,534,106,89,445,199,3736,0.0770877944325482,0.142933618843683,0.028372591006424,0.0238222698072805,0.119111349036403,0.0532655246252677
"E02001821",233,162,32,47,115,186,2172,0.107274401473297,0.074585635359116,0.0147329650092081,0.0216390423572744,0.0529465930018416,0.0856353591160221
"E02001822",347,509,390,122,387,225,2677,0.129622711991035,0.190138214419126,0.145685468808368,0.0455734030631304,0.144564811355996,0.0840493089279044
"E02001823",266,406,114,75,331,191,3566,0.0745933819405496,0.113853056646102,0.0319685922602356,0.0210319685922602,0.0928210880538418,0.0535614133482894
"E02001824",374,474,150,105,369,269,3216,0.116293532338308,0.147388059701493,0.0466417910447761,0.0326492537313433,0.114738805970149,0.0836442786069652
"E02001825",433,526,266,155,371,278,3421,0.126571178018123,0.153756211634025,0.0777550423852675,0.0453083893598363,0.108447822274189,0.0812627886582871
"E02001826",398,349,166,99,250,299,3185,0.124960753532182,0.109576138147567,0.0521193092621664,0.0310832025117739,0.0784929356357928,0.0938775510204082
"E02001827",377,423,292,116,307,261,2045,0.184352078239609,0.206845965770171,0.14278728606357,0.0567237163814181,0.150122249388753,0.127628361858191
"E02001828",412,623,539,136,487,276,2619,0.157311951126384,0.237877052310042,0.205803741886216,0.0519282168766705,0.185948835433372,0.105383734249714
"E02001829",478,688,399,198,490,280,2748,0.173944687045124,0.250363901018923,0.145196506550218,0.0720524017467249,0.178311499272198,0.101892285298399
"E02001830",551,745,778,188,557,363,3171,0.173762220119836,0.234941658782718,0.245348470514033,0.0592872910753705,0.175654367707348,0.114474929044465
"E02001831",619,1045,277,210,835,409,3959,0.15635261429654,0.263955544329376,0.0699671634251074,0.053043697903511,0.210911846425865,0.103308916393029
"E02001832",443,506,293,144,362,299,2539,0.174478141000394,0.199291059472233,0.115399763686491,0.056715242221347,0.142575817250886,0.117762898779047
"E02001833",313,473,674,113,360,200,1603,0.195258889582034,0.295071740486588,0.420461634435434,0.0704928259513412,0.224578914535246,0.124766063630692
"E02001834",385,549,381,165,384,220,1895,0.203166226912929,0.289709762532982,0.201055408970976,0.0870712401055409,0.202638522427441,0.116094986807388
"E02001835",447,523,1260,108,415,339,3175,0.140787401574803,0.164724409448819,0.396850393700787,0.0340157480314961,0.130708661417323,0.106771653543307
"E02001836",515,577,1056,149,428,366,2684,0.191877794336811,0.214977645305514,0.39344262295082,0.0555141579731744,0.15946348733234,0.136363636363636
"E02001837",729,788,1139,241,547,488,3294,0.221311475409836,0.239222829386764,0.345780206435944,0.0731633272616879,0.166059502125076,0.148148148148148
"E02001838",460,377,339,128,249,332,2228,0.206463195691203,0.169210053859964,0.152154398563734,0.0574506283662478,0.111759425493716,0.149012567324955
"E02001839",405,483,916,118,365,287,2221,0.182350292660964,0.217469608284556,0.412426834759118,0.0531292210715894,0.164340387212967,0.129221071589374
"E02001840",601,356,1462,83,273,518,3452,0.174101969872538,0.103128621089224,0.423522595596755,0.0240440324449594,0.0790845886442642,0.150057937427578
"E02001841",359,421,434,123,298,236,1773,0.202481669486746,0.237450648618161,0.24478285391991,0.0693739424703892,0.168076706147772,0.133107727016356
"E02001842",383,429,1382,93,336,290,2292,0.167102966841187,0.18717277486911,0.602966841186736,0.0405759162303665,0.146596858638743,0.12652705061082
"E02001843",368,398,1416,64,334,304,2074,0.177434908389585,0.191899710703954,0.682738669238187,0.0308582449373192,0.161041465766635,0.146576663452266
"E02001844",659,664,1700,150,514,509,4149,0.1588334538443,0.160038563509279,0.409737286093034,0.0361532899493854,0.123885273559894,0.122680163894914
"E02001845",428,697,210,228,469,200,2080,0.205769230769231,0.335096153846154,0.100961538461538,0.109615384615385,0.225480769230769,0.0961538461538462
"E02001846",510,495,1112,136,359,374,2787,0.182992465016146,0.177610333692142,0.398995335486186,0.0487979906709724,0.12881234302117,0.134194474345174
"E02001847",426,562,303,172,390,254,1895,0.224802110817942,0.296569920844327,0.159894459102902,0.0907651715039578,0.205804749340369,0.134036939313984
"E02001848",457,458,729,134,324,323,2370,0.192827004219409,0.193248945147679,0.307594936708861,0.0565400843881857,0.136708860759494,0.136286919831224
"E02001849",503,540,1450,94,446,409,3837,0.131091998957519,0.140734949179046,0.377899400573365,0.0244983059682043,0.116236643210842,0.106593692989315
"E02001850",431,474,1496,90,384,341,2421,0.178025609252375,0.195786864931846,0.617926476662536,0.0371747211895911,0.158612143742255,0.140850888062784
"E02001851",516,645,703,134,511,382,3455,0.149348769898698,0.186685962373372,0.203473227206946,0.0387843704775687,0.147901591895803,0.110564399421129
"E02001852",440,178,1827,39,139,401,2633,0.167109760729206,0.0676034941131789,0.693885301936954,0.0148120015191796,0.0527914925939992,0.152297759210027
"E02001855",371,662,90,130,532,241,3651,0.101615995617639,0.181320186250342,0.0246507806080526,0.0356066831005204,0.145713503149822,0.0660093125171186
"E02001856",645,411,2153,105,306,540,3495,0.184549356223176,0.117596566523605,0.616022889842632,0.0300429184549356,0.0875536480686695,0.15450643776824
"E02001857",915,632,3036,113,519,802,5777,0.158386705902718,0.109399342219145,0.525532283191968,0.0195603254284231,0.0898390167907218,0.138826380474295
"E02001858",532,749,1281,87,662,445,3680,0.144565217391304,0.203532608695652,0.348097826086956,0.0236413043478261,0.179891304347826,0.120923913043478
"E02001859",483,373,1994,81,292,402,3937,0.122682245364491,0.094742189484379,0.506477012954026,0.0205740411480823,0.0741681483362967,0.102108204216408
"E02001860",590,239,2416,56,183,534,3078,0.191682910981157,0.0776478232618583,0.784925276153346,0.0181936322287199,0.0594541910331384,0.173489278752437
"E02001861",776,451,2475,90,361,686,4128,0.187984496124031,0.109253875968992,0.599563953488372,0.0218023255813953,0.0874515503875969,0.166182170542636
"E02001862",572,414,2126,81,333,491,3641,0.157099697885196,0.113705026091733,0.583905520461412,0.0222466355396869,0.0914583905520461,0.134853062345509
"E02001863",513,386,1285,116,270,397,2708,0.18943870014771,0.142540620384047,0.474519940915805,0.0428360413589365,0.0997045790251108,0.146602658788774
"E02001865",955,303,2985,85,218,870,3774,0.253047164811871,0.0802861685214626,0.79093799682035,0.0225225225225225,0.0577636459989401,0.230524642289348
"E02001866",629,290,2087,80,210,549,3469,0.181320265206111,0.0835975785528971,0.601614298068608,0.0230614009801095,0.0605361775727876,0.158258864226002
"E02001867",374,361,621,84,277,290,3002,0.124583610926049,0.120253164556962,0.206862091938708,0.027981345769487,0.092271818787475,0.0966022651565623
"E02001868",479,582,1196,175,407,304,2159,0.221861973135711,0.269569245020843,0.553960166743863,0.0810560444650301,0.188513200555813,0.140805928670681
"E02001869",247,323,307,81,242,166,2555,0.0966731898238748,0.126418786692759,0.120156555772994,0.0317025440313112,0.0947162426614481,0.0649706457925636
"E02001870",551,503,1823,129,374,422,3261,0.168966574670347,0.154247163446795,0.55903097209445,0.0395584176632935,0.114688745783502,0.129408157007053
"E02001871",487,549,444,137,412,350,3338,0.145895745955662,0.164469742360695,0.13301378070701,0.0410425404433793,0.123427201917316,0.104853205512283
"E02001872",479,404,253,126,278,353,2707,0.176948651643886,0.14924270410048,0.0934613963797562,0.0465459918729221,0.102696712227558,0.130402659770964
"E02001873",683,504,2279,93,411,590,4862,0.140477169888935,0.103661044837515,0.468737145207733,0.0191279308926368,0.0845331139448787,0.121349238996298
"E02001874",405,379,1490,74,305,331,2823,0.14346439957492,0.134254339355296,0.527807297201559,0.0262132483173928,0.108041091037903,0.117251151257527
"E02001875",304,395,567,80,315,224,5217,0.0582710369944412,0.0757140118842246,0.108683151236343,0.0153344834195898,0.0603795284646348,0.0429365535748514
"E02001876",174,274,275,36,238,138,6971,0.0249605508535361,0.039305695022235,0.039449146463922,0.0051642519007316,0.0341414431215034,0.0197962989528045
"E02001877",444,302,1961,68,234,376,2996,0.148197596795728,0.100801068090788,0.654539385847797,0.0226969292389853,0.0781041388518024,0.125500667556742
"E02001878",412,406,1115,68,338,344,2965,0.138954468802698,0.136930860033727,0.376053962900506,0.0229342327150084,0.113996627318718,0.11602023608769
"E02001879",701,305,2208,90,215,611,4317,0.162381283298587,0.0706509149872597,0.511466296038916,0.0208478109798471,0.0498031040074126,0.14153347231874
"E02001880",448,688,230,179,509,269,2825,0.15858407079646,0.24353982300885,0.0814159292035398,0.0633628318584071,0.180176991150442,0.0952212389380531
"E02001881",441,240,1633,66,174,375,2548,0.173076923076923,0.0941915227629513,0.640894819466248,0.0259026687598116,0.0682888540031397,0.147174254317111
"E02001882",510,494,1048,124,370,386,2915,0.174957118353345,0.169468267581475,0.359519725557461,0.0425385934819897,0.126929674099485,0.132418524871355
"E02001883",560,615,163,193,422,367,3583,0.156293608707787,0.17164387384873,0.0454926039631594,0.0538654758582194,0.117778397990511,0.102428132849567
"E02001884",423,260,1611,64,196,359,2355,0.179617834394904,0.110403397027601,0.684076433121019,0.0271762208067941,0.0832271762208068,0.15244161358811
"E02001886",624,240,2153,63,177,561,3632,0.171806167400881,0.066079295154185,0.592786343612335,0.0173458149779736,0.0487334801762115,0.154460352422907
"E02001888",302,414,249,118,296,184,2205,0.136961451247166,0.187755102040816,0.112925170068027,0.0535147392290249,0.134240362811791,0.0834467120181406
"E02001889",426,229,1675,58,171,368,2144,0.198694029850746,0.106809701492537,0.78125,0.0270522388059701,0.0797574626865672,0.171641791044776
"E02001890",684,985,2289,112,873,572,5568,0.122844827586207,0.176903735632184,0.411099137931034,0.0201149425287356,0.156788793103448,0.102729885057471
"E02001892",570,320,1878,74,246,496,3208,0.177680798004988,0.0997506234413965,0.585411471321696,0.0230673316708229,0.0766832917705736,0.154613466334165
"E02001893",523,482,1413,130,352,393,2590,0.201930501930502,0.186100386100386,0.545559845559846,0.0501930501930502,0.135907335907336,0.151737451737452
"E02001895",422,505,448,130,375,292,3086,0.136746597537265,0.163642255346727,0.145171743357097,0.0421257290991575,0.12151652624757,0.0946208684381076
"E02001896",596,292,1948,64,228,532,2507,0.237734343837256,0.116473873155166,0.777024331870762,0.0255285201435979,0.0909453530115676,0.212205823693658
"E02001897",393,513,579,113,400,280,3891,0.101002313030069,0.131842713955281,0.148804934464148,0.029041377537908,0.102801336417373,0.0719609354921614
"E02001898",380,258,1232,64,194,316,1891,0.200951877313591,0.136435748281333,0.651507139079852,0.0338445267054469,0.102591221575886,0.167107350608144
"E02001899",497,662,1229,169,493,328,3071,0.161836535330511,0.215564962552914,0.400195376098991,0.0550309345490068,0.160534028003908,0.106805600781504
"E02001900",323,529,689,77,452,246,2890,0.111764705882353,0.183044982698962,0.23840830449827,0.026643598615917,0.156401384083045,0.085121107266436
"E02001901",665,486,2270,82,404,583,4114,0.16164316966456,0.118133203694701,0.551774428779776,0.019931939718036,0.0982012639766651,0.141711229946524
"E02001902",300,205,1325,28,177,272,2024,0.148221343873518,0.101284584980237,0.654644268774704,0.0138339920948617,0.0874505928853755,0.134387351778656
"E02001903",423,249,1301,50,199,373,2103,0.20114122681883,0.118402282453638,0.618640038040894,0.0237755587256301,0.0946267237280076,0.1773656680932
"E02001904",540,311,1803,73,238,467,2804,0.192582025677603,0.110912981455064,0.643009985734665,0.0260342368045649,0.0848787446504993,0.166547788873039
"E02001905",311,703,663,85,618,226,3280,0.0948170731707317,0.214329268292683,0.202134146341463,0.0259146341463415,0.188414634146341,0.0689024390243902
"E02001906",556,616,1085,188,428,368,2885,0.192720970537262,0.213518197573657,0.376083188908146,0.0651646447140381,0.148353552859619,0.127556325823224
"E02001907",586,679,1518,180,499,406,3799,0.154251118715451,0.178731245064491,0.399578836535931,0.0473808897078178,0.131350355356673,0.106870229007634
"E02001908",471,174,1748,40,134,431,2097,0.224606580829757,0.0829756795422032,0.833571769194087,0.0190748688602766,0.0639008106819266,0.20553171196948
"E02001909",545,294,1613,72,222,473,2643,0.206205069996216,0.111237230419977,0.610291335603481,0.0272417707150965,0.0839954597048808,0.17896329928112
"E02001910",526,349,1169,88,261,438,2970,0.177104377104377,0.117508417508418,0.393602693602694,0.0296296296296296,0.0878787878787879,0.147474747474747
"E02001911",439,692,514,148,544,291,3184,0.137876884422111,0.217336683417085,0.16143216080402,0.0464824120603015,0.170854271356784,0.091394472361809
"E02001913",518,653,1041,162,491,356,3364,0.153983353151011,0.194114149821641,0.309453032104637,0.0481569560047562,0.145957193816885,0.105826397146254
"E02001914",502,266,1238,74,192,428,2285,0.219693654266958,0.116411378555799,0.541794310722101,0.0323851203501094,0.0840262582056893,0.187308533916849
"E02001915",802,678,2023,155,523,647,4584,0.174956369982548,0.147905759162304,0.441317626527051,0.0338132635253054,0.114092495636998,0.141143106457243
"E02001916",441,271,1880,71,200,370,3196,0.137984981226533,0.084793491864831,0.588235294117647,0.0222152690863579,0.0625782227784731,0.115769712140175
"E02001918",769,565,2272,92,473,677,4711,0.163234981957122,0.119932073869667,0.482275525366164,0.019528762470813,0.100403311398854,0.143706219486309
"E02001919",432,491,1331,85,406,347,2658,0.162528216704289,0.184725357411588,0.500752445447705,0.0319789315274643,0.152746425884123,0.130549285176825
"E02001920",511,502,106,172,330,339,2491,0.205138498594942,0.201525491770373,0.0425531914893617,0.0690485748695303,0.132476916900843,0.136089923725411
"E02001921",511,703,553,195,508,316,2682,0.190529455630127,0.262117822520507,0.206189410887397,0.0727069351230425,0.189410887397465,0.117822520507084
"E02001922",727,301,2877,72,229,655,4639,0.156714809226126,0.0648846734209959,0.62017676223324,0.0155205863332615,0.0493640870877344,0.141194222892865
"E02001923",574,449,1843,107,342,467,3105,0.184863123993559,0.144605475040258,0.593558776167472,0.0344605475040258,0.110144927536232,0.150402576489533
"E02001924",361,213,1333,49,164,312,2139,0.168770453482936,0.0995792426367461,0.623188405797101,0.0229079008882655,0.0766713417484806,0.14586255259467
"E02001925",441,645,1016,145,500,296,2643,0.166855845629966,0.244040862656073,0.384411653424139,0.0548618993567915,0.189178963299281,0.111993946273174
"E02001926",499,259,1766,70,189,429,2993,0.166722352155028,0.086535248914133,0.590043434680922,0.0233879051119278,0.0631473438022051,0.143334447043101
"E02001927",452,565,319,163,402,289,2593,0.174315464712688,0.21789433089086,0.123023524874663,0.0628615503278056,0.155032780563054,0.111453914384882
"E02001928",506,618,159,176,442,330,2492,0.203049759229534,0.247993579454254,0.0638041733547351,0.0706260032102729,0.177367576243981,0.132423756019262
"E02001929",492,391,2135,92,299,400,3028,0.162483487450462,0.129128137384412,0.705085865257596,0.0303830911492734,0.0987450462351387,0.132100396301189
"E02001930",638,222,2086,55,167,583,2825,0.225840707964602,0.0785840707964602,0.738407079646018,0.0194690265486726,0.0591150442477876,0.206371681415929
"E02001931",449,544,999,146,398,303,2591,0.173292165187186,0.209957545349286,0.385565418757237,0.0563489000385951,0.153608645310691,0.116943265148591
"E02001932",451,428,111,133,295,318,2961,0.152313407632557,0.144545761567038,0.0374873353596758,0.0449172576832151,0.099628503883823,0.107396149949341
"E02001933",438,292,1427,72,220,366,2568,0.170560747663551,0.113707165109034,0.555685358255452,0.0280373831775701,0.0856697819314642,0.142523364485981
"E02001934",337,301,1081,69,232,268,1682,0.200356718192628,0.178953626634958,0.64268727705113,0.0410225921521998,0.137931034482759,0.159334126040428
"E02001935",425,503,256,165,338,260,2556,0.166275430359937,0.19679186228482,0.100156494522692,0.0645539906103286,0.132237871674491,0.101721439749609
"E02001936",353,356,776,101,255,252,1827,0.193212917350848,0.194854953475643,0.424740010946907,0.0552818828680898,0.139573070607553,0.137931034482759
"E02001937",449,456,857,127,329,322,2737,0.164048227986847,0.16660577274388,0.313116550968213,0.0464011691633175,0.120204603580563,0.117647058823529
"E02001938",530,196,2133,40,156,490,3328,0.159254807692308,0.0588942307692308,0.640925480769231,0.0120192307692308,0.046875,0.147235576923077
"E02001939",227,810,337,74,736,153,3059,0.0742072572736188,0.264792415822164,0.110166721150703,0.0241909120627656,0.240601503759398,0.0500163452108532
"E02001941",356,384,660,91,293,265,2111,0.168640454760777,0.181904310753198,0.312648034107058,0.0431075319753671,0.13879677877783,0.12553292278541
"E02001942",437,433,930,88,345,349,2801,0.156015708675473,0.154587647268833,0.332024277043913,0.0314173509460907,0.123170296322742,0.124598357729382
"E02001943",376,386,648,104,282,272,2079,0.180856180856181,0.185666185666186,0.311688311688312,0.05002405002405,0.135642135642136,0.130832130832131
"E02001944",424,527,661,126,401,298,2816,0.150568181818182,0.187144886363636,0.234730113636364,0.0447443181818182,0.142400568181818,0.105823863636364
"E02001945",376,283,1432,66,217,310,2666,0.141035258814704,0.106151537884471,0.537134283570893,0.0247561890472618,0.0813953488372093,0.116279069767442
"E02001946",427,535,778,129,406,298,2441,0.174928308070463,0.219172470299058,0.318721835313396,0.0528471937730438,0.166325276526014,0.122081114297419
"E02001947",471,414,173,132,282,339,2407,0.195679268799335,0.171998338180307,0.0718737017033652,0.0548400498545908,0.117158288325717,0.140839218944744
"E02001948",440,405,1151,125,280,315,2293,0.191888355865678,0.176624509376363,0.501962494548626,0.0545137374618404,0.122110771914522,0.137374618403838
"E02001949",322,480,402,110,370,212,2435,0.13223819301848,0.197125256673511,0.165092402464066,0.0451745379876797,0.151950718685832,0.0870636550308008
"E02001950",438,480,1116,118,362,320,3038,0.144173798551679,0.157998683344305,0.36734693877551,0.0388413429888084,0.119157340355497,0.10533245556287
"E02001951",553,444,15,129,315,424,3328,0.166165865384615,0.133413461538462,0.00450721153846154,0.0387620192307692,0.0946514423076923,0.127403846153846
"E02001952",430,587,288,143,444,287,3672,0.117102396514161,0.159858387799564,0.0784313725490196,0.0389433551198257,0.120915032679739,0.0781590413943355
"E02001953",418,604,498,184,420,234,2199,0.190086402910414,0.274670304683947,0.226466575716235,0.0836743974533879,0.190995907230559,0.106412005457026
"E02001954",471,407,67,103,304,368,2751,0.171210468920393,0.147946201381316,0.0243547800799709,0.0374409305707016,0.110505270810614,0.133769538349691
"E02001955",364,390,500,89,301,275,3547,0.102621934028757,0.109952072173668,0.140964195094446,0.0250916267268114,0.0848604454468565,0.0775303073019453
"E02001956",385,384,336,109,275,276,2257,0.170580416482056,0.170137350465219,0.148870181657067,0.0482941958351794,0.12184315463004,0.122286220646876
"E02001957",353,505,801,110,395,243,2282,0.154688869412796,0.221297107800175,0.351007887817704,0.0482033304119194,0.173093777388256,0.106485539000876
"E02001958",577,546,878,138,408,439,3188,0.18099121706399,0.171267252195734,0.275407779171895,0.0432873274780427,0.127979924717691,0.137703889585947
"E02001959",330,288,690,88,200,242,2545,0.129666011787819,0.113163064833006,0.271119842829077,0.0345776031434185,0.0785854616895874,0.0950884086444008
"E02001961",372,397,857,85,312,287,3145,0.118282988871224,0.126232114467409,0.272496025437202,0.027027027027027,0.0992050874403816,0.0912559618441971
"E02001962",358,295,1158,61,234,297,2517,0.142232816845451,0.11720301946762,0.460071513706794,0.0242352006356774,0.0929678188319428,0.117997616209774
"E02001963",357,436,673,98,338,259,1845,0.19349593495935,0.236314363143631,0.364769647696477,0.0531165311653117,0.18319783197832,0.140379403794038
"E02001964",343,203,197,31,172,312,4508,0.0760869565217391,0.0450310559006211,0.0437000887311446,0.00687666370896185,0.0381543921916593,0.0692102928127773
"E02001965",514,555,130,159,396,355,2927,0.175606422958661,0.189613939186881,0.0444140758455757,0.0543218312265118,0.135292107960369,0.121284591732149
"E02001966",368,225,1449,48,177,320,2453,0.15002038320424,0.0917244190786792,0.590705258866694,0.0195678760701182,0.0721565430085609,0.130452507134121
"E02001967",345,351,513,101,250,244,2270,0.151982378854626,0.154625550660793,0.225991189427313,0.0444933920704846,0.110132158590308,0.107488986784141
"E02001968",371,219,1490,44,175,327,2790,0.132974910394265,0.078494623655914,0.53405017921147,0.0157706093189964,0.0627240143369176,0.117204301075269
"E02001969",363,283,1500,59,224,304,2484,0.146135265700483,0.113929146537842,0.603864734299517,0.0237520128824477,0.0901771336553945,0.122383252818035
"E02001970",348,538,399,119,419,229,2146,0.162162162162162,0.250698974836906,0.185927306616962,0.0554520037278658,0.19524697110904,0.106710158434296
"E02001971",325,177,1242,39,138,286,1794,0.181159420289855,0.0986622073578595,0.692307692307692,0.0217391304347826,0.0769230769230769,0.159420289855072
"E02001972",599,404,2433,77,327,522,5138,0.11658232775399,0.0786298170494356,0.473530556636824,0.0149863760217984,0.0636434410276372,0.101595951732192
"E02001973",467,322,1721,73,249,394,3464,0.134815242494226,0.0929561200923787,0.496824480369515,0.0210739030023095,0.0718822170900693,0.113741339491917
"E02001974",582,447,1557,125,322,457,2909,0.200068752148505,0.153661051907872,0.535235476108628,0.0429700928154005,0.110690959092472,0.157098659333104
"E02001975",430,291,1517,77,214,353,2159,0.199166280685503,0.134784622510422,0.702640111162575,0.0356646595646132,0.0991199629458082,0.163501621120889
"E02001976",453,471,416,138,333,315,2749,0.164787195343761,0.171335030920335,0.151327755547472,0.0502000727537286,0.121134958166606,0.114587122590033
"E02001977",579,244,2222,56,188,523,4721,0.122643507731413,0.0516839652615971,0.470662995128151,0.0118618936665961,0.0398220715950011,0.110781614064817
"E02001978",387,205,1508,51,154,336,1986,0.194864048338369,0.103222557905337,0.759315206445116,0.0256797583081571,0.0775427995971803,0.169184290030211
"E02001979",377,431,430,132,299,245,1661,0.226971703792896,0.25948223961469,0.258880192655027,0.0794701986754967,0.180012040939193,0.147501505117399
"E02001980",379,388,52,123,265,256,1656,0.228864734299517,0.234299516908213,0.0314009661835749,0.0742753623188406,0.160024154589372,0.154589371980676
"E02001981",663,340,2471,77,263,586,5376,0.123325892857143,0.0632440476190476,0.459635416666667,0.0143229166666667,0.048921130952381,0.109002976190476
"E02001982",312,473,158,127,346,185,3383,0.0922258350576411,0.139816730712385,0.0467041087791901,0.0375406443984629,0.102276086313923,0.0546851906591782
"E02001983",453,410,1288,71,339,382,2628,0.172374429223744,0.156012176560122,0.490106544901065,0.0270167427701674,0.128995433789954,0.145357686453577
"E02001984",581,227,2180,63,164,518,3452,0.168308227114716,0.0657589803012746,0.631517960602549,0.0182502896871379,0.0475086906141367,0.150057937427578
"E02001985",586,161,2877,35,126,551,4304,0.136152416356877,0.037407063197026,0.668447955390335,0.00813197026022305,0.029275092936803,0.128020446096654
"E02001986",540,285,210,93,192,447,3523,0.153278455861482,0.080896962815782,0.0596082883905762,0.0263979562872552,0.0544990065285268,0.126880499574227
"E02001987",478,116,2236,27,89,451,3144,0.152035623409669,0.0368956743002544,0.711195928753181,0.00858778625954199,0.0283078880407125,0.143447837150127
"E02001988",359,359,1223,59,300,300,5922,0.0606214116852415,0.0606214116852415,0.206518068220196,0.0099628503883823,0.0506585612968592,0.0506585612968592
"E02001989",322,243,1192,69,174,253,2107,0.152823920265781,0.115329852871381,0.565733270052207,0.0327479829140959,0.0825818699572852,0.120075937351685
"E02001990",554,554,231,208,346,346,2544,0.217767295597484,0.217767295597484,0.0908018867924528,0.0817610062893082,0.136006289308176,0.136006289308176
"E02001991",594,372,1856,78,294,516,3143,0.188991409481387,0.118358256442889,0.590518612790328,0.0248170537702832,0.0935412026726058,0.164174355711104
"E02001992",578,502,516,139,363,439,4125,0.140121212121212,0.12169696969697,0.125090909090909,0.0336969696969697,0.088,0.106424242424242
"E02001993",330,312,495,75,237,255,3592,0.0918708240534521,0.0868596881959911,0.137806236080178,0.0208797327394209,0.0659799554565701,0.0709910913140312
"E02001994",495,631,1161,157,474,338,2806,0.176407697790449,0.224875267284391,0.41375623663578,0.0559515324305061,0.168923734853885,0.120456165359943
"E02001995",512,633,1217,150,483,362,4474,0.114438980777827,0.141484130531962,0.272016092981672,0.0335270451497541,0.107957085382208,0.0809119356280733
"E02001996",396,563,118,97,466,299,3700,0.107027027027027,0.152162162162162,0.0318918918918919,0.0262162162162162,0.125945945945946,0.0808108108108108
"E02001997",544,548,347,171,377,373,2347,0.231785257775884,0.233489561141883,0.147848317000426,0.0728589688964636,0.16063059224542,0.158926288879421
"E02001998",352,270,703,92,178,260,1532,0.22976501305483,0.176240208877285,0.4588772845953,0.0600522193211488,0.116187989556136,0.169712793733681
"E02001999",347,289,458,86,203,261,1968,0.176321138211382,0.146849593495935,0.232723577235772,0.0436991869918699,0.103150406504065,0.132621951219512
"E02002000",448,393,487,102,291,346,3437,0.130346232179226,0.114343904567937,0.141693337212685,0.0296770439336631,0.0846668606342741,0.100669188245563
"E02002001",317,348,548,89,259,228,2317,0.136814846784635,0.150194216659473,0.23651273198101,0.0384117393180837,0.11178247734139,0.0984031074665516
"E02002002",350,529,167,172,357,178,1896,0.184599156118143,0.279008438818565,0.0880801687763713,0.0907172995780591,0.188291139240506,0.0938818565400844
"E02002003",488,486,431,139,347,349,2992,0.163101604278075,0.162433155080214,0.144050802139037,0.0464572192513369,0.115975935828877,0.116644385026738
"E02002004",460,358,405,94,264,366,2787,0.165052027269465,0.128453534266236,0.145317545748116,0.0337280229637603,0.0947255113024758,0.131324004305705
"E02002005",438,324,578,90,234,348,3797,0.115354227021333,0.0853305240979721,0.15222544113774,0.0237029233605478,0.0616276007374243,0.0916513036607848
"E02002006",394,323,329,79,244,315,2777,0.141879726323371,0.116312567518905,0.118473172488297,0.0284479654303205,0.0878646020885848,0.11343176089305
"E02002007",545,497,338,173,324,372,3031,0.179808644011877,0.163972286374134,0.111514351699109,0.0570768723193665,0.106895414054767,0.122731771692511
"E02002008",334,218,320,63,155,271,2027,0.164775530340405,0.107548100641342,0.157868771583621,0.0310804144055254,0.0764676862358165,0.133695115934879
"E02002009",355,366,600,71,295,284,2866,0.123866015352408,0.127704117236567,0.209351011863224,0.0247732030704815,0.102930914166085,0.099092812281926
"E02002010",391,438,1097,75,363,316,3965,0.0986128625472888,0.11046658259773,0.276670870113493,0.0189155107187894,0.0915510718789407,0.0796973518284994
"E02002011",317,396,194,148,248,169,1916,0.16544885177453,0.206680584551148,0.10125260960334,0.0772442588726514,0.129436325678497,0.0882045929018789
"E02002012",491,502,928,83,419,408,3992,0.122995991983968,0.125751503006012,0.232464929859719,0.0207915831663327,0.104959919839679,0.102204408817635
"E02002013",358,330,316,120,210,238,1827,0.195949644225506,0.180623973727422,0.17296113847838,0.0656814449917898,0.114942528735632,0.130268199233716
"E02002014",470,398,812,106,292,364,3147,0.149348585954878,0.126469653638386,0.258023514458214,0.0336828725770575,0.0927867810613282,0.11566571337782
"E02002015",377,279,224,86,193,291,2250,0.167555555555556,0.124,0.0995555555555555,0.0382222222222222,0.0857777777777778,0.129333333333333
"E02002016",521,449,1095,91,358,430,3652,0.142661555312158,0.122946330777656,0.299835706462212,0.0249178532311062,0.0980284775465498,0.117743702081051
"E02002017",487,491,901,135,356,352,3385,0.143870014771049,0.145051698670606,0.266174298375185,0.0398818316100443,0.105169867060561,0.103988183161004
"E02002018",482,530,309,163,367,319,2388,0.201842546063652,0.221943048576214,0.129396984924623,0.0682579564489112,0.153685092127303,0.13358458961474
"E02002019",458,456,685,140,316,318,2706,0.169253510716925,0.168514412416851,0.253141167775314,0.0517368810051737,0.116777531411678,0.117516629711752
"E02002020",524,572,297,197,375,327,3261,0.160686905857099,0.17540631708065,0.0910763569457222,0.0604109168966575,0.114995400183993,0.100275988960442
"E02002021",418,421,1089,70,351,348,4492,0.0930543187889581,0.0937221727515583,0.242430988423865,0.0155832591273375,0.0781389136242208,0.0774710596616207
"E02002022",446,326,729,86,240,360,3358,0.132817153067302,0.0970815961882073,0.2170935080405,0.0256104824300179,0.0714711137581894,0.107206670637284
"E02002023",294,350,290,119,231,175,1644,0.178832116788321,0.212895377128954,0.17639902676399,0.0723844282238443,0.140510948905109,0.106447688564477
"E02002024",449,404,953,117,287,332,3026,0.148380700594845,0.133509583608724,0.314937210839392,0.0386649041639128,0.0948446794448116,0.109715796430932
"E02002025",488,560,1073,148,412,340,3160,0.154430379746835,0.177215189873418,0.339556962025316,0.0468354430379747,0.130379746835443,0.107594936708861
"E02002026",369,364,365,130,234,239,1737,0.212435233160622,0.209556706966033,0.210132412204951,0.0748416810592976,0.134715025906736,0.137593552101324
"E02002027",334,230,8,94,136,240,1350,0.247407407407407,0.17037037037037,0.00592592592592593,0.0696296296296296,0.100740740740741,0.177777777777778
"E02002028",368,307,578,90,217,278,2171,0.16950713956702,0.141409488714878,0.266236757254721,0.0414555504375864,0.0999539382772916,0.128051589129433
"E02002029",320,503,578,107,396,213,1818,0.176017601760176,0.276677667766777,0.317931793179318,0.0588558855885589,0.217821782178218,0.117161716171617
"E02002030",363,391,286,110,281,253,2844,0.127637130801688,0.137482419127989,0.10056258790436,0.0386779184247539,0.0988045007032349,0.0889592123769339
"E02002031",381,476,550,140,336,241,2200,0.173181818181818,0.216363636363636,0.25,0.0636363636363636,0.152727272727273,0.109545454545455
"E02002032",520,618,805,133,485,387,4064,0.127952755905512,0.152066929133858,0.198080708661417,0.0327263779527559,0.119340551181102,0.0952263779527559
"E02002033",452,425,541,145,280,307,2486,0.181818181818182,0.170957361222848,0.217618664521319,0.0583266291230893,0.112630732099759,0.123491552695093
"E02002034",498,467,1153,119,348,379,3922,0.12697603263641,0.11907190209077,0.29398266190719,0.0303416624171341,0.0887302396736359,0.0966343702192759
"E02002035",364,549,287,163,386,201,1665,0.218618618618619,0.32972972972973,0.172372372372372,0.0978978978978979,0.231831831831832,0.120720720720721
"E02002036",435,446,552,113,333,322,2981,0.145924186514592,0.149614223414961,0.185172760818517,0.0379067427037907,0.111707480711171,0.108017443810802
"E02002037",344,386,356,112,274,232,1917,0.179447052686489,0.201356285863328,0.185706833594158,0.0584246218049035,0.142931664058425,0.121022430881586
"E02002038",506,741,831,187,554,319,4043,0.125154588177096,0.183279742765273,0.205540440267128,0.0462527825871877,0.137026960178086,0.0789018055899085
"E02002039",370,510,434,147,363,223,2139,0.172978027115475,0.238429172510519,0.202898550724638,0.0687237026647966,0.169705469845722,0.104254324450678
"E02002040",355,308,340,94,214,261,1717,0.206755969714619,0.179382644146768,0.198019801980198,0.0547466511357018,0.124635993011066,0.152009318578917
"E02002041",440,407,113,131,276,309,1934,0.227507755946225,0.210444674250259,0.0584281282316443,0.0677352637021717,0.142709410548087,0.159772492244054
"E02002042",443,677,163,208,469,235,2362,0.187552921253175,0.28662150719729,0.0690093141405588,0.0880609652836579,0.198560541913633,0.0994919559695174
"E02002043",400,474,1020,115,359,285,2503,0.159808230123851,0.189372752696764,0.407510986815821,0.0459448661606073,0.143427886536157,0.113863363963244
"E02002044",397,331,50,72,259,325,2350,0.168936170212766,0.140851063829787,0.0212765957446809,0.0306382978723404,0.110212765957447,0.138297872340426
"E02002045",363,503,729,89,414,274,2603,0.139454475605071,0.193238570879754,0.280061467537457,0.0341913177103342,0.15904725316942,0.105263157894737
"E02002046",223,455,140,94,361,129,1466,0.152114597544338,0.310368349249659,0.0954979536152797,0.0641200545702592,0.2462482946794,0.0879945429740791
"E02002047",361,439,774,96,343,265,2691,0.134150873281308,0.163136380527685,0.287625418060201,0.0356744704570792,0.127461910070606,0.0984764028242289
"E02002048",349,583,429,152,431,197,1931,0.180735370274469,0.301916105644744,0.22216468151217,0.0787156913516313,0.223200414293112,0.102019678922838
"E02002049",251,352,202,75,277,176,1724,0.145591647331787,0.204176334106729,0.117169373549884,0.0435034802784223,0.160672853828306,0.102088167053364
"E02002051",180,301,663,44,257,136,1895,0.0949868073878628,0.158839050131926,0.349868073878628,0.0232189973614776,0.135620052770449,0.0717678100263852
"E02002052",453,534,461,126,408,327,3710,0.122102425876011,0.143935309973046,0.124258760107817,0.0339622641509434,0.109973045822102,0.0881401617250674
"E02002053",281,370,792,80,290,201,2017,0.139315815567675,0.183440753594447,0.392662369856222,0.0396628656420426,0.143777887952405,0.0996529499256321
"E02002054",303,460,220,134,326,169,1631,0.185775597792765,0.282035561005518,0.134886572654813,0.082158185162477,0.199877375843041,0.103617412630288
"E02002055",341,645,326,108,537,233,3587,0.0950655143574017,0.179816002230276,0.0908837468636744,0.0301087259548369,0.149707276275439,0.0649567884025648
"E02002056",374,553,466,96,457,278,3518,0.106310403638431,0.157191586128482,0.13246162592382,0.0272882319499716,0.129903354178511,0.0790221716884593
"E02002057",532,511,763,131,380,401,3512,0.151480637813212,0.145501138952164,0.217255125284738,0.0373006833712984,0.108200455580866,0.114179954441913
"E02002058",510,631,423,120,511,390,4192,0.121660305343511,0.150524809160305,0.100906488549618,0.0286259541984733,0.121898854961832,0.0930343511450382
"E02002059",590,858,964,175,683,415,3894,0.151515151515152,0.220338983050847,0.247560349255265,0.0449409347714432,0.175398048279404,0.106574216743708
"E02002060",335,484,467,106,378,229,2371,0.141290594685787,0.204133277098271,0.196963306621679,0.0447068747363981,0.159426402361873,0.0965837199493884
"E02002061",334,370,742,81,289,253,2440,0.136885245901639,0.151639344262295,0.304098360655738,0.0331967213114754,0.11844262295082,0.103688524590164
"E02002062",322,524,967,71,453,251,3649,0.0882433543436558,0.143600986571663,0.265004110715264,0.0194573855850918,0.124143600986572,0.068785968758564
"E02002063",570,858,573,222,636,348,3627,0.157154673283706,0.236559139784946,0.157981803143093,0.0612076095947064,0.17535153019024,0.0959470636889992
"E02002064",567,1164,587,219,945,348,3936,0.14405487804878,0.295731707317073,0.149136178861789,0.055640243902439,0.240091463414634,0.0884146341463415
"E02002065",588,536,1751,96,440,492,4047,0.14529280948851,0.132443785520138,0.432666172473437,0.0237212750185322,0.108722510501606,0.121571534469978
"E02002066",365,560,1090,103,457,262,2897,0.125992405937176,0.193303417328271,0.376251294442527,0.0355540214014498,0.157749395926821,0.0904383845357266
"E02002067",332,335,99,107,228,225,1946,0.170606372045221,0.172147995889003,0.0508735868448099,0.0549845837615622,0.117163412127441,0.115621788283659
"E02002069",315,559,326,94,465,221,2682,0.11744966442953,0.208426547352722,0.121551081282625,0.035048471290082,0.17337807606264,0.0824011931394482
"E02002070",542,483,2090,78,405,464,3594,0.150806900389538,0.134390651085142,0.581524763494713,0.0217028380634391,0.112687813021703,0.129104062326099
"E02002071",280,441,288,109,332,171,2007,0.139511709018435,0.219730941704036,0.143497757847534,0.0543099152964624,0.165421026407574,0.0852017937219731
"E02002072",463,805,971,152,653,311,3171,0.146010722169663,0.253863134657837,0.306212551245664,0.0479344055502996,0.205928729107537,0.098076316619363
"E02002073",416,554,1509,92,462,324,2584,0.160990712074303,0.214396284829721,0.583978328173375,0.0356037151702786,0.178792569659443,0.125386996904025
"E02002074",427,871,767,162,709,265,2586,0.165119876256767,0.336813611755607,0.296597061098221,0.0626450116009281,0.274168600154679,0.102474864655839
"E02002075",427,724,1048,118,606,309,3134,0.136247606892151,0.231014677728143,0.334396936821953,0.0376515634971283,0.193363114231015,0.0985960433950223
"E02002076",778,317,3566,49,268,729,4419,0.176057931658746,0.0717356868069699,0.806969902692917,0.0110884815569133,0.0606472052500566,0.164969450101833
"E02002077",560,863,786,156,707,404,4077,0.137355898945303,0.211675251410351,0.192788815305372,0.0382634289919058,0.173411822418445,0.0990924699533971
"E02002078",329,407,914,107,300,222,1724,0.190835266821346,0.236078886310905,0.530162412993039,0.0620649651972158,0.174013921113689,0.12877030162413
"E02002079",438,656,673,156,500,282,2959,0.148022980736735,0.221696519094289,0.227441703278135,0.0527205136870564,0.168976005407232,0.0953024670496789
"E02002080",382,530,606,105,425,277,2820,0.135460992907801,0.187943262411348,0.214893617021277,0.0372340425531915,0.150709219858156,0.0982269503546099
"E02002081",377,574,197,148,426,229,1932,0.195134575569358,0.297101449275362,0.101966873706004,0.0766045548654244,0.220496894409938,0.118530020703934
"E02002082",291,621,32,127,494,164,1980,0.146969696969697,0.313636363636364,0.0161616161616162,0.0641414141414141,0.249494949494949,0.0828282828282828
"E02002083",299,393,732,107,286,192,1600,0.186875,0.245625,0.4575,0.066875,0.17875,0.12
"E02002084",284,455,144,100,355,184,2465,0.115212981744422,0.184584178498986,0.0584178498985801,0.0405679513184584,0.144016227180527,0.0746450304259635
"E02002085",289,573,201,121,452,168,2281,0.126698816308637,0.251205611573871,0.0881192459447611,0.0530469092503288,0.198158702323542,0.0736519070583078
"E02002086",223,406,122,87,319,136,2287,0.0975076519457805,0.177525142107564,0.0533449934411893,0.0380411018801924,0.139484040227372,0.0594665500655881
"E02002087",336,613,80,138,475,198,2220,0.151351351351351,0.276126126126126,0.036036036036036,0.0621621621621622,0.213963963963964,0.0891891891891892
"E02002088",492,899,87,200,699,292,3605,0.136477115117892,0.249375866851595,0.0241331484049931,0.0554785020804438,0.193897364771151,0.080998613037448
"E02002089",502,604,408,183,421,319,2536,0.19794952681388,0.238170347003155,0.160883280757098,0.0721608832807571,0.166009463722397,0.125788643533123
"E02002090",335,404,1143,110,294,225,1771,0.189158667419537,0.228119706380576,0.645398080180689,0.062111801242236,0.16600790513834,0.127046866177301
"E02002091",471,595,662,182,413,289,2446,0.19255928045789,0.243254292722813,0.270645952575634,0.0744071954210957,0.168847097301717,0.118152085036795
"E02002092",398,520,621,121,399,277,2404,0.165557404326123,0.21630615640599,0.258319467554077,0.0503327787021631,0.165973377703827,0.11522462562396
"E02002093",413,516,608,147,369,266,2586,0.159706109822119,0.19953596287703,0.235112142304718,0.0568445475638051,0.142691415313225,0.102861562258314
"E02002094",304,431,484,104,327,200,1820,0.167032967032967,0.236813186813187,0.265934065934066,0.0571428571428571,0.17967032967033,0.10989010989011
"E02002095",547,700,229,221,479,326,2921,0.187264635398836,0.239643957548785,0.078397808969531,0.0756590208832592,0.163984936665525,0.111605614515577
"E02002096",511,831,831,187,644,324,3973,0.128618172665492,0.209161842436446,0.209161842436446,0.0470677070224012,0.162094135414045,0.0815504656430909
"E02002097",463,443,527,116,327,347,2462,0.188058489033306,0.179935012185215,0.214053614947197,0.0471161657189277,0.132818846466288,0.140942323314379
"E02002098",492,557,988,145,412,347,3088,0.159326424870466,0.180375647668394,0.319948186528497,0.0469559585492228,0.133419689119171,0.112370466321244
"E02002099",339,556,382,120,436,219,2652,0.127828054298643,0.209653092006033,0.144042232277526,0.0452488687782805,0.164404223227753,0.082579185520362
"E02002101",405,687,391,204,483,201,2353,0.172120696982575,0.29196770080748,0.166170845728857,0.0866978325541861,0.205269868253294,0.0854228644283893
"E02002102",469,777,670,197,580,272,3415,0.137335285505124,0.227525622254758,0.196193265007321,0.0576866764275256,0.169838945827233,0.0796486090775988
"E02002103",363,468,293,140,328,223,1746,0.207903780068729,0.268041237113402,0.167812142038946,0.0801832760595647,0.187857961053837,0.127720504009164
"E02002104",412,161,70,42,119,370,1638,0.251526251526252,0.0982905982905983,0.0427350427350427,0.0256410256410256,0.0726495726495727,0.225885225885226
"E02002105",445,430,363,136,294,309,2582,0.172347017815647,0.166537567776917,0.140588690937258,0.0526723470178156,0.113865220759101,0.119674670797831
"E02002106",596,749,498,207,542,389,3147,0.189386717508738,0.238004448681284,0.158245948522402,0.0657769304099142,0.17222751827137,0.123609787098824
"E02002107",426,98,24,36,62,390,1549,0.275016139444803,0.0632666236281472,0.0154938670109748,0.0232408005164622,0.040025823111685,0.251775338928341
"E02002108",652,541,365,157,384,495,3041,0.214403156856297,0.177902005919106,0.120026307135811,0.0516277540282802,0.126274251890825,0.162775402828017
"E02002109",434,482,327,137,345,297,5341,0.0812581913499345,0.090245272420895,0.0612244897959184,0.0256506272233664,0.0645946451975286,0.0556075641265681
"E02002110",389,328,232,104,224,285,2070,0.18792270531401,0.158454106280193,0.11207729468599,0.0502415458937198,0.108212560386473,0.13768115942029
"E02002111",318,393,234,105,288,213,2318,0.137187230371009,0.169542709232097,0.100949094046592,0.045297670405522,0.124245038826575,0.0918895599654875
"E02002112",289,345,146,96,249,193,1495,0.193311036789298,0.230769230769231,0.0976588628762542,0.0642140468227425,0.166555183946488,0.129096989966555
"E02002113",336,420,275,110,310,226,1999,0.168084042021011,0.210105052526263,0.137568784392196,0.0550275137568784,0.155077538769385,0.113056528264132
"E02002114",372,390,279,119,271,253,1884,0.197452229299363,0.207006369426752,0.148089171974522,0.0631634819532909,0.143842887473461,0.134288747346072
"E02002115",311,491,232,125,366,186,2150,0.144651162790698,0.228372093023256,0.107906976744186,0.0581395348837209,0.170232558139535,0.0865116279069767
"E02002116",419,462,197,146,316,273,1965,0.21323155216285,0.235114503816794,0.100254452926209,0.0743002544529262,0.160814249363868,0.138931297709924
"E02002117",353,316,157,72,244,281,2155,0.163805104408353,0.146635730858469,0.0728538283062645,0.0334106728538283,0.11322505800464,0.130394431554524
"E02002118",448,428,135,115,313,333,2724,0.164464023494861,0.15712187958884,0.0495594713656388,0.0422173274596182,0.114904552129222,0.122246696035242
"E02002119",352,452,182,144,308,208,1802,0.195338512763596,0.250832408435072,0.100998890122087,0.0799112097669256,0.170921198668147,0.11542730299667
"E02002120",294,306,41,100,206,194,1428,0.205882352941176,0.214285714285714,0.0287114845938375,0.0700280112044818,0.144257703081232,0.135854341736695
"E02002121",371,303,493,66,237,305,2421,0.153242461792648,0.125154894671623,0.203634861627427,0.0272614622057001,0.0978934324659232,0.125980999586948
"E02002122",243,484,155,92,392,151,2552,0.0952194357366771,0.189655172413793,0.0607366771159875,0.0360501567398119,0.153605015673981,0.0591692789968652
"E02002123",426,456,335,153,303,273,2138,0.199251637043966,0.213283442469598,0.156688493919551,0.0715622076707203,0.141721234798877,0.127689429373246
"E02002124",488,598,261,129,469,359,2799,0.174347981421936,0.213647731332619,0.0932475884244373,0.0460878885316184,0.167559842801,0.128260092890318
"E02002125",380,416,373,103,313,277,2171,0.175034546292031,0.191616766467066,0.171810225702441,0.0474435743896822,0.144173192077384,0.127590971902349
"E02002126",295,389,581,77,312,218,2713,0.10873571691854,0.143383708072245,0.214154072981939,0.0283818650939919,0.115001842978253,0.0803538518245485
"E02002127",483,579,553,150,429,333,3614,0.133646928610957,0.160210293303818,0.153016048699502,0.0415052573325955,0.118705035971223,0.0921416712783619
"E02002128",297,428,77,117,311,180,1728,0.171875,0.247685185185185,0.0445601851851852,0.0677083333333333,0.179976851851852,0.104166666666667
"E02002129",367,504,306,160,344,207,1763,0.208167895632445,0.285876347135564,0.17356778218945,0.0907543959160522,0.195121951219512,0.117413499716393
"E02002130",397,336,381,87,249,310,2663,0.149079984979347,0.126173488546752,0.143071723619977,0.0326699211415697,0.0935035674051821,0.116410063837777
"E02002131",449,499,410,149,350,300,2063,0.217644207464857,0.24188075618032,0.198739699466796,0.0722249151720795,0.16965584100824,0.145419292292778
"E02002132",297,399,96,85,314,212,2023,0.146811665842808,0.197231833910035,0.0474542758279783,0.0420168067226891,0.155215027187346,0.104794859120119
"E02002133",454,451,945,99,352,355,2986,0.15204286671132,0.151038178164769,0.316476892163429,0.0331547220361688,0.1178834561286,0.118888144675151
"E02002134",580,321,994,71,250,509,3368,0.172209026128266,0.0953087885985748,0.295130641330166,0.0210807600950119,0.0742280285035629,0.151128266033254
"E02002135",416,418,867,105,313,311,3258,0.12768569674647,0.128299570288521,0.266114180478821,0.0322283609576427,0.0960712093308778,0.0954573357888275
"E02002136",421,325,708,88,237,333,2788,0.151004304160689,0.116571018651363,0.253945480631277,0.0315638450502152,0.0850071736011478,0.119440459110473
"E02002137",378,546,304,150,396,228,1861,0.203116603976357,0.293390650188071,0.163353036002149,0.0806018269747448,0.212788823213326,0.122514777001612
"E02002138",347,391,906,87,304,260,1939,0.178958225889634,0.201650335224342,0.467251160391955,0.0448684889118102,0.156781846312532,0.134089736977824
"E02002139",521,595,1551,86,509,435,4971,0.104807885737276,0.11969422651378,0.312009656004828,0.0173003419835043,0.102393884530276,0.0875075437537719
"E02002140",500,473,950,126,347,374,2988,0.167336010709505,0.158299866131191,0.317938420348059,0.0421686746987952,0.116131191432396,0.12516733601071
"E02002141",362,466,129,161,305,201,1759,0.205798749289369,0.264923251847641,0.0733371233655486,0.091529277998863,0.173393973848778,0.114269471290506
"E02002142",418,301,868,89,212,329,2602,0.160645657186779,0.115680245964643,0.33358954650269,0.0342044581091468,0.0814757878554958,0.126441199077633
"E02002143",566,498,1467,125,373,441,3165,0.178830963665087,0.157345971563981,0.463507109004739,0.0394944707740916,0.117851500789889,0.139336492890995
"E02002144",354,538,207,163,375,191,1686,0.209964412811388,0.319098457888494,0.122775800711744,0.0966785290628707,0.222419928825623,0.113285883748517
"E02002145",431,558,665,116,442,315,3066,0.140574037834312,0.181996086105675,0.21689497716895,0.0378343118069145,0.144161774298761,0.102739726027397
"E02002146",250,545,196,134,411,116,1777,0.140686550365785,0.306696679797411,0.110298255486775,0.0754079909960608,0.231288688801351,0.0652785593697243
"E02002147",388,430,577,84,346,304,2897,0.133931653434588,0.148429409734208,0.199171556782879,0.0289955125992406,0.119433897134967,0.104936140835347
"E02002148",602,853,568,251,602,351,3298,0.18253486961795,0.258641600970285,0.172225591267435,0.0761067313523347,0.18253486961795,0.106428138265616
"E02002149",481,527,504,159,368,322,3191,0.150736446255092,0.165151989971796,0.157944218113444,0.0498276402381699,0.115324349733626,0.100908806016923
"E02002150",266,326,433,70,256,196,1718,0.154831199068685,0.189755529685681,0.252037252619325,0.0407450523864959,0.149010477299185,0.114086146682189
"E02002151",366,535,2,163,372,203,1973,0.185504308160162,0.271160669031931,0.0010136847440446,0.0826153066396351,0.188545362392296,0.102889001520527
"E02002152",229,302,267,65,237,164,1687,0.135743924125667,0.179016004742146,0.158269116775341,0.038529934795495,0.140486069946651,0.0972139893301719
"E02002153",391,491,81,142,349,249,2477,0.157852240613646,0.198223657650384,0.0327008477997578,0.0573274121921679,0.140896245458216,0.100524828421478
"E02002154",300,271,719,83,188,217,2872,0.104456824512535,0.0943593314763231,0.250348189415042,0.028899721448468,0.0654596100278552,0.0755571030640668
"E02002155",197,258,168,51,207,146,2059,0.0956775133559981,0.125303545410393,0.0815930063137445,0.024769305488101,0.100534239922292,0.070908207867897
"E02002156",435,569,833,155,414,280,2399,0.181325552313464,0.237182159233014,0.34722801167153,0.0646102542726136,0.1725719049604,0.11671529804085
"E02002157",464,485,1025,141,344,323,2357,0.196860415782775,0.205770046669495,0.434874840899448,0.0598218073822656,0.14594823928723,0.137038608400509
"E02002158",317,424,390,103,321,214,2705,0.117190388170055,0.156746765249538,0.144177449168207,0.0380776340110906,0.118669131238447,0.0791127541589649
"E02002159",300,315,827,62,253,238,1896,0.158227848101266,0.166139240506329,0.436181434599156,0.0327004219409283,0.133438818565401,0.125527426160338
"E02002160",330,372,594,86,286,244,2152,0.153345724907063,0.172862453531599,0.276022304832714,0.0399628252788104,0.132899628252788,0.113382899628253
"E02002161",383,374,733,86,288,297,2519,0.15204446208813,0.148471615720524,0.290988487495038,0.0341405319571258,0.114331083763398,0.117903930131004
"E02002162",508,504,553,158,346,350,2697,0.188357434186133,0.186874304783092,0.205042639970337,0.0585836114200964,0.128290693362996,0.129773822766036
"E02002163",409,547,1116,90,457,319,4754,0.0860328144720236,0.115061001262095,0.234749684476231,0.0189314261674379,0.0961295750946571,0.0671013883045856
"E02002164",417,541,1268,82,459,335,2967,0.140546006066734,0.182339063026626,0.427367711493091,0.0276373441186384,0.154701718907988,0.112908661948096
"E02002165",639,605,2117,68,537,571,3916,0.16317671092952,0.154494382022472,0.540602655771195,0.017364657814096,0.137129724208376,0.145812053115424
"E02002166",434,458,647,113,345,321,3096,0.140180878552972,0.147932816537468,0.208979328165375,0.0364987080103359,0.111434108527132,0.103682170542636
"E02002167",438,668,275,179,489,259,2327,0.18822518263859,0.287064890416846,0.118177911474001,0.0769230769230769,0.210141813493769,0.111302105715514
"E02002168",706,562,2457,123,439,583,6183,0.114184053048682,0.0908943878376193,0.397379912663755,0.019893255701116,0.0710011321365033,0.0942907973475659
"E02002169",552,664,814,220,444,332,2641,0.209011737978039,0.25141991669822,0.308216584627035,0.0833017796289284,0.168118137069292,0.12570995834911
"E02002170",278,214,640,60,154,218,1801,0.15435868961688,0.1188228761799,0.355358134369795,0.0333148250971682,0.0855080510827318,0.121043864519711
"E02002171",313,467,536,101,366,212,2428,0.128912685337727,0.192339373970346,0.220757825370675,0.0415980230642504,0.150741350906096,0.0873146622734761
"E02002174",441,319,1362,84,235,357,2372,0.185919055649241,0.134485666104553,0.574198988195616,0.0354131534569983,0.0990725126475548,0.150505902192243
"E02002175",362,304,757,78,226,284,2984,0.121313672922252,0.101876675603217,0.253686327077748,0.0261394101876676,0.0757372654155496,0.0951742627345844
"E02002176",325,369,566,94,275,231,2357,0.137887144675435,0.156554942723801,0.240135765803988,0.0398812049215104,0.116673737802291,0.0980059397539245
"E02002177",477,454,750,131,323,346,4605,0.103583061889251,0.0985884907709012,0.162866449511401,0.0284473398479913,0.0701411509229099,0.0751357220412595
"E02002178",391,375,960,114,261,277,1975,0.197974683544304,0.189873417721519,0.486075949367089,0.0577215189873418,0.132151898734177,0.140253164556962
"E02002179",372,401,613,122,279,250,1777,0.209341586944288,0.225661226786719,0.344963421496905,0.0686550365785031,0.157006190208216,0.140686550365785
"E02002180",293,384,241,108,276,185,1779,0.164699269252389,0.215851602023609,0.135469364811692,0.06070826306914,0.155143338954469,0.103991006183249
"E02002181",308,419,156,109,310,199,3001,0.102632455848051,0.139620126624459,0.0519826724425192,0.036321226257914,0.103298900366544,0.0663112295901366
"E02002182",275,298,318,75,223,200,1811,0.15184980673661,0.164549972390944,0.175593594699061,0.041413583655439,0.123136388735505,0.110436223081171
"E02002183",408,327,560,99,228,309,2270,0.179735682819383,0.144052863436123,0.246696035242291,0.0436123348017621,0.100440528634361,0.136123348017621
"E02002184",968,979,1371,252,727,716,4980,0.194377510040161,0.196586345381526,0.275301204819277,0.0506024096385542,0.145983935742972,0.143775100401606
"E02002185",348,334,523,92,242,256,2153,0.161634928007431,0.15513237343242,0.242916860195077,0.0427310729215049,0.112401300510915,0.118903855085927
"E02002187",376,495,358,116,379,260,2267,0.165857962064402,0.218350242611381,0.15791795324217,0.051168945743273,0.167181296868108,0.114689016321129
"E02002188",530,872,565,244,628,286,2517,0.21056813667064,0.346444179578864,0.224473579658323,0.0969408025427096,0.249503377036154,0.11362733412793
"E02002189",661,522,810,193,329,468,2058,0.321185617103984,0.253644314868805,0.393586005830904,0.0937803692905734,0.159863945578231,0.227405247813411
"E02002190",1505,1117,1811,421,696,1084,4337,0.347014065021905,0.257551302743832,0.417569748674199,0.0970717085543002,0.160479594189532,0.249942356467604
"E02002191",1070,962,1024,309,653,761,3674,0.291235710397387,0.261839956450735,0.278715296679369,0.0841045182362548,0.17773543821448,0.207131192161132
"E02002192",524,804,413,211,593,313,3025,0.173223140495868,0.265785123966942,0.136528925619835,0.0697520661157025,0.19603305785124,0.103471074380165
"E02002193",641,619,954,149,470,492,3262,0.196505211526671,0.18976088289393,0.292458614347026,0.045677498467198,0.144083384426732,0.150827713059473
"E02002194",527,759,404,193,566,334,2666,0.197674418604651,0.284696174043511,0.151537884471118,0.0723930982745686,0.212303075768942,0.125281320330083
"E02002195",395,439,348,134,305,261,1987,0.198792148968294,0.220936084549572,0.175138399597383,0.0674383492702567,0.153497735279316,0.131353799698037
"E02002196",485,356,650,105,251,380,2107,0.230185097294732,0.168960607498813,0.308495491219744,0.0498338870431894,0.119126720455624,0.180351210251542
"E02002197",769,571,1095,154,417,615,3950,0.194683544303797,0.144556962025316,0.277215189873418,0.0389873417721519,0.105569620253165,0.155696202531646
"E02002198",635,850,355,225,625,410,3289,0.193067801763454,0.258437214958954,0.107935542718151,0.0684098510185467,0.190027363940407,0.124657950744907
"E02002199",392,361,486,92,269,300,2722,0.144011756061719,0.132623071271124,0.178545187362234,0.0337986774430566,0.0988243938280676,0.110213078618663
"E02002200",623,743,983,189,554,434,3121,0.199615507850048,0.238064722845242,0.31496315283563,0.0605575136174303,0.177507209227812,0.139057994232618
"E02002201",693,581,926,119,462,574,5051,0.137200554345674,0.115026727380717,0.183330033656702,0.0235596911502673,0.0914670362304494,0.113640863195407
"E02002202",677,487,1247,129,358,548,3961,0.170916435243625,0.122948750315577,0.314819490027771,0.0325675334511487,0.0903812168644282,0.138348901792477
"E02002203",454,954,329,185,769,269,3059,0.148414514547238,0.311866623079438,0.107551487414188,0.060477280156914,0.251389342922524,0.0879372343903236
"E02002204",780,969,727,301,668,479,3841,0.203072116636293,0.252278052590471,0.189273626659724,0.0783650091122104,0.173913043478261,0.124707107524082
"E02002205",822,415,1794,127,288,695,3638,0.225948323254535,0.114073666849918,0.493128092358439,0.0349092908191314,0.0791643760307861,0.191039032435404
"E02002206",541,735,289,187,548,354,2890,0.18719723183391,0.254325259515571,0.1,0.0647058823529412,0.18961937716263,0.122491349480969
"E02002207",817,850,728,397,453,420,2169,0.376671277086215,0.391885661595205,0.335638543107423,0.183033656062702,0.208852005532503,0.193637621023513
"E02002208",601,556,635,136,420,465,3388,0.177390791027155,0.164108618654073,0.187426210153483,0.0401416765053129,0.12396694214876,0.137249114521842
"E02002209",408,391,130,102,289,306,3298,0.123711340206186,0.118556701030928,0.039417828987265,0.0309278350515464,0.0876288659793814,0.0927835051546392
"E02002210",473,573,174,169,404,304,2197,0.215293582157487,0.260810195721438,0.0791989076012745,0.0769230769230769,0.183887118798361,0.138370505234411
"E02002211",736,624,769,321,303,415,1942,0.378990731204943,0.321318228630278,0.395983522142122,0.16529351184346,0.156024716786818,0.213697219361483
"E02002212",452,527,264,159,368,293,2891,0.156347284676582,0.182289865098582,0.0913178830854376,0.0549982704946385,0.127291594603943,0.101349014181944
"E02002213",539,428,818,126,302,413,3131,0.172149473011817,0.136697540721814,0.261258383902906,0.0402427339508144,0.0964548067709997,0.131906739061003
"E02002214",529,517,579,186,331,343,2333,0.226746678096871,0.221603086155165,0.248178311187312,0.0797256750964423,0.141877411058723,0.147021003000429
"E02002215",1090,965,1098,498,467,592,2927,0.372394943628288,0.329689101469081,0.375128117526478,0.170140075162282,0.159549026306799,0.202254868466006
"E02002216",916,745,1304,402,343,514,3214,0.285003111387679,0.231798382078407,0.405724953329185,0.125077784691973,0.106720597386434,0.159925326695706
"E02002217",1237,874,1200,479,395,758,3303,0.374508023009385,0.264607932182864,0.36330608537693,0.145019679079625,0.119588253103239,0.229488343929761
"E02002218",816,953,541,248,705,568,3871,0.210798243347972,0.246189615086541,0.139757168690261,0.0640661327822268,0.182123482304314,0.146732110565745
"E02002219",842,640,986,318,322,524,2200,0.382727272727273,0.290909090909091,0.448181818181818,0.144545454545455,0.146363636363636,0.238181818181818
"E02002220",927,858,776,397,461,530,2537,0.365392195506504,0.338194718171068,0.305873078439101,0.156484036263303,0.181710681907765,0.208908159243201
"E02002222",585,604,284,169,435,416,2678,0.218446601941748,0.22554144884242,0.10604929051531,0.0631067961165049,0.162434652725915,0.155339805825243
"E02002223",765,747,816,319,428,446,2672,0.286302395209581,0.279565868263473,0.305389221556886,0.11938622754491,0.160179640718563,0.166916167664671
"E02002224",1230,1134,1273,554,580,676,3015,0.407960199004975,0.376119402985075,0.422222222222222,0.183747927031509,0.192371475953566,0.224212271973466
"E02002225",593,527,936,150,377,443,3154,0.188015218769816,0.16708941027267,0.296766011414077,0.0475586556753329,0.119530754597337,0.140456563094483
"E02002226",1675,1085,1700,727,358,948,4060,0.41256157635468,0.267241379310345,0.41871921182266,0.179064039408867,0.0881773399014778,0.233497536945813
"E02002227",774,711,715,342,369,432,2572,0.300933125972006,0.276438569206843,0.277993779160187,0.132970451010886,0.143468118195956,0.16796267496112
"E02002228",650,674,586,232,442,418,2980,0.218120805369128,0.226174496644295,0.196644295302013,0.0778523489932886,0.148322147651007,0.140268456375839
"E02002229",574,532,765,133,399,441,2897,0.198136002761477,0.183638246461857,0.26406627545737,0.0459095616154643,0.137728684846393,0.152226441146013
"E02002230",791,689,995,332,357,459,3007,0.263052876621217,0.22913202527436,0.330894579314932,0.110409045560359,0.118722979714001,0.152643831060858
"E02002231",1000,1072,818,387,685,613,4116,0.242954324586978,0.26044703595724,0.198736637512148,0.0940233236151603,0.16642371234208,0.148931000971817
"E02002232",716,663,1112,246,417,470,2628,0.272450532724505,0.252283105022831,0.423135464231355,0.0936073059360731,0.158675799086758,0.178843226788432
"E02002233",852,750,800,344,406,508,2702,0.315321983715766,0.277572168763879,0.296076980014804,0.127313101406366,0.150259067357513,0.1880088823094
"E02002234",438,454,34,91,363,347,3461,0.126553019358567,0.131175960704999,0.00982375036116729,0.0262929789078301,0.104882981797168,0.100260040450737
"E02002235",776,794,669,329,465,447,2520,0.307936507936508,0.315079365079365,0.26547619047619,0.130555555555556,0.18452380952381,0.177380952380952
"E02002236",487,806,616,229,577,258,2147,0.226828132277597,0.375407545412203,0.286911970190964,0.106660456450862,0.268747088961341,0.120167675826735
"E02002237",556,812,491,165,647,391,2785,0.199640933572711,0.291561938958707,0.176301615798923,0.059245960502693,0.232315978456014,0.140394973070018
"E02002238",476,549,566,157,392,319,2334,0.203941730934019,0.235218508997429,0.242502142245073,0.0672664952870608,0.167952013710368,0.136675235646958
"E02002239",595,656,650,196,460,399,3862,0.154065251165199,0.169860176074573,0.168306576903159,0.0507509062661833,0.119109269808389,0.103314344899016
"E02002240",673,717,1287,143,574,530,4170,0.161390887290168,0.171942446043165,0.30863309352518,0.0342925659472422,0.137649880095923,0.127098321342926
"E02002241",734,802,589,193,609,541,4557,0.161070879964889,0.175992977836296,0.129251700680272,0.0423524248409041,0.133640552995392,0.118718455123985
"E02002242",553,498,554,169,329,384,2610,0.211877394636015,0.190804597701149,0.212260536398467,0.0647509578544061,0.126053639846743,0.147126436781609
"E02002243",768,653,852,161,492,607,3910,0.196419437340153,0.167007672634271,0.217902813299233,0.0411764705882353,0.125831202046036,0.155242966751918
"E02002244",284,355,344,99,256,185,1980,0.143434343434343,0.179292929292929,0.173737373737374,0.05,0.129292929292929,0.0934343434343434
"E02002245",225,267,171,51,216,174,2586,0.0870069605568446,0.103248259860789,0.0661252900232019,0.0197215777262181,0.0835266821345708,0.0672853828306264
"E02002246",577,811,849,224,587,353,3150,0.183174603174603,0.257460317460317,0.269523809523809,0.0711111111111111,0.186349206349206,0.112063492063492
"E02002247",835,452,1748,115,337,720,3708,0.225188781014024,0.121898597626753,0.471413160733549,0.0310140237324703,0.0908845738942826,0.194174757281553
"E02002248",453,617,419,162,455,291,3327,0.136158701532913,0.185452359483018,0.125939284640818,0.048692515779982,0.136759843703036,0.0874661857529306
"E02002249",498,397,598,112,285,386,2556,0.194835680751174,0.155320813771518,0.2339593114241,0.0438184663536776,0.11150234741784,0.151017214397496
"E02002250",608,499,1117,123,376,485,3237,0.187828236021007,0.154155081865925,0.345072598084646,0.0379981464318814,0.116156935434044,0.149830089589126
"E02002251",660,572,1538,134,438,526,5220,0.126436781609195,0.109578544061303,0.294636015325671,0.0256704980842912,0.0839080459770115,0.100766283524904
"E02002252",353,672,290,176,496,177,2207,0.159945627548709,0.304485727231536,0.131400090620752,0.0797462618939737,0.224739465337562,0.0801993656547349
"E02002253",669,991,968,203,788,466,3043,0.219848833388104,0.325665461715412,0.318107131120605,0.0667104830759119,0.258954978639501,0.153138350312192
"E02002254",356,484,606,108,376,248,2173,0.163828808099402,0.222733548090198,0.278877128393925,0.0497008743672342,0.173032673722964,0.114127933732168
"E02002255",919,891,1039,342,549,577,3240,0.283641975308642,0.275,0.320679012345679,0.105555555555556,0.169444444444444,0.178086419753086
"E02002256",1120,677,1463,305,372,815,3730,0.300268096514745,0.181501340482574,0.392225201072386,0.081769436997319,0.0997319034852547,0.218498659517426
"E02002257",908,748,1068,283,465,625,2281,0.398071021481806,0.327926348092942,0.468215694870671,0.124068391056554,0.203857957036388,0.274002630425252
"E02002258",500,631,1007,137,494,363,3391,0.147449130050133,0.186080802123267,0.296962547920967,0.0404010616337364,0.145679740489531,0.107048068416396
"E02002259",715,627,1243,175,452,540,2963,0.241309483631455,0.211609854876814,0.419507256159298,0.0590617617279784,0.152548093148836,0.182247721903476
"E02002260",870,549,1489,188,361,682,4118,0.211267605633803,0.133317144244779,0.361583292860612,0.0456532297231666,0.0876639145216124,0.165614375910636
"E02002261",549,626,784,161,465,388,3177,0.172804532577904,0.197041233868429,0.24677368586717,0.0506767390620082,0.146364494806421,0.122127793515896
"E02002262",458,561,1160,122,439,336,3326,0.137702946482261,0.16867107636801,0.348767288033674,0.0366806975345761,0.131990378833434,0.101022248947685
"E02002263",343,447,666,85,362,258,2433,0.140978216193999,0.183723797780518,0.273736128236745,0.0349362926428278,0.14878750513769,0.106041923551171
"E02002264",574,496,937,137,359,437,2423,0.236896409409823,0.204704911267024,0.386710689228229,0.0565414775072225,0.148163433759802,0.1803549319026
"E02002265",619,386,823,158,228,461,2117,0.29239489844119,0.182333490788852,0.388757675956542,0.074633915918753,0.107699574870099,0.217760982522437
"E02002266",304,416,556,102,314,202,2004,0.151696606786427,0.207584830339321,0.277445109780439,0.0508982035928144,0.156686626746507,0.100798403193613
"E02002267",404,535,427,135,400,269,3082,0.131083711875406,0.173588578844906,0.13854639844257,0.0438027255029202,0.129785853341986,0.0872809863724854
"E02002268",712,678,1314,189,489,523,4438,0.160432627309599,0.152771518702118,0.29607931500676,0.0425867507886435,0.110184767913475,0.117845876520955
"E02002269",583,465,1183,120,345,463,3425,0.17021897810219,0.135766423357664,0.345401459854015,0.035036496350365,0.100729927007299,0.135182481751825
"E02002270",402,363,1012,74,289,328,2764,0.145441389290883,0.131331403762663,0.366136034732272,0.0267727930535456,0.104558610709117,0.118668596237337
"E02002271",329,407,472,87,320,242,2477,0.132821962050868,0.164311667339524,0.190553088413403,0.035123132821962,0.129188534517562,0.0976988292289059
"E02002272",398,415,606,89,326,309,3348,0.118876941457587,0.123954599761051,0.181003584229391,0.0265830346475508,0.0973715651135006,0.0922939068100358
"E02002273",242,382,485,75,307,167,2320,0.104310344827586,0.164655172413793,0.209051724137931,0.0323275862068966,0.132327586206897,0.0719827586206897
"E02002274",261,311,339,75,236,186,2156,0.121057513914657,0.144248608534323,0.157235621521336,0.0347866419294991,0.109461966604824,0.0862708719851577
"E02002275",404,620,1023,126,494,278,3505,0.115263908701854,0.176890156918688,0.291868758915835,0.0359486447931526,0.140941512125535,0.0793152639087019
"E02002276",321,431,468,78,353,243,2376,0.13510101010101,0.181397306397306,0.196969696969697,0.0328282828282828,0.148569023569024,0.102272727272727
"E02002277",319,366,634,87,279,232,2149,0.148441135411819,0.170311772917636,0.29502093997208,0.0404839460214053,0.129827826896231,0.107957189390414
"E02002278",262,322,336,67,255,195,2215,0.118284424379233,0.145372460496614,0.151693002257336,0.0302483069977427,0.115124153498871,0.0880361173814898
"E02002279",243,534,528,71,463,172,2439,0.0996309963099631,0.218942189421894,0.216482164821648,0.029110291102911,0.189831898318983,0.0705207052070521
"E02002280",236,320,390,64,256,172,2761,0.0854762767113365,0.115900036218761,0.141253169141615,0.0231800072437523,0.0927200289750091,0.0622962694675842
"E02002281",490,592,733,144,448,346,3675,0.133333333333333,0.16108843537415,0.199455782312925,0.0391836734693878,0.121904761904762,0.0941496598639456
"E02002282",273,336,555,69,267,204,2266,0.120476610767873,0.148278905560459,0.244924977934687,0.03045013239188,0.117828773168579,0.0900264783759929
"E02002283",319,440,625,121,319,198,1975,0.161518987341772,0.222784810126582,0.316455696202532,0.0612658227848101,0.161518987341772,0.100253164556962
"E02002284",252,403,362,85,318,167,2231,0.112953832362169,0.180636485880771,0.162259076647243,0.0380995069475571,0.142536978933214,0.0748543254146123
"E02002285",336,416,442,104,312,232,2411,0.139361260887599,0.172542513479884,0.183326420572377,0.043135628369971,0.129406885109913,0.0962256325176275
"E02002286",210,239,244,46,193,164,2051,0.102389078498294,0.116528522671867,0.118966357874208,0.022428083861531,0.0941004388103364,0.0799609946367626
"E02002287",338,337,830,96,241,242,2702,0.125092524056255,0.124722427831236,0.307179866765359,0.0355292376017765,0.0891931902294597,0.0895632864544782
"E02002288",380,451,445,90,361,290,3304,0.11501210653753,0.136501210653753,0.134685230024213,0.0272397094430993,0.109261501210654,0.087772397094431
"E02002289",247,438,205,98,340,149,1833,0.134751773049645,0.238952536824877,0.111838516093835,0.0534642662302237,0.185488270594654,0.0812875068194217
"E02002290",225,328,329,66,262,159,2052,0.109649122807018,0.159844054580897,0.160331384015595,0.0321637426900585,0.127680311890838,0.0774853801169591
"E02002291",311,347,322,102,245,209,2136,0.14559925093633,0.162453183520599,0.150749063670412,0.047752808988764,0.114700374531835,0.0978464419475655
"E02002292",212,351,195,75,276,137,1935,0.109560723514212,0.181395348837209,0.10077519379845,0.0387596899224806,0.142635658914729,0.0708010335917313
"E02002293",383,501,605,124,377,259,2368,0.161739864864865,0.211570945945946,0.255489864864865,0.0523648648648649,0.159206081081081,0.109375
"E02002294",506,612,610,231,381,275,2568,0.197040498442368,0.238317757009346,0.237538940809969,0.0899532710280374,0.148364485981308,0.10708722741433
"E02002295",207,393,238,47,346,160,2599,0.079646017699115,0.15121200461716,0.0915736821854559,0.0180838784147749,0.133128126202386,0.0615621392843401
"E02002296",274,377,613,73,304,201,2683,0.102124487513977,0.140514349608647,0.228475587029445,0.0272083488632128,0.113306000745434,0.0749161386507641
"E02002297",356,486,485,110,376,246,2260,0.157522123893805,0.215044247787611,0.214601769911504,0.0486725663716814,0.166371681415929,0.108849557522124
"E02002298",210,243,241,40,203,170,2166,0.0969529085872576,0.11218836565097,0.111265004616805,0.0184672206832872,0.0937211449676824,0.0784856879039705
"E02002299",440,741,1034,113,628,327,3430,0.128279883381924,0.216034985422741,0.301457725947522,0.0329446064139942,0.183090379008746,0.09533527696793
"E02002300",273,372,356,73,299,200,2958,0.0922920892494929,0.125760649087221,0.120351588911427,0.0246788370520622,0.101081812035159,0.0676132521974307
"E02002301",825,655,1397,268,387,557,2934,0.28118609406953,0.223244717109748,0.476141785957737,0.0913428766189502,0.131901840490798,0.189843217450579
"E02002302",255,287,435,76,211,179,1822,0.139956092206367,0.157519209659715,0.238748627881449,0.0417124039517014,0.115806805708013,0.0982436882546652
"E02002303",362,490,968,90,400,272,2638,0.137225170583776,0.185746777862017,0.366944655041698,0.0341167551175133,0.151630022744503,0.103108415466262
"E02002304",532,401,1416,102,299,430,3028,0.175693527080581,0.132430647291942,0.467635402906209,0.0336856010568032,0.0987450462351387,0.142007926023778
"E02002305",286,424,461,75,349,211,2238,0.127792672028597,0.189454870420018,0.205987488829312,0.0335120643431635,0.155942806076854,0.0942806076854334
"E02002306",272,265,656,62,203,210,1868,0.145610278372591,0.14186295503212,0.351177730192719,0.0331905781584582,0.108672376873662,0.112419700214133
"E02002307",228,396,296,74,322,154,1946,0.117163412127441,0.203494347379239,0.152106885919836,0.0380267214799589,0.165467625899281,0.079136690647482
"E02002308",303,381,898,71,310,232,2465,0.122920892494929,0.154563894523327,0.364300202839757,0.0288032454361055,0.125760649087221,0.0941176470588235
"E02002309",447,476,1092,120,356,327,2669,0.167478456350693,0.178343949044586,0.409142000749344,0.0449606594230049,0.133383289621581,0.122517796927688
"E02002310",321,366,722,73,293,248,2347,0.136770345121432,0.155943757988922,0.307626757562846,0.0311035364294844,0.124840221559438,0.105666808691947
"E02002311",261,235,790,36,199,225,2367,0.110266159695817,0.0992817912970004,0.33375580904098,0.0152091254752852,0.0840726658217153,0.0950570342205323
"E02002312",351,419,1045,75,344,276,3302,0.106299212598425,0.126892792247123,0.316474863718958,0.0227135069654755,0.104179285281647,0.0835857056329497
"E02002313",617,710,1496,180,530,437,2589,0.23831595210506,0.274237157203554,0.577829277713403,0.0695249130938586,0.204712244109695,0.168791039011201
"E02002314",284,384,471,81,303,203,1912,0.148535564853556,0.200836820083682,0.246338912133891,0.0423640167364017,0.15847280334728,0.106171548117155
"E02002315",371,402,1359,54,348,317,2945,0.12597623089983,0.136502546689304,0.461460101867572,0.0183361629881155,0.118166383701188,0.107640067911715
"E02002316",267,305,334,85,220,182,2056,0.129863813229572,0.148346303501946,0.162451361867704,0.0413424124513619,0.107003891050584,0.0885214007782101
"E02002317",403,544,895,99,445,304,2745,0.146812386156648,0.198178506375228,0.326047358834244,0.0360655737704918,0.162112932604736,0.110746812386157
"E02002318",339,455,612,109,346,230,2234,0.151745747538048,0.20367054610564,0.273948075201432,0.0487914055505819,0.154879140555058,0.102954341987466
"E02002319",298,256,1156,51,205,247,2401,0.12411495210329,0.106622240733028,0.481466055810079,0.0212411495210329,0.085381091211995,0.102873802582257
"E02002320",251,461,697,76,385,175,2360,0.10635593220339,0.195338983050847,0.295338983050847,0.0322033898305085,0.163135593220339,0.0741525423728814
"E02002321",229,270,573,56,214,173,2149,0.106561191251745,0.125639832480223,0.266635644485807,0.0260586319218241,0.0995812005583993,0.0805025593299209
"E02002322",398,374,1053,66,308,332,2114,0.188268684957427,0.176915799432356,0.498107852412488,0.0312204351939451,0.145695364238411,0.157048249763482
"E02002323",382,373,869,74,299,308,2814,0.135749822316986,0.132551528073916,0.308813077469794,0.0262970859985785,0.106254442075338,0.109452736318408
"E02002324",289,340,494,82,258,207,2457,0.117623117623118,0.138380138380138,0.201058201058201,0.0333740333740334,0.105006105006105,0.0842490842490843
"E02002325",349,421,836,73,348,276,3093,0.112835434852894,0.136113805366958,0.27028774652441,0.0236016812156482,0.112512124151309,0.0892337536372454
"E02002326",222,295,521,68,227,154,1773,0.125211505922166,0.166384658770446,0.29385222786238,0.0383530738860688,0.128031584884377,0.086858432036097
"E02002327",396,448,820,97,351,299,3228,0.122676579925651,0.138785625774473,0.254027261462206,0.0300495662949195,0.108736059479554,0.0926270136307311
"E02002328",292,219,740,56,163,236,2299,0.127011744236625,0.0952588081774685,0.321879077859939,0.0243584167029143,0.0709003914745542,0.10265332753371
"E02002329",477,436,1424,96,340,381,4069,0.117227820103219,0.107151634308184,0.349963135905628,0.0235930203981322,0.0835586139100516,0.0936347997050872
"E02002330",424,472,155,149,323,275,2134,0.198687910028116,0.221180880974695,0.0726335520149953,0.0698219306466729,0.151358950328022,0.128865979381443
"E02002331",386,367,301,120,247,266,2810,0.137366548042705,0.130604982206406,0.10711743772242,0.0427046263345196,0.0879003558718861,0.094661921708185
"E02002332",346,408,167,106,302,240,2203,0.157058556513845,0.185201997276441,0.0758057194734453,0.0481162051747617,0.13708579210168,0.108942351339083
"E02002333",661,422,1112,120,302,541,2970,0.222558922558923,0.142087542087542,0.374410774410774,0.0404040404040404,0.101683501683502,0.182154882154882
"E02002334",408,449,531,104,345,304,2649,0.154020385050963,0.169497923744809,0.200453001132503,0.0392600981502454,0.130237825594564,0.114760286900717
"E02002335",478,667,387,217,450,261,2371,0.201602699283003,0.281315900463939,0.163222269084774,0.0915225643188528,0.189793336145086,0.11008013496415
"E02002336",445,668,347,190,478,255,2397,0.185648727576137,0.278681685440133,0.144764288694201,0.0792657488527326,0.199415936587401,0.106382978723404
"E02002337",352,651,313,158,493,194,2600,0.135384615384615,0.250384615384615,0.120384615384615,0.0607692307692308,0.189615384615385,0.0746153846153846
"E02002338",460,520,505,116,404,344,2595,0.177263969171484,0.200385356454721,0.194605009633911,0.0447013487475915,0.155684007707129,0.132562620423892
"E02002339",440,437,327,118,319,322,2238,0.196604110813226,0.1952636282395,0.146112600536193,0.0527256478999106,0.142537980339589,0.143878462913315
"E02002340",430,379,516,117,262,313,2210,0.194570135746606,0.171493212669683,0.233484162895928,0.0529411764705882,0.118552036199095,0.141628959276018
"E02002341",483,694,126,215,479,268,2262,0.213527851458886,0.306808134394341,0.0557029177718833,0.0950486295313882,0.211759504862953,0.118479221927498
"E02002342",439,482,30,157,325,282,2285,0.192122538293217,0.210940919037199,0.0131291028446389,0.0687089715536105,0.142231947483589,0.123413566739606
"E02002343",437,487,410,144,343,293,2009,0.217521154803385,0.242409158785465,0.204081632653061,0.0716774514683922,0.170731707317073,0.145843703334993
"E02002344",568,881,82,250,631,318,3019,0.188141768797615,0.291818482941371,0.0271613116926134,0.0828088771116264,0.209009605829745,0.105332891685989
"E02002345",403,707,110,205,502,198,2066,0.195062923523717,0.342207163601162,0.05324298160697,0.0992255566311713,0.24298160696999,0.095837366892546
"E02002346",435,536,37,158,378,277,2345,0.185501066098081,0.228571428571429,0.0157782515991471,0.0673773987206823,0.161194029850746,0.118123667377399
"E02002347",316,263,50,65,198,251,2523,0.125247720967103,0.104240982956797,0.0198176773682124,0.0257629805786762,0.0784780023781213,0.0994847403884265
"E02002348",394,479,87,123,356,271,2721,0.144799705990445,0.17603822124219,0.0319735391400221,0.0452039691289967,0.130834252113194,0.099595736861448
"E02002349",391,596,607,113,483,278,2447,0.159787494891704,0.243563547200654,0.248058847568451,0.0461789946873723,0.197384552513282,0.113608500204332
"E02002350",355,487,346,117,370,238,1859,0.190962883270576,0.261968800430339,0.186121570736955,0.0629370629370629,0.199031737493276,0.128025820333513
"E02002351",359,394,279,121,273,238,1764,0.203514739229025,0.223356009070295,0.158163265306122,0.06859410430839,0.154761904761905,0.134920634920635
"E02002352",491,941,398,232,709,259,2754,0.178286129266521,0.341684822076979,0.144517066085694,0.084241103848947,0.257443718228032,0.0940450254175744
"E02002353",363,526,351,133,393,230,1776,0.204391891891892,0.296171171171171,0.197635135135135,0.0748873873873874,0.221283783783784,0.129504504504505
"E02002354",443,676,427,166,510,277,2859,0.154949282966072,0.236446309898566,0.149352920601609,0.0580622595313047,0.178384050367261,0.0968870234347674
"E02002356",545,633,895,172,461,373,3285,0.165905631659056,0.192694063926941,0.272450532724505,0.0523592085235921,0.140334855403349,0.113546423135464
"E02002357",560,685,571,181,504,379,3240,0.172839506172839,0.21141975308642,0.176234567901235,0.0558641975308642,0.155555555555556,0.116975308641975
"E02002358",412,483,52,144,339,268,2847,0.14471373375483,0.169652265542677,0.0182648401826484,0.0505795574288725,0.119072708113804,0.0941341763259572
"E02002359",368,321,366,110,211,258,2170,0.169585253456221,0.147926267281106,0.168663594470046,0.0506912442396313,0.0972350230414747,0.11889400921659
"E02002360",444,371,489,105,266,339,2900,0.153103448275862,0.127931034482759,0.168620689655172,0.0362068965517241,0.0917241379310345,0.116896551724138
"E02002361",353,493,456,129,364,224,2079,0.16979316979317,0.237133237133237,0.219336219336219,0.062049062049062,0.175084175084175,0.107744107744108
"E02002362",430,477,168,156,321,274,3477,0.123669830313489,0.137187230371009,0.0483175150992235,0.0448662640207075,0.092320966350302,0.0788035662927811
"E02002363",722,523,1235,134,389,588,3265,0.221133231240429,0.160183767228178,0.378254211332312,0.04104134762634,0.119142419601838,0.180091883614089
"E02002364",269,215,30,65,150,204,2716,0.0990427098674521,0.079160530191458,0.0110456553755523,0.0239322533136966,0.0552282768777614,0.0751104565537555
"E02002366",394,712,504,181,531,213,2457,0.16035816035816,0.28978428978429,0.205128205128205,0.0736670736670737,0.216117216117216,0.0866910866910867
"E02002367",440,420,350,98,322,342,2705,0.162661737523105,0.155268022181146,0.129390018484288,0.0362292051756007,0.119038817005545,0.126432532347505
"E02002368",617,456,903,151,305,466,2984,0.206769436997319,0.152815013404826,0.302613941018767,0.0506032171581769,0.102211796246649,0.156166219839142
"E02002369",314,348,121,92,256,222,3653,0.0859567478784561,0.0952641664385437,0.0331234601697235,0.0251847796331782,0.0700793868053654,0.0607719682452779
"E02002370",328,408,24,93,315,235,3098,0.105874757908328,0.131697869593286,0.00774693350548741,0.0300193673337637,0.101678502259522,0.0758553905745642
"E02002371",896,639,1708,139,500,757,4308,0.207985143918292,0.148328690807799,0.396471680594243,0.0322655524605385,0.116063138347261,0.175719591457753
"E02002373",1142,365,1867,129,236,1013,3522,0.324247586598524,0.103634298693924,0.530096536059057,0.0366269165247019,0.067007382169222,0.287620670073822
"E02002374",557,474,818,112,362,445,3325,0.167518796992481,0.142556390977444,0.246015037593985,0.0336842105263158,0.108872180451128,0.133834586466165
"E02002375",348,291,197,92,199,256,2353,0.147896302592435,0.123671908202295,0.0837229069273268,0.0390990225244369,0.084572885677858,0.108797280067998
"E02002376",297,287,320,80,207,217,2335,0.127194860813704,0.122912205567452,0.137044967880086,0.0342612419700214,0.0886509635974304,0.0929336188436831
"E02002377",1201,107,2184,21,86,1180,2900,0.414137931034483,0.0368965517241379,0.753103448275862,0.00724137931034483,0.0296551724137931,0.406896551724138
"E02002379",236,172,62,64,108,172,2256,0.104609929078014,0.076241134751773,0.0274822695035461,0.0283687943262411,0.0478723404255319,0.076241134751773
"E02002380",367,439,281,126,313,241,1919,0.191245440333507,0.228764981761334,0.146430432516936,0.0656591974986972,0.163105784262637,0.12558624283481
"E02002381",484,445,508,121,324,363,2668,0.181409295352324,0.166791604197901,0.190404797601199,0.045352323838081,0.12143928035982,0.136056971514243
"E02002382",1732,68,2472,22,46,1710,2956,0.585926928281461,0.0230040595399188,0.836265223274696,0.0074424898511502,0.0155615696887686,0.578484438430311
"E02002383",1446,140,2224,37,103,1409,3187,0.453718230310637,0.0439284593661751,0.697834954502667,0.0116096642610606,0.0323187951051145,0.442108566049576
"E02002384",430,327,787,55,272,375,6504,0.0661131611316113,0.0502767527675277,0.1210024600246,0.00845633456334563,0.041820418204182,0.0576568265682657
"E02002385",1558,321,2614,85,236,1473,4130,0.377239709443099,0.0777239709443099,0.632929782082324,0.0205811138014528,0.0571428571428571,0.356658595641646
"E02002386",634,643,409,207,436,427,3137,0.202103920943577,0.204972904048454,0.130379343321645,0.0659866114121772,0.138986292636277,0.136117309531399
"E02002387",563,259,792,69,190,494,2671,0.210782478472482,0.0969674279296144,0.296518157993261,0.025833021340322,0.0711344065892924,0.18494945713216
"E02002388",570,507,515,160,347,410,3156,0.180608365019011,0.1606463878327,0.16318124207858,0.0506970849176172,0.109949302915082,0.129911280101394
"E02002389",204,258,150,51,207,153,2896,0.0704419889502762,0.0890883977900552,0.0517955801104972,0.0176104972375691,0.0714779005524862,0.0528314917127072
"E02002390",277,367,262,89,278,188,2957,0.09367602299628,0.12411227595536,0.0886033141697667,0.0300980723706459,0.0940142035847142,0.0635779506256341
"E02002391",646,522,913,147,375,499,2968,0.217654986522911,0.175876010781671,0.307614555256065,0.0495283018867925,0.126347708894879,0.168126684636119
"E02002392",432,234,1391,51,183,381,4076,0.105986261040236,0.0574092247301276,0.341265947006869,0.0125122669283611,0.0448969578017664,0.0934739941118744
"E02002393",859,217,1193,32,185,827,4678,0.183625480974776,0.046387345019239,0.25502351432236,0.00684053014108593,0.0395468148781531,0.17678495083369
"E02002394",1374,203,1668,54,149,1320,3488,0.393922018348624,0.0581995412844037,0.478211009174312,0.0154816513761468,0.0427178899082569,0.378440366972477
"E02002395",439,664,211,178,486,261,2248,0.195284697508897,0.295373665480427,0.0938612099644128,0.0791814946619217,0.216192170818505,0.116103202846975
"E02002396",909,519,1310,151,368,758,4047,0.224610822831727,0.12824314306894,0.323696565357055,0.037311588831233,0.0909315542377069,0.187299234000494
"E02002397",447,388,326,123,265,324,2855,0.156567425569177,0.135901926444834,0.114185639229422,0.0430823117338004,0.0928196147110333,0.113485113835377
"E02002398",506,549,489,147,402,359,2419,0.209177346010748,0.226953286482017,0.20214964861513,0.0607689127738735,0.166184373708144,0.148408433236875
"E02002399",686,336,1034,79,257,607,2303,0.297872340425532,0.145896656534954,0.448979591836735,0.0343030829353018,0.111593573599653,0.26356925749023
"E02002400",1008,284,1571,83,201,925,4362,0.231086657496561,0.0651077487391105,0.360155891792756,0.0190279688216414,0.0460797799174691,0.21205868867492
"E02002401",243,594,67,111,483,132,2458,0.0988608624898291,0.241659886086249,0.0272579332790887,0.0451586655817738,0.196501220504475,0.0537021969080553
"E02002402",277,331,137,77,254,200,1845,0.150135501355014,0.17940379403794,0.0742547425474255,0.0417344173441734,0.137669376693767,0.10840108401084
"E02002403",394,350,452,101,249,293,2161,0.182322998611754,0.16196205460435,0.209162424803332,0.046737621471541,0.115224433132809,0.135585377140213
"E02002404",958,133,1509,43,90,915,6768,0.141548463356974,0.0196513002364066,0.222960992907801,0.00635342789598109,0.0132978723404255,0.135195035460993
"E02002405",470,502,629,147,355,323,3209,0.146463072608289,0.156435026488003,0.196011218448115,0.045808663134933,0.110626363353069,0.100654409473356
"E02002406",443,398,51,129,269,314,1943,0.227997941327844,0.204837879567679,0.0262480699948533,0.0663921770458055,0.138445702521873,0.161605764282038
"E02002407",489,368,422,103,265,386,3062,0.159699542782495,0.12018288700196,0.137818419333769,0.0336381450032658,0.0865447419986937,0.126061397779229
"E02002408",464,377,626,113,264,351,2889,0.160609207338179,0.130494980962271,0.216683973693319,0.0391138802353756,0.0913811007268951,0.121495327102804
"E02002409",299,385,182,107,278,192,2228,0.134201077199282,0.172800718132855,0.0816876122082585,0.0480251346499102,0.124775583482944,0.0861759425493716
"E02002410",486,392,471,124,268,362,2763,0.175895765472313,0.141874773796598,0.170466883821933,0.0448787549764748,0.0969960188201231,0.131017010495838
"E02002411",1162,135,1809,41,94,1121,7284,0.159527732015376,0.0185337726523888,0.24835255354201,0.00562877539813289,0.0129049972542559,0.153898956617243
"E02002412",550,435,458,144,291,406,2797,0.196639256346085,0.155523775473722,0.163746871648194,0.0514837325706114,0.10404004290311,0.145155523775474
"E02002414",649,311,1060,93,218,556,3234,0.200680272108844,0.0961657390228819,0.327767470624613,0.0287569573283859,0.067408781694496,0.171923314780458
"E02002415",1668,92,2780,28,64,1640,3728,0.447424892703863,0.0246781115879828,0.745708154506438,0.00751072961373391,0.0171673819742489,0.439914163090129
"E02002416",363,364,125,135,229,228,2229,0.162853297442799,0.163301929116196,0.0560789591745177,0.0605652759084791,0.102736653207716,0.10228802153432
"E02002417",325,241,472,81,160,244,2960,0.109797297297297,0.0814189189189189,0.159459459459459,0.0273648648648649,0.0540540540540541,0.0824324324324324
"E02002418",425,332,351,110,222,315,2234,0.190241718889884,0.148612354521038,0.157117278424351,0.0492390331244405,0.099373321396598,0.141002685765443
"E02002419",438,474,356,123,351,315,3161,0.138563745650111,0.149952546662449,0.112622587788674,0.0389117367921544,0.111040809870294,0.0996520088579563
"E02002420",889,395,1427,109,286,780,2786,0.319095477386935,0.141780330222541,0.512203876525485,0.039124192390524,0.102656137832017,0.279971284996411
"E02002421",368,216,286,53,163,315,2723,0.135145060594932,0.0793242746970253,0.105031215571061,0.0194638266617701,0.0598604480352552,0.115681233933162
"E02002422",386,378,160,120,258,266,2260,0.170796460176991,0.167256637168142,0.0707964601769911,0.0530973451327434,0.114159292035398,0.117699115044248
"E02002423",252,284,43,75,209,177,2100,0.12,0.135238095238095,0.0204761904761905,0.0357142857142857,0.0995238095238095,0.0842857142857143
"E02002424",485,420,281,157,263,328,2392,0.202759197324415,0.175585284280936,0.11747491638796,0.0656354515050167,0.10994983277592,0.137123745819398
"E02002425",540,536,408,160,376,380,3073,0.175724048161406,0.174422388545395,0.132769280833062,0.0520663846404165,0.122356003904979,0.123657663520989
"E02002426",491,372,372,105,267,386,2623,0.187190240182997,0.141822340831109,0.141822340831109,0.0400304994281357,0.101791841402974,0.147159740754861
"E02002427",386,417,313,102,315,284,2213,0.174423859014912,0.188431992769995,0.141436963398102,0.0460912788070493,0.142340713962946,0.128332580207863
"E02002428",332,376,83,96,280,236,3131,0.106036410092622,0.120089428297668,0.0265091025231555,0.030661130629192,0.0894282976684765,0.0753752794634302
"E02002429",469,359,516,108,251,361,2883,0.162677766215747,0.124523066250434,0.1789802289282,0.0374609781477627,0.0870620881026708,0.125216788067985
"E02002430",321,366,78,85,281,236,3057,0.105004906771344,0.11972522080471,0.0255152109911678,0.0278050376185803,0.0919201831861302,0.0771998691527642
"E02002431",524,367,733,123,244,401,3572,0.146696528555431,0.102743561030235,0.205207166853303,0.034434490481523,0.0683090705487122,0.112262038073908
"E02002432",381,335,476,90,245,291,2345,0.162473347547974,0.142857142857143,0.202985074626866,0.0383795309168444,0.104477611940299,0.12409381663113
"E02002433",501,398,915,84,314,417,3313,0.151222456987625,0.120132810141865,0.276184726833686,0.0253546634470269,0.0947781466948385,0.125867793540598
"E02002434",389,358,341,79,279,310,3683,0.105620418137388,0.0972033668205267,0.0925875644854738,0.0214499049687755,0.0757534618517513,0.0841705131686125
"E02002435",463,436,619,134,302,329,2985,0.155108877721943,0.14606365159129,0.207370184254606,0.044891122278057,0.101172529313233,0.110217755443886
"E02002436",318,408,365,100,308,218,2534,0.125493291239148,0.161010260457774,0.144041041831097,0.0394632991318074,0.121546961325967,0.0860299921073402
"E02002437",388,396,179,134,262,254,1837,0.211213935764834,0.215568862275449,0.0974414806750136,0.0729450190528035,0.142623843222646,0.13826891671203
"E02002438",311,499,404,70,429,241,5194,0.0598767809010397,0.0960723912206392,0.0777820562187139,0.0134770889487871,0.0825953022718521,0.0463996919522526
"E02002439",510,349,2039,55,294,455,4369,0.116731517509728,0.0798809796292058,0.46669718471046,0.0125886930647745,0.0672922865644312,0.104142824444953
"E02002440",341,335,378,85,250,256,3953,0.0862635972678978,0.0847457627118644,0.0956235770301037,0.0215026562104731,0.0632431065013914,0.0647609410574247
"E02002441",305,541,781,53,488,252,4944,0.0616909385113269,0.109425566343042,0.15796925566343,0.0107200647249191,0.098705501618123,0.0509708737864078
"E02002442",316,310,815,76,234,240,2490,0.126907630522088,0.124497991967871,0.327309236947791,0.0305220883534137,0.0939759036144578,0.0963855421686747
"E02002443",302,329,231,88,241,214,1915,0.157702349869452,0.171801566579634,0.120626631853786,0.0459530026109661,0.125848563968668,0.111749347258486
"E02002444",380,305,472,88,217,292,3563,0.106651698007297,0.0856020207690149,0.13247263541959,0.0246982879595846,0.0609037328094303,0.0819534100477126
"E02002445",446,460,481,123,337,323,3530,0.126345609065156,0.130311614730878,0.136260623229462,0.0348441926345609,0.0954674220963173,0.0915014164305949
"E02002446",354,254,503,89,165,265,2112,0.167613636363636,0.120265151515152,0.238162878787879,0.0421401515151515,0.078125,0.125473484848485
"E02002447",288,226,523,69,157,219,2670,0.107865168539326,0.0846441947565543,0.195880149812734,0.0258426966292135,0.0588014981273408,0.0820224719101124
"E02002448",341,326,378,70,256,271,4137,0.0824268793811941,0.0788010635726372,0.0913705583756345,0.0169204737732657,0.0618805897993715,0.0655064056079284
"E02002449",344,292,112,76,216,268,3592,0.0957683741648107,0.0812917594654788,0.0311804008908686,0.0211581291759465,0.0601336302895323,0.0746102449888641
"E02002450",299,323,501,58,265,241,3059,0.0977443609022556,0.105590062111801,0.163779012749264,0.0189604445897352,0.086629617522066,0.0787839163125204
"E02002451",389,424,137,123,301,266,2814,0.138237384506041,0.150675195451315,0.0486851457000711,0.0437100213219616,0.106965174129353,0.0945273631840796
"E02002452",330,876,621,72,804,258,5335,0.0618556701030928,0.164198687910028,0.116401124648547,0.0134957825679475,0.150702905342081,0.0483598875351453
"E02002453",472,654,849,95,559,377,4642,0.101680310211116,0.140887548470487,0.182895303748384,0.0204653166738475,0.120422231796639,0.0812149935372684
"E02002454",502,658,1280,90,568,412,4606,0.108988276161528,0.142857142857143,0.277898393399913,0.0195397307859314,0.123317412071211,0.089448545375597
"E02002455",359,271,177,58,213,301,3765,0.0953519256308101,0.0719787516600266,0.0470119521912351,0.0154050464807437,0.0565737051792829,0.0799468791500664
"E02002456",393,435,704,102,333,291,3322,0.118302227573751,0.130945213726671,0.211920529801325,0.0307043949428055,0.100240818783865,0.0875978326309452
"E02002457",377,544,332,93,451,284,3771,0.099973481835057,0.144258817289844,0.0880403076107133,0.0246618933969769,0.119596923892867,0.0753115884380801
"E02002458",462,618,314,137,481,325,3429,0.134733158355206,0.180227471566054,0.0915718868474774,0.0399533391659376,0.140274132400117,0.094779819189268
"E02002459",487,698,594,130,568,357,4133,0.117832083232519,0.168884587466731,0.143721267844181,0.0314541495281878,0.137430437938543,0.086377933704331
"E02002460",394,438,343,120,318,274,2742,0.143690736688549,0.159737417943107,0.12509117432531,0.0437636761487965,0.115973741794311,0.099927060539752
"E02002461",412,481,848,128,353,284,4840,0.0851239669421488,0.0993801652892562,0.175206611570248,0.0264462809917355,0.0729338842975207,0.0586776859504132
"E02002462",440,669,400,172,497,268,3255,0.135176651305684,0.205529953917051,0.122887864823349,0.0528417818740399,0.152688172043011,0.0823348694316436
"E02002463",347,410,229,67,343,280,5310,0.0653483992467043,0.0772128060263653,0.0431261770244821,0.0126177024482109,0.0645951035781544,0.0527306967984934
"E02002464",391,391,790,83,308,308,4496,0.0869661921708185,0.0869661921708185,0.175711743772242,0.0184608540925267,0.0685053380782918,0.0685053380782918
"E02002465",345,435,497,99,336,246,2599,0.132743362831858,0.1673720661793,0.191227395151982,0.0380915736821855,0.129280492497114,0.094651789149673
"E02002466",485,625,393,146,479,339,3764,0.128852284803401,0.166046758767269,0.104410201912859,0.038788522848034,0.127258235919235,0.0900637619553666
"E02002467",543,912,1287,117,795,426,4782,0.113550815558344,0.190715181932246,0.269134253450439,0.0244667503136763,0.16624843161857,0.0890840652446675
"E02002468",329,397,527,89,308,240,2288,0.143793706293706,0.173513986013986,0.230332167832168,0.0388986013986014,0.134615384615385,0.104895104895105
"E02002469",276,374,165,93,281,183,2230,0.123766816143498,0.167713004484305,0.0739910313901345,0.0417040358744395,0.126008968609865,0.0820627802690583
"E02002470",344,420,193,122,298,222,1840,0.18695652173913,0.228260869565217,0.104891304347826,0.066304347826087,0.16195652173913,0.120652173913043
"E02002471",524,599,696,173,426,351,3970,0.131989924433249,0.15088161209068,0.175314861460957,0.0435768261964736,0.107304785894207,0.0884130982367758
"E02002472",360,442,235,126,316,234,2050,0.175609756097561,0.215609756097561,0.114634146341463,0.0614634146341463,0.154146341463415,0.114146341463415
"E02002473",443,447,300,136,311,307,2222,0.199369936993699,0.201170117011701,0.135013501350135,0.0612061206120612,0.13996399639964,0.138163816381638
"E02002474",290,423,153,74,349,216,3092,0.0937904269081501,0.136804657179819,0.0494825355756792,0.0239327296248383,0.112871927554981,0.0698576972833118
"E02002475",311,295,257,84,211,227,2265,0.137306843267108,0.130242825607064,0.113465783664459,0.0370860927152318,0.0931567328918322,0.100220750551876
"E02002476",350,337,247,58,279,292,3399,0.102971462194763,0.099146807884672,0.0726684318917329,0.0170638423065608,0.0820829655781112,0.0859076198882024
"E02002477",318,374,367,87,287,231,2573,0.123591138748543,0.145355616012437,0.14263505635445,0.0338126700349786,0.111542945977458,0.0897784687135639
"E02002478",344,424,128,88,336,256,2524,0.136291600633914,0.167987321711569,0.0507131537242472,0.03486529318542,0.133122028526149,0.101426307448494
"E02002479",382,451,603,77,374,305,3670,0.10408719346049,0.122888283378747,0.164305177111717,0.0209809264305177,0.101907356948229,0.0831062670299728
"E02002480",323,403,426,100,303,223,2863,0.112818721620678,0.140761439049948,0.148794970310863,0.0349283967865875,0.10583304226336,0.0778903248340901
"E02002481",339,382,401,88,294,251,3598,0.094219010561423,0.106170094496943,0.111450806003335,0.0244580322401334,0.0817120622568093,0.0697609783212896
"E02002482",345,322,230,107,215,238,3295,0.104704097116844,0.0977238239757208,0.0698027314112291,0.0324734446130501,0.0652503793626707,0.0722306525037936
"E02002483",311,230,75,61,169,250,4048,0.0768280632411067,0.0568181818181818,0.0185276679841897,0.0150691699604743,0.0417490118577075,0.0617588932806324
"E02002484",616,496,679,108,388,508,5522,0.111553784860558,0.08982252806954,0.122962694675842,0.019558131111916,0.070264396957624,0.0919956537486418
"E02002485",380,403,407,108,295,272,3629,0.104712041884817,0.111049875998898,0.112152108018738,0.0297602645356848,0.081289611463213,0.074951777349132
"E02002489",762,573,1896,155,418,607,3843,0.198282591725215,0.149102263856362,0.493364558938329,0.0403330731199584,0.108769190736404,0.157949518605256
"E02002490",396,753,1083,126,627,270,2956,0.133964817320704,0.254736129905277,0.36637347767253,0.0426251691474966,0.212110960757781,0.091339648173207
"E02002491",324,521,237,92,429,232,2683,0.120760342899739,0.194185613119642,0.0883339545285129,0.0342899739098025,0.15989563920984,0.0864703689899366
"E02002492",286,394,167,86,308,200,2722,0.105069801616458,0.144746509919177,0.0613519470977223,0.0315944158706833,0.113152094048494,0.0734753857457752
"E02002493",306,273,199,70,203,236,2210,0.138461538461538,0.123529411764706,0.0900452488687783,0.0316742081447964,0.0918552036199095,0.106787330316742
"E02002494",383,426,68,103,323,280,3552,0.107826576576577,0.119932432432432,0.0191441441441441,0.0289977477477477,0.0909346846846847,0.0788288288288288
"E02002496",843,955,3044,162,793,681,6593,0.127862884877901,0.144850599120279,0.461701804944638,0.02457151524344,0.120279083876839,0.103291369634461
"E02002497",451,715,1463,114,601,337,3254,0.13859864781807,0.219729563614014,0.44960049170252,0.0350338045482483,0.184695759065765,0.103564843269822
"E02002498",658,667,2867,87,580,571,5089,0.1292984869326,0.131067007270584,0.563371978777756,0.0170956966005109,0.113971310670073,0.112202790332089
"E02002499",321,230,90,65,165,256,3041,0.105557382439987,0.0756330154554423,0.0295955277869122,0.0213745478461033,0.054258467609339,0.0841828345938836
"E02002500",339,339,1235,76,263,263,2188,0.154936014625229,0.154936014625229,0.564442413162706,0.0347349177330896,0.120201096892139,0.120201096892139
"E02002501",195,258,326,46,212,149,2449,0.0796243364638628,0.105349122090649,0.133115557370355,0.0187831768068599,0.0865659452837893,0.0608411596570029
"E02002502",451,335,221,90,245,361,4262,0.105818864382919,0.0786015954950727,0.0518535898639137,0.0211168465509151,0.0574847489441577,0.0847020178320037
"E02002503",208,371,482,72,299,136,2595,0.0801541425818882,0.142967244701349,0.185741811175337,0.0277456647398844,0.115221579961464,0.0524084778420039
"E02002504",418,517,1225,121,396,297,3195,0.130829420970266,0.161815336463224,0.383411580594679,0.0378716744913928,0.123943661971831,0.0929577464788732
"E02002505",289,177,36,46,131,243,2539,0.113824340291453,0.0697124852304057,0.0141788105553367,0.0181173690429303,0.0515951161874754,0.095706971248523
"E02002506",299,281,166,76,205,223,2564,0.116614664586583,0.109594383775351,0.0647425897035881,0.0296411856474259,0.0799531981279251,0.0869734789391576
"E02002507",271,354,159,91,263,180,1765,0.153541076487252,0.20056657223796,0.090084985835694,0.0515580736543909,0.149008498583569,0.101983002832861
"E02002508",265,255,52,64,191,201,1728,0.153356481481481,0.147569444444444,0.0300925925925926,0.037037037037037,0.110532407407407,0.116319444444444
"E02002509",235,255,86,63,192,172,1836,0.127995642701525,0.138888888888889,0.0468409586056645,0.0343137254901961,0.104575163398693,0.093681917211329
"E02002510",383,315,47,118,197,265,2234,0.171441360787825,0.141002685765443,0.0210384959713518,0.0528200537153089,0.0881826320501343,0.118621307072516
"E02002512",296,233,25,70,163,226,1665,0.177777777777778,0.13993993993994,0.015015015015015,0.042042042042042,0.0978978978978979,0.135735735735736
"E02002513",532,481,66,103,378,429,4782,0.11125052279381,0.100585529067336,0.013801756587202,0.0215391049769971,0.0790464240903388,0.089711417816813
"E02002514",437,413,3,105,308,332,3248,0.134544334975369,0.127155172413793,0.000923645320197044,0.0323275862068966,0.0948275862068965,0.102216748768473
"E02002515",614,552,1985,137,415,477,3441,0.178436501017146,0.160418482999128,0.576867189770416,0.039814007555943,0.120604475443185,0.138622493461203
"E02002516",258,422,162,103,319,155,1995,0.129323308270677,0.211528822055138,0.081203007518797,0.0516290726817043,0.159899749373434,0.0776942355889724
"E02002517",279,392,122,81,311,198,2305,0.121041214750542,0.170065075921909,0.0529284164859002,0.0351409978308026,0.134924078091106,0.0859002169197397
"E02002518",654,742,348,206,536,448,3418,0.19133996489175,0.217086015213575,0.101813926272674,0.0602691632533645,0.156816851960211,0.131070801638385
"E02002519",362,215,28,58,157,304,2908,0.124484181568088,0.0739339752407153,0.00962861072902338,0.0199449793672627,0.0539889958734525,0.104539202200825
"E02002520",719,647,557,185,462,534,4139,0.173713457356849,0.156317951195941,0.134573568494806,0.0446967866634453,0.111621164532496,0.129016670693404
"E02002521",457,348,1223,95,253,362,2613,0.174894756984309,0.133180252583238,0.468044393417528,0.0363566781477229,0.0968235744355147,0.138538078836586
"E02002523",266,318,194,58,260,208,2821,0.0942928039702233,0.112725983693726,0.0687699397376817,0.0205600850762141,0.0921658986175115,0.0737327188940092
"E02002524",304,235,431,62,173,242,1783,0.170499158721256,0.131800336511497,0.241727425687044,0.0347728547392036,0.0970274817722939,0.135726303982053
"E02002525",533,431,421,122,309,411,3028,0.176023778071334,0.142338177014531,0.139035667107001,0.0402906208718626,0.102047556142668,0.135733157199472
"E02002526",387,458,627,117,341,270,2769,0.1397616468039,0.165402672444926,0.226435536294691,0.0422535211267606,0.123149151318165,0.0975081256771398
"E02002527",309,319,1000,71,248,238,2115,0.146099290780142,0.150827423167849,0.472813238770686,0.0335697399527187,0.11725768321513,0.112529550827423
"E02002529",324,255,188,65,190,259,2422,0.133773740710157,0.105284888521883,0.0776218001651528,0.0268373245251858,0.0784475639966969,0.106936416184971
"E02002530",529,439,847,108,331,421,2545,0.207858546168959,0.172495088408644,0.332809430255403,0.0424361493123772,0.130058939096267,0.165422396856582
"E02002532",408,384,854,87,297,321,3023,0.134965266291763,0.127026132980483,0.282500826993053,0.0287793582533907,0.0982467747270923,0.106185908038372
"E02002533",355,307,40,89,218,266,2135,0.166276346604215,0.143793911007026,0.0187353629976581,0.0416861826697892,0.102107728337237,0.124590163934426
"E02002534",351,291,154,75,216,276,1484,0.236522911051213,0.196091644204852,0.10377358490566,0.0505390835579515,0.1455525606469,0.185983827493261
"E02002535",557,407,152,140,267,417,2762,0.201665459811731,0.14735698769008,0.055032585083273,0.0506879073135409,0.0966690803765387,0.15097755249819
"E02002536",542,564,143,170,394,372,3708,0.146170442286947,0.15210355987055,0.0385652642934196,0.0458468176914779,0.106256742179072,0.100323624595469
"E02002537",419,342,202,92,250,327,3535,0.118528995756719,0.0967468175388967,0.0571428571428571,0.026025459688826,0.0707213578500707,0.0925035360678925
"E02002538",292,312,231,83,229,209,2069,0.141130981150314,0.150797486708555,0.11164813919768,0.0401159980666989,0.110681488641856,0.101014983083615
"E02002539",406,284,217,83,201,323,3561,0.114012917719742,0.0797528784049424,0.0609379387812412,0.0233080595338388,0.0564448188711036,0.0907048581859028
"E02002540",344,322,141,98,224,246,2033,0.169208066896212,0.158386620757501,0.0693556320708313,0.0482046237088047,0.110181997048697,0.121003443187408
"E02002541",426,435,590,105,330,321,2437,0.174805088223225,0.178498153467378,0.24210094378334,0.0430857611817809,0.135412392285597,0.131719327041444
"E02002542",367,306,78,75,231,292,3235,0.113446676970634,0.0945904173106646,0.0241112828438949,0.0231839258114374,0.0714064914992272,0.0902627511591963
"E02002543",271,240,30,60,180,211,4153,0.0652540332289911,0.0577895497230917,0.00722369371538647,0.0144473874307729,0.0433421622923188,0.0508066457982182
"E02002544",426,373,649,86,287,340,3581,0.118961184026808,0.104160848924881,0.18123429209718,0.024015638089919,0.0801452108349623,0.0949455459368891
"E02002545",338,242,42,84,158,254,1479,0.228532792427316,0.163624070317782,0.0283975659229209,0.0567951318458418,0.10682893847194,0.171737660581474
"E02002546",309,484,803,66,418,243,3284,0.0940925700365408,0.147381242387333,0.244518879415347,0.0200974421437272,0.127283800243605,0.0739951278928136
"E02002547",347,291,132,92,199,255,1979,0.175341081354219,0.147043961596766,0.066700353713997,0.0464881253158161,0.10055583628095,0.128852956038403
"E02002549",467,349,51,103,246,364,2478,0.188458434221146,0.140839386602098,0.0205811138014528,0.0415657788539144,0.099273607748184,0.146892655367232
"E02002550",331,445,818,92,353,239,2390,0.138493723849372,0.186192468619247,0.342259414225941,0.0384937238493724,0.147698744769874,0.1
"E02002551",300,265,1111,35,230,265,3469,0.0864802536754108,0.0763908907466129,0.320265206111271,0.0100893629287979,0.0663015278178149,0.0763908907466129
"E02002552",253,307,176,84,223,169,2595,0.097495183044316,0.118304431599229,0.0678227360308285,0.0323699421965318,0.0859344894026975,0.0651252408477842
"E02002553",236,234,191,73,161,163,2173,0.10860561435803,0.107685227795674,0.0878969167050161,0.0335941095260009,0.0740911182696733,0.0750115048320295
"E02002554",273,185,37,36,149,237,2115,0.129078014184397,0.0874704491725768,0.0174940898345154,0.0170212765957447,0.0704491725768322,0.112056737588652
"E02002555",583,598,377,135,463,448,3761,0.155011964902951,0.159000265886732,0.100239298059027,0.0358947088540282,0.123105557032704,0.119117256048923
"E02002556",383,145,27,51,94,332,2141,0.178888369920598,0.067725361980383,0.0126109294722092,0.0238206445586175,0.0439047174217655,0.15506772536198
"E02002558",565,514,264,127,387,438,4484,0.126003568242641,0.114629794826048,0.0588760035682426,0.0283229259589652,0.086306868867083,0.0976806422836753
"E02002559",416,382,442,104,278,312,4274,0.0973327094057089,0.0893776321946654,0.103416003743566,0.0243331773514272,0.0650444548432382,0.0729995320542817
"E02002560",224,334,755,69,265,155,1958,0.114402451481103,0.170582226762002,0.385597548518897,0.0352400408580184,0.135342185903984,0.0791624106230848
"E02002561",263,448,180,86,362,177,2044,0.12866927592955,0.219178082191781,0.0880626223091976,0.0420743639921722,0.177103718199609,0.0865949119373777
"E02002562",401,401,1499,69,332,332,2856,0.140406162464986,0.140406162464986,0.524859943977591,0.0241596638655462,0.11624649859944,0.11624649859944
"E02002563",203,262,193,50,212,153,1984,0.102318548387097,0.132056451612903,0.0972782258064516,0.0252016129032258,0.106854838709677,0.077116935483871
"E02002564",391,356,801,67,289,324,3571,0.109493139176701,0.0996919630355643,0.22430691683002,0.0187622514701764,0.0809297115653878,0.0907308877065248
"E02002567",338,318,754,75,243,263,4065,0.0831488314883149,0.0782287822878229,0.185485854858549,0.018450184501845,0.0597785977859779,0.0646986469864699
"E02002568",416,508,747,114,394,302,2381,0.174716505669887,0.213355732885342,0.313733725325493,0.0478790424191516,0.165476690466191,0.126837463250735
"E02002569",435,606,412,149,457,286,2738,0.158875091307524,0.221329437545654,0.150474799123448,0.0544192841490139,0.16691015339664,0.10445580715851
"E02002570",475,563,1552,131,432,344,3588,0.132385730211817,0.156911928651059,0.432552954292085,0.0365105908584169,0.120401337792642,0.0958751393534002
"E02002571",183,265,578,33,232,150,2368,0.0772804054054054,0.111908783783784,0.244087837837838,0.0139358108108108,0.097972972972973,0.0633445945945946
"E02002572",372,241,1092,57,184,315,2529,0.147093712930012,0.0952945828390668,0.431791221826809,0.0225385527876631,0.0727560300514037,0.124555160142349
"E02002573",416,354,581,93,261,323,3677,0.113135708457982,0.0962741365243405,0.15800924666848,0.0252923579004623,0.0709817786238782,0.0878433505575197
"E02002574",355,366,182,127,239,228,2677,0.132611131864027,0.136720209189391,0.0679865521105715,0.0474411654837505,0.0892790437056406,0.0851699663802764
"E02002575",372,272,37,80,192,292,2492,0.149277688603531,0.109149277688604,0.0148475120385233,0.0321027287319422,0.0770465489566613,0.117174959871589
"E02002576",442,623,293,142,481,300,2794,0.158196134574087,0.222977809591983,0.10486757337151,0.050823192555476,0.172154617036507,0.107372942018611
"E02002577",403,493,112,126,367,277,2584,0.155959752321981,0.190789473684211,0.043343653250774,0.0487616099071207,0.14202786377709,0.107198142414861
"E02002578",363,707,291,170,537,193,2523,0.143876337693222,0.280221957986524,0.115338882282996,0.0673801030519223,0.212841854934602,0.0764962346413
"E02002579",399,563,244,118,445,281,2576,0.154891304347826,0.218555900621118,0.0947204968944099,0.0458074534161491,0.172748447204969,0.109083850931677
"E02002580",514,850,1038,169,681,345,3631,0.141558799228863,0.234095290553567,0.285871660699532,0.0465436518865326,0.187551638667034,0.0950151473423299
"E02002581",462,534,263,141,393,321,2203,0.209714026327735,0.24239673172946,0.119382660009079,0.0640036314117113,0.178393100317749,0.145710394916024
"E02002582",345,243,142,56,187,289,3200,0.1078125,0.0759375,0.044375,0.0175,0.0584375,0.0903125
"E02002583",435,206,68,42,164,393,3355,0.129657228017884,0.0614008941877794,0.0202682563338301,0.0125186289120715,0.0488822652757079,0.117138599105812
"E02002584",394,622,328,153,469,241,2448,0.160947712418301,0.254084967320261,0.133986928104575,0.0625,0.191584967320261,0.0984477124183007
"E02002585",611,720,1452,169,551,442,4667,0.13091922005571,0.154274694664667,0.311120634240411,0.0362116991643454,0.118062995500321,0.0947075208913649
"E02002586",391,761,85,110,651,281,3499,0.111746213203773,0.217490711631895,0.0242926550442984,0.0314375535867391,0.186053158045156,0.0803086596170334
"E02002587",393,290,20,83,207,310,2362,0.166384419983065,0.122777307366638,0.00846740050804403,0.0351397121083827,0.0876375952582557,0.131244707874682
"E02002588",374,367,13,84,283,290,2782,0.134435657800144,0.131919482386772,0.00467289719626168,0.0301941049604601,0.101725377426312,0.104241552839684
"E02002589",368,380,51,127,253,241,1611,0.228429546865301,0.235878336436996,0.031657355679702,0.0788330229671012,0.157045313469894,0.1495965238982
"E02002590",391,428,216,130,298,261,1922,0.203433922996878,0.222684703433923,0.112382934443288,0.0676378772112383,0.155046826222685,0.13579604578564
"E02002591",476,594,138,196,398,280,2353,0.202294942626434,0.252443688907777,0.0586485337866553,0.0832979175520612,0.169145771355716,0.118997025074373
"E02002592",410,594,255,140,454,270,2049,0.200097608589556,0.289897510980966,0.124450951683748,0.0683260126891166,0.22157149829185,0.131771595900439
"E02002593",378,288,7,115,173,263,1909,0.19800942902043,0.150864326872708,0.0036668412781561,0.0602409638554217,0.0906233630172865,0.137768465165008
"E02002594",376,213,2,81,132,295,2250,0.167111111111111,0.0946666666666667,0.000888888888888889,0.036,0.0586666666666667,0.131111111111111
"E02002595",529,1100,236,151,949,378,4317,0.122538800092657,0.254806578642576,0.0546675932360435,0.0349779939772991,0.219828584665277,0.0875608061153579
"E02002596",529,449,53,177,272,352,2385,0.221802935010482,0.188259958071279,0.0222222222222222,0.0742138364779874,0.114046121593291,0.147589098532495
"E02002597",711,665,308,140,525,571,4211,0.168843505105676,0.157919734029922,0.0731417715507005,0.033246259795773,0.124673474234149,0.135597245309903
"E02002598",286,128,2,37,91,249,4230,0.067612293144208,0.0302600472813239,0.000472813238770686,0.00874704491725768,0.0215130023640662,0.0588652482269504
"E02002599",476,334,6,99,235,377,3287,0.144812899300274,0.101612412534226,0.00182537268025555,0.0301186492242166,0.0714937633100091,0.114694250076057
"E02002600",641,1047,1344,219,828,422,3890,0.164781491002571,0.269151670951157,0.345501285347044,0.0562982005141388,0.212853470437018,0.108483290488432
"E02002601",503,662,192,225,437,278,2863,0.175689835836535,0.231225986727209,0.067062521830248,0.0785888927698219,0.152637093957387,0.0971009430667132
"E02002602",560,878,765,169,709,391,4240,0.132075471698113,0.207075471698113,0.180424528301887,0.0398584905660377,0.167216981132075,0.0922169811320755
"E02002603",345,455,33,127,328,218,1783,0.193494111048794,0.255187885586091,0.018508132361189,0.071228266965788,0.183959618620303,0.122265844083006
"E02002604",475,546,73,172,374,303,2131,0.222900046926326,0.256217738151103,0.0342562177381511,0.0807132801501642,0.175504458000939,0.142186766776161
"E02002605",603,637,104,219,418,384,2823,0.213602550478215,0.225646475380801,0.036840240878498,0.077577045696068,0.148069429684733,0.136025504782147
"E02002606",757,1086,1921,220,866,537,6063,0.124855682005608,0.179119247897081,0.316839848259937,0.0362856671614712,0.142833580735609,0.0885700148441366
"E02002607",930,1033,1101,266,767,664,7354,0.126461789502312,0.14046777264074,0.149714441120479,0.0361707914060375,0.104296981234702,0.0902909980962741
"E02002608",510,671,193,229,442,281,2198,0.232029117379436,0.305277525022748,0.0878070973612375,0.104185623293904,0.201091901728844,0.127843494085532
"E02002609",593,935,465,182,753,411,5374,0.110346110904354,0.173985857834016,0.0865277260885746,0.0338667659099367,0.140119091924079,0.0764793449944176
"E02002610",926,1085,586,328,757,598,4814,0.192355629414209,0.225384295803905,0.121728292480266,0.0681346073950976,0.157249688408808,0.124221022019111
"E02002611",527,769,166,283,486,244,2478,0.212671509281679,0.310330912025827,0.0669895076674738,0.114205004035513,0.196125907990315,0.0984665052461663
"E02002612",675,1037,779,297,740,378,3533,0.191055759977356,0.293518256439287,0.220492499292386,0.0840645343900368,0.20945372204925,0.10699122558732
"E02002613",359,541,228,154,387,205,2274,0.157871591908531,0.237906772207564,0.100263852242744,0.0677220756376429,0.170184696569921,0.0901495162708883
"E02002614",318,390,47,116,274,202,1622,0.196054254007398,0.240443896424168,0.0289765721331689,0.0715166461159063,0.168927250308261,0.124537607891492
"E02002615",734,1212,227,343,869,391,3855,0.190402075226978,0.314396887159533,0.0588845654993515,0.0889753566796368,0.225421530479896,0.101426718547341
"E02002616",625,1036,379,303,733,322,2808,0.222578347578348,0.368945868945869,0.13497150997151,0.107905982905983,0.261039886039886,0.114672364672365
"E02002617",358,775,190,176,599,182,2535,0.141222879684418,0.305719921104536,0.0749506903353057,0.0694280078895464,0.23629191321499,0.0717948717948718
"E02002618",328,672,143,157,515,171,1779,0.184373243395166,0.377740303541315,0.0803822372119168,0.0882518268690275,0.289488476672288,0.0961214165261383
"E02002619",575,1189,333,315,874,260,2867,0.200558074642483,0.414719218695501,0.116149284966864,0.109870945238926,0.304848273456575,0.0906871294035577
"E02002620",404,753,390,168,585,236,3507,0.115198175078415,0.214713430282293,0.111206159110351,0.0479041916167665,0.166809238665526,0.0672939834616481
"E02002621",369,674,161,174,500,195,2359,0.156422212802035,0.285714285714286,0.0682492581602374,0.0737600678253497,0.211954217888936,0.082662144976685
"E02002622",550,780,171,188,592,362,4211,0.130610306340537,0.185229161719307,0.0406079316076941,0.044644977440038,0.140584184279269,0.0859653289004987
"E02002623",705,1758,347,444,1314,261,5400,0.130555555555556,0.325555555555556,0.0642592592592593,0.0822222222222222,0.243333333333333,0.0483333333333333
"E02002624",499,761,141,238,523,261,2879,0.173324070857937,0.264327891629038,0.0489753386592567,0.0826675929142063,0.181660298714832,0.0906564779437305
"E02002625",490,552,219,132,420,358,4005,0.122347066167291,0.137827715355805,0.0546816479400749,0.0329588014981273,0.104868913857678,0.0893882646691635
"E02002626",447,621,159,182,439,265,2863,0.156129933636046,0.216905344044708,0.0555361508906741,0.0635696821515892,0.153335661893119,0.0925602514844569
"E02002627",338,528,258,150,378,188,2167,0.15597600369174,0.243654822335025,0.119058606368251,0.0692201199815413,0.174434702353484,0.0867558837101984
"E02002628",630,1192,1030,339,853,291,3112,0.202442159383033,0.383033419023136,0.330976863753213,0.108933161953728,0.274100257069409,0.0935089974293059
"E02002629",485,854,972,241,613,244,2893,0.167646042170757,0.29519529899758,0.335983408226754,0.0833045281714483,0.211890770826132,0.0843415139993087
"E02002630",554,643,1215,211,432,343,2840,0.195070422535211,0.226408450704225,0.427816901408451,0.0742957746478873,0.152112676056338,0.120774647887324
"E02002631",646,735,1063,207,528,439,3439,0.187845303867403,0.213724920034894,0.309101482989241,0.0601919162547252,0.153533003780169,0.127653387612678
"E02002632",442,330,806,120,210,322,1916,0.230688935281837,0.17223382045929,0.420668058455115,0.0626304801670146,0.109603340292276,0.168058455114823
"E02002633",571,1277,108,339,938,232,2941,0.194151649098946,0.434206052363142,0.0367222033321999,0.115266916014961,0.318939136348181,0.078884733083985
"E02002634",668,680,27,240,440,428,3503,0.190693691121896,0.19411932629175,0.00770767913217242,0.0685127033970882,0.125606622894662,0.122180987724807
"E02002635",665,1496,147,372,1124,293,3271,0.203301742586365,0.457352491592785,0.0449403852033017,0.113726689085906,0.343625802506879,0.0895750535004586
"E02002636",574,882,44,255,627,319,3025,0.189752066115702,0.291570247933884,0.0145454545454545,0.084297520661157,0.207272727272727,0.105454545454545
"E02002637",476,991,73,274,717,202,2170,0.219354838709677,0.45668202764977,0.0336405529953917,0.126267281105991,0.330414746543779,0.0930875576036866
"E02002638",715,2159,540,401,1758,314,4292,0.166589002795899,0.503028890959925,0.125815470643057,0.0934296365330848,0.409599254426841,0.0731593662628145
"E02002639",444,628,51,187,441,257,2757,0.161044613710555,0.22778382299601,0.0184983677910773,0.0678273485672833,0.159956474428727,0.0932172651432717
"E02002640",607,1239,131,241,998,366,3815,0.15910878112713,0.324770642201835,0.0343381389252949,0.0631716906946265,0.261598951507208,0.0959370904325033
"E02002641",672,1317,103,386,931,286,3244,0.207151664611591,0.405980271270037,0.031750924784217,0.118988902589396,0.286991368680641,0.0881627620221948
"E02002642",902,2328,734,474,1854,428,5259,0.171515497242822,0.442669709070165,0.1395702605058,0.0901312036508842,0.352538505419281,0.0813842935919376
"E02002643",704,1544,246,392,1152,312,3665,0.192087312414734,0.421282401091405,0.0671214188267394,0.106957708049113,0.314324693042292,0.0851296043656207
"E02002644",602,1274,88,340,934,262,2862,0.210342417889588,0.445143256464011,0.0307477288609364,0.118798043326345,0.326345213137666,0.0915443745632425
"E02002645",695,2020,842,417,1603,278,4470,0.155480984340045,0.451901565995526,0.188366890380313,0.0932885906040268,0.358612975391499,0.0621923937360179
"E02002646",508,610,53,192,418,316,2986,0.17012726054923,0.204286671131949,0.0177494976557267,0.0643000669792364,0.139986604152713,0.105827193569993
"E02002647",770,1554,123,439,1115,331,3634,0.211887727022565,0.427627958172812,0.0338470005503577,0.120803522289488,0.306824435883324,0.0910842047330765
"E02002648",550,1073,62,315,758,235,2715,0.202578268876611,0.395211786372007,0.0228360957642726,0.116022099447514,0.279189686924494,0.0865561694290976
"E02002649",672,1775,298,409,1366,263,3864,0.173913043478261,0.459368530020704,0.0771221532091097,0.105848861283644,0.35351966873706,0.068064182194617
"E02002650",561,912,67,279,633,282,3059,0.183393265773128,0.298136645962733,0.0219025825433148,0.0912062765609676,0.206930369401765,0.0921869892121608
"E02002651",580,1063,72,295,768,285,2699,0.214894405335309,0.393849573916265,0.0266765468692108,0.109299740644683,0.284549833271582,0.105594664690626
"E02002653",376,629,20,106,523,270,3476,0.108170310701956,0.180955120828539,0.00575373993095512,0.0304948216340621,0.150460299194476,0.0776754890678941
"E02002654",211,187,199,42,145,169,3029,0.0696599537801254,0.0617365467150875,0.0656982502476065,0.0138659623638164,0.047870584351271,0.055793991416309
"E02002655",390,307,46,82,225,308,3057,0.127576054955839,0.100425253516519,0.0150474321229964,0.0268236833496892,0.0736015701668302,0.10075237160615
"E02002656",326,305,412,81,224,245,1748,0.18649885583524,0.174485125858124,0.235697940503432,0.0463386727688787,0.128146453089245,0.140160183066362
"E02002657",391,279,15,80,199,311,2287,0.170966331438566,0.121993878443376,0.00655881066899869,0.034980323567993,0.0870135548753826,0.135986007870573
"E02002658",401,291,287,74,217,327,2411,0.16632102861883,0.120696806304438,0.119037743674824,0.030692658647864,0.090004147656574,0.135628369970966
"E02002659",507,505,1262,115,390,392,4365,0.116151202749141,0.115693012600229,0.289117983963345,0.0263459335624284,0.0893470790378007,0.0898052691867125
"E02002660",363,365,420,96,269,267,2684,0.135245901639344,0.135991058122206,0.156482861400894,0.0357675111773472,0.100223546944858,0.099478390461997
"E02002661",366,331,616,76,255,290,3018,0.121272365805169,0.109675281643472,0.204108681245858,0.0251822398939695,0.084493041749503,0.0960901259111995
"E02002662",270,365,259,63,302,207,3310,0.081570996978852,0.110271903323263,0.0782477341389728,0.0190332326283988,0.091238670694864,0.0625377643504532
"E02002663",259,213,1544,39,174,220,2304,0.112413194444444,0.0924479166666667,0.670138888888889,0.0169270833333333,0.0755208333333333,0.0954861111111111
"E02002664",294,293,590,58,235,236,1787,0.164521544487969,0.163961947397874,0.330162283156128,0.0324566312255176,0.131505316172356,0.132064913262451
"E02002665",310,254,1581,48,206,262,2513,0.123358535614803,0.101074413052129,0.629128531635495,0.0191006764822921,0.0819737365698368,0.104257859132511
"E02002666",650,413,2964,85,328,565,4525,0.143646408839779,0.0912707182320442,0.655027624309392,0.0187845303867403,0.0724861878453039,0.124861878453039
"E02002667",360,573,2049,97,476,263,2951,0.121992544900034,0.194171467299221,0.69434090138936,0.0328702134869536,0.161301253812267,0.0891223314130803
"E02002668",389,446,700,68,378,321,4130,0.0941888619854722,0.107990314769976,0.169491525423729,0.0164648910411622,0.0915254237288136,0.0777239709443099
"E02002669",536,375,3032,60,315,476,3889,0.137824633581898,0.0964258164052456,0.779634867575212,0.0154281306248393,0.0809976857804063,0.122396502957058
"E02002670",356,387,618,77,310,279,3292,0.108140947752126,0.117557715674362,0.187727825030377,0.0233900364520049,0.0941676792223572,0.0847509113001215
"E02002671",358,360,1618,55,305,303,3121,0.114706824735662,0.115347644985582,0.518423582185197,0.0176225568727972,0.0977250881127844,0.0970842678628645
"E02002672",368,300,818,67,233,301,3308,0.111245465538089,0.090689238210399,0.247279322853688,0.0202539298669891,0.0704353083434099,0.0909915356711004
"E02002673",412,545,2442,92,453,320,3280,0.125609756097561,0.166158536585366,0.744512195121951,0.0280487804878049,0.138109756097561,0.0975609756097561
"E02002674",283,524,1883,80,444,203,2755,0.102722323049002,0.190199637023593,0.683484573502722,0.029038112522686,0.161161524500907,0.0736842105263158
"E02002675",816,466,1728,122,344,694,4500,0.181333333333333,0.103555555555556,0.384,0.0271111111111111,0.0764444444444444,0.154222222222222
"E02002676",492,401,2803,64,337,428,3446,0.142774230992455,0.116366802089379,0.813406848520023,0.0185722576900754,0.0977945443993035,0.12420197330238
"E02002677",592,540,1402,89,451,503,4430,0.133634311512415,0.121896162528217,0.31647855530474,0.0200902934537246,0.101805869074492,0.113544018058691
"E02002678",393,332,2463,51,281,342,3458,0.11364950838635,0.0960092539039907,0.712261422787739,0.0147484094852516,0.0812608444187392,0.0989010989010989
"E02002679",300,270,1376,51,219,249,2562,0.117096018735363,0.105386416861827,0.537080405932865,0.0199063231850117,0.085480093676815,0.0971896955503513
"E02002680",472,468,1156,94,374,378,7311,0.0645602516755574,0.0640131308986459,0.158117904527424,0.0128573382574203,0.0511557926412256,0.0517029134181371
"E02002681",816,577,2743,130,447,686,5034,0.162097735399285,0.114620580055622,0.544894715931665,0.0258243941199841,0.0887961859356377,0.136273341279301
"E02002682",397,360,1676,68,292,329,4659,0.0852114187593904,0.077269800386349,0.359733848465336,0.0145954067396437,0.0626743936467053,0.0706160120197467
"E02002684",777,802,159,218,584,559,4517,0.172016825326544,0.177551472216073,0.0352003542174009,0.0482621208766881,0.129289351339385,0.123754704449856
"E02002685",689,730,378,254,476,435,3130,0.220127795527157,0.233226837060703,0.120766773162939,0.081150159744409,0.152076677316294,0.138977635782748
"E02002686",470,778,519,154,624,316,3575,0.131468531468531,0.217622377622378,0.145174825174825,0.0430769230769231,0.174545454545455,0.0883916083916084
"E02002687",685,446,1437,116,330,569,3009,0.227650382186773,0.148222000664673,0.477567298105683,0.0385510136257893,0.109670987038883,0.189099368560984
"E02002688",861,459,1844,114,345,747,3158,0.272640911969601,0.145345155161495,0.583913869537682,0.0360987967067764,0.109246358454718,0.236542115262825
"E02002689",514,313,585,114,199,400,2509,0.204862495017935,0.124750896771622,0.233160621761658,0.045436428856118,0.0793144679155042,0.159426066161817
"E02002691",550,370,537,121,249,429,2990,0.183946488294314,0.123745819397993,0.179598662207358,0.0404682274247492,0.0832775919732441,0.143478260869565
"E02002692",485,293,300,110,183,375,2991,0.162153126044801,0.0979605483116015,0.100300902708124,0.0367769976596456,0.0611835506519559,0.125376128385155
"E02002693",494,388,545,131,257,363,2710,0.182287822878229,0.143173431734317,0.201107011070111,0.0483394833948339,0.0948339483394834,0.133948339483395
"E02002694",566,422,710,125,297,441,5807,0.0974685724126055,0.0726709144136387,0.122266230411572,0.0215257447907698,0.0511451696228689,0.0759428276218357
"E02002695",648,552,978,167,385,481,3406,0.190252495596007,0.162066940692895,0.287140340575455,0.0490311215502055,0.113035819142689,0.141221374045802
"E02002696",412,249,448,80,169,332,2046,0.201368523949169,0.121700879765396,0.218963831867058,0.0391006842619746,0.0826001955034213,0.162267839687195
"E02002697",399,359,379,106,253,293,2485,0.16056338028169,0.144466800804829,0.15251509054326,0.0426559356136821,0.101810865191147,0.117907444668008
"E02002698",345,253,310,69,184,276,3473,0.0993377483443709,0.0728476821192053,0.08926000575871,0.0198675496688742,0.0529801324503311,0.0794701986754967
"E02002699",533,379,294,92,287,441,3195,0.166823161189358,0.118622848200313,0.092018779342723,0.0287949921752739,0.0898278560250391,0.138028169014085
"E02002700",283,389,414,77,312,206,2529,0.111901937524713,0.153815737445631,0.163701067615658,0.0304468169236853,0.123368920521945,0.0814551206010281
"E02002701",485,336,591,125,211,360,2851,0.170115748860049,0.117853384777271,0.207295685724307,0.0438442651701157,0.0740091196071554,0.126271483689933
"E02002702",585,528,1490,101,427,484,4936,0.118517017828201,0.106969205834684,0.301863857374392,0.0204619124797407,0.0865072933549433,0.0980551053484603
"E02002703",422,231,241,78,153,344,4109,0.102701387198832,0.0562180579216354,0.0586517400827452,0.0189827208566561,0.0372353370649793,0.0837186663421757
"E02002704",570,440,450,148,292,422,2296,0.248257839721254,0.191637630662021,0.195993031358885,0.0644599303135888,0.127177700348432,0.183797909407665
"E02002705",407,414,334,141,273,266,2628,0.154870624048706,0.157534246575342,0.127092846270928,0.0536529680365297,0.103881278538813,0.101217656012177
"E02002706",374,459,823,110,349,264,2576,0.145186335403727,0.178183229813665,0.319487577639752,0.0427018633540373,0.135481366459627,0.102484472049689
"E02002707",421,285,332,89,196,332,2246,0.187444345503117,0.126892252894034,0.147818343722173,0.0396260017809439,0.0872662511130899,0.147818343722173
"E02002708",366,430,591,114,316,252,2410,0.151867219917012,0.178423236514523,0.245228215767635,0.0473029045643154,0.131120331950207,0.104564315352697
"E02002709",424,417,419,138,279,286,2607,0.162639048714998,0.159953970080552,0.16072113540468,0.0529344073647871,0.107019562715765,0.109704641350211
"E02002710",337,504,767,116,388,221,2210,0.152488687782805,0.228054298642534,0.347058823529412,0.0524886877828054,0.175565610859728,0.1
"E02002711",474,447,514,146,301,328,2888,0.164127423822715,0.154778393351801,0.17797783933518,0.0505540166204986,0.104224376731302,0.113573407202216
"E02002712",414,460,466,115,345,299,2578,0.160589604344453,0.178432893716059,0.180760279286268,0.0446082234290147,0.133824670287044,0.115981380915438
"E02002714",544,416,501,128,288,416,2578,0.211016291698991,0.161365399534523,0.19433669511249,0.0496508921644686,0.111714507370054,0.161365399534523
"E02002715",514,422,480,132,290,382,5054,0.101701622477246,0.0834982192322913,0.0949742777997626,0.0261179263949347,0.0573802928373566,0.075583696082311
"E02002716",454,360,214,105,255,349,2749,0.165150963986904,0.130956711531466,0.0778464896325937,0.0381957075300109,0.0927610040014551,0.126955256456893
"E02002717",381,394,1203,89,305,292,3213,0.118580765639589,0.122626828509181,0.374416433239963,0.0276999688764395,0.094926859632742,0.0908807967631497
"E02002718",448,406,555,113,293,335,2672,0.167664670658683,0.151946107784431,0.207709580838323,0.0422904191616766,0.109655688622754,0.125374251497006
"E02002719",303,267,781,64,203,239,2699,0.112263801407929,0.0989255279733234,0.289366432011856,0.0237124861059652,0.0752130418673583,0.0885513153019637
"E02002720",343,224,464,71,153,272,2480,0.138306451612903,0.0903225806451613,0.187096774193548,0.0286290322580645,0.0616935483870968,0.109677419354839
"E02002721",320,345,477,94,251,226,3046,0.10505581089954,0.113263296126067,0.156598818122127,0.03086014445174,0.082403151674327,0.0741956664478004
"E02002722",648,523,1361,130,393,518,3426,0.189141856392294,0.152656158785756,0.397256275539988,0.0379451255107998,0.114711033274956,0.151196730881494
"E02002723",753,321,1855,80,241,673,3521,0.213859698949162,0.0911672820221528,0.526838966202783,0.0227208179494462,0.0684464640727066,0.191138880999716
"E02002724",578,285,1604,88,197,490,3730,0.154959785522788,0.0764075067024129,0.430026809651475,0.0235924932975871,0.0528150134048257,0.131367292225201
"E02002725",345,279,395,84,195,261,2241,0.153949129852744,0.124497991967871,0.176260597947345,0.0374832663989291,0.0870147255689424,0.116465863453815
"E02002726",675,483,294,157,326,518,3881,0.173924246328266,0.124452460706004,0.0757536717340892,0.0404534913682041,0.0839989693377995,0.133470754960062
"E02002727",416,401,1062,60,341,356,3048,0.136482939632546,0.131561679790026,0.348425196850394,0.0196850393700787,0.111876640419948,0.116797900262467
"E02002728",604,601,2431,100,501,504,4125,0.146424242424242,0.14569696969697,0.589333333333333,0.0242424242424242,0.121454545454545,0.122181818181818
"E02002729",382,240,86,52,188,330,2184,0.174908424908425,0.10989010989011,0.0393772893772894,0.0238095238095238,0.0860805860805861,0.151098901098901
"E02002730",526,259,2610,54,205,472,3117,0.168752005133141,0.0830927173564325,0.837343599615014,0.0173243503368624,0.0657683670195701,0.151427654796278
"E02002731",436,222,2022,42,180,394,2490,0.175100401606426,0.0891566265060241,0.812048192771084,0.0168674698795181,0.072289156626506,0.158232931726908
"E02002732",408,435,250,118,317,290,2747,0.148525664361121,0.158354568620313,0.0910083727702949,0.0429559519475792,0.115398616672734,0.105569712413542
"E02002733",370,554,1069,98,456,272,2376,0.155723905723906,0.233164983164983,0.449915824915825,0.0412457912457912,0.191919191919192,0.114478114478114
"E02002734",336,296,269,76,220,260,2109,0.159317211948791,0.140350877192982,0.127548601232812,0.036036036036036,0.104314841156946,0.123281175912755
"E02002736",431,214,1940,48,166,383,2513,0.171508157580581,0.0851571826502189,0.771985674492638,0.0191006764822921,0.0660565061679268,0.152407481098289
"E02002737",363,462,851,113,349,250,2339,0.155194527575887,0.197520307823856,0.363830696879008,0.0483112441214194,0.149209063702437,0.106883283454468
"E02002738",474,386,94,136,250,338,2158,0.219647822057461,0.178869323447637,0.0435588507877665,0.0630213160333642,0.115848007414272,0.156626506024096
"E02002739",356,288,1067,56,232,300,2615,0.136137667304015,0.110133843212237,0.408030592734226,0.021414913957935,0.0887189292543021,0.11472275334608
"E02002740",294,417,301,95,322,199,1990,0.147738693467337,0.209547738693467,0.151256281407035,0.0477386934673367,0.161809045226131,0.1
"E02002741",511,593,1644,124,469,387,3161,0.161657703258463,0.187598861119899,0.520088579563429,0.0392280923758304,0.148370768744068,0.122429610882632
"E02002743",346,268,95,80,188,266,1912,0.180962343096234,0.140167364016736,0.0496861924686192,0.0418410041841004,0.098326359832636,0.139121338912134
"E02002744",395,407,495,117,290,278,2703,0.14613392526822,0.150573436921939,0.183129855715871,0.0432852386237514,0.107288198298187,0.102848686644469
"E02002745",629,374,90,145,229,484,2371,0.26528890763391,0.157739350485027,0.0379586672290173,0.061155630535639,0.0965837199493884,0.204133277098271
"E02002746",478,516,229,107,409,371,3746,0.127602776294714,0.137746930058729,0.0611318739989322,0.0285638013881474,0.109183128670582,0.099038974906567
"E02002747",469,448,171,113,335,356,3708,0.126483279395901,0.120819848975189,0.0461165048543689,0.0304746494066882,0.0903451995685005,0.0960086299892125
"E02002748",498,404,274,117,287,381,2711,0.183696053116931,0.149022500922169,0.101069715971966,0.0431575064551826,0.105864994466986,0.140538546661748
"E02002749",606,470,986,135,335,471,4527,0.133863485752154,0.10382151535233,0.217804285398719,0.0298210735586481,0.0740004417936824,0.104042412193506
"E02002750",376,188,560,51,137,325,2106,0.178537511870845,0.0892687559354226,0.265906932573599,0.0242165242165242,0.0650522317188984,0.154320987654321
"E02002751",310,311,476,67,244,243,2169,0.142923005993545,0.143384047948363,0.219455970493315,0.0308898109727985,0.112494236975565,0.112033195020747
"E02002752",386,349,616,92,257,294,2506,0.154030327214685,0.13926576217079,0.245810055865922,0.0367118914604948,0.102553870710295,0.11731843575419
"E02002753",490,505,605,120,385,370,3006,0.163007318695941,0.167997338656021,0.201264138389887,0.0399201596806387,0.128077178975383,0.123087159015303
"E02002754",495,397,647,110,287,385,3013,0.164288084965151,0.131762363093263,0.214736143378692,0.0365084633255891,0.0952538997676734,0.127779621639562
"E02002755",277,494,849,77,417,200,2900,0.0955172413793103,0.170344827586207,0.292758620689655,0.026551724137931,0.143793103448276,0.0689655172413793
"E02002756",433,516,1696,65,451,368,3708,0.116774541531823,0.13915857605178,0.457389428263215,0.017529665587918,0.121628910463862,0.0992448759439051
"E02002757",263,680,267,131,549,132,1855,0.14177897574124,0.366576819407008,0.143935309973046,0.0706199460916442,0.295956873315364,0.0711590296495957
"E02002758",269,601,885,81,520,188,2398,0.112176814011676,0.250625521267723,0.369057547956631,0.0337781484570475,0.216847372810676,0.0783986655546289
"E02002759",477,467,801,131,336,346,3428,0.139148191365228,0.136231038506418,0.233663943990665,0.0382147024504084,0.0980163360560093,0.100933488914819
"E02002760",258,491,307,91,400,167,1961,0.131565527791943,0.250382457929628,0.156552779194289,0.0464048954614992,0.203977562468129,0.0851606323304436
"E02002761",370,348,410,90,258,280,2236,0.165474060822898,0.155635062611807,0.183363148479428,0.0402504472271914,0.115384615384615,0.125223613595707
"E02002762",250,414,265,70,344,180,2338,0.106928999144568,0.177074422583405,0.113344739093242,0.029940119760479,0.147134302822926,0.076988879384089
"E02002763",298,565,355,91,474,207,3579,0.0832634814193909,0.157865325509919,0.0991897177982677,0.0254260966750489,0.13243922883487,0.057837384744342
"E02002764",279,299,73,63,236,216,1919,0.14538822303283,0.155810317873893,0.0380406461698801,0.0328295987493486,0.122980719124544,0.112558624283481
"E02002765",355,494,401,116,378,239,2482,0.143029814665592,0.199033037872683,0.161563255439162,0.0467365028203062,0.152296535052377,0.0962933118452861
"E02002766",384,393,87,92,301,292,2902,0.132322536181943,0.135423845623708,0.0299793246037216,0.0317022742935906,0.103721571330117,0.100620261888353
"E02002767",394,410,123,115,295,279,2044,0.192759295499022,0.200587084148728,0.0601761252446184,0.0562622309197652,0.144324853228963,0.136497064579256
"E02002768",386,281,334,86,195,300,2578,0.149728471683476,0.10899922420481,0.12955779674166,0.0333591931730023,0.0756400310318076,0.116369278510473
"E02002769",298,257,235,73,184,225,1682,0.177170035671819,0.152794292508918,0.139714625445898,0.0434007134363853,0.109393579072533,0.133769322235434
"E02002770",406,263,442,85,178,321,2562,0.158469945355191,0.102654176424668,0.172521467603435,0.0331772053083529,0.0694769711163154,0.125292740046838
"E02002771",417,295,355,106,189,311,2210,0.18868778280543,0.133484162895928,0.160633484162896,0.0479638009049774,0.0855203619909502,0.140723981900452
"E02002772",336,261,142,80,181,256,2078,0.161693936477382,0.125601539942252,0.068334937439846,0.0384985563041386,0.0871029836381136,0.123195380173244
"E02002773",426,363,186,143,220,283,1808,0.235619469026549,0.200774336283186,0.10287610619469,0.0790929203539823,0.121681415929204,0.156526548672566
"E02002774",425,401,57,130,271,295,1857,0.228863758750673,0.215939687668282,0.0306946688206785,0.0700053850296177,0.145934302638665,0.158858373721055
"E02002775",316,268,281,75,193,241,2510,0.125896414342629,0.106772908366534,0.11195219123506,0.0298804780876494,0.0768924302788845,0.0960159362549801
"E02002776",415,338,65,107,231,308,2369,0.175179400590967,0.142676234698185,0.0274377374419586,0.0451667370198396,0.0975094976783453,0.130012663571127
"E02002777",415,286,74,105,181,310,3054,0.135887360838245,0.0936476751800917,0.0242305173542895,0.0343811394891945,0.0592665356908972,0.10150622134905
"E02002778",489,393,620,85,308,404,2930,0.166894197952218,0.134129692832765,0.21160409556314,0.0290102389078498,0.105119453924915,0.137883959044369
"E02002779",651,646,500,205,441,446,3060,0.212745098039216,0.211111111111111,0.163398692810458,0.0669934640522876,0.144117647058824,0.145751633986928
"E02002780",438,303,1283,62,241,376,3005,0.145757071547421,0.100831946755408,0.426955074875208,0.0206322795341098,0.0801996672212978,0.125124792013311
"E02002781",465,396,1334,75,321,390,4463,0.104190006721936,0.0887295541115841,0.298902083800134,0.0168048397938606,0.0719247143177235,0.0873851669280753
"E02002782",358,259,179,91,168,267,1914,0.187042842215256,0.135318704284222,0.093521421107628,0.0475444096133751,0.0877742946708464,0.139498432601881
"E02002783",473,531,325,158,373,315,3113,0.151943462897526,0.170575008030838,0.104400899453903,0.0507548988114359,0.119820109219403,0.101188564086091
"E02002784",713,295,2120,68,227,645,6881,0.103618660078477,0.0428716756285424,0.308094753669525,0.009882284551664,0.0329893910768784,0.093736375526813
"E02002785",399,457,80,140,317,259,2685,0.148603351955307,0.170204841713222,0.0297951582867784,0.0521415270018622,0.118063314711359,0.0964618249534451
"E02002786",417,587,854,108,479,309,3692,0.112946912242687,0.15899241603467,0.231310942578548,0.0292524377031419,0.129739978331528,0.083694474539545
"E02002787",549,554,1188,137,417,412,3752,0.146321961620469,0.147654584221748,0.316631130063966,0.0365138592750533,0.111140724946695,0.109808102345416
"E02002788",605,583,1797,143,440,462,4001,0.151212196950762,0.145713571607098,0.449137715571107,0.0357410647338165,0.109972506873282,0.115471132216946
"E02002789",393,392,327,128,264,265,2968,0.132412398921833,0.132075471698113,0.110175202156334,0.0431266846361186,0.0889487870619946,0.0892857142857143
"E02002790",677,475,1701,117,358,560,4527,0.149547161475591,0.104925999558206,0.375745526838966,0.025844930417495,0.0790810691407113,0.123702231058096
"E02002791",373,249,185,96,153,277,1868,0.199678800856531,0.133297644539615,0.0990364025695931,0.0513918629550321,0.0819057815845824,0.148286937901499
"E02002792",454,491,1302,119,372,335,3487,0.130197877831947,0.140808718095784,0.37338686550043,0.0341267565242329,0.106681961571551,0.0960711213077144
"E02002793",562,504,151,169,335,393,3187,0.176341386884217,0.15814245371823,0.0473799811735174,0.0530279259491685,0.105114527769062,0.123313460935049
"E02002794",366,287,349,90,197,276,2086,0.175455417066155,0.13758389261745,0.167305848513902,0.0431447746883988,0.0944391179290508,0.132310642377756
"E02002795",443,435,195,144,291,299,2346,0.188832054560955,0.18542199488491,0.0831202046035806,0.061381074168798,0.124040920716113,0.127450980392157
"E02002796",357,415,334,129,286,228,1795,0.198885793871866,0.231197771587744,0.186072423398329,0.071866295264624,0.15933147632312,0.127019498607242
"E02002797",489,652,270,148,504,341,2483,0.196939186467982,0.26258558195731,0.108739428111156,0.0596053161498188,0.202980265807491,0.137333870318164
"E02002798",689,288,48,91,197,598,3436,0.200523864959255,0.0838183934807916,0.0139697322467986,0.0264842840512224,0.0573341094295693,0.174039580908033
"E02002799",247,157,88,34,123,213,2117,0.116674539442607,0.0741615493623052,0.0415682569674067,0.0160604629192253,0.0581010864430798,0.100614076523382
"E02002800",392,380,1129,94,286,298,2994,0.130928523714095,0.126920507682031,0.377087508350033,0.0313961255845023,0.0955243820975284,0.0995323981295925
"E02002801",336,248,609,68,180,268,2128,0.157894736842105,0.116541353383459,0.286184210526316,0.0319548872180451,0.0845864661654135,0.12593984962406
"E02002802",432,237,1057,50,187,382,2877,0.150156412930136,0.0823774765380605,0.367396593673966,0.0173792144595064,0.0649982620785541,0.132777198470629
"E02002803",464,302,1343,52,250,412,4495,0.103225806451613,0.0671857619577308,0.298776418242492,0.0115684093437152,0.0556173526140156,0.0916573971078977
"E02002804",432,331,216,89,242,343,3245,0.133127889060092,0.102003081664099,0.0665639445300462,0.0274268104776579,0.0745762711864407,0.105701078582435
"E02002805",353,331,419,107,224,246,1639,0.215375228798048,0.201952410006101,0.255643685173887,0.0652837095790116,0.13666870042709,0.150091519219036
"E02002806",414,190,1792,33,157,381,3265,0.126799387442573,0.0581929555895865,0.54885145482389,0.0101071975497703,0.0480857580398162,0.116692189892802
"E02002807",438,542,759,157,385,281,2668,0.164167916041979,0.203148425787106,0.28448275862069,0.0588455772113943,0.144302848575712,0.105322338830585
"E02002808",940,609,3165,95,514,845,7962,0.118060788746546,0.0764883195177091,0.397513187641296,0.0119316754584275,0.0645566440592816,0.106129113288119
"E02002809",357,403,401,122,281,235,2502,0.142685851318945,0.161071143085532,0.160271782573941,0.0487609912070344,0.112310151878497,0.0939248601119105
"E02002810",448,480,159,146,334,302,3456,0.12962962962963,0.138888888888889,0.0460069444444444,0.0422453703703704,0.0966435185185185,0.0873842592592593
"E02002811",666,223,2881,47,176,619,4364,0.152612282309808,0.0510999083409716,0.660174152153987,0.0107699358386801,0.0403299725022915,0.141842346471127
"E02002812",394,447,567,126,321,268,2889,0.13637937002423,0.15472481827622,0.196261682242991,0.043613707165109,0.111111111111111,0.0927656628591208
"E02002813",580,226,2453,51,175,529,5622,0.103166133048737,0.04019921736037,0.436321593738883,0.00907150480256137,0.0311277125578086,0.0940946282461757
"E02002814",498,572,374,186,386,312,2504,0.19888178913738,0.228434504792332,0.149361022364217,0.0742811501597444,0.154153354632588,0.124600638977636
"E02002815",413,190,2034,44,146,369,2503,0.165001997602877,0.0759089093088294,0.812624850179784,0.0175789053136237,0.0583300039952058,0.147423092289253
"E02002816",438,482,314,95,387,343,2973,0.147325933400605,0.162125798856374,0.105617221661621,0.0319542549613185,0.130171543895056,0.115371678439287
"E02002817",377,275,504,83,192,294,1660,0.22710843373494,0.16566265060241,0.303614457831325,0.05,0.11566265060241,0.17710843373494
"E02002818",358,334,1388,51,283,307,2693,0.132937244708504,0.124025250649833,0.515410323059785,0.0189379873746751,0.105087263275158,0.113999257333828
"E02002819",467,336,649,97,239,370,3206,0.145664379288833,0.104803493449782,0.202432938240798,0.0302557704304429,0.0745477230193387,0.115408608858391
"E02002820",557,345,1994,73,272,484,3621,0.153824910245788,0.0952775476387738,0.550676608671638,0.020160176746755,0.0751173708920188,0.133664733499033
"E02002821",769,414,1552,86,328,683,4849,0.158589399876263,0.0853784285419674,0.320065992988245,0.0177356155908435,0.0676428129511239,0.14085378428542
"E02002822",367,430,328,124,306,243,2214,0.16576332429991,0.194218608852755,0.148148148148148,0.0560072267389341,0.138211382113821,0.109756097560976
"E02002823",500,379,402,119,260,381,2552,0.195924764890282,0.148510971786834,0.157523510971787,0.0466300940438871,0.101880877742947,0.149294670846395
"E02002824",617,521,286,164,357,453,3444,0.179152148664344,0.151277584204413,0.0830429732868757,0.0476190476190476,0.103658536585366,0.131533101045296
"E02002825",464,369,413,128,241,336,3088,0.150259067357513,0.11949481865285,0.133743523316062,0.0414507772020725,0.0780440414507772,0.10880829015544
"E02002826",356,314,131,96,218,260,2383,0.149391523289971,0.131766680654637,0.0549727234578263,0.0402853545950483,0.0914813260595888,0.109106168694922
"E02002827",440,235,8,73,162,367,2396,0.183639398998331,0.0980801335559265,0.00333889816360601,0.0304674457429048,0.0676126878130217,0.153171953255426
"E02002828",400,351,417,92,259,308,2595,0.154142581888247,0.135260115606936,0.160693641618497,0.0354527938342967,0.0998073217726397,0.11868978805395
"E02002829",672,436,463,101,335,571,4013,0.167455768751557,0.108646897582856,0.115375031148767,0.0251682033391478,0.0834786942437079,0.14228756541241
"E02002830",559,586,58,143,443,416,3903,0.14322316167051,0.150140917243146,0.0148603638227005,0.0366384832180374,0.113502434025109,0.106584678452472
"E02002831",328,397,686,90,307,238,1888,0.173728813559322,0.210275423728814,0.363347457627119,0.0476694915254237,0.16260593220339,0.126059322033898
"E02002832",364,232,1584,51,181,313,3076,0.118335500650195,0.0754226267880364,0.514954486345904,0.0165799739921977,0.0588426527958388,0.101755526657997
"E02002833",325,156,1785,17,139,308,2329,0.139544869042508,0.0669815371404036,0.766423357664234,0.0072992700729927,0.0596822670674109,0.132245598969515
"E02002834",373,471,942,102,369,271,5463,0.0682775032033681,0.086216364634816,0.172432729269632,0.0186710598572213,0.0675453047775947,0.0496064433461468
"E02002836",326,291,1832,34,257,292,2807,0.116138225863912,0.103669397933737,0.652654079087994,0.0121125757035981,0.0915568222301389,0.104025650160313
"E02002837",442,458,771,114,344,328,2619,0.168766704849179,0.17487590683467,0.29438717067583,0.0435280641466208,0.131347842688049,0.125238640702558
"E02002838",551,326,104,81,245,470,2862,0.192522711390636,0.113906359189378,0.0363382250174703,0.0283018867924528,0.0856044723969252,0.164220824598183
"E02002839",513,443,402,130,313,383,2341,0.219137120888509,0.189235369500214,0.171721486544212,0.0555318240068347,0.133703545493379,0.163605296881674
"E02002842",681,179,3125,31,148,650,4308,0.158077994428969,0.0415506035283194,0.725394614670381,0.00719591457753018,0.0343546889507892,0.150882079851439
"E02002843",660,327,2798,74,253,586,3773,0.174927113702624,0.0866684336072091,0.741584945666578,0.0196130400212033,0.0670553935860058,0.155314073681421
"E02002844",428,265,973,58,207,370,3476,0.12313003452244,0.0762370540851554,0.279919447640967,0.0166858457997698,0.0595512082853855,0.10644418872267
"E02002845",656,554,927,139,415,517,3580,0.183240223463687,0.154748603351955,0.258938547486034,0.0388268156424581,0.115921787709497,0.144413407821229
"E02002846",404,353,1163,76,277,328,2449,0.1649652919559,0.144140465496121,0.474887709269089,0.0310330747243773,0.113107390771744,0.133932217231523
"E02002847",391,179,2068,38,141,353,2385,0.163941299790356,0.0750524109014675,0.867085953878407,0.0159329140461216,0.0591194968553459,0.148008385744235
"E02002848",620,211,2902,45,166,575,3523,0.175986375248368,0.0598921373829123,0.823729775759296,0.0127732046551235,0.0471189327277888,0.163213170593244
"E02002849",1191,289,4141,61,228,1130,6538,0.182165799938819,0.0442031202202508,0.633374120526155,0.00933007035790762,0.0348730498623432,0.172835729580912
"E02002851",401,466,362,129,337,272,2127,0.188528443817583,0.219087917254349,0.170192759755524,0.0606488011283498,0.158439116125999,0.127879642689234
"E02002852",342,739,412,127,612,215,2111,0.162008526764567,0.350071056371388,0.195168166745618,0.0601610611084794,0.289909995262909,0.101847465656087
"E02002853",684,454,2594,100,354,584,3966,0.172465960665658,0.114473020675744,0.654059505799294,0.0252143217347453,0.0892586989409985,0.147251638930913
"E02002854",606,281,1221,85,196,521,2819,0.21496984746364,0.0996807378503015,0.433132316424264,0.0301525363604115,0.06952820148989,0.184817311103228
"E02002855",492,174,2061,41,133,451,3261,0.150873965041398,0.0533578656853726,0.632014719411224,0.0125728304201165,0.0407850352652561,0.138301134621282
"E02002856",826,548,3535,74,474,752,5533,0.149286101572384,0.0990421109705404,0.638893909271643,0.0133742996566058,0.0856678113139346,0.135911801915778
"E02002857",590,158,2288,38,120,552,3461,0.170470962149668,0.0456515457960127,0.661080612539728,0.0109794856977752,0.0346720600982375,0.159491476451893
"E02002858",401,330,1324,62,268,339,2352,0.170493197278912,0.14030612244898,0.562925170068027,0.0263605442176871,0.113945578231293,0.144132653061224
"E02002860",508,365,1128,94,271,414,2878,0.176511466296039,0.126824183460737,0.391938846421126,0.0326615705350938,0.0941626129256428,0.143849895760945
"E02002861",398,114,458,29,85,369,2267,0.175562417291575,0.0502867225408028,0.202029113365682,0.0127922364358183,0.0374944861049846,0.162770180855757
"E02002862",625,260,77,68,192,557,3005,0.207986688851913,0.086522462562396,0.0256239600665557,0.0226289517470882,0.0638935108153078,0.185357737104825
"E02002863",415,230,570,96,134,319,2635,0.157495256166983,0.0872865275142315,0.216318785578748,0.0364326375711575,0.050853889943074,0.121062618595825
"E02002864",356,293,492,103,190,253,3230,0.110216718266254,0.0907120743034056,0.152321981424149,0.0318885448916409,0.0588235294117647,0.078328173374613
"E02002865",448,343,362,95,248,353,3183,0.140747722274584,0.107759974866478,0.113729186302231,0.0298460571787622,0.077913917687716,0.110901665095822
"E02002866",510,343,632,111,232,399,2586,0.197215777262181,0.132637277648879,0.244392884764114,0.04292343387471,0.0897138437741686,0.154292343387471
"E02002867",514,358,1009,107,251,407,3115,0.165008025682183,0.114927768860353,0.323916532905297,0.0343499197431782,0.080577849117175,0.130658105939005
"E02002868",321,286,22,90,196,231,1843,0.174172544763972,0.155181768855128,0.0119370591427021,0.0488334237655996,0.106348345089528,0.125339120998372
"E02002869",505,254,1058,60,194,445,3611,0.139850456937137,0.0703406258654112,0.292993630573248,0.0166158958737192,0.0537247299916921,0.123234561063417
"E02002871",490,305,1379,74,231,416,2964,0.16531713900135,0.102901484480432,0.465249662618084,0.0249662618083671,0.0779352226720648,0.140350877192982
"E02002872",652,472,253,128,344,524,3903,0.167050986420702,0.120932615936459,0.064821931847297,0.0327952856776838,0.0881373302587753,0.134255700743018
"E02002873",483,351,79,101,250,382,4361,0.110754414125201,0.0804861270350837,0.0181151112130245,0.023159825728044,0.0573263013070397,0.0875945883971566
"E02002874",392,210,1506,36,174,356,2989,0.131147540983607,0.0702576112412178,0.503847440615591,0.0120441619270659,0.0582134493141519,0.119103379056541
"E02002875",663,398,1522,107,291,556,3816,0.17374213836478,0.104297693920335,0.398846960167715,0.0280398322851153,0.0762578616352201,0.145702306079665
"E02002876",504,429,607,112,317,392,3277,0.153799206591395,0.130912419896247,0.185230393652731,0.0341776014647543,0.0967348184314922,0.11962160512664
"E02002877",830,385,2341,88,297,742,3967,0.209226115452483,0.0970506680110915,0.590118477438871,0.0221830098311066,0.0748676581799849,0.187043105621376
"E02002878",547,282,166,56,226,491,3956,0.138270980788675,0.0712841253791709,0.0419615773508595,0.0141557128412538,0.0571284125379171,0.124115267947422
"E02002879",608,441,2123,95,346,513,4270,0.142388758782201,0.10327868852459,0.497189695550351,0.022248243559719,0.0810304449648712,0.120140515222482
"E02002880",410,181,1671,20,161,390,3649,0.112359550561798,0.0496026308577693,0.4579336804604,0.00548095368594135,0.0441216771718279,0.106878596875856
"E02002881",273,192,77,56,136,217,3045,0.0896551724137931,0.0630541871921182,0.0252873563218391,0.0183908045977011,0.0446633825944171,0.071264367816092
"E02002882",728,613,2379,118,495,610,4431,0.164296998420221,0.13834348905439,0.536899119837508,0.0266305574362446,0.111712931618145,0.137666440983977
"E02002883",570,384,781,110,274,460,3875,0.147096774193548,0.0990967741935484,0.201548387096774,0.0283870967741936,0.0707096774193548,0.118709677419355
"E02002884",626,266,2193,71,195,555,3122,0.200512491992313,0.0852017937219731,0.702434336963485,0.0227418321588725,0.0624599615631006,0.17777065983344
"E02002885",689,402,2566,69,333,620,4193,0.16432148819461,0.0958740758406869,0.611972334843787,0.0164559980920582,0.0794180777486287,0.147865490102552
"E02002886",448,474,1161,114,360,334,3665,0.122237380627558,0.129331514324693,0.316780354706685,0.0311050477489768,0.0982264665757162,0.0911323328785812
"E02002887",323,226,272,53,173,270,3040,0.10625,0.0743421052631579,0.0894736842105263,0.0174342105263158,0.0569078947368421,0.0888157894736842
"E02002888",361,203,838,47,156,314,3584,0.100725446428571,0.056640625,0.233816964285714,0.0131138392857143,0.0435267857142857,0.0876116071428571
"E02002889",421,333,1815,34,299,387,4373,0.0962725817516579,0.0761490967299337,0.415046878573062,0.00777498284930254,0.0683741138806312,0.0884975989023554
"E02002890",391,231,903,53,178,338,6023,0.0649178150423377,0.0383529802424041,0.149925286402125,0.008799601527478,0.0295533787149261,0.0561182135148597
"E02002891",360,417,1496,75,342,285,3137,0.114759324195091,0.13292955052598,0.476888747210711,0.0239081925406439,0.109021357985336,0.0908511316544469
"E02002892",315,196,209,52,144,263,2620,0.120229007633588,0.0748091603053435,0.0797709923664122,0.0198473282442748,0.0549618320610687,0.100381679389313
"E02002893",621,435,1796,74,361,547,5525,0.112398190045249,0.0787330316742081,0.325067873303167,0.013393665158371,0.0653393665158371,0.0990045248868778
"E02002895",617,407,2079,55,352,562,5482,0.112550164173659,0.0742429770156877,0.379241152863918,0.0100328347318497,0.064210142283838,0.10251732944181
"E02002896",1006,585,3178,143,442,863,5402,0.186227323213625,0.108293224731581,0.58830062939652,0.0264716771566087,0.0818215475749722,0.159755646057016
"E02002897",377,425,577,107,318,270,2356,0.160016977928693,0.180390492359932,0.24490662139219,0.0454159592529711,0.134974533106961,0.114601018675722
"E02002898",905,410,2179,105,305,800,4253,0.212790971079238,0.0964025393839643,0.512344227604044,0.0246884552080884,0.0717140841758759,0.18810251587115
"E02002901",324,277,482,82,195,242,2511,0.129032258064516,0.11031461569096,0.191955396256472,0.0326563122262047,0.0776583034647551,0.0963759458383114
"E02002902",490,331,69,90,241,400,3534,0.138653084323713,0.0936615732880589,0.0195246179966044,0.0254668930390492,0.0681946802490096,0.113186191284663
"E02002903",412,229,68,83,146,329,2987,0.137931034482759,0.0766655507197857,0.0227653163709407,0.0277870773351188,0.0488784733846669,0.11014395714764
"E02002904",440,155,56,55,100,385,2732,0.161054172767204,0.0567349926793558,0.020497803806735,0.0201317715959004,0.0366032210834553,0.140922401171303
"E02002905",661,280,714,129,151,532,2371,0.278785322648671,0.118093631379165,0.301138760016871,0.0544074230282581,0.0636862083509068,0.224377899620413
"E02002906",435,386,139,133,253,302,2130,0.204225352112676,0.181220657276995,0.0652582159624413,0.0624413145539906,0.118779342723005,0.141784037558685
"E02002907",447,377,642,115,262,332,2647,0.168870419342652,0.142425387230827,0.242538723082735,0.0434454098979977,0.0989799773328296,0.125425009444654
"E02002908",711,479,812,198,281,513,2929,0.242744964151588,0.163537043359508,0.277227722772277,0.0675998634346193,0.095937179924889,0.175145100716968
"E02002909",849,500,1008,197,303,652,3961,0.21433981317849,0.126230749810654,0.254481191618278,0.0497349154253976,0.0764958343852562,0.164604897753093
"E02002910",775,460,953,197,263,578,3013,0.257218718884832,0.152671755725191,0.316296050448058,0.0653833388649187,0.0872884168602722,0.191835380019914
"E02002911",619,439,632,162,277,457,3274,0.189065363469762,0.134086744043983,0.193036041539401,0.049480757483201,0.0846059865607819,0.139584605986561
"E02002912",437,293,338,115,178,322,2430,0.179835390946502,0.120576131687243,0.139094650205761,0.0473251028806584,0.0732510288065844,0.132510288065844
"E02002913",416,292,565,108,184,308,2104,0.197718631178707,0.138783269961977,0.268536121673004,0.0513307984790875,0.0874524714828897,0.14638783269962
"E02002914",678,574,287,154,420,524,3337,0.203176505843572,0.172010788133054,0.0860053940665268,0.0461492358405754,0.125861552292478,0.157027270002997
"E02002915",373,386,322,108,278,265,3423,0.108968740870581,0.112766579024248,0.0940695296523517,0.0315512708150745,0.0812153082091732,0.0774174700555069
"E02002916",690,644,1508,137,507,553,4598,0.150065245759026,0.140060896041757,0.327968682035668,0.0297955632883863,0.110265332753371,0.120269682470639
"E02002917",444,396,946,124,272,320,2808,0.158119658119658,0.141025641025641,0.336894586894587,0.0441595441595442,0.0968660968660969,0.113960113960114
"E02002918",349,411,177,111,300,238,1740,0.200574712643678,0.236206896551724,0.101724137931034,0.0637931034482759,0.172413793103448,0.136781609195402
"E02002919",363,653,264,134,519,229,3443,0.105431309904153,0.189660180075516,0.0766773162939297,0.0389195469067674,0.150740633168748,0.066511762997386
"E02002920",459,177,184,64,113,395,2315,0.198272138228942,0.0764578833693305,0.0794816414686825,0.027645788336933,0.0488120950323974,0.170626349892009
"E02002921",371,589,197,118,471,253,2811,0.131981501245108,0.209533973674849,0.0700818214158662,0.0419779437922448,0.167556029882604,0.0900035574528637
"E02002922",433,253,638,102,151,331,2091,0.207077953132473,0.120994739359158,0.305117168818747,0.0487804878048781,0.0722142515542803,0.158297465327594
"E02002923",624,421,648,134,287,490,4164,0.14985590778098,0.101104707012488,0.155619596541787,0.032180595581172,0.068924111431316,0.117675312199808
"E02002924",550,348,733,146,202,404,2030,0.270935960591133,0.171428571428571,0.361083743842365,0.0719211822660099,0.0995073891625616,0.199014778325123
"E02002925",868,537,896,230,307,638,3872,0.224173553719008,0.138688016528926,0.231404958677686,0.059400826446281,0.0792871900826446,0.164772727272727
"E02002926",701,665,832,176,489,525,4824,0.145315091210614,0.137852404643449,0.172470978441128,0.0364842454394693,0.10136815920398,0.108830845771144
"E02002927",882,606,1399,232,374,650,4244,0.207822808671065,0.142789820923657,0.329641847313855,0.0546654099905749,0.088124410933082,0.15315739868049
"E02002928",347,307,191,105,202,242,2094,0.165711556829035,0.146609360076409,0.0912129894937918,0.0501432664756447,0.0964660936007641,0.115568290353391
"E02002929",344,309,408,104,205,240,2177,0.158015617822692,0.141938447404685,0.187413872301332,0.0477721635277905,0.0941662838768948,0.110243454294901
"E02002930",375,299,327,97,202,278,2914,0.128689087165408,0.102608098833219,0.112216884008236,0.0332875772134523,0.0693205216197667,0.0954015099519561
"E02002931",316,223,175,67,156,249,2505,0.126147704590818,0.0890219560878244,0.0698602794411178,0.0267465069860279,0.0622754491017964,0.0994011976047904
"E02002932",287,310,127,44,266,243,3246,0.0884165126309304,0.0955021565003081,0.0391250770178681,0.0135551447935921,0.081947011706716,0.0748613678373383
"E02002933",531,367,49,130,237,401,2819,0.1883646683221,0.1301880099326,0.0173820503724725,0.0461156438453352,0.084072366087265,0.142249024476765
"E02002934",341,263,42,62,201,279,2377,0.143458140513252,0.110643668489693,0.0176693310896088,0.0260832982751367,0.0845603702145562,0.117374842238115
"E02002935",385,410,289,125,285,260,2210,0.17420814479638,0.18552036199095,0.130769230769231,0.0565610859728507,0.1289592760181,0.117647058823529
"E02002936",383,379,225,123,256,260,4047,0.0946380034593526,0.0936496170002471,0.055596738324685,0.0303928836174944,0.0632567333827527,0.0642451198418582
"E02002937",651,460,855,161,299,490,4095,0.158974358974359,0.112332112332112,0.208791208791209,0.0393162393162393,0.073015873015873,0.11965811965812
"E02002938",360,368,576,83,285,277,2808,0.128205128205128,0.131054131054131,0.205128205128205,0.0295584045584046,0.101495726495726,0.0986467236467237
"E02002939",341,353,455,106,247,235,3098,0.110071013557134,0.113944480309877,0.146868947708199,0.0342156229825694,0.0797288573273079,0.0758553905745642
"E02002940",362,334,478,108,226,254,2333,0.155165023574796,0.143163309044149,0.204886412344621,0.0462923274753536,0.0968709815687955,0.108872696099443
"E02002941",516,494,380,132,362,384,4095,0.126007326007326,0.120634920634921,0.0927960927960928,0.0322344322344322,0.0884004884004884,0.0937728937728938
"E02002942",291,196,82,45,151,246,3521,0.0826469752911105,0.0556660039761431,0.0232888383981823,0.0127804600965635,0.0428855438795797,0.069866515194547
"E02002944",396,467,165,108,359,288,3350,0.118208955223881,0.139402985074627,0.0492537313432836,0.0322388059701493,0.107164179104478,0.0859701492537313
"E02002945",538,629,24,175,454,363,3395,0.158468335787923,0.185272459499264,0.00706921944035346,0.0515463917525773,0.133726067746686,0.106921944035346
"E02002946",517,416,190,114,302,403,2948,0.175373134328358,0.141112618724559,0.0644504748982361,0.0386702849389417,0.102442333785617,0.136702849389417
"E02002947",425,346,30,124,222,301,2478,0.171509281678773,0.139628732849072,0.0121065375302663,0.0500403551251009,0.0895883777239709,0.121468926553672
"E02002948",485,445,40,129,316,356,2925,0.165811965811966,0.152136752136752,0.0136752136752137,0.0441025641025641,0.108034188034188,0.121709401709402
"E02002949",307,285,300,67,218,240,2254,0.13620230700976,0.126441881100266,0.133096716947649,0.0297249334516415,0.0967169476486247,0.106477373558119
"E02002950",361,441,38,116,325,245,2322,0.155469422911283,0.189922480620155,0.016365202411714,0.0499569336778639,0.139965546942291,0.105512489233419
"E02002951",456,493,210,162,331,294,2555,0.178473581213307,0.192954990215264,0.0821917808219178,0.0634050880626223,0.129549902152642,0.115068493150685
"E02002952",386,437,360,129,308,257,2721,0.141859610437339,0.160602719588387,0.132304299889746,0.0474090407938258,0.113193678794561,0.0944505696435134
"E02002953",392,428,127,127,301,265,2355,0.166454352441614,0.181740976645435,0.053927813163482,0.053927813163482,0.127813163481953,0.112526539278132
"E02002954",584,645,292,229,416,355,2949,0.198033231603934,0.218718209562564,0.0990166158019668,0.0776534418446931,0.14106476771787,0.12037978975924
"E02002955",520,506,1428,118,388,402,3142,0.165499681731381,0.161043921069383,0.45448758752387,0.037555697008275,0.123488224061108,0.127943984723106
"E02002956",622,717,1081,225,492,397,3190,0.194984326018809,0.224764890282132,0.338871473354232,0.0705329153605016,0.15423197492163,0.124451410658307
"E02002957",565,651,445,225,426,340,2890,0.195501730103806,0.225259515570934,0.153979238754325,0.0778546712802768,0.147404844290657,0.117647058823529
"E02002958",514,662,679,174,488,340,3217,0.159776188995959,0.20578178427106,0.211066210755362,0.0540876593099161,0.151694124961144,0.105688529686043
"E02002959",546,683,1458,168,515,378,4619,0.118207404200043,0.147867503788699,0.315652738688028,0.0363715089846287,0.11149599480407,0.0818358952154146
"E02002960",371,321,173,130,191,241,1712,0.216705607476636,0.1875,0.101051401869159,0.0759345794392523,0.111565420560748,0.140771028037383
"E02002961",551,501,1150,145,356,406,3274,0.168295662797801,0.153023824068418,0.351252290775809,0.0442883323152108,0.108735491753207,0.12400733048259
"E02002962",407,414,166,172,242,235,2984,0.136394101876676,0.138739946380697,0.0556300268096515,0.0576407506702413,0.0810991957104558,0.0787533512064343
"E02002963",603,746,1927,167,579,436,3585,0.168200836820084,0.208089260808926,0.537517433751743,0.0465829846582985,0.161506276150628,0.121617852161785
"E02002964",541,572,379,186,386,355,2854,0.189558514365802,0.20042046250876,0.132796075683252,0.0651716888577435,0.135248773651016,0.124386825508059
"E02002965",488,452,1245,111,341,377,3279,0.148825861543153,0.137846904544068,0.379688929551693,0.0338517840805123,0.103995120463556,0.114974077462641
"E02002966",602,716,2084,154,562,448,5054,0.119113573407202,0.141669964384646,0.412346656113969,0.0304709141274238,0.111199050257222,0.0886426592797784
"E02002967",665,446,22,200,246,465,3973,0.167379813742764,0.112257739743267,0.00553737729675308,0.0503397936068462,0.0619179461364208,0.117040020135917
"E02002968",640,743,1538,203,540,437,3820,0.167539267015707,0.194502617801047,0.40261780104712,0.0531413612565445,0.141361256544503,0.114397905759162
"E02002969",688,824,2283,180,644,508,4824,0.142620232172471,0.170812603648425,0.473258706467662,0.0373134328358209,0.133499170812604,0.10530679933665
"E02002970",683,715,1860,185,530,498,3742,0.182522715125601,0.191074291822555,0.497060395510422,0.0494388027792624,0.141635489043292,0.133083912346339
"E02002973",432,565,756,138,427,294,2865,0.150785340314136,0.197207678883072,0.263874345549738,0.0481675392670157,0.149040139616056,0.10261780104712
"E02002974",360,383,112,112,271,248,1880,0.191489361702128,0.203723404255319,0.0595744680851064,0.0595744680851064,0.144148936170213,0.131914893617021
"E02002975",431,327,49,125,202,306,2021,0.21326076199901,0.161801088570015,0.0242454230578921,0.061850569025235,0.0999505195447798,0.151410192973775
"E02002976",325,355,125,131,224,194,1767,0.183927560837578,0.200905489530277,0.0707413695529145,0.0741369552914544,0.126768534238823,0.109790605546123
"E02002977",453,465,306,135,330,318,2265,0.2,0.205298013245033,0.135099337748344,0.0596026490066225,0.145695364238411,0.140397350993377
"E02002978",416,417,325,111,306,305,2895,0.143696027633851,0.144041450777202,0.112262521588946,0.0383419689119171,0.105699481865285,0.105354058721934
"E02002979",396,306,974,90,216,306,1837,0.215568862275449,0.166575939031029,0.530212302667392,0.0489929232444202,0.117583015786609,0.166575939031029
"E02002980",414,421,141,146,275,268,1890,0.219047619047619,0.222751322751323,0.0746031746031746,0.0772486772486772,0.145502645502645,0.141798941798942
"E02002981",426,477,167,112,365,314,2672,0.159431137724551,0.178517964071856,0.0625,0.0419161676646707,0.136601796407186,0.11751497005988
"E02002982",413,474,48,126,348,287,3284,0.125761266747868,0.144336175395859,0.0146163215590743,0.03836784409257,0.105968331303289,0.0873934226552984
"E02002983",279,181,25,69,112,210,1421,0.1963406052076,0.127375087966221,0.0175932441942294,0.0485573539760732,0.0788177339901478,0.147783251231527
"E02002984",350,271,77,102,169,248,1558,0.224646983311938,0.173940949935815,0.0494223363286264,0.0654685494223363,0.108472400513479,0.159178433889602
"E02002985",297,448,504,104,344,193,2699,0.110040755835495,0.165987402741756,0.186735828084476,0.0385327899221934,0.127454612819563,0.0715079659133012
"E02002986",287,490,256,130,360,157,2967,0.0967307044152342,0.165149983147961,0.0862824401752612,0.0438153016514998,0.121334681496461,0.0529154027637344
"E02002987",410,600,209,203,397,207,2061,0.19893255701116,0.291120815138282,0.101407083939835,0.0984958757884522,0.19262493934983,0.100436681222707
"E02002988",340,481,643,109,372,231,2150,0.158139534883721,0.223720930232558,0.29906976744186,0.0506976744186046,0.173023255813953,0.107441860465116
"E02002989",335,482,338,117,365,218,2132,0.157129455909944,0.226078799249531,0.158536585365854,0.0548780487804878,0.171200750469043,0.102251407129456
"E02002990",410,439,1419,90,349,320,3144,0.130407124681934,0.139631043256997,0.451335877862595,0.0286259541984733,0.111005089058524,0.101781170483461
"E02002991",740,512,3414,99,413,641,7119,0.103947183593201,0.0719202135131339,0.479561736198904,0.0139064475347661,0.0580137659783677,0.0900407360584352
"E02002992",357,430,740,123,307,234,2123,0.168158266603862,0.202543570419218,0.348563353744701,0.0579368817710787,0.144606688648139,0.110221384832784
"E02002993",424,292,1607,43,249,381,3281,0.129228893629991,0.0889972569338616,0.489789698262725,0.0131057604388906,0.075891496494971,0.1161231331911
"E02002994",728,713,1102,223,490,505,3584,0.203125,0.198939732142857,0.307477678571429,0.0622209821428571,0.13671875,0.140904017857143
"E02002995",284,408,269,99,309,185,2706,0.104951958610495,0.150776053215078,0.0994087213599409,0.0365853658536585,0.114190687361419,0.0683665927568367
"E02002996",530,507,1727,113,394,417,3690,0.143631436314363,0.13739837398374,0.468021680216802,0.0306233062330623,0.106775067750678,0.113008130081301
"E02002997",411,319,1509,84,235,327,3577,0.114900754822477,0.0891808778305843,0.421861895443109,0.0234833659491194,0.0656975118814649,0.0914173888733576
"E02002998",346,395,938,87,308,259,2242,0.154326494201606,0.176181980374665,0.418376449598573,0.0388046387154326,0.137377341659233,0.115521855486173
"E02002999",301,557,203,147,410,154,2072,0.14527027027027,0.268822393822394,0.097972972972973,0.0709459459459459,0.197876447876448,0.0743243243243243
"E02003000",617,625,689,225,400,392,2977,0.2072556264696,0.209942895532415,0.231441048034935,0.0755794423916695,0.134363453140746,0.131676184077931
"E02003001",317,353,812,96,257,221,1842,0.172095548317047,0.191639522258415,0.440825190010858,0.0521172638436482,0.139522258414767,0.119978284473398
"E02003002",312,362,540,94,268,218,2777,0.112351458408354,0.13035649981995,0.194454447245229,0.0338494778537991,0.0965070219661505,0.0785019805545553
"E02003003",307,447,216,127,320,180,2121,0.144743045733145,0.210749646393211,0.101838755304102,0.0598774163130599,0.150872230080151,0.0848656294200849
"E02003004",357,324,522,111,213,246,2216,0.161101083032491,0.146209386281588,0.235559566787004,0.0500902527075812,0.0961191335740072,0.11101083032491
"E02003005",387,328,647,99,229,288,2029,0.190734351897486,0.161655988171513,0.318876293740759,0.0487925086249384,0.112863479546575,0.141941843272548
"E02003006",515,503,683,132,371,383,3034,0.169742913645353,0.165787738958471,0.225115359261701,0.043506921555702,0.122280817402769,0.126235992089651
"E02003007",464,545,530,175,370,289,3102,0.149580915538362,0.175693101225016,0.170857511283043,0.0564152159896841,0.119277885235332,0.0931656995486783
"E02003008",351,396,562,103,293,248,2323,0.151097718467499,0.170469220835127,0.241928540680155,0.0443392165303487,0.126130004304778,0.10675850193715
"E02003009",356,288,533,97,191,259,2029,0.175455889600789,0.141941843272548,0.262690980778709,0.0478068013799901,0.0941350418925579,0.127649088220798
"E02003010",289,344,425,106,238,183,2137,0.13523631258774,0.160973327094057,0.198876930276088,0.0496022461394478,0.111371080954609,0.085634066448292
"E02003011",324,373,215,113,260,211,1953,0.165898617511521,0.190988223246288,0.110087045570917,0.0578597030209933,0.133128520225294,0.108038914490527
"E02003012",492,565,515,140,425,352,4350,0.113103448275862,0.129885057471264,0.118390804597701,0.032183908045977,0.0977011494252874,0.0809195402298851
"E02003013",553,662,365,201,461,352,4106,0.134680954700438,0.161227471992207,0.0888943010228933,0.0489527520701413,0.112274719922065,0.0857282026302971
"E02003014",280,308,419,83,225,197,3123,0.0896573807236631,0.0986231187960295,0.134165866154339,0.026577009285943,0.0720461095100865,0.0630803714377201
"E02003015",313,440,625,116,324,197,2490,0.12570281124498,0.176706827309237,0.251004016064257,0.0465863453815261,0.130120481927711,0.0791164658634538
"E02003016",287,347,742,88,259,199,3059,0.0938215102974828,0.113435763321347,0.242562929061785,0.0287675711016672,0.0846681922196796,0.0650539391958156
"E02003017",397,500,1069,75,425,322,2307,0.17208495882098,0.216731686172518,0.463372345036844,0.0325097529258778,0.184221933246641,0.139575205895102
"E02003018",267,374,194,113,261,154,1777,0.150253235790658,0.210467079347214,0.109172763083849,0.0635903207653348,0.14687675858188,0.0866629150253236
"E02003019",543,555,1045,179,376,364,3472,0.15639400921659,0.159850230414747,0.300979262672811,0.0515552995391705,0.108294930875576,0.104838709677419
"E02003020",325,535,772,120,415,205,1872,0.173611111111111,0.285790598290598,0.412393162393162,0.0641025641025641,0.221688034188034,0.109508547008547
"E02003021",472,207,1664,64,143,408,2556,0.184663536776213,0.0809859154929577,0.651017214397496,0.0250391236306729,0.0559467918622848,0.15962441314554
"E02003022",316,238,989,74,164,242,1711,0.18468731735827,0.139099941554646,0.57802454704851,0.043249561659848,0.0958503798947984,0.141437755698422
"E02003023",326,406,499,93,313,233,2090,0.155980861244019,0.194258373205742,0.238755980861244,0.0444976076555024,0.149760765550239,0.111483253588517
"E02003024",477,431,1274,103,328,374,3995,0.119399249061327,0.107884856070088,0.318898623279099,0.0257822277847309,0.0821026282853567,0.0936170212765957
"E02003025",320,331,657,80,251,240,2821,0.11343495214463,0.117334278624601,0.232896136121943,0.0283587380361574,0.0889755405884438,0.0850762141084722
"E02003026",346,697,965,112,585,234,2529,0.136812969553183,0.275603005140372,0.381573744563068,0.044286279161724,0.231316725978648,0.0925266903914591
"E02003027",745,305,2915,74,231,671,4691,0.1588147516521,0.0650181198038798,0.621402685994457,0.0157748880835643,0.0492432317203155,0.143039863568535
"E02003028",591,291,1962,37,254,554,3131,0.188757585435963,0.0929415522197381,0.626636857234111,0.0118173107633344,0.0811242414564037,0.176940274672629
"E02003029",306,397,529,97,300,209,1872,0.163461538461538,0.21207264957265,0.28258547008547,0.0518162393162393,0.16025641025641,0.111645299145299
"E02003030",481,513,1336,106,407,375,3160,0.152215189873418,0.162341772151899,0.422784810126582,0.0335443037974684,0.12879746835443,0.118670886075949
"E02003031",731,175,2971,38,137,693,4157,0.175847967284099,0.0420976665864806,0.714698099591051,0.0091412076016358,0.0329564589848448,0.166706759682463
"E02003032",467,393,1253,104,289,363,3095,0.150888529886914,0.126978998384491,0.404846526655897,0.0336025848142165,0.0933764135702746,0.117285945072698
"E02003033",577,199,2924,32,167,545,3972,0.145266868076536,0.0501007049345418,0.736153071500504,0.0080563947633434,0.0420443101711984,0.137210473313192
"E02003036",377,288,2284,42,246,335,4677,0.0806072268548215,0.0615779345734445,0.488347231131067,0.00898011545862733,0.0525978191148172,0.0716271113961941
"E02003037",553,223,3375,32,191,521,4689,0.117935593943271,0.0475581147366176,0.719769673704415,0.00682448283216038,0.0407336319044572,0.111111111111111
"E02003038",370,424,1075,105,319,265,2561,0.144474814525576,0.165560327996876,0.419757907067552,0.0409996095275283,0.124560718469348,0.103475204998048
"E02003039",510,450,1499,124,326,386,3490,0.146131805157593,0.128939828080229,0.429512893982808,0.0355300859598854,0.0934097421203438,0.110601719197708
"E02003040",800,288,3084,68,220,732,5028,0.159108989657916,0.0572792362768496,0.613365155131265,0.0135242641209228,0.0437549721559268,0.145584725536993
"E02003041",316,170,2111,7,163,309,3140,0.100636942675159,0.054140127388535,0.672292993630573,0.00222929936305732,0.0519108280254777,0.0984076433121019
"E02003044",446,497,636,176,321,270,2156,0.206864564007421,0.230519480519481,0.294990723562152,0.0816326530612245,0.148886827458256,0.125231910946197
"E02003045",322,232,1641,36,196,286,3065,0.105057096247961,0.0756933115823817,0.535399673735726,0.0117455138662316,0.0639477977161501,0.0933115823817292
"E02003046",680,306,1597,84,222,596,3902,0.1742696053306,0.0784213223987699,0.409277293695541,0.0215274218349564,0.0568939005638134,0.152742183495643
"E02003047",608,324,2754,62,262,546,4721,0.128786274094472,0.0686295276424486,0.583350984960813,0.0131328108451599,0.0554967167972887,0.115653463249312
"E02003048",520,360,2226,57,303,463,3398,0.153031194820483,0.105944673337257,0.655091230135374,0.0167745732783991,0.0891701000588582,0.136256621542084
"E02003049",426,445,1054,132,313,294,2649,0.160815402038505,0.1679879199698,0.397885994714987,0.0498301245753114,0.118157795394488,0.110985277463194
"E02003050",479,365,1899,92,273,387,5803,0.0825435119765638,0.062898500775461,0.327244528692056,0.0158538686886093,0.0470446320868516,0.0666896432879545
"E02003051",411,322,1349,97,225,314,2785,0.147576301615799,0.115619389587074,0.484380610412926,0.0348294434470377,0.0807899461400359,0.112746858168761
"E02003052",448,276,1657,86,190,362,2681,0.16710182767624,0.102946661693398,0.618052965311451,0.0320775829914211,0.0708690787019769,0.135024244684819
"E02003053",506,417,1411,113,304,393,2708,0.18685376661743,0.153988183161004,0.521048744460857,0.0417282127031019,0.112259970457903,0.145125553914328
"E02003054",469,333,944,96,237,373,2311,0.202942449156209,0.144093466032021,0.408481176979662,0.0415404586758979,0.102553007356123,0.161401990480312
"E02003055",330,414,288,119,295,211,2576,0.128105590062112,0.160714285714286,0.111801242236025,0.046195652173913,0.114518633540373,0.0819099378881988
"E02003056",338,323,241,100,223,238,2290,0.147598253275109,0.141048034934498,0.105240174672489,0.0436681222707424,0.0973799126637555,0.103930131004367
"E02003057",310,545,363,150,395,160,1966,0.157680569684639,0.277212614445575,0.184638860630722,0.0762970498474059,0.200915564598169,0.081383519837233
"E02003058",623,590,655,200,390,423,3389,0.183830038359398,0.174092652699911,0.193272351726173,0.0590144585423429,0.115078194157569,0.124815579817055
"E02003059",298,465,195,130,335,168,2506,0.118914604948125,0.185554668794892,0.0778132482043097,0.0518754988028731,0.133679169992019,0.0670391061452514
"E02003060",607,594,291,190,404,417,3437,0.176607506546407,0.17282513820192,0.0846668606342741,0.0552807681117253,0.117544370090195,0.121326738434681
"E02003061",323,332,131,102,230,221,2038,0.158488714425908,0.162904808635918,0.0642787046123651,0.0500490677134446,0.112855740922473,0.108439646712463
"E02003062",319,253,63,69,184,250,1942,0.164263645726056,0.130278063851699,0.0324407826982492,0.0355303810504634,0.0947476828012358,0.128733264675592
"E02003063",542,650,80,255,395,287,1973,0.274708565636087,0.329447541814496,0.0405473897617841,0.129244804865687,0.200202736948809,0.1454637607704
"E02003064",247,251,39,53,198,194,3396,0.0727326266195524,0.0739104829210836,0.0114840989399293,0.0156065959952886,0.0583038869257951,0.0571260306242638
"E02003065",394,423,548,128,295,266,4773,0.0825476639430128,0.0886235072281584,0.11481248690551,0.0268175151896082,0.0618059920385502,0.0557301487534046
"E02003066",436,354,152,119,235,317,1935,0.225322997416021,0.182945736434109,0.0785529715762274,0.0614987080103359,0.121447028423773,0.163824289405685
"E02003067",303,327,132,86,241,217,3123,0.0970220941402498,0.104707012487992,0.0422670509125841,0.0275376240794108,0.0771693884085815,0.0694844700608389
"E02003068",442,538,475,173,365,269,2226,0.198562443845463,0.241689128481581,0.213387241689128,0.0777178796046721,0.163971248876909,0.120844564240791
"E02003069",420,444,767,130,314,290,2110,0.199052132701422,0.21042654028436,0.363507109004739,0.0616113744075829,0.148815165876777,0.137440758293839
"E02003070",681,736,591,273,463,408,4391,0.155089956729674,0.16761557731724,0.134593486677294,0.0621726258255523,0.105442951491688,0.0929173309041221
"E02003071",514,579,1084,170,409,344,3330,0.154354354354354,0.173873873873874,0.325525525525526,0.0510510510510511,0.122822822822823,0.103303303303303
"E02003072",698,744,347,252,492,446,3905,0.178745198463508,0.190524967989757,0.0888604353393086,0.0645326504481434,0.125992317541613,0.114212548015365
"E02003073",436,430,93,173,257,263,1819,0.239692138537658,0.236393622869709,0.051126992853216,0.0951072017592084,0.1412864211105,0.14458493677845
"E02003074",648,685,108,255,430,393,2709,0.239202657807309,0.252860834256183,0.0398671096345515,0.0941306755260244,0.158730158730159,0.145071982281285
"E02003075",449,453,375,170,283,279,1914,0.234587251828631,0.236677115987461,0.195924764890282,0.0888192267502612,0.1478578892372,0.14576802507837
"E02003076",604,532,454,197,335,407,3437,0.175734652313064,0.154786150712831,0.132091940645912,0.0573174279895258,0.0974687227233052,0.118417224323538
"E02003077",479,397,499,149,248,330,2106,0.227445394112061,0.188509021842355,0.236942070275404,0.0707502374169041,0.117758784425451,0.156695156695157
"E02003078",472,402,350,151,251,321,2297,0.205485415759687,0.175010883761428,0.152372659991293,0.065737919024815,0.109272964736613,0.139747496734872
"E02003079",729,439,53,182,257,547,3129,0.232981783317354,0.140300415468201,0.0169383189517418,0.058165548098434,0.0821348673697667,0.17481623521892
"E02003080",727,717,330,263,454,464,3290,0.2209726443769,0.217933130699088,0.100303951367781,0.0799392097264438,0.137993920972644,0.141033434650456
"E02003081",819,960,547,334,626,485,3175,0.257952755905512,0.302362204724409,0.172283464566929,0.105196850393701,0.197165354330709,0.152755905511811
"E02003082",693,664,2607,139,525,554,4914,0.141025641025641,0.135124135124135,0.530525030525031,0.0282865282865283,0.106837606837607,0.112739112739113
"E02003084",839,737,3028,139,598,700,5534,0.151608239971088,0.133176725695699,0.547162992410553,0.0251174557282255,0.108059269967474,0.126490784242862
"E02003085",408,343,692,93,250,315,3957,0.103108415466262,0.0866818296689411,0.174879959565327,0.023502653525398,0.0631791761435431,0.0796057619408643
"E02003086",563,407,1550,107,300,456,2850,0.197543859649123,0.14280701754386,0.543859649122807,0.0375438596491228,0.105263157894737,0.16
"E02003087",778,536,492,218,318,560,4783,0.162659418774828,0.112063558436128,0.102864311101819,0.0455780890654401,0.0664854693706878,0.117081329709387
"E02003088",694,542,641,210,332,484,3428,0.2024504084014,0.158109684947491,0.186989498249708,0.0612602100350058,0.0968494749124854,0.141190198366394
"E02003089",524,472,287,181,291,343,2198,0.238398544131028,0.214740673339399,0.130573248407643,0.0823475887170155,0.132393084622384,0.156050955414013
"E02003090",491,498,294,197,301,294,3314,0.148159324079662,0.150271575135788,0.0887145443572722,0.0594447797223899,0.0908267954133977,0.0887145443572722
"E02003091",479,473,230,163,310,316,2529,0.18940292605773,0.187030446816924,0.0909450375642546,0.0644523527085805,0.122578094108343,0.12495057334915
"E02003092",512,431,542,170,261,342,2735,0.187202925045704,0.157586837294333,0.198171846435101,0.0621572212065814,0.0954296160877514,0.125045703839122
"E02003093",400,450,520,148,302,252,1923,0.208008320332813,0.234009360374415,0.270410816432657,0.0769630785231409,0.157046281851274,0.131045241809672
"E02003094",543,485,456,158,327,385,3388,0.160271546635183,0.143152302243211,0.134592680047225,0.0466351829988194,0.096517119244392,0.113636363636364
"E02003095",317,348,55,79,269,238,4021,0.0788361104202935,0.0865456354140761,0.0136781895050982,0.0196468540164138,0.0668987813976623,0.0591892564038796
"E02003096",447,345,66,90,255,357,2225,0.200898876404494,0.155056179775281,0.0296629213483146,0.0404494382022472,0.114606741573034,0.160449438202247
"E02003097",339,388,237,110,278,229,2165,0.156581986143187,0.179214780600462,0.109468822170901,0.0508083140877598,0.128406466512702,0.105773672055427
"E02003098",813,249,5,85,164,728,3795,0.214229249011858,0.0656126482213439,0.00131752305665349,0.0223978919631094,0.0432147562582345,0.191831357048748
"E02003099",421,718,137,219,499,202,2476,0.170032310177706,0.289983844911147,0.0553311793214863,0.0884491114701131,0.201534733441034,0.0815831987075929
"E02003101",799,282,4,52,230,747,4383,0.182295231576546,0.0643394934976044,0.000912616929044034,0.0118640200775724,0.0524754734200319,0.170431211498973
"E02003102",346,441,393,130,311,216,2087,0.165788212745568,0.211308097747964,0.188308576904648,0.0622903689506469,0.149017728797317,0.103497843794921
"E02003103",422,895,76,259,636,163,2038,0.207065750736016,0.439156035328754,0.0372914622178607,0.127085377821394,0.31207065750736,0.0799803729146222
"E02003104",539,655,203,214,441,325,2256,0.238918439716312,0.290336879432624,0.0899822695035461,0.0948581560283688,0.195478723404255,0.144060283687943
"E02003105",340,527,357,167,360,173,1684,0.201900237529691,0.312945368171021,0.211995249406176,0.0991686460807601,0.213776722090261,0.102731591448931
"E02003107",801,1088,1517,294,794,507,4308,0.185933147632312,0.25255338904364,0.35213556174559,0.0682451253481894,0.18430826369545,0.117688022284123
"E02003108",486,607,447,199,408,287,4964,0.0979049153908139,0.122280419016922,0.0900483481063658,0.040088638195004,0.0821917808219178,0.0578162771958098
"E02003109",359,459,516,148,311,211,1569,0.22880815806246,0.292543021032505,0.32887189292543,0.094327597195666,0.198215423836839,0.134480560866794
"E02003110",326,334,168,58,276,268,4176,0.0780651340996169,0.0799808429118774,0.0402298850574713,0.0138888888888889,0.0660919540229885,0.064176245210728
"E02003111",347,485,896,105,380,242,2126,0.163217309501411,0.228127939793039,0.421448730009407,0.0493885230479774,0.178739416745061,0.113828786453434
"E02003112",324,460,326,139,321,185,2092,0.154875717017208,0.219885277246654,0.155831739961759,0.0664435946462715,0.153441682600382,0.0884321223709369
"E02003113",674,517,1038,157,360,517,3095,0.217770597738288,0.167043618739903,0.335379644588045,0.0507269789983845,0.116316639741519,0.167043618739903
"E02003114",436,602,907,146,456,290,2372,0.183811129848229,0.253794266441821,0.382377740303541,0.0615514333895447,0.192242833052277,0.122259696458685
"E02003115",577,661,1465,158,503,419,3648,0.158168859649123,0.181195175438596,0.401589912280702,0.0433114035087719,0.137883771929825,0.114857456140351
"E02003116",525,622,517,188,434,337,2694,0.194877505567929,0.230883444691908,0.191907943578322,0.0697847067557535,0.161098737936154,0.125092798812175
"E02003117",529,673,1044,189,484,340,3336,0.158573141486811,0.20173860911271,0.31294964028777,0.0566546762589928,0.145083932853717,0.101918465227818
"E02003118",566,594,356,175,419,391,3108,0.182110682110682,0.191119691119691,0.114543114543115,0.0563063063063063,0.134813384813385,0.125804375804376
"E02003119",604,736,393,200,536,404,3094,0.195216548157725,0.237879767291532,0.127020038784745,0.0646412411118294,0.173238526179703,0.130575307045895
"E02003120",535,558,731,171,387,364,2720,0.196691176470588,0.205147058823529,0.26875,0.0628676470588235,0.142279411764706,0.133823529411765
"E02003121",682,689,232,243,446,439,2926,0.233082706766917,0.235475051264525,0.0792891319207109,0.0830485304169515,0.152426520847573,0.150034176349966
"E02003122",506,400,96,147,253,359,2495,0.202805611222445,0.160320641282565,0.0384769539078156,0.0589178356713427,0.101402805611222,0.143887775551102
"E02003123",505,822,102,151,671,354,3371,0.149807178878671,0.243844556511421,0.0302580836547019,0.0447938297241175,0.199050726787303,0.105013349154554
"E02003124",606,617,156,142,475,464,3197,0.189552705661558,0.192993431341883,0.0487957460118861,0.044416640600563,0.14857679074132,0.145136065060995
"E02003125",450,399,102,114,285,336,2317,0.194216659473457,0.172205438066465,0.0440224428139836,0.0492015537332758,0.123003884333189,0.145015105740181
"E02003126",518,380,31,116,264,402,2912,0.177884615384615,0.130494505494506,0.0106456043956044,0.0398351648351648,0.0906593406593407,0.138049450549451
"E02003127",500,400,348,109,291,391,2687,0.186081131373279,0.148864905098623,0.129512467435802,0.0405656866393748,0.108299218459248,0.145515444733904
"E02003128",816,565,237,182,383,634,3963,0.205904617713853,0.142568761039616,0.0598031794095382,0.04592480444108,0.0966439565985365,0.159979813272773
"E02003129",371,577,196,126,451,245,2614,0.141928079571538,0.220734506503443,0.0749808722264728,0.0482019892884468,0.172532517214996,0.093726090283091
"E02003130",873,1257,644,380,877,493,3969,0.219954648526077,0.316704459561602,0.162257495590829,0.0957420005039053,0.220962459057697,0.124212648022172
"E02003131",562,593,146,163,430,399,2569,0.218762164266251,0.230829116387699,0.0568314519268198,0.0634488127676139,0.167380303620086,0.155313351498638
"E02003132",571,623,599,178,445,393,3141,0.181789239095829,0.198344476281439,0.190703597580388,0.0566698503661254,0.141674625915314,0.125119388729704
"E02003133",548,708,229,226,482,322,2287,0.239615216440752,0.309575863576738,0.10013117621338,0.0988194140795802,0.210756449497158,0.140795802361172
"E02003134",379,446,221,105,341,274,2963,0.127910901113736,0.150523118461019,0.0745865676679042,0.035437057036787,0.115086061424232,0.092473844076949
"E02003135",497,502,1236,107,395,390,2901,0.17132023440193,0.173043778007584,0.426059979317477,0.036883833160979,0.136159944846605,0.134436401240951
"E02003136",491,588,267,195,393,296,2407,0.203988367262152,0.244287494806813,0.110926464478604,0.0810137100124636,0.16327378479435,0.122974657249688
"E02003137",494,702,679,203,499,291,2514,0.196499602227526,0.279236276849642,0.270087509944312,0.0807478122513922,0.19848846459825,0.115751789976134
"E02003138",620,343,2055,89,254,531,2755,0.225045372050817,0.124500907441016,0.745916515426497,0.0323049001814882,0.0921960072595281,0.192740471869328
"E02003139",433,259,17,84,175,349,2042,0.212047012732615,0.126836434867777,0.00832517140058766,0.0411361410381978,0.0857002938295788,0.170910871694417
"E02003140",533,638,384,215,423,318,2322,0.229543496985357,0.274763135228252,0.165374677002584,0.0925925925925926,0.182170542635659,0.136950904392765
"E02003141",768,487,2485,113,374,655,3757,0.204418418951291,0.129624700558957,0.661431993611924,0.0300771892467394,0.0995475113122172,0.174341229704552
"E02003142",802,847,676,237,610,565,3583,0.223834775327937,0.236394083170527,0.188668713368685,0.066145687970974,0.170248395199553,0.157689087356963
"E02003143",557,696,120,201,495,356,2698,0.206449221645663,0.257968865826538,0.044477390659748,0.0744996293550778,0.18346923647146,0.131949592290586
"E02003144",717,240,2875,42,198,675,3963,0.180923542770628,0.060560181680545,0.725460509714862,0.0105980317940954,0.0499621498864497,0.170325510976533
"E02003145",555,312,1426,69,243,486,2913,0.190525231719876,0.107106076210093,0.489529694473052,0.023686920700309,0.0834191555097837,0.166838311019567
"E02003146",798,278,2892,65,213,733,3700,0.215675675675676,0.0751351351351351,0.781621621621622,0.0175675675675676,0.0575675675675676,0.198108108108108
"E02003147",313,481,715,71,410,242,5002,0.0625749700119952,0.0961615353858457,0.142942822870852,0.0141943222710916,0.0819672131147541,0.0483806477409036
"E02003148",512,646,1754,70,576,442,5550,0.0922522522522523,0.116396396396396,0.316036036036036,0.0126126126126126,0.103783783783784,0.0796396396396396
"E02003149",831,380,2982,75,305,756,4548,0.182717678100264,0.0835532102022867,0.655672823218997,0.016490765171504,0.0670624450307828,0.16622691292876
"E02003151",549,780,220,256,524,293,2701,0.203258052573121,0.288781932617549,0.0814513143280267,0.0947797112180674,0.194002221399482,0.108478341355054
"E02003152",678,1042,582,309,733,369,3986,0.170095333667837,0.261414952333166,0.146011038635223,0.0775213246362268,0.183893627696939,0.0925740090316106
"E02003153",584,625,122,173,452,411,2825,0.206725663716814,0.221238938053097,0.0431858407079646,0.0612389380530973,0.16,0.145486725663717
"E02003154",499,670,219,224,446,275,2226,0.224168912848158,0.300988319856244,0.0983827493261455,0.10062893081761,0.200359389038634,0.123539982030548
"E02003155",447,636,939,161,475,286,2590,0.172586872586873,0.245559845559846,0.362548262548263,0.0621621621621622,0.183397683397683,0.11042471042471
"E02003156",674,736,256,239,497,435,3862,0.174520973588814,0.190574831693423,0.0662868979803211,0.0618850336613154,0.128689798032108,0.112635939927499
"E02003157",524,672,1148,169,503,355,2875,0.182260869565217,0.233739130434783,0.399304347826087,0.0587826086956522,0.17495652173913,0.123478260869565
"E02003158",441,651,949,156,495,285,2442,0.180589680589681,0.266584766584767,0.388615888615889,0.0638820638820639,0.202702702702703,0.116707616707617
"E02003159",524,504,1481,149,355,375,2386,0.219614417435038,0.211232187761945,0.62070410729254,0.0624476110645432,0.148784576697401,0.157166806370495
"E02003161",605,537,2434,93,444,512,4738,0.1276910088645,0.113338961587168,0.513718868720979,0.0196285352469396,0.0937104263402279,0.10806247361756
"E02003163",574,1152,1726,154,998,420,4880,0.117622950819672,0.236065573770492,0.353688524590164,0.0315573770491803,0.204508196721311,0.0860655737704918
"E02003164",718,1217,316,377,840,341,3340,0.21497005988024,0.36437125748503,0.0946107784431138,0.112874251497006,0.251497005988024,0.102095808383234
"E02003165",656,919,376,330,589,326,2478,0.264729620661824,0.370863599677159,0.151735270379338,0.13317191283293,0.237691686844229,0.131557707828894
"E02003166",741,850,206,291,559,450,4609,0.160772401822521,0.18442178346713,0.044695161640269,0.063137339986982,0.121284443480148,0.0976350618355392
"E02003167",895,1026,2196,231,795,664,5370,0.166666666666667,0.191061452513966,0.408938547486034,0.0430167597765363,0.14804469273743,0.12364990689013
"E02003168",626,704,293,247,457,379,2890,0.216608996539792,0.243598615916955,0.101384083044983,0.0854671280276817,0.158131487889273,0.131141868512111
"E02003169",618,695,158,274,421,344,2401,0.257392753019575,0.289462723865056,0.0658059142024157,0.114119117034569,0.175343606830487,0.143273635985006
"E02003170",997,1162,1165,350,812,647,4569,0.218209673889254,0.254322608885971,0.254979207704093,0.0766031954475815,0.177719413438389,0.141606478441672
"E02003171",608,830,462,252,578,356,2701,0.22510181414291,0.307293594964828,0.171047760088856,0.0932987782302851,0.213994816734543,0.131803035912625
"E02003172",465,459,59,171,288,294,2127,0.218617771509168,0.215796897038082,0.0277385989656794,0.080394922425952,0.13540197461213,0.138222849083216
"E02003173",500,503,30,175,328,325,2394,0.208855472013367,0.210108604845447,0.012531328320802,0.0730994152046784,0.137009189640769,0.135756056808688
"E02003174",576,744,59,242,502,334,2598,0.221709006928406,0.286374133949192,0.0227097767513472,0.0931485758275597,0.193225558121632,0.128560431100847
"E02003175",745,647,25,255,392,490,3018,0.246852220013254,0.214380384360504,0.00828363154406892,0.084493041749503,0.129887342611001,0.162359178263751
"E02003176",436,530,65,141,389,295,2317,0.18817436340095,0.228744065602072,0.0280535174794994,0.0608545533016832,0.167889512300388,0.127319810099266
"E02003177",541,890,61,235,655,306,2575,0.210097087378641,0.345631067961165,0.0236893203883495,0.0912621359223301,0.254368932038835,0.118834951456311
"E02003178",542,814,75,234,580,308,2956,0.183355886332882,0.275372124492557,0.0253721244925575,0.0791610284167794,0.196211096075778,0.104194857916103
"E02003179",414,467,46,159,308,255,2112,0.196022727272727,0.221117424242424,0.021780303030303,0.0752840909090909,0.145833333333333,0.120738636363636
"E02003180",590,1244,79,330,914,260,3879,0.152101056973447,0.320701211652488,0.0203660737303429,0.0850734725444702,0.235627739108018,0.0670275844289765
"E02003181",643,1120,87,313,807,330,2967,0.216717222783957,0.377485675766768,0.0293225480283114,0.105493764745534,0.271991911021234,0.111223458038423
"E02003182",531,530,34,165,365,366,2101,0.252736792003808,0.252260828177059,0.0161827701094717,0.0785340314136126,0.173726796763446,0.174202760590195
"E02003183",545,907,142,269,638,276,2705,0.201478743068392,0.335304990757856,0.0524953789279113,0.0994454713493531,0.235859519408503,0.102033271719039
"E02003184",596,1368,134,373,995,223,3523,0.169173999432302,0.388305421515754,0.0380357649730343,0.105875674141357,0.282429747374397,0.0632983252909452
"E02003185",547,867,41,284,583,263,2517,0.217322208978943,0.34445768772348,0.0162892332141438,0.112832737385777,0.231624950337704,0.104489471593166
"E02003186",664,1309,135,353,956,311,4140,0.160386473429952,0.316183574879227,0.0326086956521739,0.0852657004830918,0.230917874396135,0.0751207729468599
"E02003187",700,1746,189,428,1318,272,4440,0.157657657657658,0.393243243243243,0.0425675675675676,0.0963963963963964,0.296846846846847,0.0612612612612613
"E02003188",470,2391,919,217,2174,253,7181,0.065450494360117,0.332961983010723,0.127976604929676,0.030218632502437,0.302743350508286,0.03523186185768
"E02003189",633,1520,195,336,1184,297,4341,0.145818935729095,0.350149735084082,0.0449205252246026,0.0774015203870076,0.272748214697074,0.0684174153420871
"E02003190",521,2272,924,221,2051,300,7301,0.0713600876592248,0.311190247911245,0.126558005752637,0.0302698260512259,0.280920421860019,0.0410902616079989
"E02003191",686,1048,127,336,712,350,3638,0.188565145684442,0.28807036833425,0.0349092908191314,0.0923584387025838,0.195711929631666,0.0962067069818582
"E02003192",393,2488,824,231,2257,162,7644,0.0514128728414443,0.325484039769754,0.107796964939822,0.0302197802197802,0.295264259549974,0.0211930926216641
"E02003194",447,457,93,177,280,270,1743,0.256454388984509,0.262191623637407,0.0533562822719449,0.101549053356282,0.160642570281124,0.154905335628227
"E02003195",383,414,24,150,264,233,1951,0.196309584828293,0.212198872373142,0.0123013839056894,0.0768836494105587,0.135315222962583,0.119425935417734
"E02003196",704,745,40,258,487,446,3027,0.232573505120581,0.246118268913115,0.013214403700033,0.0852329038652131,0.160885365047902,0.147340601255368
"E02003197",465,437,33,136,301,329,2273,0.204575450945887,0.1922569291685,0.0145182578090629,0.0598328200615926,0.132424109106907,0.144742630884294
"E02003198",583,586,30,192,394,391,2347,0.248402215594376,0.249680443118875,0.0127822752449936,0.0818065615679591,0.167873881550916,0.166595654026417
"E02003199",714,623,48,216,407,498,3210,0.222429906542056,0.194080996884735,0.0149532710280374,0.0672897196261682,0.126791277258567,0.155140186915888
"E02003200",817,905,35,319,586,498,3335,0.244977511244378,0.271364317841079,0.0104947526236882,0.0956521739130435,0.175712143928036,0.149325337331334
"E02003201",758,1082,96,329,753,429,4273,0.177392932366019,0.253217879709806,0.0224666510648256,0.0769950854200796,0.176222794289726,0.10039784694594
"E02003202",375,767,183,140,627,235,2411,0.155537121526338,0.318125259228536,0.0759021153048528,0.0580671920364994,0.260058067192037,0.0974699294898382
"E02003203",588,989,77,281,708,307,2798,0.210150107219442,0.353466761972838,0.0275196568977841,0.100428877769836,0.253037884203002,0.109721229449607
"E02003204",557,988,117,241,747,316,3821,0.145773357759749,0.258571054697723,0.0306202564773619,0.0630724941114891,0.195498560586234,0.0827008636482596
"E02003205",550,680,70,247,433,303,2406,0.228595178719867,0.28262676641729,0.029093931837074,0.102660016625104,0.179966749792186,0.125935162094763
"E02003206",716,1329,106,392,937,324,4099,0.174676750426933,0.32422542083435,0.0258599658453281,0.0956330812393267,0.228592339595023,0.0790436691876067
"E02003207",488,607,93,230,377,258,2569,0.189957181782795,0.236278707668353,0.0362008563643441,0.0895289996107435,0.14674970805761,0.100428182172051
"E02003208",595,1291,453,280,1011,315,6394,0.0930559899906162,0.201908038786362,0.0708476696903347,0.0437910541132312,0.158116984673131,0.049264935877385
"E02003209",442,506,54,181,325,261,2651,0.166729536024142,0.190871369294606,0.020369671821954,0.0682761222180309,0.122595247076575,0.0984534138061109
"E02003210",709,1561,183,375,1186,334,4981,0.14234089540253,0.313390885364385,0.0367396105199759,0.0752860871310982,0.238104798233286,0.0670548082714314
"E02003211",417,1814,337,225,1589,192,5640,0.073936170212766,0.321631205673759,0.0597517730496454,0.0398936170212766,0.281737588652482,0.0340425531914894
"E02003212",620,896,312,275,621,345,3034,0.20435069215557,0.295319709953856,0.102834541858932,0.0906394199077126,0.204680290046144,0.113711272247858
"E02003214",264,319,40,66,253,198,2269,0.116350815337153,0.140590568532393,0.0176289114147201,0.0290877038342882,0.111502864698105,0.0872631115028647
"E02003215",390,464,53,115,349,275,2123,0.18370230805464,0.21855864342911,0.0249646726330664,0.054168629298163,0.164390014130947,0.129533678756477
"E02003216",514,634,191,196,438,318,3106,0.165486155827431,0.204121056020605,0.0614938828074694,0.0631036703155183,0.141017385705087,0.102382485511912
"E02003217",351,375,92,95,280,256,2502,0.140287769784173,0.149880095923261,0.0367705835331735,0.0379696243005595,0.111910471622702,0.102318145483613
"E02003218",276,481,52,88,393,188,1879,0.146886641830761,0.255987227248536,0.0276742948376796,0.0468334220329963,0.20915380521554,0.100053219797765
"E02003219",355,329,329,118,211,237,4846,0.0732562938505984,0.0678910441601321,0.0678910441601321,0.0243499793644243,0.0435410647957078,0.0489063144861742
"E02003220",616,655,185,184,471,432,3743,0.164573871226289,0.174993320865616,0.0494255944429602,0.0491584290675928,0.125834891798023,0.115415442158696
"E02003221",417,829,772,209,620,208,2654,0.157121326299925,0.312358703843255,0.290881688018086,0.0787490580256217,0.233609645817634,0.0783722682743029
"E02003222",403,184,3,53,131,350,2018,0.199702675916749,0.0911793855302279,0.00148662041625372,0.0262636273538157,0.0649157581764123,0.173439048562934
"E02003223",553,979,835,256,723,297,4590,0.120479302832244,0.213289760348584,0.181917211328976,0.0557734204793028,0.157516339869281,0.0647058823529412
"E02003224",532,606,62,181,425,351,2595,0.205009633911368,0.233526011560694,0.0238921001926782,0.0697495183044316,0.163776493256262,0.135260115606936
"E02003225",466,333,27,127,206,339,2481,0.18782748891576,0.134220072551391,0.0108827085852479,0.0511890366787586,0.083031035872632,0.136638452237001
"E02003226",649,1008,1907,288,720,361,4012,0.161764705882353,0.251246261216351,0.475324027916251,0.0717846460618146,0.179461615154536,0.0899800598205384
"E02003227",276,348,24,49,299,227,2458,0.112286411716843,0.141578519121237,0.00976403580146461,0.0199349064279902,0.121643612693247,0.0923515052888527
"E02003228",427,708,237,177,531,250,2417,0.176665287546545,0.29292511377741,0.0980554406288788,0.0732312784443525,0.219693835333058,0.103434009102193
"E02003229",396,274,5,104,170,292,1873,0.211425520555259,0.146289375333689,0.00266951414842499,0.0555258942872397,0.0907634810464495,0.155899626268019
"E02003230",608,900,2032,193,707,415,4502,0.135051088405153,0.199911150599733,0.451354953354065,0.0428698356286095,0.157041314971124,0.0921812527765438
"E02003231",394,445,35,93,352,301,2629,0.149866869532142,0.169265880562952,0.0133130467858501,0.0353746671738304,0.133891213389121,0.114492202358311
"E02003232",404,606,596,147,459,257,3327,0.121430718364893,0.18214607754734,0.179140366696724,0.0441839495040577,0.137962128043282,0.0772467688608356
"E02003233",590,641,22,193,448,397,2907,0.202958376332989,0.220502235982112,0.00756793945648435,0.0663914688682491,0.154110767113863,0.13656690746474
"E02003234",481,790,75,217,573,264,2505,0.192015968063872,0.315369261477046,0.029940119760479,0.086626746506986,0.22874251497006,0.105389221556886
"E02003235",421,626,197,177,449,244,4021,0.104700323302661,0.155682666003482,0.0489927878637155,0.0440189007709525,0.111663765232529,0.0606814225317085
"E02003236",583,615,316,183,432,400,4954,0.117682680662091,0.124142107387969,0.063786838918046,0.0369398465886153,0.0872022607993541,0.080742834073476
"E02003237",419,261,240,104,157,315,1919,0.218342886920271,0.136008337675873,0.125065138092757,0.0541948931735279,0.081813444502345,0.164147993746743
"E02003238",533,147,16,63,84,470,2010,0.265174129353234,0.073134328358209,0.00796019900497512,0.0313432835820895,0.0417910447761194,0.233830845771144
"E02003239",564,279,166,111,168,453,2599,0.217006540977299,0.107348980377068,0.0638707195075029,0.042708734128511,0.0646402462485571,0.174297806848788
"E02003240",339,181,411,70,111,269,2820,0.120212765957447,0.0641843971631206,0.145744680851064,0.024822695035461,0.0393617021276596,0.0953900709219858
"E02003241",350,254,430,83,171,267,2628,0.133181126331811,0.0966514459665145,0.163622526636225,0.0315829528158295,0.0650684931506849,0.101598173515982
"E02003242",468,335,741,100,235,368,3020,0.154966887417219,0.110927152317881,0.245364238410596,0.033112582781457,0.0778145695364238,0.121854304635762
"E02003243",502,397,167,114,283,388,5202,0.0965013456362937,0.076316801230296,0.0321030372933487,0.0219146482122261,0.05440215301807,0.0745866974240677
"E02003244",452,344,453,100,244,352,3724,0.121374865735768,0.0923737916219119,0.121643394199785,0.0268528464017186,0.0655209452201933,0.0945220193340494
"E02003245",474,502,189,155,347,319,3175,0.149291338582677,0.158110236220472,0.0595275590551181,0.0488188976377953,0.109291338582677,0.100472440944882
"E02003246",536,265,2064,69,196,467,3576,0.149888143176734,0.0741051454138702,0.577181208053691,0.0192953020134228,0.0548098434004474,0.130592841163311
"E02003247",574,566,39,185,381,389,3451,0.16632860040568,0.16401043175891,0.0113010721529991,0.0536076499565343,0.110402781802376,0.112720950449145
"E02003248",562,340,2300,75,265,487,3539,0.158801921446736,0.0960723368183103,0.649901102006216,0.0211924272393331,0.0748799095789771,0.137609494207403
"E02003249",691,465,566,122,343,569,5208,0.132680491551459,0.0892857142857143,0.108678955453149,0.0234254992319508,0.0658602150537634,0.109254992319508
"E02003250",747,373,2830,77,296,670,6432,0.116138059701493,0.0579912935323383,0.439987562189055,0.0119713930348259,0.0460199004975124,0.104166666666667
"E02003251",522,415,165,150,265,372,2425,0.215257731958763,0.171134020618557,0.0680412371134021,0.0618556701030928,0.109278350515464,0.15340206185567
"E02003252",557,442,1542,105,337,452,5327,0.104561666979538,0.0829735310681434,0.289468744133659,0.0197109067017083,0.0632626243664351,0.0848507602778299
"E02003253",521,356,1639,76,280,445,5089,0.102377677343289,0.0699548044802515,0.322067203772843,0.014934171742975,0.0550206327372765,0.0874435056003144
"E02003254",606,376,212,147,229,459,3411,0.177660510114336,0.110231603635298,0.0621518616241571,0.0430958663148637,0.0671357373204339,0.134564643799472
"E02003255",506,452,217,143,309,363,5347,0.0946325042079671,0.0845333832055358,0.0405835047690294,0.0267439685805124,0.0577894146250234,0.0678885356274546
"E02003257",684,907,55,245,662,439,4168,0.164107485604607,0.217610364683301,0.0131957773512476,0.0587811900191939,0.158829174664107,0.105326295585413
"E02003258",725,383,21,143,240,582,2547,0.284648606203377,0.150372987828818,0.00824499411071849,0.0561444837063212,0.0942285041224971,0.228504122497055
"E02003259",379,491,282,179,312,200,2175,0.174252873563218,0.225747126436782,0.129655172413793,0.0822988505747126,0.143448275862069,0.0919540229885057
"E02003260",489,590,67,159,431,330,3020,0.161920529801325,0.195364238410596,0.0221854304635762,0.0526490066225166,0.142715231788079,0.109271523178808
"E02003261",524,475,91,210,265,314,1832,0.286026200873362,0.259279475982533,0.0496724890829694,0.114628820960699,0.144650655021834,0.171397379912664
"E02003262",706,710,482,238,472,468,3660,0.192896174863388,0.193989071038251,0.131693989071038,0.0650273224043716,0.12896174863388,0.127868852459016
"E02003263",726,875,842,288,587,438,3654,0.198686371100164,0.239463601532567,0.230432402846196,0.0788177339901478,0.160645867542419,0.119868637110016
"E02003264",689,574,354,213,361,476,2517,0.273738577671832,0.228049264998014,0.140643623361144,0.0846245530393325,0.143424711958681,0.189114024632499
"E02003265",612,961,156,348,613,264,2509,0.243921881227581,0.383021123953766,0.0621761658031088,0.138700677560781,0.244320446392985,0.1052212036668
"E02003266",542,518,74,161,357,381,3090,0.175404530744337,0.167637540453074,0.0239482200647249,0.0521035598705502,0.115533980582524,0.123300970873786
"E02003267",527,462,1761,106,356,421,2980,0.176845637583893,0.15503355704698,0.590939597315436,0.0355704697986577,0.119463087248322,0.141275167785235
"E02003268",556,526,865,160,366,396,3189,0.174349325807463,0.164941988084039,0.271244904358733,0.0501724678582628,0.114769520225776,0.1241768579492
"E02003269",783,842,1043,267,575,516,3558,0.220067453625632,0.236649803260259,0.293142214727375,0.0750421585160202,0.161607644744238,0.145025295109612
"E02003270",585,643,436,219,424,366,2340,0.25,0.274786324786325,0.186324786324786,0.0935897435897436,0.181196581196581,0.156410256410256
"E02003271",857,703,36,264,439,593,3154,0.271718452758402,0.22289156626506,0.0114140773620799,0.0837032339885859,0.139188332276474,0.188015218769816
"E02003272",397,418,1259,105,313,292,2439,0.162771627716277,0.171381713817138,0.51619516195162,0.043050430504305,0.128331283312833,0.119721197211972
"E02003273",668,730,672,254,476,414,4180,0.159808612440191,0.174641148325359,0.160765550239234,0.0607655502392345,0.113875598086124,0.0990430622009569
"E02003274",459,442,1693,93,349,366,3322,0.138169777242625,0.133052378085491,0.509632751354606,0.0279951836243227,0.105057194461168,0.110174593618302
"E02003276",419,225,1669,48,177,371,2759,0.151866618339978,0.081551286698079,0.604929322218195,0.0173976078289235,0.0641536788691555,0.134469010511055
"E02003277",649,636,764,228,408,421,4021,0.161402636160159,0.158169609549863,0.190002486943546,0.0567023128574981,0.101467296692365,0.104700323302661
"E02003278",716,711,2537,140,571,576,6211,0.11527934310095,0.114474319755273,0.408468845596522,0.0225406536789567,0.0919336660763162,0.0927386894219932
"E02003279",746,818,856,281,537,465,2812,0.265291607396871,0.290896159317212,0.304409672830725,0.0999288762446657,0.190967283072546,0.165362731152205
"E02003280",756,666,1279,198,468,558,3398,0.22248381400824,0.195997645673926,0.376397881106533,0.0582695703354915,0.137728075338434,0.164214243672749
"E02003281",732,467,1580,138,329,594,3258,0.224677716390424,0.143339472068754,0.484960098219767,0.0423572744014733,0.100982197667281,0.18232044198895
"E02003282",753,301,2152,89,212,664,3753,0.200639488409273,0.0802025046629363,0.573407940314415,0.0237143618438582,0.0564881428190781,0.176925126565414
"E02003283",764,451,1646,133,318,631,3599,0.212281189219228,0.125312586829675,0.457349263684357,0.0369547096415671,0.0883578771881078,0.17532647957766
"E02003284",840,308,2627,95,213,745,3892,0.215827338129496,0.079136690647482,0.67497430626927,0.0244090441932169,0.0547276464542652,0.19141829393628
"E02003285",914,69,3662,15,54,899,4467,0.204611596149541,0.0154466084620551,0.819789567942691,0.00335795836131632,0.0120886501007388,0.201253637788225
"E02003286",565,381,2006,72,309,493,2951,0.191460521856998,0.129108776685869,0.679769569637411,0.0243985089800068,0.104710267705862,0.167062012876991
"E02003287",714,578,1196,201,377,513,3384,0.210992907801418,0.17080378250591,0.353427895981087,0.0593971631205674,0.111406619385343,0.151595744680851
"E02003288",786,243,2594,21,222,765,6256,0.125639386189258,0.0388427109974425,0.414641943734015,0.00335677749360614,0.0354859335038363,0.122282608695652
"E02003289",880,346,3245,41,305,839,4623,0.190352584901579,0.0748431754272118,0.701925156824573,0.00886869997836902,0.0659744754488427,0.18148388492321
"E02003290",746,274,3071,38,236,708,4642,0.160706591986213,0.0590262817750969,0.661568289530375,0.00818612666953899,0.0508401551055579,0.152520465316674
"E02003291",860,825,601,269,556,591,4477,0.192092919365647,0.184275184275184,0.134241679696225,0.0600848782666965,0.124190306008488,0.13200804109895
"E02003292",992,814,3175,112,702,880,6261,0.158441143587286,0.130011180322632,0.507107490816164,0.0178885162114678,0.112122664111164,0.140552627375819
"E02003293",1054,227,4392,33,194,1021,6679,0.157808055098069,0.0339871238209313,0.657583470579428,0.00494085941009133,0.0290462644108399,0.152867195687977
"E02003294",710,469,1688,131,338,579,3018,0.235255135851557,0.155400927766733,0.559310801855534,0.0434062292909211,0.111994698475812,0.191848906560636
"E02003295",684,546,1025,178,368,506,3043,0.224778179428196,0.179428195859349,0.336838646072954,0.0584949063424252,0.120933289516924,0.166283273085771
"E02003296",519,559,441,231,328,288,1806,0.287375415282392,0.30952380952381,0.244186046511628,0.127906976744186,0.181616832779623,0.159468438538206
"E02003297",542,565,383,180,385,362,2181,0.248509857863365,0.25905547913801,0.175607519486474,0.0825309491059147,0.176524530032095,0.165978908757451
"E02003298",472,657,327,210,447,262,1983,0.238023197175996,0.331316187594554,0.164901664145234,0.10590015128593,0.225416036308623,0.132123045890066
"E02003299",347,306,387,119,187,228,1823,0.190345584201865,0.167855183763028,0.212287438288535,0.0652770159078442,0.102578167855184,0.125068568294021
"E02003300",552,758,662,227,531,325,3123,0.176753121998079,0.242715337816202,0.211975664425232,0.0726865193723983,0.170028818443804,0.10406660262568
"E02003301",529,493,390,122,371,407,4054,0.130488406512087,0.121608288110508,0.0962012826837691,0.0300937345831278,0.0915145535273804,0.100394671928959
"E02003302",504,522,758,160,362,344,3613,0.139496263492942,0.144478272903404,0.209797951840576,0.0442845280929975,0.100193744810407,0.0952117353999446
"E02003303",536,572,622,193,379,343,2997,0.178845512178846,0.190857524190858,0.207540874207541,0.0643977310643977,0.12645979312646,0.114447781114448
"E02003304",478,481,857,146,335,332,2825,0.169203539823009,0.170265486725664,0.303362831858407,0.0516814159292035,0.11858407079646,0.117522123893805
"E02003305",344,236,916,70,166,274,1992,0.172690763052209,0.118473895582329,0.459839357429719,0.035140562248996,0.0833333333333333,0.137550200803213
"E02003307",558,621,425,203,418,355,3322,0.167971101745936,0.186935580975316,0.127934978928356,0.0611077664057797,0.125827814569536,0.106863335340157
"E02003308",477,926,327,253,673,224,2341,0.203759077317386,0.395557454079453,0.139683895771038,0.10807347287484,0.287483981204613,0.0956856044425459
"E02003309",462,303,1154,87,216,375,2272,0.203345070422535,0.133362676056338,0.507922535211268,0.0382922535211268,0.0950704225352113,0.165052816901408
"E02003311",670,223,1694,67,156,603,3245,0.206471494607088,0.0687211093990755,0.522033898305085,0.0206471494607088,0.0480739599383667,0.185824345146379
"E02003312",489,439,376,89,350,400,4268,0.114573570759138,0.102858481724461,0.0880974695407685,0.0208528584817245,0.0820056232427366,0.0937207122774133
"E02003313",899,961,1085,321,640,578,5042,0.178302261007537,0.190598968663229,0.215192383974613,0.0636652122173741,0.126933756445855,0.114637048790163
"E02003314",471,522,234,221,301,250,2102,0.22407231208373,0.248334919124643,0.111322549952426,0.105137963843958,0.143196955280685,0.118934348239772
"E02003315",392,402,254,151,251,241,1765,0.222096317280453,0.227762039660057,0.143909348441926,0.0855524079320113,0.142209631728045,0.136543909348442
"E02003316",615,650,192,233,417,382,4438,0.138575935105904,0.146462370437134,0.0432627309598918,0.0525011266336187,0.0939612438035151,0.0860748084722848
"E02003317",314,420,214,109,311,205,2261,0.138876603272888,0.185758513931889,0.0946483856700575,0.0482087571870854,0.137549756744803,0.0906678460858027
"E02003318",371,479,196,150,329,221,1502,0.247003994673768,0.318908122503329,0.130492676431425,0.099866844207723,0.219041278295606,0.147137150466045
"E02003319",535,420,1739,116,304,419,3155,0.169572107765452,0.133122028526149,0.551188589540412,0.0367670364500792,0.0963549920760697,0.132805071315372
"E02003320",330,334,607,56,278,274,5534,0.0596313697144922,0.06035417419588,0.109685580050596,0.010119262739429,0.050234911456451,0.0495121069750632
"E02003321",384,496,133,170,326,214,2258,0.170062001771479,0.219663418954827,0.0589016829052259,0.0752878653675819,0.144375553587245,0.0947741364038973
"E02003322",430,386,1580,76,310,354,3504,0.122716894977169,0.110159817351598,0.450913242009132,0.021689497716895,0.0884703196347032,0.101027397260274
"E02003323",446,613,719,192,421,254,2730,0.163369963369963,0.224542124542125,0.263369963369963,0.0703296703296703,0.154212454212454,0.093040293040293
"E02003324",603,891,394,281,610,322,3661,0.164709095875444,0.243376126741327,0.107620868615132,0.0767549849767823,0.166621141764545,0.0879541108986616
"E02003325",485,527,2100,59,468,426,3666,0.132296781232951,0.143753409710857,0.572831423895254,0.0160938352427714,0.127659574468085,0.11620294599018
"E02003326",495,513,1497,148,365,347,2541,0.194805194805195,0.201889020070838,0.58913813459268,0.0582447855175128,0.143644234553325,0.136560409287682
"E02003327",436,325,1189,55,270,381,3713,0.117425262590897,0.0875302989496364,0.320226232157285,0.0148128198222462,0.0727174791273903,0.102612442768651
"E02003328",519,607,1800,84,523,435,6052,0.0857567746199603,0.100297422339722,0.297422339722406,0.0138797091870456,0.0864177131526768,0.0718770654329147
"E02003329",443,209,2008,40,169,403,2621,0.169019458222053,0.079740557039298,0.766119801602442,0.0152613506295307,0.0644792064097673,0.153758107592522
"E02003330",438,572,895,173,399,265,2407,0.181969256335688,0.23764021603656,0.371832156211051,0.0718737017033652,0.165766514333195,0.110095554632322
"E02003331",684,839,162,291,548,393,3219,0.212488350419385,0.260639950295123,0.0503261882572227,0.0904007455731594,0.170239204721963,0.122087604846226
"E02003332",360,478,548,134,344,226,1812,0.198675496688742,0.263796909492274,0.30242825607064,0.0739514348785872,0.189845474613687,0.124724061810155
"E02003333",513,474,1789,120,354,393,3376,0.151954976303318,0.140402843601896,0.529917061611374,0.0355450236966825,0.104857819905213,0.116409952606635
"E02003334",401,558,867,173,385,228,2046,0.195992179863148,0.272727272727273,0.42375366568915,0.08455522971652,0.188172043010753,0.111436950146628
"E02003335",475,448,1335,140,308,335,2802,0.169521770164168,0.1598857958601,0.47644539614561,0.0499643112062812,0.109921484653819,0.119557458957887
"E02003336",439,554,147,196,358,243,1941,0.226172076249356,0.285419886656363,0.0757341576506955,0.100978876867594,0.184441009788769,0.125193199381762
"E02003337",379,520,341,142,378,237,2149,0.176361098185202,0.241973010702652,0.158678455095393,0.0660772452303397,0.175895765472313,0.110283852954863
"E02003338",565,865,477,245,620,320,3241,0.174328910829991,0.266892934279543,0.147176797284789,0.0755939524838013,0.191298981795742,0.0987349583461894
"E02003339",382,633,147,204,429,178,1732,0.220554272517321,0.365473441108545,0.0848729792147806,0.117782909930716,0.247690531177829,0.102771362586605
"E02003340",467,603,119,196,407,271,2796,0.167024320457797,0.215665236051502,0.0425608011444921,0.0701001430615164,0.145565092989986,0.0969241773962804
"E02003341",308,365,359,118,247,190,1983,0.155320221886031,0.184064548663641,0.181038830055472,0.059505799293999,0.124558749369642,0.0958144225920323
"E02003342",420,619,192,198,421,222,1917,0.219092331768388,0.322900365153886,0.100156494522692,0.103286384976526,0.21961398017736,0.115805946791862
"E02003343",449,413,93,152,261,297,1468,0.305858310626703,0.28133514986376,0.0633514986376022,0.103542234332425,0.177792915531335,0.202316076294278
"E02003344",527,502,61,185,317,342,2357,0.223589308442936,0.212982605006364,0.0258803563852355,0.0784896054306322,0.134492999575732,0.145099703012304
"E02003345",457,782,59,280,502,177,1773,0.25775521714608,0.441060349689791,0.0332769317540891,0.157924421883813,0.283135927805979,0.0998307952622673
"E02003346",457,601,129,228,373,229,2167,0.210890632210429,0.277341947392709,0.0595293031841255,0.105214582371943,0.172127365020766,0.105676049838486
"E02003347",505,409,32,144,265,361,2060,0.245145631067961,0.198543689320388,0.0155339805825243,0.0699029126213592,0.128640776699029,0.175242718446602
"E02003348",592,566,67,216,350,376,2027,0.292057227429699,0.27923038973853,0.0330537740503207,0.106561420818944,0.172668968919586,0.185495806610755
"E02003349",607,1068,209,390,678,217,2179,0.278568150527765,0.49013308857274,0.0959155575952272,0.178981184029371,0.311151904543368,0.0995869664983938
"E02003350",451,541,84,182,359,269,2022,0.223046488625124,0.2675568743818,0.0415430267062315,0.0900098911968348,0.177546983184965,0.133036597428289
"E02003351",570,744,110,245,499,325,2378,0.239697224558452,0.31286795626577,0.0462573591253154,0.103027754415475,0.209840201850294,0.136669470142977
"E02003352",299,247,342,86,161,213,1626,0.183886838868389,0.151906519065191,0.210332103321033,0.0528905289052891,0.0990159901599016,0.1309963099631
"E02003353",717,413,354,153,260,564,5622,0.127534685165422,0.0734614016364283,0.0629669156883671,0.0272145144076841,0.0462468872287442,0.100320170757737
"E02003354",644,459,50,122,337,522,3448,0.18677494199536,0.133120649651972,0.0145011600928074,0.0353828306264501,0.097737819025522,0.15139211136891
"E02003355",459,475,130,148,327,311,2840,0.161619718309859,0.167253521126761,0.0457746478873239,0.052112676056338,0.115140845070423,0.109507042253521
"E02003356",505,503,314,164,339,341,2445,0.206543967280164,0.205725971370143,0.128425357873211,0.0670756646216769,0.138650306748466,0.139468302658487
"E02003357",625,793,131,239,554,386,4375,0.142857142857143,0.181257142857143,0.0299428571428571,0.0546285714285714,0.126628571428571,0.0882285714285714
"E02003358",651,769,130,202,567,449,5772,0.112785862785863,0.133229383229383,0.0225225225225225,0.034996534996535,0.0982328482328482,0.0777893277893278
"E02003359",690,578,12,211,367,479,2613,0.26406429391504,0.221201683888251,0.00459242250287026,0.0807500956754688,0.140451588212782,0.183314198239571
"E02003360",595,711,123,210,501,385,3948,0.150709219858156,0.180091185410334,0.0311550151975684,0.0531914893617021,0.126899696048632,0.0975177304964539
"E02003361",585,843,80,291,552,294,2613,0.223880597014925,0.322617680826636,0.0306161500191351,0.111366245694604,0.211251435132032,0.112514351320321
"E02003362",613,931,177,331,600,282,2327,0.263429308122046,0.400085947571981,0.076063601203266,0.142243231628707,0.257842715943275,0.121186076493339
"E02003363",350,426,141,123,303,227,2362,0.148179508890771,0.180355630821338,0.0596951735817104,0.0520745131244708,0.128281117696867,0.0961049957662997
"E02003364",453,459,101,144,315,309,2592,0.174768518518519,0.177083333333333,0.038966049382716,0.0555555555555556,0.121527777777778,0.119212962962963
"E02003365",511,581,171,179,402,332,2160,0.236574074074074,0.268981481481481,0.0791666666666667,0.0828703703703704,0.186111111111111,0.153703703703704
"E02003366",434,487,78,156,331,278,2192,0.197992700729927,0.222171532846715,0.0355839416058394,0.0711678832116788,0.151003649635036,0.126824817518248
"E02003367",468,359,502,144,215,324,2082,0.22478386167147,0.172430355427474,0.241114313160423,0.069164265129683,0.103266090297791,0.155619596541787
"E02003368",514,413,406,199,214,315,2138,0.240411599625819,0.193171188026193,0.189897100093545,0.0930776426566885,0.100093545369504,0.14733395696913
"E02003369",483,493,517,163,330,320,2207,0.218849116447667,0.223380154055279,0.234254644313548,0.0738559130040779,0.149524241051201,0.144993203443589
"E02003370",546,433,129,170,263,376,2035,0.268304668304668,0.212776412776413,0.0633906633906634,0.0835380835380835,0.129238329238329,0.184766584766585
"E02003371",436,465,43,184,281,252,1285,0.339299610894942,0.361867704280156,0.0334630350194553,0.143190661478599,0.218677042801556,0.196108949416342
"E02003372",520,640,127,247,393,273,2203,0.23604176123468,0.290512936904222,0.0576486609169315,0.112119836586473,0.178393100317749,0.123921924648207
"E02003373",505,375,353,157,218,348,2373,0.212810788032027,0.15802781289507,0.148756847871892,0.0661609776654024,0.0918668352296671,0.146649810366625
"E02003374",476,420,34,142,278,334,2062,0.230843840931135,0.20368574199806,0.0164888457807953,0.0688651794374394,0.134820562560621,0.161978661493695
"E02003375",455,459,271,124,335,331,2296,0.198170731707317,0.199912891986063,0.118031358885017,0.054006968641115,0.145905923344948,0.144163763066202
"E02003376",524,476,472,153,323,371,2560,0.2046875,0.1859375,0.184375,0.059765625,0.126171875,0.144921875
"E02003377",616,475,502,178,297,438,3082,0.199870214146658,0.154120700843608,0.162881245944192,0.0577547047371836,0.0963659961064244,0.142115509409474
"E02003378",530,674,427,198,476,332,3603,0.147099639189564,0.18706633361088,0.118512350818762,0.0549542048293089,0.132112128781571,0.0921454343602553
"E02003379",420,496,106,156,340,264,2763,0.152008686210641,0.179515019905899,0.0383640969960188,0.0564603691639522,0.123054650741947,0.0955483170466884
"E02003380",567,657,120,258,399,309,2528,0.224287974683544,0.259889240506329,0.0474683544303797,0.102056962025316,0.157832278481013,0.122231012658228
"E02003381",467,323,146,84,239,383,1987,0.235027679919477,0.162556618017111,0.0734776044287871,0.0422747861097131,0.120281831907398,0.192752893809763
"E02003382",527,617,148,186,431,341,2923,0.180294218268902,0.211084502223743,0.0506329113924051,0.0636332535066712,0.147451248717071,0.116660964762231
"E02003383",391,372,66,120,252,271,2112,0.185132575757576,0.176136363636364,0.03125,0.0568181818181818,0.119318181818182,0.128314393939394
"E02003384",579,426,664,168,258,411,2403,0.240948813982522,0.177278401997503,0.27632126508531,0.0699126092384519,0.107365792759051,0.17103620474407
"E02003385",474,591,717,109,482,365,6902,0.0686757461605332,0.0856273543900319,0.103882932483338,0.0157925239061142,0.0698348304839177,0.052883222254419
"E02003386",637,673,540,221,452,416,3449,0.184691214844883,0.19512902290519,0.15656712090461,0.0640765439257756,0.131052478979414,0.120614670919107
"E02003387",594,744,212,262,482,332,2880,0.20625,0.258333333333333,0.0736111111111111,0.0909722222222222,0.167361111111111,0.115277777777778
"E02003388",413,384,316,137,247,276,2115,0.195271867612293,0.181560283687943,0.149408983451537,0.0647754137115839,0.116784869976359,0.130496453900709
"E02003389",536,686,145,273,413,263,2384,0.224832214765101,0.287751677852349,0.0608221476510067,0.114513422818792,0.173238255033557,0.110318791946309
"E02003390",525,651,264,233,418,292,1987,0.264217413185707,0.327629592350277,0.13286361348767,0.117262204328133,0.210367388022144,0.146955208857574
"E02003391",597,864,622,273,591,324,2766,0.215835140997831,0.31236442516269,0.224873463485177,0.0986984815618221,0.213665943600868,0.117136659436009
"E02003392",686,583,1332,166,417,520,3739,0.183471516448248,0.155924043861995,0.356244985290185,0.0443968975661942,0.111527146295801,0.139074618882054
"E02003393",608,815,331,271,544,337,2449,0.248264597795018,0.332788893425888,0.135157207023275,0.11065741118824,0.222131482237648,0.137607186606778
"E02003394",469,705,370,199,506,270,2850,0.164561403508772,0.247368421052632,0.129824561403509,0.0698245614035088,0.177543859649123,0.0947368421052632
"E02003395",819,445,2750,108,337,711,5003,0.16370177893264,0.0889466320207875,0.549670197881271,0.0215870477713372,0.0673595842494503,0.142114731161303
"E02003396",759,690,1577,178,512,581,4251,0.178546224417784,0.162314749470713,0.370971536109151,0.0418725005880969,0.120442248882616,0.136673723829687
"E02003397",529,584,328,193,391,336,2455,0.215478615071283,0.237881873727088,0.133604887983707,0.0786150712830957,0.159266802443992,0.136863543788187
"E02003398",701,410,2458,90,320,611,4451,0.157492698270052,0.0921141316558077,0.552235452707257,0.0202201752415188,0.0718939564142889,0.137272523028533
"E02003400",613,427,2023,89,338,524,3333,0.183918391839184,0.128112811281128,0.606960696069607,0.0267026702670267,0.101410141014101,0.157215721572157
"E02003401",628,1086,687,262,824,366,3819,0.164440953129091,0.284367635506677,0.179890023566379,0.0686043466876146,0.215763288819063,0.0958366064414768
"E02003402",830,721,2227,181,540,649,4500,0.184444444444444,0.160222222222222,0.494888888888889,0.0402222222222222,0.12,0.144222222222222
"E02003403",513,718,213,215,503,298,3168,0.161931818181818,0.226641414141414,0.0672348484848485,0.0678661616161616,0.158775252525253,0.0940656565656566
"E02003404",339,490,440,124,366,215,2163,0.156726768377254,0.226537216828479,0.203421174294961,0.0573277854831253,0.169209431345354,0.0993989828941285
"E02003405",474,500,264,152,348,322,5388,0.0879732739420935,0.0927988121752042,0.0489977728285078,0.0282108389012621,0.0645879732739421,0.0597624350408315
"E02003406",472,597,200,190,407,282,2297,0.205485415759687,0.259904222899434,0.087070091423596,0.0827165868524162,0.177187636047018,0.12276882890727
"E02003407",534,704,346,221,483,313,3190,0.167398119122257,0.220689655172414,0.10846394984326,0.0692789968652038,0.15141065830721,0.0981191222570533
"E02003408",496,863,850,217,646,279,3015,0.164510779436153,0.286235489220564,0.281923714759536,0.0719734660033167,0.214262023217247,0.0925373134328358
"E02003409",781,884,400,250,634,531,3533,0.22105859043306,0.250212284177753,0.11321822813473,0.0707613925842061,0.179450891593547,0.150297197848854
"E02003410",464,746,681,187,559,277,2614,0.177505738332058,0.285386381025249,0.260520275439939,0.0715378729915838,0.213848508033665,0.105967865340474
"E02003411",534,779,163,220,559,314,3193,0.167240839336048,0.2439711869715,0.0510491700595052,0.0689007203257125,0.175070466645788,0.0983401190103351
"E02003412",554,767,700,215,552,339,3206,0.172800998128509,0.239238927011853,0.218340611353712,0.0670617592014972,0.172177167810356,0.105739238927012
"E02003414",776,733,225,231,502,545,4656,0.166666666666667,0.157431271477663,0.0483247422680412,0.0496134020618557,0.107817869415808,0.117053264604811
"E02003415",599,830,1098,198,632,401,5047,0.118684366950664,0.16445413116703,0.217554983158312,0.039231226471171,0.125222904695859,0.0794531404794928
"E02003416",624,541,402,157,384,467,3112,0.200514138817481,0.173843187660668,0.129177377892031,0.0504498714652956,0.123393316195373,0.150064267352185
"E02003417",514,611,1043,111,500,403,5499,0.0934715402800509,0.111111111111111,0.189670849245317,0.0201854882705947,0.0909256228405165,0.0732860520094563
"E02003418",492,659,703,210,449,282,2860,0.172027972027972,0.23041958041958,0.245804195804196,0.0734265734265734,0.156993006993007,0.0986013986013986
"E02003419",390,687,203,175,512,215,2672,0.145958083832335,0.257110778443114,0.0759730538922156,0.0654940119760479,0.191616766467066,0.0804640718562874
"E02003420",525,686,344,219,467,306,2532,0.207345971563981,0.270932069510269,0.135860979462875,0.0864928909952607,0.184439178515008,0.12085308056872
"E02003421",399,405,264,175,230,224,1526,0.261467889908257,0.265399737876802,0.17300131061599,0.114678899082569,0.150720838794233,0.146788990825688
"E02003422",896,919,1034,331,588,565,3753,0.238742339461764,0.244870770050626,0.275512922994937,0.0881961097788436,0.156674660271783,0.15054622968292
"E02003423",332,566,176,146,420,186,2155,0.154060324825986,0.262645011600928,0.0816705336426914,0.0677494199535963,0.194895591647332,0.0863109048723898
"E02003424",562,786,388,238,548,324,3665,0.153342428376535,0.214461118690314,0.105866302864939,0.0649386084583902,0.149522510231924,0.0884038199181446
"E02003425",610,841,1394,166,675,444,7195,0.0847810979847116,0.116886726893676,0.193745656706046,0.0230715774843641,0.093815149409312,0.0617095205003475
"E02003426",628,613,853,189,424,439,3023,0.207740654978498,0.202778696658948,0.28217002977175,0.0625206748263315,0.140258021832617,0.145219980152167
"E02003427",486,796,478,230,566,256,2804,0.173323823109843,0.283880171184023,0.170470756062767,0.0820256776034237,0.201854493580599,0.0912981455064194
"E02003428",581,714,195,247,467,334,2648,0.219410876132931,0.26963746223565,0.0736404833836858,0.0932779456193353,0.176359516616314,0.126132930513595
"E02003429",500,579,442,199,380,301,2271,0.220167327168648,0.254953764861295,0.194627917217085,0.087626596213122,0.167327168648173,0.132540730955526
"E02003430",393,450,793,98,352,295,2445,0.160736196319018,0.184049079754601,0.324335378323108,0.040081799591002,0.143967280163599,0.120654396728016
"E02003431",629,491,596,182,309,447,2348,0.267887563884157,0.209114139693356,0.253833049403748,0.0775127768313458,0.13160136286201,0.190374787052811
"E02003432",442,624,1394,119,505,323,3437,0.12860052371254,0.181553680535351,0.405586267093395,0.0346232179226069,0.146930462612744,0.0939773057899331
"E02003433",402,600,233,187,413,215,2095,0.191885441527446,0.286396181384248,0.111217183770883,0.0892601431980907,0.197136038186158,0.102625298329356
"E02003434",518,718,509,193,525,325,3362,0.1540749553837,0.213563355145747,0.151397977394408,0.0574063057703748,0.156157049375372,0.0966686496133254
"E02003435",503,543,819,152,391,351,2661,0.18902668169861,0.204058624577227,0.307779030439684,0.0571213829387448,0.146937241638482,0.131905298759865
"E02003436",621,613,601,224,389,397,2681,0.231629988810145,0.228646027601641,0.224170085788885,0.0835509138381201,0.145095113763521,0.148079074972025
"E02003437",491,412,482,154,258,337,2619,0.187476135929744,0.157311951126384,0.184039709812906,0.0588010691103475,0.0985108820160367,0.128675066819397
"E02003438",697,875,784,239,636,458,4435,0.157158962795941,0.197294250281849,0.176775648252537,0.0538895152198422,0.143404735062007,0.103269447576099
"E02003439",432,429,470,151,278,281,2039,0.211868563021089,0.210397253555665,0.230505149583129,0.0740559097596861,0.136341343795978,0.137812653261403
"E02003440",849,575,319,250,325,599,3136,0.270727040816327,0.183354591836735,0.10172193877551,0.079719387755102,0.103635204081633,0.191007653061224
"E02003441",523,641,254,218,423,305,2109,0.247984826932195,0.30393551446183,0.120436225699384,0.103366524419156,0.200568990042674,0.144618302513039
"E02003442",591,329,96,122,207,469,2663,0.221930153961697,0.123544874202028,0.0360495681562148,0.0458129928651896,0.0777318813368382,0.176117161096508
"E02003443",386,559,103,176,383,210,2396,0.16110183639399,0.23330550918197,0.0429883138564274,0.0734557595993322,0.159849749582638,0.0876460767946578
"E02003444",603,828,134,331,497,272,2414,0.249792874896437,0.342999171499586,0.0555095277547639,0.137116818558409,0.205882352941176,0.112676056338028
"E02003445",605,877,118,321,556,284,2323,0.260439087387,0.377529057253551,0.0507963839862247,0.138183383555747,0.239345673697805,0.122255703831253
"E02003446",633,607,60,231,376,402,2158,0.293327154772938,0.281278962001854,0.0278035217794254,0.107043558850788,0.174235403151066,0.18628359592215
"E02003447",546,535,123,169,366,377,3475,0.157122302158273,0.153956834532374,0.0353956834532374,0.0486330935251799,0.105323741007194,0.108489208633094
"E02003448",405,468,229,166,302,239,2837,0.142756432851604,0.164962989072964,0.0807190694395488,0.0585125132181882,0.106450475854776,0.0842439196334156
"E02003449",747,361,13,137,224,610,2702,0.276461880088823,0.13360473723168,0.00481125092524056,0.0507031828275352,0.0829015544041451,0.225758697261288
"E02003450",720,679,204,212,467,508,4978,0.144636400160707,0.136400160707111,0.040980313378867,0.0425873844917638,0.0938127762153475,0.102049015668943
"E02003451",670,821,627,208,613,462,5315,0.126058325493885,0.154468485418627,0.11796801505174,0.039134524929445,0.115333960489182,0.0869238005644403
"E02003452",299,464,167,115,349,184,3295,0.0907435508345979,0.140819423368741,0.0506828528072838,0.0349013657056146,0.105918057663126,0.0558421851289833
"E02003453",452,328,56,136,192,316,1845,0.244986449864499,0.177777777777778,0.0303523035230352,0.0737127371273713,0.104065040650407,0.171273712737127
"E02003454",514,596,199,192,404,322,3123,0.164585334614153,0.19084213896894,0.063720781300032,0.0614793467819404,0.129362792187,0.103105987832213
"E02003455",389,358,338,122,236,267,4139,0.0939840541193525,0.0864943223000725,0.0816622372553757,0.0294757187726504,0.0570186035274221,0.0645083353467021
"E02003456",381,407,155,107,300,274,4093,0.0930857561690691,0.0994380649890056,0.0378695333496213,0.0261421939897386,0.073295870999267,0.0669435621793306
"E02003457",682,743,156,269,474,413,2617,0.260603744745892,0.283912877340466,0.0596102407336645,0.102789453572793,0.181123423767673,0.157814291173099
"E02003458",522,558,131,195,363,327,2275,0.229450549450549,0.245274725274725,0.0575824175824176,0.0857142857142857,0.15956043956044,0.143736263736264
"E02003459",534,347,773,102,245,432,3653,0.146181220914317,0.0949904188338352,0.211606898439639,0.0279222556802628,0.0670681631535724,0.118258965234054
"E02003460",554,428,744,135,293,419,4739,0.116902300063305,0.090314412323275,0.156995146655413,0.0284870225786031,0.0618273897446719,0.0884152774847014
"E02003461",532,472,205,167,305,365,2309,0.230402771762668,0.204417496751841,0.0887830229536596,0.072325682113469,0.132091814638372,0.158077089649199
"E02003462",547,426,542,143,283,404,2951,0.185360894611996,0.144357844798373,0.183666553710607,0.0484581497797357,0.0958996950186378,0.13690274483226
"E02003463",501,407,47,141,266,360,2032,0.246555118110236,0.200295275590551,0.0231299212598425,0.0693897637795276,0.130905511811024,0.177165354330709
"E02003464",440,483,232,137,346,303,2379,0.184951660361496,0.203026481715006,0.0975199663724254,0.0575872215216478,0.145439260193359,0.127364438839849
"E02003465",363,111,9,34,77,329,2132,0.170262664165103,0.0520637898686679,0.00422138836772983,0.0159474671669794,0.0361163227016886,0.154315196998124
"E02003466",462,170,1739,44,126,418,3019,0.153030804902286,0.0563100364359059,0.576018549188473,0.0145743623716462,0.0417356740642597,0.138456442530639
"E02003467",437,537,36,131,406,306,2747,0.159082635602475,0.195485984710593,0.0131052056789225,0.0476883873316345,0.147797597378959,0.111394248270841
"E02003468",523,691,670,214,477,309,3683,0.142003801248982,0.187618789030682,0.181916915557969,0.0581048058647841,0.129513983165897,0.0838989953841977
"E02003469",434,275,103,80,195,354,1789,0.242593627724986,0.153717160424818,0.0575740637227501,0.0447177193963108,0.108999441028508,0.197875908328675
"E02003470",503,1326,26,272,1054,231,2595,0.19383429672447,0.510982658959538,0.010019267822736,0.104816955684008,0.40616570327553,0.0890173410404624
"E02003471",481,453,2,135,318,346,2274,0.211521547933157,0.199208443271768,0.000879507475813544,0.0593667546174142,0.139841688654354,0.152154793315743
"E02003472",484,1178,12,250,928,234,7556,0.0640550555849656,0.155902593965061,0.00158814187400741,0.0330862890418211,0.12281630492324,0.0309687665431445
"E02003473",544,167,3,57,110,487,1885,0.288594164456233,0.0885941644562334,0.00159151193633952,0.0302387267904509,0.0583554376657825,0.258355437665783
"E02003474",325,472,28,75,397,250,2925,0.111111111111111,0.161367521367521,0.00957264957264957,0.0256410256410256,0.135726495726496,0.0854700854700855
"E02003476",548,795,11,182,613,366,3242,0.169031462060457,0.245219000616903,0.00339296730413325,0.0561381863047502,0.189080814312153,0.112893275755706
"E02003478",441,200,76,61,139,380,2302,0.191572545612511,0.0868809730668983,0.0330147697654214,0.026498696785404,0.0603822762814944,0.165073848827107
"E02003479",506,463,1,145,318,361,2698,0.187546330615271,0.171608598962194,0.000370644922164566,0.0537435137138621,0.117865085248332,0.133802816901408
"E02003480",510,232,6,65,167,445,3339,0.152740341419587,0.0694818808026355,0.00179694519317161,0.0194669062593591,0.0500149745432764,0.133273435160228
"E02003481",384,370,119,38,332,346,4066,0.0944417117560256,0.0909985243482538,0.02926709296606,0.00934579439252336,0.0816527299557304,0.0850959173635022
"E02003482",326,258,489,61,197,265,5871,0.055527167433146,0.0439448134900358,0.083290751149719,0.0103900528019077,0.0335547606881281,0.0451371146312383
"E02003483",349,110,13,14,96,335,3689,0.0946055841691515,0.029818378964489,0.00352399024125779,0.00379506641366224,0.0260233125508268,0.0908105177554893
"E02003484",566,153,0,61,92,505,2449,0.231114740710494,0.0624744793793385,0,0.0249081257656186,0.0375663536137199,0.206206614944875
"E02003485",467,492,83,157,335,310,2354,0.19838572642311,0.209005947323704,0.0352591333899745,0.0666949872557349,0.142310960067969,0.131690739167375
"E02003486",489,145,2,33,112,456,4166,0.117378780604897,0.0348055688910226,0.000480076812289966,0.00792126740278445,0.0268843014882381,0.109457513202112
"E02003487",463,492,87,151,341,312,2178,0.212580348943985,0.225895316804408,0.0399449035812672,0.0693296602387511,0.156565656565657,0.143250688705234
"E02003488",393,477,729,133,344,260,3238,0.121371216800494,0.147313156269302,0.225138974675726,0.0410747374922792,0.106238418777023,0.0802964793082149
"E02003489",414,352,190,124,228,290,2648,0.156344410876133,0.132930513595166,0.0717522658610272,0.0468277945619335,0.0861027190332326,0.109516616314199
"E02003490",106,360,50,28,332,78,4652,0.0227858985382631,0.0773860705073087,0.0107480653482373,0.0060189165950129,0.0713671539122958,0.0167669819432502
"E02003491",528,851,147,264,587,264,2248,0.234875444839858,0.37855871886121,0.0653914590747331,0.117437722419929,0.261120996441281,0.117437722419929
"E02003492",295,439,144,118,321,177,1925,0.153246753246753,0.228051948051948,0.0748051948051948,0.0612987012987013,0.166753246753247,0.0919480519480519
"E02003493",585,1040,216,297,743,288,2850,0.205263157894737,0.364912280701754,0.0757894736842105,0.104210526315789,0.260701754385965,0.101052631578947
"E02003494",489,841,271,261,580,228,1988,0.245975855130785,0.423038229376258,0.136317907444668,0.131287726358149,0.291750503018109,0.114688128772636
"E02003495",643,604,55,251,353,392,2155,0.298375870069606,0.280278422273782,0.0255220417633411,0.116473317865429,0.163805104408353,0.181902552204176
"E02003496",613,558,76,234,324,379,2307,0.265713047247508,0.241872561768531,0.0329432162982228,0.101430429128739,0.140442132639792,0.164282618118769
"E02003497",514,975,186,314,661,200,2285,0.224945295404814,0.426695842450766,0.0814004376367615,0.137417943107221,0.289277899343545,0.087527352297593
"E02003498",447,818,447,191,627,256,3286,0.136031649421789,0.248934875228241,0.136031649421789,0.0581253804017042,0.190809494826537,0.0779062690200852
"E02003499",356,696,164,169,527,187,2125,0.167529411764706,0.327529411764706,0.0771764705882353,0.0795294117647059,0.248,0.088
"E02003500",541,1258,913,303,955,238,2644,0.204614220877458,0.475794251134644,0.345310136157337,0.114599092284418,0.361195158850227,0.0900151285930409
"E02003501",595,1194,1122,272,922,323,3596,0.165461624026696,0.332035595105673,0.312013348164627,0.0756395995550612,0.256395995550612,0.0898220244716351
"E02003502",561,826,494,250,576,311,2648,0.211858006042296,0.311933534743202,0.186555891238671,0.0944108761329305,0.217522658610272,0.117447129909366
"E02003503",595,976,102,299,677,296,2478,0.240112994350282,0.393866020984665,0.0411622276029056,0.120661824051655,0.273204196933011,0.119451170298628
"E02003504",521,659,2631,56,603,465,4418,0.11792666364871,0.149162516976007,0.595518334087823,0.012675418741512,0.136487098234495,0.105251244907198
"E02003505",609,457,2711,94,363,515,3991,0.152593335003758,0.114507642194939,0.67927837634678,0.0235529942370333,0.0909546479579053,0.129040340766725
"E02003506",533,637,1630,157,480,376,3555,0.149929676511955,0.179184247538678,0.458509142053446,0.0441631504922644,0.135021097046413,0.105766526019691
"E02003507",751,857,155,312,545,439,2784,0.269755747126437,0.307830459770115,0.0556752873563218,0.112068965517241,0.195761494252874,0.157686781609195
"E02003508",624,1413,1364,313,1100,311,3374,0.184943687018376,0.418790752815649,0.404267931238886,0.0927682276229994,0.32602252519265,0.0921754593953764
"E02003509",519,652,3131,62,590,457,5448,0.0952643171806167,0.119676945668135,0.574706314243759,0.0113803230543319,0.108296622613803,0.0838839941262849
"E02003510",357,1312,1497,163,1149,194,4692,0.0760869565217391,0.279624893435635,0.319053708439898,0.0347399829497016,0.244884910485933,0.0413469735720375
"E02003511",634,1248,750,337,911,297,3335,0.190104947526237,0.374212893553223,0.224887556221889,0.101049475262369,0.273163418290855,0.0890554722638681
"E02003512",542,490,2549,78,412,464,3751,0.144494801386297,0.130631831511597,0.679552119434817,0.0207944548120501,0.109837376699547,0.123700346574247
"E02003513",407,951,675,194,757,213,2613,0.15575966322235,0.363949483352468,0.258323765786452,0.0742441637964026,0.289705319556066,0.0815154994259472
"E02003514",468,364,3780,43,321,425,5345,0.0875584658559401,0.0681010289990645,0.707202993451824,0.00804490177736202,0.0600561272217025,0.0795135640785781
"E02003515",320,543,158,114,429,206,2878,0.111188325225851,0.188672689367616,0.0548992355802641,0.0396108408617095,0.149061848505907,0.0715774843641418
"E02003516",411,415,3976,22,393,389,5520,0.0744565217391304,0.0751811594202899,0.720289855072464,0.00398550724637681,0.071195652173913,0.0704710144927536
"E02003517",691,499,3377,60,439,631,7624,0.0906348373557188,0.0654512067156348,0.44294333683106,0.00786988457502623,0.0575813221406086,0.0827649527806926
"E02003518",370,1007,2587,67,940,303,4917,0.0752491356518202,0.204799674598332,0.526133821435835,0.0136261948342485,0.191173479764084,0.0616229408175717
"E02003519",402,276,3955,5,271,397,5691,0.0706378492356352,0.0484976278334212,0.694956949569496,0.000878580214373572,0.0476190476190476,0.0697592690212616
"E02003520",450,515,2640,60,455,390,5295,0.084985835694051,0.097261567516525,0.498583569405099,0.0113314447592068,0.0859301227573182,0.0736543909348442
"E02003521",373,433,2782,32,401,341,4919,0.0758284204106526,0.0880260215490953,0.56556210611913,0.00650538727383615,0.0815206342752592,0.0693230331368164
"E02003522",439,643,1162,118,525,321,4249,0.10331842786538,0.151329724641092,0.273476112026359,0.0277712402918334,0.123558484349259,0.0755471875735467
"E02003523",1026,1356,317,492,864,534,4151,0.247169356781498,0.326668272705372,0.0763671404480848,0.118525656468321,0.208142616237051,0.128643700313178
"E02003524",670,426,65,168,258,502,2679,0.250093318402389,0.159014557670773,0.0242627846211273,0.0627099664053751,0.0963045912653975,0.187383351997014
"E02003525",459,589,56,190,399,269,2339,0.196237708422403,0.251817015818726,0.0239418554938008,0.0812312954253955,0.17058572039333,0.115006412997007
"E02003526",435,771,61,227,544,208,2151,0.202231520223152,0.358437935843794,0.0283589028358903,0.105532310553231,0.252905625290563,0.096699209669921
"E02003527",425,571,56,138,433,287,2532,0.167851500789889,0.225513428120063,0.0221169036334913,0.0545023696682464,0.171011058451817,0.113349131121643
"E02003529",494,1011,131,302,709,192,2575,0.191844660194175,0.392621359223301,0.050873786407767,0.117281553398058,0.275339805825243,0.0745631067961165
"E02003530",467,959,118,250,709,217,2961,0.157716987504222,0.32387706855792,0.0398514015535292,0.0844309354947653,0.239446133063154,0.0732860520094563
"E02003531",681,1034,71,327,707,354,2459,0.276941846278975,0.420496136640911,0.0288735258235055,0.132980886539244,0.287515250101667,0.143960959739732
"E02003532",687,1907,213,521,1386,166,3181,0.215969820811066,0.599497013517762,0.0669600754479723,0.163784973278843,0.435712040238919,0.0521848475322226
"E02003533",447,1379,179,328,1051,119,2274,0.196569920844327,0.606420404573439,0.0787159190853122,0.144239226033421,0.462181178540018,0.0523306948109059
"E02003534",736,2037,241,570,1467,166,3148,0.233799237611182,0.64707750952986,0.076556543837357,0.181067344345616,0.466010165184244,0.0527318932655654
"E02003535",760,2281,411,599,1682,161,3623,0.209770908087221,0.629588738614408,0.113441898978747,0.165332597295059,0.464256141319349,0.0444383107921612
"E02003536",324,789,160,121,668,203,3352,0.0966587112171838,0.235381861575179,0.0477326968973747,0.0360978520286396,0.199284009546539,0.0605608591885442
"E02003537",735,1642,211,531,1111,204,3564,0.206228956228956,0.460718294051627,0.0592031425364759,0.148989898989899,0.311728395061728,0.0572390572390572
"E02003538",925,2477,591,657,1820,268,4646,0.199095996556177,0.533146792940164,0.127206198880758,0.141411967283685,0.391734825656479,0.0576840292724925
"E02003540",623,1471,129,422,1049,201,3624,0.171909492273731,0.405905077262693,0.0355960264900662,0.11644591611479,0.289459161147903,0.0554635761589404
"E02003541",466,1687,486,284,1403,182,4865,0.0957862281603289,0.346762589928058,0.0998972250770812,0.0583761562178828,0.288386433710175,0.037410071942446
"E02003542",845,2387,283,675,1712,170,3634,0.232526141992295,0.65685195376995,0.0778756191524491,0.185745734727573,0.471106219042378,0.0467804072647221
"E02003543",768,2438,614,586,1852,182,3854,0.199273482096523,0.632589517384536,0.159314997405293,0.152049818370524,0.480539699014011,0.047223663725999
"E02003544",595,1669,202,476,1193,119,2832,0.210098870056497,0.58933615819209,0.0713276836158192,0.168079096045198,0.421257062146893,0.0420197740112994
"E02003545",456,1909,1053,264,1645,192,4116,0.110787172011662,0.46379980563654,0.255830903790087,0.0641399416909621,0.399659863945578,0.0466472303206997
"E02003546",603,1748,326,394,1354,209,3638,0.165750412314459,0.480483782297966,0.0896096756459593,0.108301264431006,0.37218251786696,0.0574491478834524
"E02003547",348,1776,1059,177,1599,171,5488,0.0634110787172012,0.323615160349854,0.192966472303207,0.0322521865889213,0.291362973760933,0.0311588921282799
"E02003548",544,1687,562,403,1284,141,2999,0.181393797932644,0.562520840280093,0.187395798599533,0.134378126042014,0.428142714238079,0.0470156718906302
"E02003549",435,810,105,209,601,226,2430,0.179012345679012,0.333333333333333,0.0432098765432099,0.0860082304526749,0.247325102880658,0.0930041152263374
"E02003550",581,836,76,240,596,341,2690,0.215985130111524,0.310780669144981,0.0282527881040892,0.0892193308550186,0.221561338289963,0.126765799256506
"E02003551",345,804,153,151,653,194,2350,0.146808510638298,0.342127659574468,0.0651063829787234,0.0642553191489362,0.277872340425532,0.0825531914893617
"E02003552",429,747,107,163,584,266,2480,0.172983870967742,0.301209677419355,0.0431451612903226,0.0657258064516129,0.235483870967742,0.107258064516129
"E02003553",344,782,69,178,604,166,2318,0.148403796376186,0.337359792924935,0.0297670405522002,0.0767903364969802,0.260569456427955,0.0716134598792062
"E02003554",358,714,94,153,561,205,2375,0.150736842105263,0.300631578947368,0.0395789473684211,0.0644210526315789,0.236210526315789,0.0863157894736842
"E02003555",454,594,116,152,442,302,3313,0.13703591910655,0.179293691518261,0.0350135828554181,0.0458798671898581,0.133413824328403,0.0911560519166918
"E02003556",358,701,58,173,528,185,1869,0.191546281433922,0.375066880684858,0.0310326377742108,0.0925628678437667,0.282504012841092,0.0989834135901552
"E02003557",464,996,226,231,765,233,3049,0.152181042964907,0.326664480157429,0.0741226631682519,0.075762545096753,0.250901935060676,0.0764184978681535
"E02003558",436,969,207,228,741,208,3200,0.13625,0.3028125,0.0646875,0.07125,0.2315625,0.065
"E02003559",423,972,105,245,727,178,2400,0.17625,0.405,0.04375,0.102083333333333,0.302916666666667,0.0741666666666667
"E02003560",447,455,206,116,339,331,2621,0.170545593285006,0.173597863410912,0.0785959557420832,0.0442579168256391,0.129339946585273,0.126287676459367
"E02003561",528,1247,325,254,993,274,3795,0.139130434782609,0.328590250329381,0.0856389986824769,0.0669301712779974,0.261660079051383,0.0722002635046113
"E02003562",536,988,161,249,739,287,3577,0.149846239865809,0.276209113782499,0.0450097847358121,0.0696114062063181,0.206597707576181,0.0802348336594912
"E02003563",454,1247,156,237,1010,217,3743,0.121293080416778,0.333155223083088,0.041677798557307,0.0633181939620625,0.269837029121026,0.0579748864547155
"E02003564",508,1046,94,241,805,267,3103,0.163712536255237,0.337093135675153,0.0302932645826619,0.0776667740895907,0.259426361585562,0.0860457621656461
"E02003565",429,1044,341,238,806,191,3394,0.126399528579847,0.307601649970536,0.100471420153212,0.070123747790218,0.237477902180318,0.0562757807896288
"E02003566",421,429,70,143,286,278,2184,0.192765567765568,0.196428571428571,0.032051282051282,0.0654761904761905,0.130952380952381,0.127289377289377
"E02003567",440,648,100,183,465,257,2487,0.176919983916365,0.260554885404101,0.0402090872537193,0.0735826296743064,0.186972255729795,0.103337354242059
"E02003568",566,1296,383,251,1045,315,4206,0.134569662387066,0.308131241084165,0.0910603899191631,0.0596766524013314,0.248454588682834,0.0748930099857347
"E02003569",552,1324,312,284,1040,268,3888,0.141975308641975,0.340534979423868,0.0802469135802469,0.0730452674897119,0.267489711934156,0.0689300411522634
"E02003570",492,1632,545,277,1355,215,5254,0.0936429387133613,0.310620479634564,0.103730491054435,0.0527217358203274,0.257898743814237,0.0409212028930339
"E02003571",383,935,400,220,715,163,4232,0.0905009451795841,0.22093572778828,0.0945179584120983,0.0519848771266541,0.168950850661626,0.0385160680529301
"E02003572",392,700,61,192,508,200,1895,0.206860158311346,0.369393139841689,0.0321899736147757,0.10131926121372,0.268073878627968,0.105540897097625
"E02003573",415,580,45,129,451,286,2926,0.141831852358168,0.198222829801777,0.0153793574846206,0.0440874914559125,0.154135338345865,0.0977443609022556
"E02003574",535,929,119,240,689,295,2819,0.189783611209649,0.329549485633203,0.0422135509045761,0.0851365732529266,0.244412912380277,0.104647037956722
"E02003575",320,537,55,107,430,213,2769,0.115565185987721,0.193932827735645,0.0198627663416396,0.0386421090646443,0.155290718671,0.0769230769230769
"E02003576",510,955,140,221,734,289,2977,0.171313402754451,0.32079274437353,0.047027208599261,0.074235807860262,0.246556936513268,0.0970775948941888
"E02003578",437,532,40,155,377,282,2151,0.203161320316132,0.247326824732682,0.0185960018596002,0.0720595072059507,0.175267317526732,0.131101813110181
"E02003579",566,974,228,240,734,326,4378,0.129282777523984,0.222476016445866,0.05207857469164,0.0548195523069895,0.167656464138876,0.0744632252169941
"E02003580",394,390,45,113,277,281,2405,0.163825363825364,0.162162162162162,0.0187110187110187,0.046985446985447,0.115176715176715,0.116839916839917
"E02003581",627,1713,533,356,1357,271,4116,0.152332361516035,0.416180758017493,0.129494655004859,0.086491739552964,0.329689018464529,0.0658406219630709
"E02003582",492,1144,141,259,885,233,3072,0.16015625,0.372395833333333,0.0458984375,0.0843098958333333,0.2880859375,0.0758463541666667
"E02003583",392,745,140,194,551,198,3260,0.120245398773006,0.228527607361963,0.0429447852760736,0.0595092024539877,0.169018404907975,0.0607361963190184
"E02003584",374,1223,1227,185,1038,189,3666,0.102018548827059,0.333606110201855,0.334697217675941,0.0504637206764866,0.283142389525368,0.0515548281505728
"E02003585",525,809,114,252,557,273,2448,0.214460784313725,0.33047385620915,0.0465686274509804,0.102941176470588,0.227532679738562,0.111519607843137
"E02003586",491,1087,276,239,848,252,2986,0.16443402545211,0.36403215003349,0.0924313462826524,0.080040187541862,0.283991962491628,0.0843938379102478
"E02003587",401,1470,292,223,1247,178,3809,0.105276975584143,0.385928065108953,0.0766605408243634,0.0585455500131268,0.327382515095826,0.046731425571016
"E02003588",429,945,160,227,718,202,3524,0.121736662883087,0.268161180476731,0.0454029511918275,0.0644154370034052,0.203745743473326,0.0573212258796822
"E02003589",510,1232,457,256,976,254,3531,0.144435004248088,0.348909657320872,0.129425092041914,0.0725007080147267,0.276408949306146,0.0719342962333617
"E02003590",842,1404,246,461,943,381,3676,0.22905331882481,0.381936887921654,0.0669205658324265,0.125408052230686,0.256528835690968,0.103645266594124
"E02003591",559,1087,270,272,815,287,3444,0.162311265969803,0.315621370499419,0.078397212543554,0.0789779326364692,0.23664343786295,0.0833333333333333
"E02003592",857,1549,355,471,1078,386,4736,0.180954391891892,0.327069256756757,0.0749577702702703,0.0994510135135135,0.227618243243243,0.0815033783783784
"E02003593",477,586,322,210,376,267,1986,0.240181268882175,0.295065458207452,0.162134944612286,0.105740181268882,0.18932527693857,0.134441087613293
"E02003594",564,1291,357,290,1001,274,3834,0.147104851330203,0.336724047991654,0.0931142410015649,0.0756390193009911,0.261085028690662,0.0714658320292123
"E02003595",591,931,127,279,652,312,2973,0.198789101917255,0.313151698620922,0.0427177934746048,0.0938446014127144,0.219307097208207,0.104944500504541
"E02003596",616,1668,342,361,1307,255,4357,0.141381684645398,0.382832224007345,0.0784943768648152,0.0828551755795272,0.299977048427817,0.058526509065871
"E02003597",498,580,409,205,375,293,2226,0.223719676549865,0.260557053009883,0.183737646001797,0.0920934411500449,0.168463611859838,0.13162623539982
"E02003598",627,1003,1256,241,762,386,3871,0.161973650219582,0.259106174115216,0.32446396280031,0.0622578145182123,0.196848359597003,0.0997158357013692
"E02003599",371,314,137,78,236,293,2039,0.181951937224129,0.153997057381069,0.0671897989210397,0.0382540461010299,0.115743011280039,0.1436978911231
"E02003600",400,419,401,114,305,286,2205,0.18140589569161,0.190022675736961,0.181859410430839,0.0517006802721088,0.138321995464853,0.129705215419501
"E02003601",516,353,501,119,234,397,3048,0.169291338582677,0.115813648293963,0.164370078740157,0.0390419947506562,0.0767716535433071,0.130249343832021
"E02003602",424,293,499,85,208,339,2417,0.175424079437319,0.12122465866777,0.206454282167977,0.0351675630947456,0.0860570955730244,0.140256516342573
"E02003603",653,659,708,154,505,499,4619,0.141372591470015,0.142671573933752,0.153279930720935,0.0333405499025763,0.109331024031176,0.108032041567439
"E02003604",357,282,145,92,190,265,4068,0.0877581120943953,0.0693215339233038,0.0356440511307768,0.0226155358898722,0.0467059980334317,0.0651425762045231
"E02003605",459,400,612,126,274,333,3582,0.128140703517588,0.111669458403127,0.170854271356784,0.0351758793969849,0.0764935790061418,0.092964824120603
"E02003606",495,332,391,115,217,380,3716,0.133207750269107,0.0893433799784715,0.105220667384284,0.0309472551130248,0.0583961248654467,0.102260495156082
"E02003607",531,366,786,109,257,422,4273,0.124268663702317,0.0856541071846478,0.18394570559326,0.0255090100631875,0.0601450971214603,0.0987596536391294
"E02003608",679,685,749,198,487,481,4689,0.144806995094903,0.146086585625933,0.159735551290254,0.0422264875239923,0.103860098101941,0.102580507570911
"E02003609",660,570,528,173,397,487,4502,0.146601510439805,0.126610395379831,0.117281208351844,0.0384273656152821,0.0881830297645491,0.108174144824522
"E02003610",394,323,499,93,230,301,3055,0.128968903436989,0.105728314238953,0.163338788870704,0.0304418985270049,0.0752864157119476,0.0985270049099836
"E02003611",414,506,351,139,367,275,4245,0.0975265017667845,0.119199057714959,0.0826855123674912,0.0327444051825677,0.0864546525323911,0.0647820965842167
"E02003612",465,370,500,118,252,347,5014,0.0927403270841643,0.0737933785400878,0.0997207818109294,0.0235341045073793,0.0502592740327084,0.069206222576785
"E02003613",396,224,223,92,132,304,2059,0.192326372025255,0.108790675084993,0.108305002428363,0.0446818844099077,0.064108790675085,0.147644487615347
"E02003614",478,477,178,167,310,311,2631,0.181679969593311,0.181299885974914,0.0676548840744964,0.0634739642721399,0.117825921702775,0.118206005321171
"E02003615",526,414,365,168,246,358,3366,0.156268568033274,0.122994652406417,0.108437314319667,0.0499108734402852,0.0730837789661319,0.106357694592989
"E02003616",336,257,337,85,172,251,1782,0.188552188552189,0.144219977553311,0.189113355780022,0.047699214365881,0.0965207631874299,0.140852974186308
"E02003617",541,348,822,142,206,399,2840,0.190492957746479,0.122535211267606,0.28943661971831,0.05,0.0725352112676056,0.140492957746479
"E02003618",472,449,408,140,309,332,2643,0.178584941354521,0.169882709042754,0.154370034052213,0.0529701097237987,0.116912599318956,0.125614831630723
"E02003619",555,422,533,152,270,403,4077,0.136129506990434,0.103507480990925,0.130733382389012,0.0372823154280108,0.0662251655629139,0.0988471915624233
"E02003620",477,552,139,185,367,292,2521,0.189210630702102,0.2189607298691,0.0551368504561682,0.0733835779452598,0.14557715192384,0.115827052756843
"E02003621",475,518,76,182,336,293,2083,0.228036485837734,0.248679788766203,0.0364858377340374,0.0873739798367739,0.161305808929429,0.14066250600096
"E02003622",580,527,195,168,359,412,3584,0.161830357142857,0.147042410714286,0.0544084821428571,0.046875,0.100167410714286,0.114955357142857
"E02003623",393,385,230,110,275,283,4893,0.0803188228080932,0.0786838340486409,0.047005926834253,0.0224810954424688,0.0562027386061721,0.0578377273656244
"E02003624",390,299,1110,68,231,322,2367,0.164765525982256,0.126320236586396,0.468948035487959,0.0287283481199831,0.0975918884664132,0.136037177862273
"E02003625",634,428,1777,85,343,549,4603,0.137736258961547,0.0929828372800348,0.386052574407995,0.0184662176841191,0.0745166195959157,0.119270041277428
"E02003626",378,283,231,101,182,277,1804,0.209534368070953,0.156873614190687,0.128048780487805,0.0559866962305987,0.100886917960089,0.153547671840355
"E02003627",705,299,2436,53,246,652,5470,0.128884826325411,0.0546617915904936,0.445338208409506,0.00968921389396709,0.0449725776965265,0.119195612431444
"E02003628",374,283,1253,98,185,276,2786,0.13424264178033,0.101579325197416,0.449748743718593,0.0351758793969849,0.0664034458004307,0.0990667623833453
"E02003629",627,361,627,121,240,506,4340,0.144470046082949,0.0831797235023042,0.144470046082949,0.0278801843317972,0.0552995391705069,0.116589861751152
"E02003630",490,174,1410,47,127,443,4709,0.104056062858356,0.0369505202803143,0.299426629857719,0.00998088766192397,0.0269696326183903,0.0940751751964324
"E02003631",275,292,287,63,229,212,1870,0.147058823529412,0.156149732620321,0.153475935828877,0.0336898395721925,0.122459893048128,0.113368983957219
"E02003632",395,333,697,100,233,295,2069,0.190913484775254,0.160947317544708,0.336877718704688,0.0483325277912035,0.112614789753504,0.14258095698405
"E02003633",425,471,313,159,312,266,3609,0.117761152673871,0.13050706566916,0.086727625380992,0.0440565253532835,0.086450540315877,0.0737046273205874
"E02003635",348,239,161,104,135,244,3620,0.0961325966850829,0.0660220994475138,0.044475138121547,0.0287292817679558,0.037292817679558,0.0674033149171271
"E02003636",532,397,175,137,260,395,2280,0.233333333333333,0.174122807017544,0.0767543859649123,0.0600877192982456,0.114035087719298,0.173245614035088
"E02003637",752,555,604,191,364,561,4302,0.174802417480242,0.129009762900976,0.140399814039981,0.0443979544397954,0.0846118084611808,0.130404463040446
"E02003638",465,595,96,174,421,291,3024,0.153769841269841,0.196759259259259,0.0317460317460317,0.0575396825396825,0.139219576719577,0.0962301587301587
"E02003639",571,709,1028,153,556,418,4804,0.118859283930058,0.147585345545379,0.21398834304746,0.0318484596169858,0.115736885928393,0.0870108243130724
"E02003640",412,448,518,123,325,289,2315,0.177969762419006,0.193520518358531,0.223758099352052,0.0531317494600432,0.140388768898488,0.124838012958963
"E02003641",379,530,151,158,372,221,1535,0.246905537459283,0.345276872964169,0.098371335504886,0.102931596091205,0.242345276872964,0.143973941368078
"E02003642",734,661,77,252,409,482,4557,0.161070879964889,0.145051569014703,0.0168970814132104,0.0552995391705069,0.0897520298441957,0.105771340794382
"E02003643",404,282,215,87,195,317,5217,0.0774391412689285,0.0540540540540541,0.0412114241901476,0.0166762507188039,0.0373778033352501,0.0607628905501246
"E02003644",761,548,193,193,355,568,5732,0.132763433356595,0.0956036287508723,0.0336706210746685,0.0336706210746685,0.0619330076762038,0.099092812281926
"E02003645",443,478,271,162,316,281,1876,0.236140724946695,0.254797441364606,0.144456289978678,0.0863539445628998,0.168443496801706,0.149786780383795
"E02003646",630,709,266,206,503,424,4103,0.153546185717767,0.172800389958567,0.0648306117475018,0.0502071654886668,0.1225932244699,0.103339020229101
"E02003647",663,617,1036,139,478,524,4991,0.132839110398718,0.123622520536967,0.207573632538569,0.027850130234422,0.0957723903025446,0.104988980164296
"E02003648",411,326,353,85,241,326,2454,0.167481662591687,0.132844335778321,0.143846780766096,0.0346373268133659,0.0982070089649552,0.132844335778321
"E02003649",410,595,184,159,436,251,2120,0.193396226415094,0.280660377358491,0.0867924528301887,0.075,0.205660377358491,0.118396226415094
"E02003650",582,581,312,206,375,376,2389,0.243616575973211,0.243197990791126,0.130598576810381,0.0862285475094182,0.156969443281708,0.157388028463792
"E02003651",426,418,437,129,289,297,2335,0.182441113490364,0.179014989293362,0.187152034261242,0.0552462526766595,0.123768736616702,0.127194860813704
"E02003652",515,319,398,110,209,405,3854,0.133627400103788,0.0827711468604048,0.103269330565646,0.0285417747794499,0.0542293720809549,0.105085625324338
"E02003653",420,427,416,135,292,285,2902,0.144727773949001,0.147139903514817,0.143349414197105,0.0465196416264645,0.100620261888353,0.0982081323225362
"E02003654",375,297,399,111,186,264,1948,0.192505133470226,0.152464065708419,0.20482546201232,0.0569815195071869,0.095482546201232,0.135523613963039
"E02003655",625,394,678,150,244,475,3773,0.165650675854757,0.104426186058839,0.179697853167241,0.0397561622051418,0.0646700238536973,0.125894513649616
"E02003656",452,287,391,116,171,336,2806,0.161083392729865,0.102280826799715,0.139344262295082,0.0413399857448325,0.0609408410548824,0.119743406985032
"E02003657",422,280,474,89,191,333,2716,0.155375552282769,0.103092783505155,0.174521354933726,0.0327687776141384,0.0703240058910162,0.12260677466863
"E02003658",511,396,592,157,239,354,4570,0.111816192560175,0.0866520787746171,0.129540481400438,0.0343544857768052,0.0522975929978118,0.0774617067833698
"E02003659",488,337,767,113,224,375,3810,0.128083989501312,0.0884514435695538,0.201312335958005,0.0296587926509186,0.0587926509186352,0.0984251968503937
"E02003660",720,498,506,197,301,523,3644,0.197585071350165,0.136663007683864,0.138858397365532,0.0540614709110867,0.0826015367727772,0.143523600439078
"E02003661",446,308,370,126,182,320,1826,0.244249726177437,0.168674698795181,0.2026286966046,0.0690032858707558,0.099671412924425,0.175246440306681
"E02003662",412,260,42,69,191,343,2397,0.171881518564873,0.108468919482687,0.0175219023779725,0.0287859824780976,0.0796829370045891,0.143095536086775
"E02003663",309,216,38,93,123,216,5489,0.0562944069958098,0.0393514301329933,0.00692293678265622,0.0169429768628165,0.0224084532701767,0.0393514301329933
"E02003664",380,484,255,169,315,211,3370,0.112759643916914,0.143620178041543,0.0756676557863502,0.0501483679525223,0.0934718100890208,0.0626112759643917
"E02003665",420,340,253,102,238,318,1995,0.210526315789474,0.170426065162907,0.126817042606516,0.0511278195488722,0.119298245614035,0.159398496240602
"E02003666",343,287,882,71,216,272,4014,0.0854509217737917,0.0714997508719482,0.219730941704036,0.0176880916791231,0.0538116591928251,0.0677628300946687
"E02003667",423,336,44,118,218,305,3900,0.108461538461538,0.0861538461538462,0.0112820512820513,0.0302564102564103,0.0558974358974359,0.0782051282051282
"E02003668",517,836,135,249,587,268,2414,0.214167357083679,0.346313173156587,0.055923777961889,0.103148301574151,0.243164871582436,0.111019055509528
"E02003669",261,228,482,79,149,182,2619,0.0996563573883162,0.0870561282932417,0.184039709812906,0.0301641848033601,0.0568919434898816,0.0694921725849561
"E02003670",632,637,216,212,425,420,3312,0.190821256038647,0.192330917874396,0.0652173913043478,0.0640096618357488,0.128321256038647,0.126811594202899
"E02003671",499,337,13,157,180,342,2137,0.233504913430042,0.15769770706598,0.00608329433785681,0.0734674777725784,0.084230229293402,0.160037435657464
"E02003672",615,582,517,203,379,412,5163,0.119116792562464,0.112725159790819,0.100135580089095,0.0393182258376913,0.073406933953128,0.0797985667247724
"E02003673",530,492,401,175,317,355,3647,0.145324924595558,0.134905401700027,0.109953386344941,0.0479846449136276,0.0869207567863998,0.0973402796819303
"E02003674",389,296,330,124,172,265,2019,0.192669638434869,0.146607231302625,0.163447251114413,0.0614165428429916,0.0851906884596335,0.131253095591877
"E02003675",540,575,391,176,399,364,3537,0.152671755725191,0.162567147299972,0.110545660163981,0.0497596833474696,0.112807463952502,0.102912072377721
"E02003676",619,515,650,185,330,434,2389,0.259104227710339,0.215571368773545,0.27208036835496,0.0774382586856425,0.138133110087903,0.181665969024697
"E02003677",535,706,323,198,508,337,3249,0.164666051092644,0.217297630040012,0.0994152046783626,0.0609418282548476,0.156355801785165,0.103724222837796
"E02003678",410,476,393,148,328,262,1869,0.219368646334938,0.254681647940075,0.210272873194221,0.0791867308721241,0.175494917067951,0.140181915462814
"E02003679",471,532,911,120,412,351,3206,0.14691203992514,0.165938864628821,0.284154709918902,0.0374298190892077,0.128509045539613,0.109482220835933
"E02003680",774,976,458,318,658,456,3270,0.236697247706422,0.298470948012232,0.140061162079511,0.0972477064220184,0.201223241590214,0.139449541284404
"E02003681",711,844,508,261,583,450,3702,0.192058346839546,0.227984873041599,0.137223122636413,0.0705024311183144,0.157482441923285,0.121555915721232
"E02003682",542,670,348,222,448,320,2541,0.213301849665486,0.263675718221173,0.136953955135773,0.0873671782762692,0.176308539944904,0.125934671389217
"E02003683",452,616,195,197,419,255,2483,0.182037857430528,0.248086991542489,0.0785340314136126,0.0793395086588804,0.168747482883609,0.102698348771647
"E02003685",576,774,366,252,522,324,2604,0.221198156682028,0.297235023041475,0.140552995391705,0.0967741935483871,0.200460829493088,0.124423963133641
"E02003686",499,745,354,230,515,269,2546,0.195993715632365,0.29261586802828,0.139041633935585,0.0903377847604085,0.202278083267871,0.105655930871956
"E02003687",347,486,342,149,337,198,1847,0.187872225230103,0.263129399025447,0.185165132647537,0.0806713589604764,0.18245804006497,0.107200866269626
"E02003688",903,905,657,244,661,659,5046,0.178953626634958,0.179349980182323,0.130202140309156,0.0483551327784384,0.130994847403884,0.13059849385652
"E02003689",514,813,541,229,584,285,3322,0.154726068633353,0.24473208910295,0.162853702588802,0.0689343768813968,0.175797712221553,0.0857916917519567
"E02003690",522,690,609,176,514,346,3261,0.160073597056118,0.211591536338546,0.186752529898804,0.0539711744863539,0.157620361852193,0.106102422569764
"E02003691",537,583,406,189,394,348,2625,0.204571428571429,0.222095238095238,0.154666666666667,0.072,0.150095238095238,0.132571428571429
"E02003692",557,805,486,254,551,303,2708,0.205686853766617,0.297267355982275,0.179468242245199,0.0937961595273264,0.203471196454948,0.111890694239291
"E02003693",463,513,593,155,358,308,2663,0.173864063086744,0.192639879834773,0.222681186631618,0.0582050319188885,0.134434847915884,0.115659031167856
"E02003694",617,662,646,195,467,422,3304,0.186743341404358,0.200363196125908,0.195520581113801,0.0590193704600484,0.14134382566586,0.12772397094431
"E02003695",711,889,876,258,631,453,3678,0.193311582381729,0.241707449700924,0.238172920065253,0.0701468189233279,0.171560630777597,0.123164763458401
"E02003696",701,705,322,219,486,482,3763,0.186287536539995,0.187350518203561,0.0855700239170874,0.0581982460802551,0.129152272123306,0.12808929045974
"E02003697",410,434,411,142,292,268,2285,0.179431072210066,0.189934354485777,0.179868708971554,0.062144420131291,0.127789934354486,0.117286652078775
"E02003698",627,626,309,232,394,395,2621,0.239221671117894,0.238840137352156,0.117893933613125,0.0885158336512781,0.150324303700878,0.150705837466616
"E02003699",532,501,271,182,319,350,2255,0.235920177383592,0.222172949002217,0.120177383592018,0.0807095343680709,0.141463414634146,0.155210643015521
"E02003701",855,1234,321,382,852,473,4172,0.204937679769895,0.295781399808245,0.0769415148609779,0.0915627996164909,0.204218600191755,0.113374880153404
"E02003702",742,615,865,243,372,499,2964,0.250337381916329,0.20748987854251,0.291835357624831,0.0819838056680162,0.125506072874494,0.168353576248313
"E02003703",589,763,762,195,568,394,3495,0.168526466380544,0.218311874105866,0.218025751072961,0.055793991416309,0.162517882689556,0.112732474964235
"E02003704",480,595,181,225,370,255,1831,0.262151829601311,0.324959038776625,0.0988530857454943,0.122883670125614,0.20207536865101,0.139268159475696
"E02003705",510,740,685,216,524,294,2722,0.187362233651727,0.271858927259368,0.25165319617928,0.0793534166054372,0.192505510653931,0.108008817046289
"E02003706",473,540,142,153,387,320,3039,0.155643303718328,0.177690029615005,0.0467258966765383,0.0503455083909181,0.127344521224087,0.10529779532741
"E02003707",616,582,421,234,348,382,2688,0.229166666666667,0.216517857142857,0.156622023809524,0.0870535714285714,0.129464285714286,0.142113095238095
"E02003708",686,702,783,221,481,465,3941,0.174067495559503,0.178127378837858,0.198680537934534,0.0560771377822888,0.12205024105557,0.117990357777214
"E02003709",515,572,205,166,406,349,2613,0.197091465748182,0.218905472636816,0.0784538844240337,0.0635285112897053,0.155376961347111,0.133562954458477
"E02003710",691,817,500,231,586,460,5177,0.133474985512845,0.15781340544717,0.0965810314854163,0.0446204365462623,0.113192968900908,0.088854548966583
"E02003711",670,641,582,170,471,500,5207,0.12867294027271,0.123103514499712,0.11177261378913,0.0326483579796428,0.0904551565200691,0.096024582293067
"E02003712",783,646,223,229,417,554,3298,0.237416616130988,0.195876288659794,0.0676167374166161,0.069436021831413,0.126440266828381,0.167980594299576
"E02003713",452,494,226,166,328,286,1867,0.242099625066952,0.264595607927156,0.121049812533476,0.0889126941617568,0.175682913765399,0.153186930905196
"E02003714",573,567,496,193,374,380,2846,0.201335207308503,0.199226985242446,0.174279690794097,0.0678144764581869,0.131412508784259,0.133520730850316
"E02003715",455,444,250,170,274,285,2058,0.22108843537415,0.215743440233236,0.121477162293489,0.0826044703595724,0.133138969873664,0.138483965014577
"E02003716",605,501,382,188,313,417,2414,0.250621375310688,0.207539353769677,0.15824357912179,0.0778790389395195,0.129660314830157,0.172742336371168
"E02003717",947,844,563,314,530,633,3786,0.25013206550449,0.222926571579503,0.148705758055996,0.0829371368198627,0.139989434759641,0.167194928684628
"E02003718",575,585,399,211,374,364,2433,0.236333744348541,0.240443896424168,0.163995067817509,0.0867242087957254,0.153719687628442,0.149609535552815
"E02003719",505,838,387,188,650,317,3564,0.141694725028058,0.235129068462402,0.108585858585859,0.0527497194163861,0.182379349046016,0.0889450056116723
"E02003720",531,664,1032,163,501,368,3738,0.142054574638844,0.177635098983414,0.276083467094703,0.0436062065275548,0.134028892455859,0.0984483681112895
"E02003721",394,423,829,108,315,286,3904,0.100922131147541,0.108350409836066,0.21234631147541,0.0276639344262295,0.0806864754098361,0.0732581967213115
"E02003722",427,414,1481,61,353,366,3750,0.113866666666667,0.1104,0.394933333333333,0.0162666666666667,0.0941333333333333,0.0976
"E02003723",324,446,651,96,350,228,3579,0.0905280804694049,0.124615814473317,0.181894383906119,0.0268231349538977,0.0977926795194188,0.0637049455155071
"E02003724",445,447,983,106,341,339,3807,0.116889939584975,0.117415287628054,0.258208563173102,0.0278434462831626,0.089571841344891,0.0890464933018125
"E02003725",445,393,1366,66,327,379,3996,0.111361361361361,0.0983483483483484,0.341841841841842,0.0165165165165165,0.0818318318318318,0.0948448448448448
"E02003726",401,317,1600,57,260,344,3769,0.10639426903688,0.0841071902361369,0.424515786680817,0.0151233749005041,0.0689838153356328,0.0912708941363757
"E02003727",528,326,2320,81,245,447,4556,0.115891132572432,0.0715539947322213,0.509218612818262,0.0177787532923617,0.0537752414398595,0.0981123792800702
"E02003728",437,426,1070,69,357,368,3896,0.112166324435318,0.109342915811088,0.274640657084189,0.0177104722792608,0.0916324435318275,0.0944558521560575
"E02003729",602,844,327,212,632,390,3358,0.179273377010125,0.251340083382966,0.0973793924955331,0.0631328171530673,0.188207266229899,0.116140559857058
"E02003731",387,426,788,106,320,281,2972,0.13021534320323,0.143337819650067,0.26514131897712,0.0356662180349933,0.107671601615074,0.0945491251682369
"E02003732",482,353,729,107,246,375,4035,0.119454770755886,0.0874845105328377,0.180669144981413,0.0265179677819083,0.0609665427509294,0.0929368029739777
"E02003733",493,307,467,109,198,384,2857,0.172558627931397,0.107455372768638,0.163458172908645,0.0381519075953798,0.0693034651732587,0.134406720336017
"E02003734",578,445,600,121,324,457,5192,0.111325115562404,0.0857087827426811,0.115562403697997,0.0233050847457627,0.0624036979969183,0.088020030816641
"E02003735",465,295,717,73,222,392,3507,0.132591958939264,0.0841174793270602,0.204448246364414,0.0208155118334759,0.0633019674935843,0.111776447105788
"E02003736",711,417,528,176,241,535,3879,0.183294663573086,0.107501933488012,0.136117556071152,0.0453725186903841,0.0621294147976283,0.137922144882702
"E02003737",685,496,795,174,322,511,5196,0.131832178598922,0.0954580446497306,0.153002309468822,0.0334872979214781,0.0619707467282525,0.0983448806774442
"E02003738",420,305,496,102,203,318,2730,0.153846153846154,0.111721611721612,0.181684981684982,0.0373626373626374,0.0743589743589744,0.116483516483516
"E02003739",379,262,269,93,169,286,2156,0.175788497217069,0.12152133580705,0.124768089053803,0.0431354359925789,0.0783858998144712,0.13265306122449
"E02003740",354,282,394,103,179,251,2090,0.169377990430622,0.134928229665072,0.188516746411483,0.0492822966507177,0.0856459330143541,0.120095693779904
"E02003742",488,302,514,108,194,380,2616,0.186544342507645,0.115443425076453,0.196483180428135,0.0412844036697248,0.0741590214067278,0.14525993883792
"E02003743",641,427,905,130,297,511,4191,0.152946790742066,0.101884991648771,0.215938916726318,0.0310188499164877,0.0708661417322835,0.121927940825579
"E02003744",882,528,1519,164,364,718,5794,0.152226441146013,0.0911287538833276,0.262167759751467,0.0283051432516396,0.062823610631688,0.123921297894373
"E02003745",631,358,654,136,222,495,4002,0.157671164417791,0.0894552723638181,0.163418290854573,0.0339830084957521,0.055472263868066,0.123688155922039
"E02003746",363,250,938,70,180,293,2853,0.127234490010515,0.087627059235892,0.328776726253067,0.0245355765860498,0.0630914826498423,0.102698913424465
"E02003747",714,496,779,148,348,566,5388,0.132516703786192,0.0920564216778025,0.144580549368968,0.0274684484038604,0.0645879732739421,0.105048255382331
"E02003748",486,336,661,104,232,382,3240,0.15,0.103703703703704,0.204012345679012,0.0320987654320988,0.0716049382716049,0.117901234567901
"E02003749",417,245,281,98,147,319,2349,0.177522349936143,0.104299702000851,0.119625372498936,0.0417198808003406,0.0625798212005109,0.135802469135802
"E02003750",413,232,442,58,174,355,2869,0.143952596723597,0.0808644126873475,0.154060648309516,0.0202161031718369,0.0606483095155106,0.12373649355176
"E02003751",419,280,506,93,187,326,2921,0.143444026018487,0.0958575830195139,0.173228346456693,0.03183841150291,0.0640191715166039,0.111605614515577
"E02003752",620,480,948,146,334,474,4630,0.133909287257019,0.103671706263499,0.20475161987041,0.0315334773218143,0.0721382289416847,0.102375809935205
"E02003753",565,526,484,139,387,426,3940,0.143401015228426,0.133502538071066,0.122842639593909,0.0352791878172589,0.0982233502538071,0.108121827411168
"E02003754",421,273,364,94,179,327,2033,0.207083128381702,0.134284308903099,0.179045745204132,0.0462370880472209,0.088047220855878,0.160846040334481
"E02003755",625,385,645,118,267,507,3890,0.160668380462725,0.0989717223650386,0.165809768637532,0.0303341902313625,0.0686375321336761,0.130334190231362
"E02003756",514,357,224,161,196,353,2703,0.190159082500925,0.132075471698113,0.0828708842027377,0.0595634480207177,0.0725120236773955,0.130595634480207
"E02003757",376,387,378,91,296,285,2674,0.140613313388183,0.144727000747943,0.141361256544503,0.0340314136125654,0.110695587135378,0.106581899775617
"E02003758",650,475,585,161,314,489,3524,0.184449489216799,0.134790011350738,0.166004540295119,0.0456867196367764,0.0891032917139614,0.138762769580023
"E02003759",333,313,235,90,223,243,1875,0.1776,0.166933333333333,0.125333333333333,0.048,0.118933333333333,0.1296
"E02003760",416,402,91,122,280,294,3266,0.127372933251684,0.123086344151868,0.0278628291488059,0.0373545621555419,0.0857317819963258,0.0900183710961421
"E02003761",380,423,150,120,303,260,2018,0.188305252725471,0.209613478691774,0.0743310208126858,0.0594648166501487,0.150148662041625,0.128840436075322
"E02003762",521,400,339,146,254,375,4894,0.106456885982836,0.081732733959951,0.0692684920310584,0.0298324478953821,0.0519002860645689,0.076624438087454
"E02003763",771,751,94,256,495,515,3381,0.228039041703638,0.22212363206152,0.0278024253179533,0.0757172434191068,0.146406388642413,0.152321798284531
"E02003764",676,349,732,82,267,594,4719,0.143250688705234,0.0739563466836194,0.155117609663064,0.0173765628311083,0.0565797838525111,0.125874125874126
"E02003765",401,373,642,107,266,294,3203,0.125195129566032,0.116453325007805,0.200437090227911,0.0334061817046519,0.0830471433031533,0.09178894786138
"E02003766",399,291,403,77,214,322,3453,0.115551694178975,0.0842745438748914,0.1167101071532,0.0222994497538372,0.0619750941210542,0.0932522444251376
"E02003767",531,281,456,128,153,403,2272,0.233714788732394,0.123679577464789,0.200704225352113,0.0563380281690141,0.0673415492957746,0.17737676056338
"E02003768",524,555,474,176,379,348,3407,0.153800997945407,0.162899911945994,0.139125330202524,0.0516583504549457,0.111241561491048,0.102142647490461
"E02003769",473,333,356,126,207,347,2322,0.203703703703704,0.143410852713178,0.153316106804479,0.0542635658914729,0.0891472868217054,0.149440137812231
"E02003770",368,303,247,107,196,261,5418,0.067921742340347,0.0559246954595792,0.0455887781469177,0.0197489848652639,0.0361757105943152,0.0481727574750831
"E02003771",364,295,503,74,221,290,2807,0.129675810473815,0.105094406840043,0.179194869967937,0.0263626647666548,0.078731742073388,0.103313145707161
"E02003772",506,360,200,130,230,376,2306,0.219427580225499,0.1561144839549,0.0867302688638335,0.0563746747614918,0.0997398091934085,0.163052905464007
"E02003773",530,404,225,129,275,401,4174,0.126976521322472,0.0967896502156205,0.0539051269765213,0.0309056061332056,0.065884044082415,0.0960709151892669
"E02003774",329,268,154,67,201,262,2086,0.157718120805369,0.128475551294343,0.0738255033557047,0.0321188878235858,0.0963566634707574,0.125599232981783
"E02003775",348,311,348,109,202,239,2589,0.13441483198146,0.1201235998455,0.13441483198146,0.0421011973735033,0.0780224024719969,0.0923136346079567
"E02003776",308,283,418,77,206,231,2555,0.120547945205479,0.110763209393346,0.163600782778865,0.0301369863013699,0.0806262230919765,0.0904109589041096
"E02003777",343,265,240,95,170,248,4266,0.0804031879981247,0.0621190811064229,0.0562587904360056,0.0222691045475856,0.0398499765588373,0.0581340834505391
"E02003778",259,378,285,81,297,178,2627,0.0985915492957746,0.143890369242482,0.108488770460601,0.0308336505519604,0.113056718690522,0.0677578987438142
"E02003780",422,417,540,119,298,303,4075,0.103558282208589,0.102331288343558,0.132515337423313,0.0292024539877301,0.0731288343558282,0.0743558282208589
"E02003781",526,275,286,86,189,440,2705,0.19445471349353,0.101663585951941,0.105730129390018,0.0317929759704251,0.0698706099815157,0.162661737523105
"E02003784",499,463,207,173,290,326,3138,0.159018483110261,0.147546207775653,0.0659655831739962,0.0551306564690886,0.0924155513065647,0.103887826641173
"E02003785",617,408,344,115,293,502,3470,0.177809798270893,0.117579250720461,0.099135446685879,0.0331412103746398,0.0844380403458213,0.144668587896254
"E02003786",383,386,477,117,269,266,2405,0.159251559251559,0.160498960498961,0.198336798336798,0.0486486486486487,0.111850311850312,0.110602910602911
"E02003787",437,394,435,132,262,305,2787,0.156799425905992,0.141370649443846,0.156081808396125,0.0473627556512379,0.0940078937926085,0.109436670254754
"E02003788",363,319,379,91,228,272,3036,0.119565217391304,0.105072463768116,0.124835309617918,0.0299736495388669,0.075098814229249,0.0895915678524374
"E02003789",465,414,272,148,266,317,2509,0.185332801913113,0.165005978477481,0.108409724990036,0.0589876444798725,0.106018333997609,0.12634515743324
"E02003790",588,550,451,187,363,401,3140,0.187261146496815,0.17515923566879,0.143630573248408,0.0595541401273885,0.115605095541401,0.127707006369427
"E02003791",486,425,454,141,284,345,3019,0.160980457105002,0.140775091089765,0.150380920834713,0.0467042066909573,0.0940708843988075,0.114276250414044
"E02003792",526,501,299,155,346,371,3462,0.151935297515887,0.14471403812825,0.086366262276141,0.0447718082033507,0.0999422299248989,0.107163489312536
"E02003793",540,354,369,141,213,399,2566,0.210444271239283,0.137957911145752,0.143803585346843,0.0549493374902572,0.0830085736554949,0.155494933749026
"E02003794",518,407,335,152,255,366,2438,0.212469237079573,0.166940114848236,0.13740771123872,0.0623461853978671,0.104593929450369,0.150123051681706
"E02003795",309,256,330,90,166,219,1892,0.163319238900634,0.135306553911205,0.174418604651163,0.047568710359408,0.087737843551797,0.115750528541226
"E02003796",500,455,185,151,304,349,2671,0.187195806813927,0.170348184200674,0.0692624485211531,0.0565331336578061,0.113815050542868,0.130662673156121
"E02003797",568,553,784,185,368,383,3386,0.167749556999409,0.163319551092735,0.231541642055523,0.0546367395156527,0.108682811577082,0.113112817483757
"E02003798",380,222,49,84,138,296,2094,0.181470869149952,0.106017191977077,0.0234001910219675,0.0401146131805158,0.0659025787965616,0.141356255969436
"E02003799",354,348,91,110,238,244,2632,0.134498480243161,0.132218844984802,0.0345744680851064,0.0417933130699088,0.0904255319148936,0.0927051671732523
"E02003800",385,326,382,106,220,279,2201,0.174920490686052,0.148114493412085,0.173557473875511,0.0481599273057701,0.0999545661063153,0.126760563380282
"E02003801",396,463,347,123,340,273,2107,0.187944945420028,0.219743711438064,0.16468913146654,0.0583768391077361,0.161366872330327,0.129568106312292
"E02003802",507,314,1643,47,267,460,5608,0.0904065620542083,0.0559914407988588,0.292974322396576,0.00838088445078459,0.0476105563480742,0.0820256776034237
"E02003803",677,333,1951,87,246,590,5382,0.12578966926793,0.0618729096989967,0.362504645113341,0.016164994425864,0.0457079152731327,0.109624674842066
"E02003804",611,335,1510,103,232,508,3162,0.193232131562302,0.105945604048071,0.477545857052498,0.0325743200506009,0.0733712839974699,0.160657811511701
"E02003805",370,339,333,129,210,241,1810,0.204419889502762,0.187292817679558,0.183977900552486,0.0712707182320442,0.116022099447514,0.133149171270718
"E02003806",344,277,293,75,202,269,2969,0.115863927248232,0.0932974065341866,0.0986864264061974,0.0252610306500505,0.0680363758841361,0.0906028965981812
"E02003807",599,812,869,217,595,382,3235,0.18516228748068,0.251004636785162,0.268624420401855,0.0670788253477589,0.183925811437403,0.118083462132921
"E02003808",430,362,223,120,242,310,2280,0.18859649122807,0.158771929824561,0.0978070175438596,0.0526315789473684,0.106140350877193,0.135964912280702
"E02003809",616,387,868,156,231,460,3792,0.162447257383966,0.102056962025316,0.228902953586498,0.0411392405063291,0.0609177215189873,0.121308016877637
"E02003810",531,398,743,134,264,397,3439,0.154405350392556,0.115731317243385,0.216051177667927,0.0389648153533004,0.0767665018900843,0.115440535039256
"E02003811",381,362,320,136,226,245,2859,0.133263378803778,0.126617698495978,0.111927247289262,0.0475690800979363,0.0790486183980413,0.0856942987058412
"E02003812",379,395,155,100,295,279,2422,0.156482246077622,0.163088356729975,0.0639966969446738,0.0412881915772089,0.121800165152766,0.115194054500413
"E02003813",361,250,533,82,168,279,2176,0.165900735294118,0.114889705882353,0.244944852941176,0.0376838235294118,0.0772058823529412,0.128216911764706
"E02003814",401,342,373,85,257,316,2965,0.135244519392917,0.115345699831366,0.125801011804384,0.0286677908937605,0.0866779089376054,0.106576728499157
"E02003815",423,601,251,142,459,281,3280,0.128963414634146,0.183231707317073,0.0765243902439024,0.0432926829268293,0.139939024390244,0.0856707317073171
"E02003816",452,527,834,148,379,304,3752,0.12046908315565,0.14045842217484,0.22228144989339,0.0394456289978678,0.101012793176972,0.0810234541577825
"E02003817",396,401,135,130,271,266,2770,0.142960288808664,0.144765342960289,0.0487364620938628,0.0469314079422383,0.0978339350180505,0.096028880866426
"E02003818",381,352,228,133,219,248,1696,0.224646226415094,0.207547169811321,0.134433962264151,0.0784198113207547,0.129127358490566,0.14622641509434
"E02003819",481,319,373,109,210,372,2527,0.190344281757024,0.126236644242184,0.147605856747131,0.0431341511673922,0.0831024930747922,0.147210130589632
"E02003820",443,258,413,95,163,348,3733,0.118671309938387,0.0691133136887222,0.110634878114117,0.0254487007768551,0.0436646129118671,0.0932226091615323
"E02003821",384,341,357,117,224,267,2465,0.15578093306288,0.138336713995943,0.144827586206897,0.0474645030425963,0.0908722109533469,0.108316430020284
"E02003822",803,697,739,273,424,530,4165,0.192797118847539,0.16734693877551,0.177430972388956,0.065546218487395,0.101800720288115,0.127250900360144
"E02003823",466,473,299,144,329,322,2617,0.178066488345434,0.180741306839893,0.11425296140619,0.0550248376003057,0.125716469239587,0.123041650745128
"E02003824",374,331,193,121,210,253,2559,0.146150840171942,0.129347401328644,0.0754200859710824,0.047284095349746,0.082063305978898,0.0988667448221962
"E02003825",427,183,76,66,117,361,1927,0.221587960560457,0.0949662688116243,0.0394395433316035,0.0342501297353399,0.0607161390762844,0.187337830825117
"E02003826",406,444,771,84,360,322,3615,0.112309820193638,0.122821576763485,0.213278008298755,0.0232365145228216,0.0995850622406639,0.089073305670816
"E02003827",628,468,1601,117,351,511,4788,0.131161236424394,0.0977443609022556,0.3343776106934,0.0244360902255639,0.0733082706766917,0.10672514619883
"E02003828",336,308,668,63,245,273,2470,0.136032388663968,0.124696356275304,0.270445344129555,0.0255060728744939,0.0991902834008097,0.110526315789474
"E02003829",471,295,352,131,164,340,2213,0.212833258020786,0.133303208314505,0.159060099412562,0.0591956619972887,0.0741075463172164,0.153637596023498
"E02003830",552,305,1585,88,217,464,3642,0.151565074135091,0.0837451949478309,0.435200439319055,0.0241625480505217,0.0595826468973092,0.127402526084569
"E02003831",601,372,599,142,230,459,3623,0.165884626000552,0.10267733922164,0.165332597295059,0.0391940380899807,0.0634833011316588,0.126690587910571
"E02003832",470,242,1885,26,216,444,2604,0.180491551459293,0.0929339477726575,0.723886328725038,0.00998463901689708,0.0829493087557604,0.170506912442396
"E02003833",344,306,77,105,201,239,2060,0.166990291262136,0.148543689320388,0.037378640776699,0.0509708737864078,0.0975728155339806,0.116019417475728
"E02003834",411,250,1019,83,167,328,2676,0.153587443946188,0.093423019431988,0.380792227204783,0.03101644245142,0.062406576980568,0.122571001494768
"E02003835",540,389,313,150,239,390,2671,0.202171471359042,0.145638337701235,0.117184575065519,0.0561587420441782,0.0894795956570573,0.146012729314863
"E02003836",439,415,846,103,312,336,3074,0.14281067013663,0.135003253090436,0.275211450878334,0.0335068314899154,0.10149642160052,0.109303838646714
"E02003838",427,356,565,111,245,316,3339,0.127882599580713,0.106618748128182,0.16921233902366,0.0332434860736747,0.0733752620545073,0.094639113507038
"E02003839",363,270,485,83,187,280,3006,0.120758483033932,0.0898203592814371,0.161343978709248,0.0276114437791085,0.0622089155023287,0.0931470392548237
"E02003840",805,434,1012,192,242,613,3874,0.207795560144553,0.112028910686629,0.261228704181724,0.0495611770779556,0.0624677336086732,0.158234383066598
"E02003841",474,338,627,115,223,359,2901,0.163391933815926,0.116511547742158,0.216132368148914,0.0396415029300241,0.0768700448121337,0.123750430885901
"E02003842",362,330,557,108,222,254,2002,0.180819180819181,0.164835164835165,0.278221778221778,0.0539460539460539,0.110889110889111,0.126873126873127
"E02003843",367,276,306,104,172,263,2165,0.169515011547344,0.127482678983834,0.141339491916859,0.0480369515011547,0.079445727482679,0.121478060046189
"E02003844",440,459,340,161,298,279,1935,0.227390180878553,0.237209302325581,0.175710594315245,0.0832041343669251,0.154005167958656,0.144186046511628
"E02003845",507,340,1432,73,267,434,5879,0.0862391563191019,0.0578329647899303,0.243578839938765,0.0124170777343086,0.0454158870556217,0.0738220785847933
"E02003846",311,356,340,91,265,220,2326,0.133705932932072,0.153052450558899,0.146173688736028,0.0391229578675838,0.113929492691316,0.0945829750644884
"E02003847",528,323,216,114,209,414,3154,0.167406467977172,0.102409638554217,0.0684844641724794,0.036144578313253,0.0662650602409639,0.131261889663919
"E02003848",272,275,256,86,189,186,1623,0.167590881084412,0.169439309919901,0.157732593961799,0.0529882932840419,0.11645101663586,0.11460258780037
"E02003849",312,284,142,81,203,231,3041,0.102597829661296,0.0933903321275896,0.0466951660637948,0.026635975008221,0.0667543571193686,0.0759618546530746
"E02003850",312,278,60,120,158,192,1380,0.226086956521739,0.201449275362319,0.0434782608695652,0.0869565217391304,0.114492753623188,0.139130434782609
"E02003851",336,255,228,91,164,245,1527,0.220039292730845,0.166994106090373,0.149312377210216,0.0595939751146038,0.107400130975769,0.160445317616241
"E02003852",385,314,87,122,192,263,1590,0.242138364779874,0.19748427672956,0.0547169811320755,0.0767295597484277,0.120754716981132,0.165408805031447
"E02003853",421,547,379,185,362,236,2027,0.207696102614702,0.269856931425752,0.186975826344351,0.091267883571781,0.178589047853971,0.116428219042921
"E02003854",503,516,100,201,315,302,2222,0.226372637263726,0.232223222322232,0.045004500450045,0.0904590459045905,0.141764176417642,0.135913591359136
"E02003855",489,518,260,189,329,300,2082,0.234870317002882,0.248799231508165,0.124879923150817,0.0907780979827089,0.158021133525456,0.144092219020173
"E02003856",714,965,172,278,687,436,5026,0.142061281337047,0.19200159172304,0.0342220453641066,0.0553123756466375,0.136689216076403,0.0867489056904099
"E02003857",440,469,123,136,333,304,2591,0.16981860285604,0.181011192589734,0.0474720185256658,0.0524893863373215,0.128521806252412,0.117329216518719
"E02003858",476,771,411,233,538,243,2902,0.164024810475534,0.265678842177808,0.141626464507236,0.080289455547898,0.18538938662991,0.0837353549276361
"E02003859",918,915,994,339,576,579,4324,0.212303422756707,0.211609620721554,0.229879740980574,0.0783996299722479,0.133209990749306,0.133903792784459
"E02003860",482,721,328,224,497,258,2262,0.213085764809903,0.318744473916888,0.14500442086649,0.099027409372237,0.219717064544651,0.114058355437666
"E02003861",462,621,134,203,418,259,2762,0.167270094134685,0.224837074583635,0.0485155684286749,0.0734974656046343,0.151339608979001,0.0937726285300507
"E02003862",356,457,220,159,298,197,1768,0.201357466063348,0.258484162895928,0.124434389140271,0.0899321266968326,0.168552036199095,0.111425339366516
"E02003863",498,606,444,196,410,302,2701,0.184376156978897,0.224361347649019,0.164383561643836,0.0725657164013328,0.151795631247686,0.111810440577564
"E02003864",611,720,648,207,513,404,3661,0.166894291177274,0.196667577164709,0.177000819448238,0.0565419284348539,0.140125648729855,0.11035236274242
"E02003865",508,440,958,138,302,370,3049,0.166612003935717,0.144309609708101,0.31420137750082,0.0452607412266317,0.0990488684814693,0.121351262709085
"E02003866",324,393,36,78,315,246,1880,0.172340425531915,0.209042553191489,0.0191489361702128,0.0414893617021277,0.167553191489362,0.130851063829787
"E02003867",404,419,150,109,310,295,2632,0.153495440729483,0.15919452887538,0.0569908814589666,0.0414133738601824,0.117781155015198,0.112082066869301
"E02003868",572,671,826,176,495,396,3858,0.148263348885433,0.173924313115604,0.21410057024365,0.0456194919647486,0.128304821150855,0.102643856920684
"E02003869",452,550,482,138,412,314,2756,0.164005805515239,0.199564586357039,0.17489114658926,0.0500725689404935,0.149492017416546,0.113933236574746
"E02003870",887,874,2530,209,665,678,5553,0.159733477399604,0.157392400504232,0.455609580406987,0.0376373131640555,0.119755087340176,0.122096164235548
"E02003871",446,638,145,182,456,264,2620,0.170229007633588,0.243511450381679,0.0553435114503817,0.0694656488549618,0.174045801526718,0.100763358778626
"E02003872",633,570,887,193,377,440,3428,0.18465577596266,0.166277712952159,0.258751458576429,0.0563010501750292,0.10997666277713,0.128354725787631
"E02003873",350,429,395,92,337,258,3174,0.110270951480781,0.135160680529301,0.124448645242596,0.0289855072463768,0.106175173282924,0.0812854442344045
"E02003874",559,596,457,190,406,369,3042,0.183760683760684,0.195923734385273,0.150230111768573,0.0624589086127548,0.133464825772518,0.121301775147929
"E02003875",428,415,514,143,272,285,1790,0.239106145251397,0.231843575418994,0.287150837988827,0.0798882681564246,0.15195530726257,0.159217877094972
"E02003876",368,391,482,118,273,250,1842,0.199782844733985,0.212269272529859,0.261672095548317,0.0640608034744843,0.148208469055375,0.135722041259501
"E02003877",508,562,556,168,394,340,3065,0.165742251223491,0.183360522022839,0.181402936378467,0.0548123980424144,0.128548123980424,0.110929853181077
"E02003878",478,461,455,140,321,338,2844,0.168073136427567,0.162095639943741,0.159985935302391,0.0492264416315049,0.112869198312236,0.118846694796062
"E02003879",412,351,1150,74,277,338,4460,0.0923766816143498,0.0786995515695067,0.257847533632287,0.0165919282511211,0.0621076233183857,0.0757847533632287
"E02003880",490,446,196,163,283,327,2080,0.235576923076923,0.214423076923077,0.0942307692307692,0.0783653846153846,0.136057692307692,0.157211538461538
"E02003881",486,454,718,138,316,348,2277,0.213438735177866,0.199385155906895,0.315327184892402,0.0606060606060606,0.138779095300834,0.152832674571805
"E02003882",545,632,741,155,477,390,3220,0.169254658385093,0.196273291925466,0.230124223602484,0.0481366459627329,0.148136645962733,0.12111801242236
"E02003883",449,521,363,137,384,312,4458,0.100717810677434,0.116868550919695,0.0814266487213997,0.0307312696276357,0.0861372812920592,0.0699865410497981
"E02003884",493,532,324,184,348,309,2870,0.171777003484321,0.185365853658537,0.112891986062718,0.0641114982578397,0.121254355400697,0.107665505226481
"E02003885",357,309,525,82,227,275,2012,0.177435387673956,0.153578528827038,0.260934393638171,0.0407554671968191,0.112823061630219,0.136679920477137
"E02003886",300,276,237,82,194,218,2148,0.139664804469274,0.128491620111732,0.110335195530726,0.0381750465549348,0.090316573556797,0.101489757914339
"E02003887",357,239,130,76,163,281,2489,0.143431096826035,0.0960224989955806,0.0522298111691442,0.0305343511450382,0.0654881478505424,0.112896745680996
"E02003888",356,322,642,75,247,281,2621,0.135826020602823,0.122853872567722,0.244944677603968,0.0286150324303701,0.0942388401373522,0.107210988172453
"E02003889",388,245,120,71,174,317,2426,0.159934047815334,0.100989282769992,0.0494641384995878,0.0292662819455894,0.0717230008244023,0.130667765869744
"E02003890",337,233,382,75,158,262,2454,0.137326813365933,0.0949470252648737,0.155664221678892,0.0305623471882641,0.0643846780766096,0.106764466177669
"E02003891",381,311,476,114,197,267,2202,0.173024523160763,0.141235240690282,0.216167120799273,0.0517711171662125,0.089464123524069,0.12125340599455
"E02003892",512,367,836,146,221,366,2501,0.204718112754898,0.146741303478609,0.334266293482607,0.0583766493402639,0.0883646541383447,0.146341463414634
"E02003893",557,327,901,114,213,443,2494,0.223336006415397,0.131114675220529,0.361267040898156,0.0457097032878909,0.0854049719326383,0.177626303127506
"E02003894",556,382,615,129,253,427,3267,0.170186715641261,0.116926844199571,0.188246097337006,0.039485766758494,0.0774410774410774,0.130700948882767
"E02003895",493,362,614,100,262,393,4103,0.120155983426761,0.0882281257616378,0.149646600048745,0.0243724104313917,0.0638557153302462,0.0957835729953692
"E02003896",363,338,577,93,245,270,2536,0.14313880126183,0.133280757097792,0.227523659305994,0.0366719242902208,0.096608832807571,0.106466876971609
"E02003897",320,270,252,98,172,222,1930,0.16580310880829,0.139896373056995,0.130569948186529,0.0507772020725389,0.089119170984456,0.115025906735751
"E02003898",645,458,797,195,263,450,2640,0.244318181818182,0.173484848484848,0.301893939393939,0.0738636363636364,0.0996212121212121,0.170454545454545
"E02003899",333,402,212,137,265,196,1831,0.181867831785909,0.219552157291098,0.115783724740579,0.0748225013653741,0.144729655925724,0.107045330420535
"E02003900",443,488,565,147,341,296,2587,0.171240819482026,0.188635485117897,0.2183996907615,0.0568225744105141,0.131812910707383,0.114418245071511
"E02003901",753,551,1046,202,349,551,3723,0.202256244963739,0.147998925597636,0.28095621810368,0.0542573193661026,0.0937416062315337,0.147998925597636
"E02003902",373,359,538,112,247,261,1931,0.193164163645779,0.185914034179182,0.278612118073537,0.0580010357327809,0.127912998446401,0.135163127912998
"E02003903",590,456,660,169,287,421,2573,0.229304314030315,0.177225029148853,0.256509910610183,0.0656820831713953,0.111542945977458,0.16362223085892
"E02003904",638,533,963,192,341,446,2725,0.234128440366972,0.195596330275229,0.353394495412844,0.0704587155963303,0.125137614678899,0.163669724770642
"E02003905",562,419,587,172,247,390,2807,0.200213751335946,0.149269682935518,0.209120057000356,0.0612753829711436,0.0879942999643748,0.138938368364802
"E02003906",491,546,601,163,383,328,2865,0.171378708551483,0.190575916230366,0.20977312390925,0.0568935427574171,0.133682373472949,0.114485165794066
"E02003907",848,536,768,214,322,634,3769,0.224993366940833,0.142212788538074,0.203767577606792,0.0567789864685593,0.0854338020695145,0.168214380472274
"E02003908",368,416,344,121,295,247,2988,0.123159303882195,0.139223560910308,0.115127175368139,0.0404953145917001,0.0987282463186078,0.0826639892904953
"E02003909",473,459,353,113,346,360,3739,0.126504412944638,0.122760096282428,0.0944102701257021,0.030221984487831,0.0925381117945975,0.0962824284568066
"E02003910",401,572,1117,106,466,295,3404,0.11780258519389,0.168037602820212,0.328143360752056,0.0311398354876616,0.13689776733255,0.086662749706228
"E02003911",665,563,842,205,358,460,3359,0.197975587972611,0.167609407561774,0.250669842214945,0.0610300684727597,0.106579339089015,0.136945519499851
"E02003912",767,642,1023,225,417,542,3778,0.203017469560614,0.169931180518793,0.270778189518264,0.0595553202752779,0.110375860243515,0.143462149285336
"E02003913",454,406,711,122,284,332,2234,0.203222918531782,0.181736794986571,0.318263205013429,0.0546105640107431,0.127126230975828,0.148612354521038
"E02003914",490,414,790,113,301,377,3237,0.151374729687983,0.127896200185357,0.244053135619401,0.0349088662341674,0.0929873339511894,0.116465863453815
"E02003915",489,517,1176,134,383,355,3096,0.157945736434109,0.166989664082687,0.37984496124031,0.04328165374677,0.123708010335917,0.114664082687339
"E02003916",556,524,1422,128,396,428,3339,0.166516921233902,0.156933213536987,0.425876010781671,0.038334830787661,0.118598382749326,0.128182090446241
"E02003917",436,456,380,124,332,312,2864,0.152234636871508,0.159217877094972,0.13268156424581,0.0432960893854749,0.115921787709497,0.108938547486034
"E02003918",565,507,472,159,348,406,2905,0.194492254733219,0.174526678141136,0.162478485370052,0.0547332185886403,0.119793459552496,0.139759036144578
"E02003919",389,474,791,114,360,275,3340,0.116467065868263,0.141916167664671,0.236826347305389,0.0341317365269461,0.107784431137725,0.0823353293413174
"E02003920",440,434,1072,127,307,313,3200,0.1375,0.135625,0.335,0.0396875,0.0959375,0.0978125
"E02003921",543,406,781,162,244,381,2282,0.23794916739702,0.177914110429448,0.342243645924628,0.0709903593339176,0.10692375109553,0.166958808063103
"E02003922",505,508,754,134,374,371,3338,0.151288196524865,0.152186938286399,0.225883762732175,0.0401437986818454,0.112043139604554,0.11114439784302
"E02003923",426,546,1137,133,413,293,3619,0.117712075158884,0.150870406189555,0.314175186515612,0.0367504835589942,0.114119922630561,0.0809615915998895
"E02003924",461,501,880,142,359,319,3050,0.151147540983607,0.164262295081967,0.288524590163934,0.0465573770491803,0.117704918032787,0.104590163934426
"E02003925",440,498,821,141,357,299,2511,0.175228992433294,0.198327359617682,0.326961369972123,0.0561529271206691,0.142174432497013,0.119076065312624
"E02003926",619,438,1105,174,264,445,2776,0.222982708933718,0.157780979827089,0.398054755043228,0.0626801152737752,0.0951008645533141,0.160302593659942
"E02003927",687,548,977,212,336,475,4200,0.163571428571429,0.13047619047619,0.232619047619048,0.0504761904761905,0.08,0.113095238095238
"E02003928",754,668,732,178,490,576,4688,0.160836177474403,0.142491467576792,0.156143344709898,0.0379692832764505,0.104522184300341,0.122866894197952
"E02003929",751,524,981,227,297,524,3122,0.240550928891736,0.167841127482383,0.314221652786675,0.072709801409353,0.0951313260730301,0.167841127482383
"E02003930",911,739,1158,263,476,648,3824,0.238232217573222,0.193253138075314,0.302824267782427,0.0687761506276151,0.124476987447699,0.169456066945607
"E02003931",818,752,802,259,493,559,4823,0.169603980924736,0.155919552145967,0.166286543645034,0.0537010159651669,0.1022185361808,0.115902964959569
"E02003932",695,466,649,178,288,517,3278,0.212019524100061,0.14215985356925,0.197986577181208,0.0543014032946919,0.0878584502745577,0.157718120805369
"E02003933",789,448,1093,166,282,623,3375,0.233777777777778,0.132740740740741,0.323851851851852,0.0491851851851852,0.0835555555555555,0.184592592592593
"E02003934",548,258,736,94,164,454,2988,0.183400267737617,0.0863453815261044,0.246318607764391,0.0314591700133869,0.0548862115127175,0.15194109772423
"E02003935",550,433,784,139,294,411,4388,0.125341841385597,0.0986782133090246,0.178669097538742,0.0316773017319964,0.0670009115770283,0.0936645396536007
"E02003936",658,395,955,159,236,499,3113,0.211371667202056,0.12688724702859,0.306778027626084,0.0510761323482172,0.0758111146803726,0.160295534853839
"E02003937",831,645,915,257,388,574,3764,0.220775770456961,0.171360255047821,0.243092454835282,0.068278427205101,0.103081827842721,0.15249734325186
"E02003938",779,707,720,287,420,492,4063,0.19173024858479,0.174009352695053,0.177208958897366,0.0706374600049225,0.10337189269013,0.121092788579867
"E02003939",529,387,565,141,246,388,2748,0.192503639010189,0.140829694323144,0.205604075691412,0.0513100436681223,0.0895196506550218,0.141193595342067
"E02003940",687,285,846,116,169,571,2688,0.255580357142857,0.106026785714286,0.314732142857143,0.0431547619047619,0.0628720238095238,0.212425595238095
"E02003941",410,352,524,108,244,302,3709,0.110541925047183,0.0949042868697762,0.141277972499326,0.0291183607441359,0.0657859261256403,0.0814235643030466
"E02003942",441,337,388,96,241,345,3226,0.136701797892126,0.104463732176069,0.120272783632982,0.0297582145071296,0.0747055176689399,0.106943583384997
"E02003943",772,675,1686,179,496,593,4496,0.171708185053381,0.150133451957295,0.375,0.0398131672597865,0.110320284697509,0.131895017793594
"E02003944",767,742,896,219,523,548,4659,0.164627602489805,0.159261644129642,0.192315947628246,0.047005795235029,0.112255848894613,0.117621807254776
"E02003945",575,446,619,173,273,402,2886,0.199237699237699,0.154539154539155,0.214483714483714,0.0599445599445599,0.0945945945945946,0.139293139293139
"E02003946",1005,620,1020,266,354,739,4275,0.235087719298246,0.145029239766082,0.23859649122807,0.0622222222222222,0.0828070175438596,0.172865497076023
"E02003947",648,487,1113,166,321,482,2750,0.235636363636364,0.177090909090909,0.404727272727273,0.0603636363636364,0.116727272727273,0.175272727272727
"E02003948",688,690,862,228,462,460,3346,0.205618649133293,0.206216377764495,0.257621040047818,0.0681410639569635,0.138075313807531,0.13747758517633
"E02003949",645,584,1957,138,446,507,3811,0.169246916819732,0.153240619260037,0.513513513513513,0.0362109682498032,0.117029651010234,0.133035948569929
"E02003950",530,467,1092,149,318,381,2635,0.201138519924099,0.177229601518027,0.414421252371917,0.0565464895635674,0.120683111954459,0.144592030360531
"E02003951",691,548,1325,178,370,513,2757,0.2506347479144,0.198766775480595,0.480594849474066,0.0645629307217991,0.134203844758796,0.186071817192601
"E02003952",559,616,447,197,419,362,5209,0.107314263774237,0.11825686312152,0.0858130159339605,0.0378191591476291,0.0804377039738913,0.0694951046266078
"E02003953",977,717,834,306,411,671,4758,0.205338377469525,0.150693568726356,0.175283732660782,0.064312736443884,0.0863808322824716,0.141025641025641
"E02003954",537,662,1070,142,520,395,4759,0.112838831687329,0.139104853960916,0.224837150661904,0.0298382013027947,0.109266652658121,0.0830006303845346
"E02003955",730,872,599,232,640,498,4470,0.16331096196868,0.195078299776286,0.134004474272931,0.0519015659955257,0.143176733780761,0.111409395973154
"E02003956",592,320,688,101,219,491,2871,0.206199930337861,0.111459421804249,0.239637756879136,0.0351793800069662,0.0762800417972832,0.171020550330895
"E02003957",836,542,1242,167,375,669,4449,0.187907394920207,0.121825129242526,0.279163857046527,0.0375365250618116,0.0842886041807148,0.150370869858395
"E02003958",657,349,738,121,228,536,2928,0.224385245901639,0.119193989071038,0.252049180327869,0.0413251366120219,0.0778688524590164,0.183060109289617
"E02003959",454,529,474,151,378,303,2747,0.165271204950855,0.192573716781944,0.172551874772479,0.0549690571532581,0.137604659628686,0.110302147797597
"E02003960",521,370,944,121,249,400,2743,0.189938024061247,0.13488880787459,0.344148742253008,0.044112285818447,0.0907765220561429,0.1458257382428
"E02003961",538,488,257,150,338,388,3963,0.135755740600555,0.123139036083775,0.0648498612162503,0.0378501135503407,0.0852889225334343,0.0979056270502145
"E02003962",375,327,646,92,235,283,3000,0.125,0.109,0.215333333333333,0.0306666666666667,0.0783333333333333,0.0943333333333333
"E02003963",637,587,930,148,439,489,4479,0.142219245367269,0.131056039294485,0.207635632953784,0.0330430899754409,0.0980129493190444,0.109176155391829
"E02003964",782,542,1028,188,354,594,3757,0.208144796380091,0.144264040457812,0.273622571200426,0.0500399254724514,0.0942241149853607,0.158104870907639
"E02003965",738,952,998,224,728,514,4332,0.170360110803324,0.219759926131117,0.230378578024007,0.0517082179132041,0.168051708217913,0.11865189289012
"E02003966",561,426,939,140,286,421,2464,0.227678571428571,0.17288961038961,0.381087662337662,0.0568181818181818,0.116071428571429,0.17086038961039
"E02003967",779,673,1318,218,455,561,3229,0.241251161350263,0.20842366057603,0.408175905853205,0.06751316196965,0.14091049860638,0.173737999380613
"E02003968",651,729,1040,215,514,436,3209,0.202866936740418,0.227173574322219,0.324088501090682,0.0669990651293238,0.160174509192895,0.135867871611094
"E02003969",428,915,561,201,714,227,2780,0.153956834532374,0.329136690647482,0.201798561151079,0.0723021582733813,0.256834532374101,0.0816546762589928
"E02003970",520,558,1042,123,435,397,3519,0.147769252628588,0.158567774936061,0.296106848536516,0.0349531116794544,0.123614663256607,0.112816140949133
"E02003971",489,677,709,156,521,333,2987,0.163709407432206,0.226648811516572,0.237361901573485,0.0522263140274523,0.17442249748912,0.111483093404754
"E02003972",667,923,1182,257,666,410,3349,0.199163929531203,0.275604658106898,0.352941176470588,0.076739325171693,0.198865332935205,0.12242460435951
"E02003973",566,1002,1313,231,771,335,4292,0.131873252562908,0.233457595526561,0.30591798695247,0.0538210624417521,0.179636533084809,0.0780521901211556
"E02003974",420,916,230,197,719,223,3224,0.130272952853598,0.284119106699752,0.0713399503722084,0.0611042183622829,0.223014888337469,0.0691687344913151
"E02003975",378,555,372,160,395,218,2469,0.153098420413123,0.224787363304982,0.150668286755772,0.0648035641960308,0.159983799108951,0.0882948562170919
"E02003976",643,672,1110,205,467,438,3256,0.197481572481572,0.206388206388206,0.340909090909091,0.062960687960688,0.143427518427518,0.134520884520885
"E02003977",443,671,924,176,495,267,2115,0.209456264775414,0.31725768321513,0.436879432624113,0.0832151300236407,0.234042553191489,0.126241134751773
"E02003978",440,594,688,184,410,256,2027,0.217069560927479,0.293043907252097,0.339417858904785,0.0907745436605821,0.202269363591515,0.126295017266897
"E02003979",488,772,149,246,526,242,2197,0.22212107419208,0.3513882567137,0.0678197542102868,0.111970869367319,0.239417387346381,0.110150204824761
"E02003980",420,976,165,222,754,198,3017,0.139211136890951,0.323500165727544,0.0546900894928737,0.0735830294995028,0.249917136228041,0.0656281073914485
"E02003981",406,1348,247,281,1067,125,2535,0.160157790927022,0.531755424063116,0.0974358974358974,0.110848126232742,0.420907297830375,0.0493096646942801
"E02003982",393,561,221,144,417,249,2485,0.158148893360161,0.225754527162978,0.088933601609658,0.0579476861167002,0.167806841046278,0.100201207243461
"E02003983",431,1163,186,258,905,173,2915,0.147855917667238,0.398970840480274,0.0638078902229846,0.0885077186963979,0.310463121783877,0.0593481989708405
"E02003984",571,1916,710,380,1536,191,3932,0.145218718209563,0.487283825025432,0.180569684638861,0.0966429298067141,0.390640895218718,0.0485757884028484
"E02003985",394,913,157,204,709,190,2274,0.173262972735268,0.401495162708883,0.0690413368513632,0.0897097625329815,0.311785400175902,0.0835532102022867
"E02003986",437,1069,579,274,795,163,2987,0.146300636089722,0.35788416471376,0.193839973217275,0.0917308336123201,0.26615333110144,0.0545698024774021
"E02003987",552,404,722,133,271,419,2337,0.23620025673941,0.172871202396234,0.308943089430894,0.0569105691056911,0.115960633290543,0.179289687633718
"E02003988",599,356,835,117,239,482,2774,0.215933669790916,0.128334534967556,0.301009372746936,0.0421773612112473,0.0861571737563086,0.173756308579668
"E02003989",376,334,225,91,243,285,2744,0.137026239067055,0.121720116618076,0.081997084548105,0.0331632653061225,0.0885568513119534,0.103862973760933
"E02003990",535,514,406,118,396,417,4213,0.126987894611916,0.122003323047709,0.0963683835746499,0.0280085449798244,0.0939947780678851,0.0989793496320912
"E02003991",362,330,227,97,233,265,1984,0.182459677419355,0.16633064516129,0.114415322580645,0.0488911290322581,0.117439516129032,0.133568548387097
"E02003992",717,431,2194,99,332,618,4052,0.176949654491609,0.106367226061204,0.541461006910168,0.0244323790720632,0.0819348469891412,0.152517275419546
"E02003993",571,402,842,136,266,435,3055,0.186906710310966,0.131587561374795,0.275613747954173,0.0445171849427169,0.0870703764320786,0.142389525368249
"E02003994",444,535,966,113,422,331,3192,0.139097744360902,0.167606516290727,0.302631578947368,0.0354010025062657,0.132205513784461,0.103696741854637
"E02003995",358,545,246,107,438,251,4184,0.0855640535372849,0.130258126195029,0.0587954110898662,0.0255736137667304,0.104684512428298,0.0599904397705545
"E02003996",717,591,2474,149,442,568,4719,0.151938970120788,0.125238397965671,0.524263615172706,0.0315744861199407,0.09366391184573,0.120364484000848
"E02003997",382,515,201,128,387,254,3728,0.102467811158798,0.138143776824034,0.0539163090128755,0.0343347639484979,0.103809012875536,0.0681330472103004
"E02003998",253,317,170,62,255,191,2122,0.119227144203582,0.149387370405278,0.0801131008482564,0.0292177191328935,0.120169651272385,0.090009425070688
"E02003999",486,442,405,125,317,361,4232,0.114839319470699,0.104442344045369,0.0956994328922495,0.0295368620037807,0.0749054820415879,0.0853024574669187
"E02004000",320,599,482,128,471,192,1758,0.182025028441411,0.340728100113766,0.274175199089875,0.0728100113765643,0.267918088737201,0.109215017064846
"E02004001",419,539,842,136,403,283,2352,0.178146258503401,0.229166666666667,0.357993197278912,0.0578231292517007,0.171343537414966,0.120323129251701
"E02004002",489,1073,258,241,832,248,2937,0.166496424923391,0.365338781069118,0.0878447395301328,0.0820565202587674,0.283282260810351,0.0844399046646238
"E02004003",887,1382,1442,363,1019,524,4524,0.19606542882405,0.305481874447392,0.318744473916888,0.0802387267904509,0.225243147656941,0.115826702033599
"E02004004",398,896,348,180,716,218,3750,0.106133333333333,0.238933333333333,0.0928,0.048,0.190933333333333,0.0581333333333333
"E02004005",541,1083,576,286,797,255,2745,0.197085610200364,0.394535519125683,0.20983606557377,0.104189435336976,0.290346083788707,0.092896174863388
"E02004006",731,759,897,269,490,462,3034,0.240936058009229,0.250164798945287,0.29564930784443,0.0886618325642716,0.161502966381015,0.152274225444957
"E02004007",844,1020,1365,329,691,515,3455,0.244283646888567,0.295224312590449,0.395079594790159,0.0952243125904486,0.2,0.149059334298119
"E02004008",590,277,1179,104,173,486,2641,0.223400227186672,0.104884513441878,0.446421809920485,0.0393790230973116,0.0655054903445665,0.18402120408936
"E02004009",449,229,793,89,140,360,2206,0.203535811423391,0.103807796917498,0.35947416137806,0.0403445149592022,0.0634632819582956,0.163191296464189
"E02004010",599,402,790,98,304,501,3658,0.16375068343357,0.109896118097321,0.215965008201203,0.0267905959540733,0.0831055221432477,0.136960087479497
"E02004011",682,474,745,138,336,544,4465,0.152743561030235,0.106159014557671,0.166853303471445,0.0309070548712206,0.0752519596864502,0.121836506159015
"E02004012",526,329,1024,114,215,412,2651,0.198415692191626,0.124104111655979,0.386269332327424,0.043002640513014,0.0811014711429649,0.155413051678612
"E02004013",783,461,1358,148,313,635,3962,0.197627460878344,0.116355376072691,0.342756183745583,0.0373548712771328,0.0790005047955578,0.160272589601212
"E02004014",700,289,1498,100,189,600,3187,0.219642296830875,0.0906808911201757,0.470034515218073,0.0313774709758393,0.0593034201443364,0.188264825855036
"E02004015",728,557,1584,162,395,566,3870,0.188113695090439,0.143927648578811,0.409302325581395,0.0418604651162791,0.102067183462532,0.14625322997416
"E02004016",755,669,1232,199,470,556,3973,0.190032720865844,0.168386609614901,0.310093128618173,0.050088094638812,0.118298514976089,0.139944626227032
"E02004017",579,532,1067,150,382,429,3941,0.146917026135499,0.134991119005329,0.270743466125349,0.0380614057345851,0.0969297132707435,0.108855620400913
"E02004018",451,441,1063,71,370,380,4195,0.107508939213349,0.105125148986889,0.253396901072706,0.0169249106078665,0.0882002383790226,0.0905840286054827
"E02004019",465,428,705,116,312,349,2461,0.188947582283625,0.173913043478261,0.286468915075173,0.0471353108492483,0.126777732629013,0.141812271434376
"E02004020",478,548,400,148,400,330,3372,0.141755634638197,0.162514827995255,0.118623962040332,0.0438908659549229,0.118623962040332,0.097864768683274
"E02004021",547,377,1228,136,241,411,2664,0.20533033033033,0.141516516516517,0.460960960960961,0.0510510510510511,0.0904654654654655,0.154279279279279
"E02004022",542,344,1180,122,222,420,2413,0.224616659759635,0.142561127227518,0.489017820140903,0.0505594695399917,0.0920016576875259,0.174057190219644
"E02004023",554,241,1119,70,171,484,2785,0.198922800718133,0.0865350089766607,0.401795332136445,0.0251346499102334,0.0614003590664273,0.173788150807899
"E02004024",481,361,775,124,237,357,2811,0.171113482746354,0.128424048381359,0.275702596940591,0.0441124155104945,0.0843116328708645,0.127001067235859
"E02004025",569,516,893,159,357,410,3161,0.180006327111674,0.163239481176843,0.282505536222714,0.0503005378044922,0.112938943372351,0.129705789307181
"E02004026",558,877,1227,162,715,396,3945,0.141444866920152,0.222306717363752,0.311026615969582,0.04106463878327,0.181242078580482,0.100380228136882
"E02004027",688,706,1086,236,470,452,3632,0.18942731277533,0.194383259911894,0.299008810572687,0.0649779735682819,0.129405286343612,0.124449339207048
"E02004028",576,583,577,185,398,391,2763,0.208469055374593,0.211002533478104,0.208830980817952,0.0669562070213536,0.14404632645675,0.141512848353239
"E02004029",338,290,749,78,212,260,3113,0.108576935432059,0.0931577256665596,0.240603919049149,0.0250562158689367,0.0681015097976229,0.0835207195631224
"E02004030",280,216,708,69,147,211,2189,0.127912288716309,0.0986751941525811,0.323435358611238,0.031521242576519,0.0671539515760621,0.0963910461397899
"E02004031",377,333,823,61,272,316,3103,0.121495327102804,0.107315501127941,0.26522719948437,0.0196583951015147,0.087657106026426,0.101836932001289
"E02004032",420,306,655,89,217,331,2895,0.145077720207254,0.105699481865285,0.226252158894646,0.0307426597582038,0.0749568221070812,0.11433506044905
"E02004033",473,357,1443,80,277,393,3487,0.135646687697161,0.102380269572699,0.413822770289647,0.0229423573272154,0.0794379122454832,0.112704330369946
"E02004034",374,271,664,82,189,292,2249,0.166296131614051,0.120497999110716,0.295242329924411,0.0364606491774122,0.0840373499333037,0.129835482436639
"E02004035",355,293,612,108,185,247,2186,0.162397072278134,0.134034766697164,0.27996340347667,0.0494053064958829,0.0846294602012809,0.112991765782251
"E02004036",485,426,834,125,301,360,4170,0.116306954436451,0.102158273381295,0.2,0.0299760191846523,0.0721822541966427,0.0863309352517986
"E02004037",432,286,452,84,202,348,2568,0.168224299065421,0.111370716510903,0.17601246105919,0.0327102803738318,0.0786604361370716,0.135514018691589
"E02004038",527,339,1359,86,253,441,3597,0.146510981373367,0.0942452043369475,0.377814845704754,0.0239088128996386,0.0703363914373089,0.122602168473728
"E02004039",423,294,602,89,205,334,2594,0.163068619892059,0.113338473400154,0.232074016962221,0.0343099460292984,0.0790285273708558,0.12875867386276
"E02004040",445,352,1110,91,261,354,3259,0.136544952439399,0.108008591592513,0.340595274624118,0.0279226756673826,0.0800859159251304,0.108622276772016
"E02004041",369,319,747,77,242,292,2587,0.142636258214148,0.123308851952068,0.28875144955547,0.0297642056436026,0.0935446463084654,0.112872052570545
"E02004043",408,385,565,126,259,282,2529,0.161328588374852,0.152234084618426,0.223408461842626,0.0498220640569395,0.102412020561487,0.111506524317912
"E02004044",397,402,716,114,288,283,3720,0.106720430107527,0.108064516129032,0.19247311827957,0.0306451612903226,0.0774193548387097,0.0760752688172043
"E02004045",529,452,747,125,327,404,3784,0.139799154334038,0.119450317124736,0.197410147991543,0.0330338266384778,0.0864164904862579,0.10676532769556
"E02004046",363,333,361,86,247,277,2635,0.137760910815939,0.126375711574953,0.137001897533207,0.0326375711574953,0.0937381404174573,0.105123339658444
"E02004047",360,257,1254,45,212,315,3352,0.107398568019093,0.0766706443914081,0.374105011933174,0.0134248210023866,0.0632458233890215,0.0939737470167064
"E02004048",476,265,1033,78,187,398,3635,0.130949105914718,0.0729023383768913,0.284181568088033,0.0214580467675378,0.0514442916093535,0.10949105914718
"E02004049",338,431,304,92,339,246,3304,0.102300242130751,0.13044794188862,0.0920096852300242,0.0278450363196126,0.102602905569007,0.074455205811138
"E02004050",256,278,206,53,225,203,3305,0.0774583963691377,0.0841149773071104,0.0623298033282905,0.016036308623298,0.0680786686838124,0.0614220877458396
"E02004051",525,491,1066,103,388,422,4153,0.126414640019263,0.118227787141825,0.256681916686732,0.0248013484228269,0.0934264387189983,0.101613291596436
"E02004052",439,273,732,68,205,371,3425,0.128175182481752,0.0797080291970803,0.213722627737226,0.0198540145985401,0.0598540145985401,0.108321167883212
"E02004053",430,349,759,92,257,338,3259,0.131942313593127,0.107088063823259,0.232893525621356,0.0282295182571341,0.0788585455661246,0.103712795335993
"E02004054",467,253,648,69,184,398,3397,0.137474241978216,0.0744774801295261,0.190756549896968,0.0203120400353253,0.0541654400942008,0.117162201942891
"E02004055",414,343,463,73,270,341,3038,0.136273864384463,0.112903225806452,0.152402896642528,0.0240289664252798,0.0888742593811718,0.112244897959184
"E02004056",236,180,397,39,141,197,3253,0.0725484168459883,0.055333538272364,0.122041192745158,0.0119889332923455,0.0433446049800184,0.0605594835536428
"E02004057",389,436,908,87,349,302,3086,0.126053143227479,0.141283214517174,0.294232015554115,0.0281918340894362,0.113091380427738,0.0978613091380428
"E02004058",339,320,287,80,240,259,3659,0.0926482645531566,0.0874555889587319,0.0784367313473627,0.021863897239683,0.0655916917190489,0.0707843673134736
"E02004059",322,416,249,90,326,232,2642,0.121877365632097,0.157456472369417,0.0942467827403482,0.0340651021953066,0.123391370174111,0.0878122634367903
"E02004060",358,274,180,63,211,295,2561,0.139789144865287,0.106989457243264,0.0702850449043343,0.024599765716517,0.0823896915267474,0.11518937914877
"E02004061",358,435,486,95,340,263,3056,0.117146596858639,0.142342931937173,0.159031413612565,0.031086387434555,0.111256544502618,0.0860602094240838
"E02004062",456,405,41,102,303,354,3132,0.145593869731801,0.129310344827586,0.0130906768837803,0.0325670498084291,0.0967432950191571,0.113026819923372
"E02004063",503,674,589,186,488,317,2659,0.189168860473862,0.253478751410305,0.221511846558857,0.069951109439639,0.183527641970666,0.119217751034223
"E02004064",668,600,1875,161,439,507,5159,0.129482457840667,0.116301608838922,0.363442527621632,0.0312075983717775,0.0850940104671448,0.0982748594688893
"E02004065",480,589,155,168,421,312,2487,0.193003618817853,0.236831523924407,0.062324085243265,0.0675512665862485,0.169280257338158,0.125452352231604
"E02004066",628,639,803,161,478,467,4036,0.155599603567889,0.158325074331021,0.198959365708622,0.0398909811694747,0.118434093161546,0.115708622398414
"E02004067",335,275,207,61,214,274,2939,0.113984348417829,0.0935692412385165,0.0704321197686288,0.0207553589656346,0.0728138822728819,0.0932289894521946
"E02004068",503,391,1226,95,296,408,2570,0.195719844357977,0.152140077821012,0.47704280155642,0.0369649805447471,0.115175097276265,0.15875486381323
"E02004069",478,373,1228,121,252,357,2545,0.187819253438114,0.146561886051081,0.482514734774067,0.0475442043222004,0.0990176817288802,0.140275049115914
"E02004072",374,431,987,105,326,269,3649,0.102493833927103,0.118114551932036,0.270485064401206,0.0287750068511921,0.0893395450808441,0.0737188270759112
"E02004073",476,385,1469,75,310,401,3756,0.126730564430245,0.102502662406816,0.391107561235357,0.0199680511182109,0.0825346112886049,0.106762513312034
"E02004074",291,249,685,42,207,249,2274,0.127968337730871,0.109498680738786,0.301231310466139,0.0184696569920844,0.0910290237467019,0.109498680738786
"E02004075",463,259,878,89,170,374,2607,0.177598772535481,0.0993479094744917,0.336785577291906,0.034138856923667,0.0652090525508247,0.143459915611814
"E02004076",357,431,402,89,342,268,3327,0.107303877366997,0.129546137661557,0.12082957619477,0.0267508265704839,0.102795311091073,0.0805530507965134
"E02004077",524,298,743,116,182,408,2673,0.19603441825664,0.111485222596334,0.277964833520389,0.0433969322858212,0.0680882903105125,0.152637485970819
"E02004078",419,361,671,98,263,321,2932,0.142905866302865,0.1231241473397,0.228854024556617,0.0334242837653479,0.089699863574352,0.109481582537517
"E02004080",740,286,2427,82,204,658,4602,0.160799652325076,0.0621468926553672,0.527379400260756,0.0178183398522382,0.0443285528031291,0.142981312472838
"E02004081",326,279,512,95,184,231,1826,0.178532311062432,0.152792990142388,0.28039430449069,0.052026286966046,0.100766703176342,0.126506024096386
"E02004082",344,310,401,111,199,233,1730,0.198843930635838,0.179190751445087,0.231791907514451,0.0641618497109827,0.115028901734104,0.134682080924855
"E02004083",421,359,1053,104,255,317,3008,0.139960106382979,0.119348404255319,0.350066489361702,0.0345744680851064,0.0847739361702128,0.105385638297872
"E02004084",444,405,47,131,274,313,2191,0.202647193062529,0.184847101780009,0.0214513920584208,0.0597900502053857,0.125057051574623,0.142857142857143
"E02004085",506,386,886,123,263,383,3052,0.165792922673657,0.126474442988204,0.290301441677588,0.0403014416775885,0.086173001310616,0.125491480996068
"E02004086",429,376,530,120,256,309,2265,0.189403973509934,0.166004415011038,0.233995584988962,0.0529801324503311,0.113024282560706,0.136423841059603
"E02004087",460,304,1348,69,235,391,2837,0.162143108917871,0.10715544589355,0.475149806133239,0.0243214663376806,0.0828339795558689,0.13782164258019
"E02004088",496,352,591,129,223,367,2308,0.214904679376083,0.152512998266898,0.256065857885615,0.055892547660312,0.0966204506065858,0.159012131715771
"E02004089",464,210,1898,43,167,421,3642,0.127402526084569,0.057660626029654,0.521142229544207,0.0118066996155958,0.0458539264140582,0.115595826468973
"E02004090",373,247,795,83,164,290,2189,0.170397441754226,0.112836911831887,0.363179534033805,0.0379168570123344,0.0749200548195523,0.132480584741891
"E02004091",575,341,1165,97,244,478,3160,0.181962025316456,0.107911392405063,0.368670886075949,0.0306962025316456,0.0772151898734177,0.15126582278481
"E02004092",564,415,688,152,263,412,3131,0.180134142446503,0.132545512615778,0.219738102842542,0.0485467901628873,0.0839987224528904,0.131587352283615
"E02004093",399,247,893,90,157,309,2269,0.175848391361833,0.108858527985897,0.393565447333627,0.0396650506831203,0.0691934773027766,0.136183340678713
"E02004094",273,222,370,62,160,211,2001,0.136431784107946,0.110944527736132,0.184907546226887,0.0309845077461269,0.079960019990005,0.105447276361819
"E02004095",642,299,1725,75,224,567,4094,0.156814851001466,0.0730337078651685,0.421348314606742,0.0183194919394235,0.054714215925745,0.138495359062042
"E02004096",592,560,626,213,347,379,2842,0.208304011259676,0.197044334975369,0.220267417311752,0.0749472202674173,0.122097114707952,0.133356790992259
"E02004097",521,347,1345,124,223,397,2578,0.202094647013189,0.134600465477114,0.521722265321955,0.0480993017843289,0.0865011636927851,0.15399534522886
"E02004098",416,340,914,93,247,323,2548,0.163265306122449,0.133437990580848,0.358712715855573,0.0364992150706436,0.0969387755102041,0.126766091051805
"E02004100",379,324,874,96,228,283,2684,0.141207153502235,0.120715350223547,0.325633383010432,0.0357675111773472,0.0849478390461997,0.105439642324888
"E02004102",551,391,1812,60,331,491,3777,0.145882975906804,0.103521313211544,0.479745830023828,0.0158856235107228,0.0876356897008208,0.129997352396082
"E02004103",343,355,536,86,269,257,2296,0.149390243902439,0.154616724738676,0.233449477351916,0.0374564459930314,0.117160278745645,0.111933797909408
"E02004104",326,407,443,117,290,209,2842,0.114707952146376,0.143209007741027,0.155876143560873,0.0411681914144968,0.102040816326531,0.073539760731879
"E02004105",508,344,355,123,221,385,2865,0.177312390924956,0.120069808027923,0.1239092495637,0.0429319371727749,0.0771378708551483,0.134380453752181
"E02004106",493,440,243,163,277,330,2013,0.244908097367114,0.218579234972678,0.120715350223547,0.0809736711376056,0.137605563835072,0.163934426229508
"E02004108",447,479,459,116,363,331,2704,0.165310650887574,0.177144970414201,0.169748520710059,0.0428994082840237,0.134245562130178,0.12241124260355
"E02004109",405,430,236,119,311,286,1932,0.209627329192547,0.222567287784679,0.122153209109731,0.0615942028985507,0.160973084886128,0.148033126293996
"E02004110",459,525,122,177,348,282,2105,0.218052256532067,0.249406175771971,0.0579572446555819,0.0840855106888361,0.165320665083135,0.13396674584323
"E02004111",335,366,189,104,262,231,2231,0.150156880322725,0.164051994621246,0.0847153742716271,0.0466158673240699,0.117436127297176,0.103541012998655
"E02004112",397,334,286,117,217,280,1854,0.214131607335491,0.180151024811219,0.154261057173679,0.0631067961165049,0.117044228694714,0.151024811218986
"E02004113",452,369,538,67,302,385,4438,0.101847679134745,0.0831455610635421,0.121225777377197,0.0150968904912123,0.0680486705723299,0.0867507886435331
"E02004114",429,366,376,102,264,327,3157,0.13588850174216,0.115932847640165,0.119100411783339,0.0323091542603738,0.0836236933797909,0.103579347481787
"E02004115",477,437,533,106,331,371,3339,0.142857142857143,0.130877508235999,0.159628631326745,0.0317460317460317,0.099131476489967,0.111111111111111
"E02004116",417,277,618,65,212,352,3804,0.109621451104101,0.0728180862250263,0.162460567823344,0.0170872765509989,0.0557308096740273,0.092534174553102
"E02004117",356,339,516,75,264,281,3016,0.118037135278515,0.112400530503979,0.171087533156499,0.024867374005305,0.0875331564986737,0.0931697612732096
"E02004118",307,210,396,62,148,245,3481,0.0881930479747199,0.0603274920999713,0.113760413674232,0.0178109738580868,0.0425165182418845,0.0703820741166332
"E02004119",357,301,223,60,241,297,4632,0.0770725388601036,0.0649827288428325,0.0481433506044905,0.0129533678756477,0.0520293609671848,0.064119170984456
"E02004120",450,312,170,110,202,340,3649,0.12332145793368,0.0855028775006851,0.0465881063305015,0.0301452452726774,0.0553576322280077,0.093176212661003
"E02004121",351,252,372,82,170,269,3823,0.0918127125294271,0.0659168192518964,0.0973057808004185,0.0214491237248234,0.044467695527073,0.0703635888046037
"E02004122",308,243,453,72,171,236,2122,0.145146088595664,0.114514608859566,0.213477851083883,0.0339302544769086,0.0805843543826579,0.111215834118756
"E02004123",399,236,778,61,175,338,2709,0.147286821705426,0.0871170173495755,0.28719084533038,0.0225175341454411,0.0645994832041344,0.124769287559985
"E02004124",416,286,318,89,197,327,2758,0.150833937635968,0.103698332124728,0.11530094271211,0.0322697606961566,0.0714285714285714,0.118564176939811
"E02004125",441,447,565,122,325,319,3650,0.120821917808219,0.122465753424658,0.154794520547945,0.0334246575342466,0.089041095890411,0.0873972602739726
"E02004126",356,291,475,86,205,270,3080,0.115584415584416,0.0944805194805195,0.154220779220779,0.0279220779220779,0.0665584415584416,0.0876623376623377
"E02004128",588,393,788,122,271,466,4888,0.120294599018003,0.0804009819967267,0.161211129296236,0.0249590834697218,0.0554418985270049,0.0953355155482815
"E02004129",597,358,586,147,211,450,2143,0.278581427904806,0.167055529631358,0.273448436770882,0.0685954269715352,0.0984601026598227,0.209986000933271
"E02004130",445,514,474,104,410,341,3134,0.141991065730696,0.164007657945118,0.151244416081685,0.0331844288449266,0.130823229100191,0.108806636885769
"E02004131",374,298,58,97,201,277,2048,0.1826171875,0.1455078125,0.0283203125,0.04736328125,0.09814453125,0.13525390625
"E02004132",560,460,490,167,293,393,2897,0.193303417328271,0.158784949948222,0.169140490162237,0.0576458405246807,0.101139109423542,0.13565757680359
"E02004133",653,706,581,241,465,412,4317,0.151262450776002,0.16353949501969,0.134584201992124,0.0558258049571462,0.107713690062543,0.0954366458188557
"E02004135",705,644,777,240,404,465,3095,0.227786752827141,0.208077544426494,0.251050080775444,0.0775444264943457,0.130533117932149,0.150242326332795
"E02004136",577,603,422,186,417,391,3436,0.167927823050058,0.175494761350407,0.122817229336438,0.0541327124563446,0.121362048894063,0.113795110593714
"E02004137",525,536,644,180,356,345,2295,0.228758169934641,0.233551198257081,0.280610021786492,0.0784313725490196,0.155119825708061,0.150326797385621
"E02004138",812,789,591,258,531,554,3924,0.206931702344546,0.201070336391437,0.150611620795107,0.0657492354740061,0.135321100917431,0.14118246687054
"E02004139",508,710,203,218,492,290,2942,0.172671651937458,0.241332426920462,0.0690006798096533,0.0740992522093814,0.167233174711081,0.0985723997280761
"E02004140",521,878,499,233,645,288,2753,0.189248092989466,0.318924809298947,0.181256810751907,0.0846349436977842,0.234289865601162,0.104613149291682
"E02004141",413,409,310,132,277,281,2276,0.181458699472759,0.179701230228471,0.136203866432337,0.0579964850615114,0.12170474516696,0.123462214411248
"E02004142",323,350,382,99,251,224,1900,0.17,0.184210526315789,0.201052631578947,0.0521052631578947,0.132105263157895,0.117894736842105
"E02004143",473,466,34,176,290,297,2177,0.217271474506201,0.2140560404226,0.0156178226917777,0.0808451998162609,0.133210840606339,0.13642627468994
"E02004144",595,720,130,250,470,345,2443,0.243553008595989,0.294719607040524,0.0532132623823168,0.102333196889071,0.192386410151453,0.141219811706918
"E02004145",477,898,420,227,671,250,2847,0.16754478398314,0.315419740077274,0.147523709167545,0.0797330523357921,0.235686687741482,0.0878117316473481
"E02004146",526,633,162,199,434,327,2801,0.187790074973224,0.225990717600857,0.0578364869689397,0.0710460549803642,0.154944662620493,0.11674401999286
"E02004147",714,1219,1349,337,882,377,3745,0.190654205607477,0.325500667556742,0.360213618157543,0.0899866488651535,0.235514018691589,0.100667556742323
"E02004148",472,810,448,186,624,286,4080,0.115686274509804,0.198529411764706,0.109803921568627,0.0455882352941176,0.152941176470588,0.0700980392156863
"E02004149",500,647,148,213,434,287,2160,0.231481481481481,0.299537037037037,0.0685185185185185,0.0986111111111111,0.200925925925926,0.13287037037037
"E02004150",518,749,195,251,498,267,2337,0.221651690201113,0.320496362858365,0.0834403080872914,0.107402652973898,0.213093709884467,0.114249037227214
"E02004151",553,555,171,204,351,349,4230,0.130732860520095,0.131205673758865,0.0404255319148936,0.0482269503546099,0.0829787234042553,0.0825059101654846
"E02004152",828,912,1563,275,637,553,3447,0.240208877284595,0.264577893820714,0.453437771975631,0.0797795184218161,0.184798375398898,0.160429358862779
"E02004153",713,607,140,188,419,525,2979,0.239342061094327,0.20375965088956,0.0469956361195032,0.06310842564619,0.14065122524337,0.176233635448137
"E02004154",702,1145,1072,333,812,369,3364,0.208680142687277,0.340368608799049,0.318668252080856,0.0989892984542212,0.241379310344828,0.109690844233056
"E02004155",396,461,215,122,339,274,2489,0.159100040176778,0.18521494576135,0.0863800723182001,0.0490156689433507,0.136199276817999,0.110084371233427
"E02004156",664,845,1476,177,668,487,5775,0.114978354978355,0.146320346320346,0.255584415584416,0.0306493506493506,0.115670995670996,0.0843290043290043
"E02004157",491,763,856,211,552,280,2935,0.167291311754685,0.259965928449744,0.291652470187394,0.0718909710391823,0.188074957410562,0.0954003407155026
"E02004158",617,894,1035,264,630,353,3187,0.193598995920929,0.280514590524004,0.324756824599937,0.0828365233762159,0.197678067147788,0.110762472544713
"E02004159",483,473,139,136,337,347,4682,0.10316104228962,0.101025202904742,0.0296881674498078,0.0290474156343443,0.0719777872703973,0.0741136266552755
"E02004160",469,607,132,192,415,277,2182,0.214940421631531,0.278185151237397,0.0604949587534372,0.0879926672777269,0.19019248395967,0.126947754353804
"E02004161",404,636,249,139,497,265,3660,0.110382513661202,0.173770491803279,0.0680327868852459,0.0379781420765027,0.135792349726776,0.0724043715846995
"E02004162",539,485,344,142,343,397,2927,0.184147591390502,0.165698667577725,0.117526477622139,0.0485138366928596,0.117184830884865,0.135633754697643
"E02004163",528,640,527,185,455,343,3777,0.139793486894361,0.169446650781043,0.139528726502515,0.0489806724913953,0.120465978289648,0.0908128144029653
"E02004164",574,334,822,119,215,455,2375,0.241684210526316,0.140631578947368,0.346105263157895,0.0501052631578947,0.0905263157894737,0.191578947368421
"E02004165",466,410,244,124,286,342,3440,0.13546511627907,0.119186046511628,0.0709302325581395,0.036046511627907,0.0831395348837209,0.0994186046511628
"E02004166",508,306,504,126,180,382,2320,0.218965517241379,0.131896551724138,0.217241379310345,0.0543103448275862,0.0775862068965517,0.164655172413793
"E02004167",474,381,452,134,247,340,2693,0.176011882658745,0.141477905681396,0.16784255477163,0.0497586334942443,0.0917192721871519,0.126253249164501
"E02004168",578,419,846,139,280,439,2694,0.214550853749072,0.155530809205642,0.314031180400891,0.0515961395694135,0.103934669636229,0.162954714179659
"E02004169",438,293,328,96,197,342,2549,0.171832091016085,0.114947038054139,0.128677912907022,0.037661828167909,0.0772852098862299,0.134170262848176
"E02004170",557,459,345,152,307,405,3449,0.161496085821977,0.133082052768919,0.100028993911279,0.0440707451435199,0.0890113076253987,0.117425340678458
"E02004171",491,443,501,149,294,342,3060,0.160457516339869,0.144771241830065,0.163725490196078,0.0486928104575163,0.096078431372549,0.111764705882353
"E02004172",562,337,374,161,176,401,2191,0.256503879507074,0.153811045184847,0.170698311273391,0.073482428115016,0.0803286170698311,0.183021451392058
"E02004173",587,379,443,144,235,443,2475,0.237171717171717,0.153131313131313,0.178989898989899,0.0581818181818182,0.094949494949495,0.178989898989899
"E02004174",536,526,589,159,367,377,3407,0.157323158203698,0.154388024655122,0.172879366011154,0.0466686234223657,0.107719401232756,0.110654534781333
"E02004175",462,406,1330,106,300,356,2720,0.169852941176471,0.149264705882353,0.488970588235294,0.0389705882352941,0.110294117647059,0.130882352941176
"E02004176",587,390,1236,126,264,461,2569,0.228493577267419,0.151810042818217,0.481121058777735,0.0490463215258856,0.102763721292332,0.179447255741534
"E02004177",486,440,908,120,320,366,2624,0.185213414634146,0.167682926829268,0.346036585365854,0.0457317073170732,0.121951219512195,0.139481707317073
"E02004178",787,611,574,238,373,549,3039,0.25896676538335,0.201052977953274,0.188877920368542,0.0783152352747614,0.122737742678513,0.180651530108588
"E02004179",689,738,486,246,492,443,3568,0.193105381165919,0.206838565022422,0.136210762331839,0.0689461883408072,0.137892376681614,0.124159192825112
"E02004180",396,319,577,123,196,273,2311,0.171354392038079,0.138035482475119,0.249675465166595,0.0532237126784942,0.0848117697966248,0.118130679359585
"E02004181",421,442,514,151,291,270,2112,0.199337121212121,0.209280303030303,0.243371212121212,0.0714962121212121,0.137784090909091,0.127840909090909
"E02004182",549,381,860,135,246,414,2947,0.186291143535799,0.129284017645063,0.291822192059722,0.0458092975907703,0.0834747200542925,0.140481845945029
"E02004183",499,469,449,175,294,324,2344,0.212883959044369,0.200085324232082,0.191552901023891,0.0746587030716724,0.12542662116041,0.138225255972696
"E02004184",566,555,503,168,387,398,3171,0.178492589088616,0.175023651844844,0.158625039419741,0.0529801324503311,0.122043519394513,0.125512456638284
"E02004185",444,416,320,152,264,292,2659,0.166980067694622,0.156449793155322,0.120345994734863,0.0571643474990598,0.0992854456562618,0.109815720195562
"E02004186",494,413,506,134,279,360,4111,0.120165409875943,0.100462174653369,0.123084407686694,0.0325954755533933,0.0678666990999757,0.0875699343225493
"E02004187",796,568,1088,217,351,579,4443,0.179158226423588,0.127841548503264,0.244879585865406,0.0488408732838172,0.0790006752194463,0.13031735313977
"E02004188",571,388,644,157,231,414,2783,0.205174272367948,0.139417894358606,0.231404958677686,0.0564139417894359,0.08300395256917,0.148760330578512
"E02004189",525,230,307,93,137,432,2111,0.248697299857887,0.108953102794884,0.145428706774041,0.04405495026054,0.0648981525343439,0.204642349597347
"E02004190",617,472,883,160,312,457,3445,0.179100145137881,0.137010159651669,0.256313497822932,0.04644412191582,0.0905660377358491,0.132656023222061
"E02004191",818,758,745,241,517,577,4158,0.196729196729197,0.182299182299182,0.179172679172679,0.057960557960558,0.124338624338624,0.138768638768639
"E02004192",727,609,883,223,386,504,3338,0.21779508687837,0.182444577591372,0.264529658478131,0.066806470940683,0.115638106650689,0.150988615937687
"E02004193",782,664,321,228,436,554,3910,0.2,0.169820971867008,0.0820971867007673,0.0583120204603581,0.11150895140665,0.141687979539642
"E02004194",554,351,805,123,228,431,2928,0.189207650273224,0.119877049180328,0.274931693989071,0.0420081967213115,0.0778688524590164,0.147199453551913
"E02004195",602,713,948,187,526,415,3080,0.195454545454545,0.231493506493507,0.307792207792208,0.0607142857142857,0.170779220779221,0.13474025974026
"E02004196",647,493,884,171,322,476,3093,0.209182023924992,0.159392175881022,0.285806660200453,0.055286129970902,0.10410604591012,0.15389589395409
"E02004197",505,566,423,206,360,299,3820,0.132198952879581,0.148167539267016,0.110732984293194,0.0539267015706806,0.0942408376963351,0.0782722513089005
"E02004198",661,549,621,174,375,487,3003,0.22011322011322,0.182817182817183,0.206793206793207,0.0579420579420579,0.124875124875125,0.162171162171162
"E02004199",801,534,827,231,303,570,3336,0.240107913669065,0.160071942446043,0.247901678657074,0.0692446043165468,0.0908273381294964,0.170863309352518
"E02004200",762,776,716,272,504,490,3412,0.223329425556858,0.227432590855803,0.209847596717468,0.0797186400937866,0.147713950762016,0.143610785463072
"E02004201",356,223,366,67,156,289,1682,0.211652794292509,0.132580261593341,0.217598097502973,0.039833531510107,0.0927467300832342,0.171819262782402
"E02004202",579,400,491,148,252,431,3740,0.154812834224599,0.106951871657754,0.131283422459893,0.039572192513369,0.067379679144385,0.11524064171123
"E02004203",469,334,753,108,226,361,2275,0.206153846153846,0.146813186813187,0.330989010989011,0.0474725274725275,0.0993406593406593,0.158681318681319
"E02004204",738,452,773,154,298,584,4059,0.181818181818182,0.111357477211136,0.190440995319044,0.037940379403794,0.0734170978073417,0.143877802414388
"E02004205",525,613,315,170,443,355,3722,0.141053197205803,0.164696399785062,0.084631918323482,0.045674368619022,0.11902203116604,0.0953788285867813
"E02004206",573,580,806,168,412,405,3218,0.178060907395898,0.180236171535115,0.250466128029832,0.0522063393412057,0.128029832193909,0.125854568054692
"E02004207",419,300,304,107,193,312,2296,0.182491289198606,0.130662020905923,0.132404181184669,0.046602787456446,0.0840592334494774,0.13588850174216
"E02004208",662,670,442,235,435,427,3198,0.207004377736085,0.209505941213258,0.138211382113821,0.0734834271419637,0.136022514071295,0.133520950594121
"E02004209",618,533,296,178,355,440,3243,0.190564292321924,0.164353993216158,0.0912735121800802,0.0548874498920752,0.109466543324083,0.135676842429849
"E02004210",559,581,1287,133,448,426,3415,0.163689604685212,0.1701317715959,0.376866764275256,0.0389458272327965,0.131185944363104,0.124743777452416
"E02004211",460,447,586,133,314,327,2595,0.177263969171484,0.172254335260116,0.225818882466281,0.051252408477842,0.121001926782274,0.126011560693642
"E02004212",329,551,157,146,405,183,2313,0.142239515780372,0.238218763510592,0.0678772157371379,0.0631214872460009,0.175097276264591,0.0791180285343709
"E02004213",390,336,215,116,220,274,3281,0.118866199329473,0.102407802499238,0.0655288021944529,0.035355074672356,0.067052727826882,0.0835111246571167
"E02004214",523,577,1156,149,428,374,2919,0.179170948955122,0.197670435080507,0.396026036313806,0.0510448783830079,0.146625556697499,0.128126070572114
"E02004215",437,384,745,115,269,322,2380,0.183613445378151,0.161344537815126,0.313025210084034,0.0483193277310924,0.113025210084034,0.135294117647059
"E02004216",465,402,48,148,254,317,1802,0.258046614872364,0.223085460599334,0.0266370699223085,0.0821309655937847,0.140954495005549,0.175915649278579
"E02004217",604,476,889,154,322,450,2925,0.206495726495727,0.162735042735043,0.303931623931624,0.0526495726495727,0.11008547008547,0.153846153846154
"E02004218",432,460,311,148,312,284,2164,0.199630314232902,0.212569316081331,0.143715341959335,0.0683918669131238,0.144177449168207,0.131238447319778
"E02004219",357,312,390,106,206,251,1719,0.207678883071553,0.181500872600349,0.226876090750436,0.0616637579988365,0.119837114601513,0.146015125072717
"E02004220",595,542,735,153,389,442,3137,0.189671660822442,0.17277653809372,0.23430028689831,0.0487727127829136,0.124003825310807,0.140898948039528
"E02004221",421,388,482,116,272,305,3238,0.130018529956763,0.119827053736875,0.148857319332922,0.0358245830759728,0.0840024706609018,0.0941939468807906
"E02004222",470,328,1172,95,233,375,2834,0.165843330980946,0.115737473535639,0.413549752999294,0.0335215243472124,0.0822159491884263,0.132321806633733
"E02004223",638,793,818,220,573,418,5321,0.119902274008645,0.149032136816388,0.153730501785379,0.041345611727119,0.107686525089269,0.078556662281526
"E02004224",593,378,901,138,240,455,2733,0.216977680204903,0.138309549945115,0.329674350530552,0.0504939626783754,0.0878155872667399,0.166483717526528
"E02004225",376,318,601,89,229,287,2278,0.165057067603161,0.139596136962248,0.263827919227392,0.0390693590869184,0.100526777875329,0.125987708516242
"E02004226",614,428,758,159,269,455,2861,0.214610276127228,0.149598042642433,0.264942327857393,0.0555749737853897,0.094023068857043,0.159035302341839
"E02004227",882,648,889,230,418,652,4366,0.202015574896931,0.148419606046725,0.203618873110399,0.0526797984425103,0.0957398076042144,0.149335776454421
"E02004228",663,403,703,161,242,502,2746,0.241442097596504,0.146758922068463,0.256008739985433,0.0586307356154406,0.0881281864530226,0.182811361981063
"E02004229",629,399,660,149,250,480,4102,0.153339834227206,0.0972696245733788,0.160897123354461,0.0363237445148708,0.060945880058508,0.117016089712335
"E02004230",556,433,721,146,287,410,3216,0.172885572139303,0.134639303482587,0.224191542288557,0.0453980099502488,0.0892412935323383,0.127487562189055
"E02004231",596,359,968,140,219,456,2590,0.23011583011583,0.138610038610039,0.373745173745174,0.0540540540540541,0.0845559845559846,0.176061776061776
"E02004232",651,339,958,167,172,484,2451,0.265605875152999,0.138310893512852,0.390860873113015,0.0681354549163607,0.0701754385964912,0.197470420236638
"E02004233",968,891,994,343,548,625,5261,0.183995438129633,0.169359437369321,0.188937464360388,0.0651967306595704,0.104162706709751,0.118798707470063
"E02004234",554,423,688,155,268,399,2041,0.271435570798628,0.207251347378736,0.337089661930426,0.0759431651151396,0.131308182263596,0.195492405683488
"E02004235",499,422,688,134,288,365,2373,0.210282343025706,0.177833965444585,0.289928360724821,0.0564686051411715,0.121365360303413,0.153813737884534
"E02004236",418,497,145,186,311,232,1954,0.213920163766633,0.254350051177073,0.0742067553735926,0.0951893551688843,0.159160696008188,0.118730808597748
"E02004237",538,621,36,213,408,325,2594,0.207401696222051,0.239398612181958,0.0138781804163454,0.082112567463377,0.157286044718581,0.125289128758674
"E02004238",632,1134,261,296,838,336,3804,0.166140904311251,0.298107255520505,0.0686119873817035,0.0778128286014721,0.220294426919033,0.0883280757097792
"E02004239",518,418,49,159,259,359,2256,0.229609929078014,0.185283687943262,0.0217198581560284,0.0704787234042553,0.114804964539007,0.159131205673759
"E02004240",413,422,80,116,306,297,2679,0.154162000746547,0.157521463232549,0.0298618887644644,0.0432997387084733,0.114221724524076,0.110862262038074
"E02004241",634,984,255,274,710,360,4465,0.141993281075028,0.220380739081747,0.0571108622620381,0.0613661814109742,0.159014557670773,0.0806270996640538
"E02004242",647,770,89,233,537,414,2781,0.232650125854009,0.276878820568141,0.0320028766630708,0.0837828119381517,0.193096008629989,0.148867313915858
"E02004243",535,544,302,185,359,350,2073,0.258080077182827,0.26242161119151,0.145682585624698,0.0892426435118186,0.173178967679691,0.168837433671008
"E02004244",649,373,23,146,227,503,2676,0.242526158445441,0.139387144992526,0.0085949177877429,0.054559043348281,0.0848281016442451,0.18796711509716
"E02004245",440,378,44,131,247,309,2572,0.171073094867807,0.14696734059098,0.0171073094867807,0.0509331259720062,0.0960342146189736,0.120139968895801
"E02004246",593,448,112,196,252,397,2621,0.226249523082793,0.170927127050744,0.042731781762686,0.0747806180847005,0.0961465089660435,0.151468904998092
"E02004247",417,413,371,157,256,260,1771,0.235460191981931,0.233201581027668,0.209486166007905,0.0886504799548278,0.14455110107284,0.146809712027103
"E02004248",547,532,74,180,352,367,2738,0.199780861943024,0.194302410518627,0.027027027027027,0.0657414170927684,0.128560993425858,0.134039444850256
"E02004249",395,368,62,142,226,253,2099,0.188184849928537,0.175321581705574,0.0295378751786565,0.0676512625059552,0.107670319199619,0.120533587422582
"E02004250",634,658,70,246,412,388,3297,0.192296026690931,0.199575371549894,0.0212314225053079,0.0746132848043676,0.124962086745526,0.117682741886564
"E02004251",557,515,51,210,305,347,2061,0.270257156720039,0.249878699660359,0.024745269286754,0.101892285298399,0.14798641436196,0.16836487142164
"E02004252",572,815,311,205,610,367,4258,0.134335368717708,0.191404415218412,0.0730389854391733,0.0481446688586191,0.143259746359793,0.0861906998590888
"E02004253",752,707,97,296,411,456,3433,0.219050393242062,0.205942324497524,0.0282551704048937,0.0862219632974075,0.119720361200117,0.132828429944655
"E02004254",652,707,55,231,476,421,3042,0.214332675871137,0.23241288625904,0.0180802103879027,0.0759368836291913,0.156476002629849,0.138395792241946
"E02004255",629,408,270,161,247,468,3257,0.193122505373043,0.125268652133866,0.0828983727356463,0.0494319926312558,0.0758366595026098,0.143690512741787
"E02004256",568,391,667,146,245,422,3290,0.172644376899696,0.118844984802432,0.20273556231003,0.0443768996960486,0.074468085106383,0.128267477203647
"E02004257",498,472,412,144,328,354,4064,0.12253937007874,0.116141732283465,0.101377952755906,0.0354330708661417,0.0807086614173228,0.0871062992125984
"E02004258",710,576,602,190,386,520,4149,0.171125572427091,0.13882863340564,0.145095203663533,0.0457941672692215,0.0930344661364184,0.125331405157869
"E02004259",473,385,528,133,252,340,2265,0.208830022075055,0.169977924944812,0.233112582781457,0.058719646799117,0.111258278145695,0.150110375275938
"E02004260",405,562,430,117,445,288,3498,0.115780445969125,0.160663236134934,0.12292738707833,0.0334476843910806,0.127215551743854,0.0823327615780446
"E02004261",616,573,557,159,414,457,4294,0.143455985095482,0.133442012109921,0.129715882626921,0.0370284117373079,0.0964136003726129,0.106427573358174
"E02004262",526,384,454,147,237,379,2601,0.202229911572472,0.147635524798155,0.174548250672818,0.0565167243367935,0.091118800461361,0.145713187235679
"E02004263",423,471,206,137,334,286,2052,0.206140350877193,0.22953216374269,0.100389863547758,0.0667641325536062,0.162768031189084,0.139376218323587
"E02004264",538,598,60,208,390,330,2575,0.208932038834951,0.232233009708738,0.0233009708737864,0.0807766990291262,0.151456310679612,0.128155339805825
"E02004265",631,602,255,206,396,425,2877,0.219325686478971,0.209245742092457,0.0886339937434828,0.0716023635731665,0.137643378519291,0.147723322905805
"E02004266",574,511,320,187,324,387,2971,0.193200942443622,0.171995960955907,0.10770784247728,0.0629417704476607,0.109054190508246,0.130259171995961
"E02004267",539,408,439,201,207,338,1845,0.292140921409214,0.221138211382114,0.237940379403794,0.108943089430894,0.11219512195122,0.18319783197832
"E02004268",938,1382,653,388,994,550,4817,0.194727008511522,0.286900560514843,0.135561552833714,0.0805480589578576,0.206352501556986,0.114178949553664
"E02004269",614,680,714,186,494,428,4355,0.140987370838117,0.156142365097589,0.163949483352468,0.0427095292766935,0.113432835820896,0.0982778415614236
"E02004270",653,487,756,173,314,480,2752,0.237281976744186,0.176962209302326,0.274709302325581,0.0628633720930233,0.114098837209302,0.174418604651163
"E02004271",940,640,1072,254,386,686,4150,0.226506024096386,0.15421686746988,0.258313253012048,0.0612048192771084,0.0930120481927711,0.165301204819277
"E02004272",787,656,870,228,428,559,4510,0.17450110864745,0.145454545454545,0.19290465631929,0.0505543237250554,0.09490022172949,0.123946784922395
"E02004273",648,740,833,230,510,418,3557,0.182175991003655,0.208040483553556,0.234186111892044,0.064661231374754,0.143379252178802,0.117514759628901
"E02004274",503,548,486,169,379,334,2564,0.196177847113885,0.213728549141966,0.189547581903276,0.0659126365054602,0.147815912636505,0.130265210608424
"E02004275",728,579,781,260,319,468,3059,0.237986270022883,0.189277541680288,0.255312193527297,0.084995096436744,0.104282445243544,0.152991173586139
"E02004276",453,505,501,146,359,307,2844,0.159282700421941,0.177566807313643,0.176160337552743,0.0513361462728551,0.126230661040788,0.107946554149086
"E02004278",535,797,213,237,560,298,3103,0.172413793103448,0.256848211408315,0.0686432484692233,0.0763776990009668,0.180470512407348,0.0960360941024815
"E02004279",564,501,385,177,324,387,2990,0.188628762541806,0.167558528428094,0.12876254180602,0.0591973244147157,0.108361204013378,0.12943143812709
"E02004280",533,482,410,150,332,383,3201,0.166510465479538,0.150577944392377,0.128084973445798,0.0468603561387067,0.103717588253671,0.119650109340831
"E02004281",581,454,208,146,308,435,3027,0.19193921374298,0.149983481995375,0.0687148992401718,0.0482325735051206,0.101750908490254,0.143706640237859
"E02004282",681,798,176,274,524,407,3223,0.211293825628297,0.247595408004964,0.0546075085324232,0.085013962147068,0.162581445857896,0.126279863481229
"E02004283",568,774,109,238,536,330,2894,0.196268140981341,0.267449896337249,0.0376641326883207,0.0822391154111956,0.185210780926054,0.114029025570145
"E02004284",850,1496,1475,328,1168,522,5845,0.145423438836612,0.255945252352438,0.252352437981181,0.0561163387510693,0.199828913601369,0.0893071000855432
"E02004285",521,962,220,263,699,258,3355,0.155290611028316,0.286736214605067,0.0655737704918033,0.0783904619970194,0.208345752608048,0.0769001490312966
"E02004286",279,457,131,135,322,144,1658,0.168275030156815,0.275633293124246,0.0790108564535585,0.0814234016887817,0.194209891435464,0.0868516284680338
"E02004287",360,571,145,184,387,176,1827,0.197044334975369,0.312534209085933,0.0793650793650794,0.100711548987411,0.211822660098522,0.0963327859879584
"E02004288",444,430,732,130,300,314,2503,0.177387135437475,0.17179384738314,0.292449061126648,0.0519376747902517,0.119856172592889,0.125449460647223
"E02004289",679,718,549,260,458,419,2743,0.247539190667153,0.261757200145826,0.200145825738243,0.0947867298578199,0.166970470288006,0.152752460809333
"E02004290",310,396,168,106,290,204,1757,0.176437108708025,0.225384177575413,0.0956175298804781,0.0603301081388731,0.16505406943654,0.116107000569152
"E02004291",311,428,239,107,321,204,2961,0.105032083755488,0.144545761567038,0.0807159743329956,0.0361364403917595,0.108409321175279,0.0688956433637285
"E02004292",368,461,129,119,342,249,2708,0.13589364844904,0.170236336779911,0.0476366322008863,0.043943870014771,0.12629246676514,0.0919497784342688
"E02004293",501,437,161,100,337,401,4253,0.117799200564308,0.102750999294616,0.0378556313190689,0.0235128144838937,0.0792381848107218,0.0942863860804138
"E02004294",452,577,180,161,416,291,2558,0.17670054730258,0.22556684910086,0.0703674745895231,0.0629397967161845,0.162627052384676,0.113760750586396
"E02004295",354,405,179,93,312,261,2468,0.143435980551053,0.164100486223663,0.0725283630470016,0.0376823338735819,0.126418152350081,0.105753646677472
"E02004296",340,448,326,88,360,252,3262,0.104230533415083,0.137339055793991,0.0999386879215205,0.0269773145309626,0.110361741263029,0.0772532188841202
"E02004297",368,494,540,110,384,258,2714,0.135593220338983,0.18201915991157,0.198968312453943,0.0405305821665438,0.141488577745026,0.0950626381724392
"E02004298",528,609,624,139,470,389,3273,0.161319890009166,0.186067827681027,0.190650779101742,0.0424686831652918,0.143599144515735,0.118851206843874
"E02004299",408,559,567,110,449,298,3088,0.132124352331606,0.181023316062176,0.183613989637306,0.0356217616580311,0.145401554404145,0.0965025906735751
"E02004300",446,624,595,130,494,316,2930,0.15221843003413,0.212969283276451,0.203071672354949,0.0443686006825939,0.168600682593857,0.107849829351536
"E02004301",432,654,376,110,544,322,3726,0.115942028985507,0.175523349436393,0.100912506709608,0.0295222758990875,0.146001073537305,0.0864197530864197
"E02004302",523,735,1849,165,570,358,3769,0.138763597771292,0.1950119395065,0.490581055983019,0.0437781905014593,0.151233749005041,0.0949854072698328
"E02004303",590,844,1512,155,689,435,4460,0.132286995515695,0.189237668161435,0.339013452914798,0.0347533632286996,0.154484304932735,0.0975336322869955
"E02004304",388,586,475,112,474,276,3139,0.12360624402676,0.186683657215674,0.151322077094616,0.0356801529149411,0.151003504300733,0.0879260911118191
"E02004305",546,722,284,144,578,402,3916,0.139427987742594,0.184371807967314,0.0725229826353422,0.0367722165474974,0.147599591419816,0.102655771195097
"E02004306",325,426,314,117,309,208,2034,0.159783677482793,0.209439528023599,0.154375614552606,0.0575221238938053,0.151917404129794,0.102261553588987
"E02004307",417,409,546,119,290,298,2533,0.164626924595342,0.161468614291354,0.215554678247138,0.0469798657718121,0.114488748519542,0.117647058823529
"E02004308",338,593,138,142,451,196,2182,0.154903758020165,0.271769019248396,0.0632447296058662,0.0650779101741522,0.206691109074244,0.0898258478460128
"E02004309",342,339,188,99,240,243,2840,0.120422535211268,0.119366197183099,0.0661971830985915,0.0348591549295775,0.0845070422535211,0.0855633802816901
"E02004310",430,487,221,85,402,345,3401,0.126433401940606,0.143193178476919,0.0649808879741253,0.0249926492208174,0.118200529256101,0.101440752719788
"E02004311",633,638,259,142,496,491,4225,0.149822485207101,0.151005917159763,0.061301775147929,0.0336094674556213,0.117396449704142,0.116213017751479
"E02004312",447,557,217,154,403,293,2577,0.173457508731083,0.216142801707412,0.0842064415987582,0.0597594101668607,0.156383391540551,0.113698098564222
"E02004313",351,425,340,81,344,270,3597,0.097581317764804,0.118154017236586,0.0945232137892688,0.0225187656380317,0.0956352515985543,0.0750625521267723
"E02004314",379,619,852,130,489,249,3031,0.125041240514682,0.204223028703398,0.281095348069944,0.0428901352688882,0.16133289343451,0.0821511052457935
"E02004315",499,828,736,204,624,295,4704,0.106079931972789,0.176020408163265,0.156462585034014,0.0433673469387755,0.13265306122449,0.0627125850340136
"E02004316",458,444,281,120,324,338,3091,0.148172112584924,0.143642834034293,0.0909090909090909,0.038822387576836,0.104820446457457,0.109349725008088
"E02004317",464,455,131,111,344,353,3444,0.13472706155633,0.132113821138211,0.0380371660859466,0.0322299651567944,0.099883855981417,0.102497096399535
"E02004318",354,352,595,88,264,266,3211,0.110246029274369,0.109623170351915,0.185300529430084,0.0274057925879788,0.0822173777639365,0.0828402366863905
"E02004319",494,320,292,60,260,434,3658,0.135046473482777,0.0874794969928923,0.0798250410060142,0.0164024056861673,0.071077091306725,0.11864406779661
"E02004320",302,381,139,97,284,205,3125,0.09664,0.12192,0.04448,0.03104,0.09088,0.0656
"E02004321",456,646,572,142,504,314,3544,0.128668171557562,0.182279909706546,0.161399548532731,0.0400677200902935,0.142212189616253,0.0886004514672686
"E02004322",403,533,123,91,442,312,4392,0.0917577413479053,0.121357012750455,0.0280054644808743,0.0207194899817851,0.10063752276867,0.0710382513661202
"E02004323",355,520,192,102,418,253,3124,0.113636363636364,0.166453265044814,0.0614596670934699,0.0326504481434059,0.133802816901408,0.0809859154929577
"E02004324",315,466,561,105,361,210,2904,0.108471074380165,0.160468319559229,0.193181818181818,0.0361570247933884,0.12431129476584,0.0723140495867769
"E02004325",470,793,150,146,647,324,4744,0.0990725126475548,0.167158516020236,0.0316188870151771,0.0307757166947723,0.136382799325464,0.0682967959527825
"E02004326",312,391,197,77,314,235,3092,0.100905562742561,0.126455368693402,0.0637128072445019,0.0249029754204398,0.101552393272962,0.0760025873221216
"E02004327",437,727,199,167,560,270,3082,0.141791044776119,0.235885788449059,0.0645684620376379,0.054185593770279,0.18170019467878,0.0876054510058404
"E02004328",265,510,40,71,439,194,3163,0.0837812203604173,0.161239329750237,0.0126462219411951,0.0224470439456212,0.138792285804616,0.0613341764147961
"E02004329",257,446,45,53,393,204,2456,0.104641693811075,0.181596091205212,0.0183224755700326,0.0215798045602606,0.160016286644951,0.0830618892508143
"E02004330",413,655,141,144,511,269,2850,0.144912280701754,0.229824561403509,0.0494736842105263,0.0505263157894737,0.179298245614035,0.0943859649122807
"E02004331",333,482,328,106,376,227,3219,0.103448275862069,0.149735942839391,0.101894998446723,0.0329294812053433,0.116806461634048,0.0705187946567257
"E02004332",435,415,474,113,302,322,3194,0.136192861615529,0.129931120851597,0.148403256105197,0.0353788353162179,0.0945522855353788,0.100814026299311
"E02004333",324,385,422,99,286,225,2275,0.142417582417582,0.169230769230769,0.185494505494505,0.0435164835164835,0.125714285714286,0.0989010989010989
"E02004334",396,472,340,107,365,289,2911,0.136035726554449,0.162143593266919,0.116798351082102,0.0367571281346616,0.125386465132257,0.099278598419787
"E02004335",337,566,681,102,464,235,4515,0.074640088593577,0.125359911406423,0.150830564784053,0.0225913621262458,0.102768549280177,0.0520487264673311
"E02004336",379,622,370,123,499,256,3459,0.109569239664643,0.179820757444348,0.106967331598728,0.0355594102341717,0.144261347210176,0.0740098294304712
"E02004337",441,605,825,118,487,323,4978,0.0885897950984331,0.121534752912816,0.165729208517477,0.023704298915227,0.0978304539975894,0.0648854961832061
"E02004338",410,701,549,162,539,248,3619,0.113290964354794,0.193699917104172,0.151699364465322,0.0447637468914065,0.148936170212766,0.0685272174633877
"E02004339",315,502,317,104,398,211,2750,0.114545454545455,0.182545454545455,0.115272727272727,0.0378181818181818,0.144727272727273,0.0767272727272727
"E02004340",573,866,1450,168,698,405,5395,0.106209453197405,0.160518999073216,0.268767377201112,0.0311399443929564,0.12937905468026,0.0750695088044486
"E02004341",341,265,34,64,201,277,3328,0.102463942307692,0.0796274038461538,0.0102163461538462,0.0192307692307692,0.0603966346153846,0.0832331730769231
"E02004342",145,360,9,43,317,102,2716,0.0533873343151694,0.132547864506627,0.00331369661266568,0.0158321060382916,0.116715758468336,0.0375552282768778
"E02004343",238,282,85,76,206,162,2268,0.104938271604938,0.124338624338624,0.0374779541446208,0.0335097001763668,0.0908289241622575,0.0714285714285714
"E02004344",337,318,153,79,239,258,2946,0.11439239646979,0.107942973523422,0.0519348268839104,0.026816021724372,0.0811269517990496,0.0875763747454175
"E02004345",923,994,2148,244,750,679,4799,0.192331735778287,0.207126484684309,0.447593248593457,0.0508439258178787,0.15628255886643,0.141487809960408
"E02004348",598,368,1559,101,267,497,3299,0.1812670506214,0.111548954228554,0.472567444680206,0.0306153379812064,0.0809336162473477,0.150651712640194
"E02004349",585,529,962,115,414,470,4657,0.125617350225467,0.113592441485935,0.206570753704101,0.0246940090186816,0.0888984324672536,0.100923341206785
"E02004350",570,754,1243,166,588,404,3945,0.144486692015209,0.191128010139417,0.315082382762991,0.0420785804816223,0.149049429657795,0.102408111533587
"E02004351",387,322,515,74,248,313,3681,0.105134474327628,0.0874762292855202,0.139907633795164,0.0201032328171692,0.067372996468351,0.0850312415104591
"E02004352",557,614,1379,150,464,407,4542,0.122633201232937,0.13518273888155,0.303610744165566,0.0330250990752972,0.102157639806253,0.0896081021576398
"E02004353",389,727,746,144,583,245,2720,0.143014705882353,0.267279411764706,0.274264705882353,0.0529411764705882,0.214338235294118,0.0900735294117647
"E02004354",474,483,775,122,361,352,4136,0.114603481624758,0.116779497098646,0.187379110251451,0.0294970986460348,0.0872823984526112,0.0851063829787234
"E02004355",364,341,160,82,259,282,3804,0.0956887486855941,0.0896424815983176,0.0420609884332282,0.0215562565720294,0.0680862250262881,0.0741324921135647
"E02004356",544,500,36,175,325,369,2340,0.232478632478632,0.213675213675214,0.0153846153846154,0.0747863247863248,0.138888888888889,0.157692307692308
"E02004357",554,782,68,272,510,282,2438,0.227235438884331,0.320754716981132,0.0278917145200984,0.111566858080394,0.209187858900738,0.115668580803938
"E02004358",635,693,170,247,446,388,2910,0.218213058419244,0.238144329896907,0.0584192439862543,0.0848797250859107,0.153264604810997,0.133333333333333
"E02004359",562,859,142,229,630,333,2794,0.201145311381532,0.307444523979957,0.050823192555476,0.0819613457408733,0.225483178239084,0.119183965640659
"E02004361",554,806,178,274,532,280,2480,0.223387096774194,0.325,0.0717741935483871,0.110483870967742,0.214516129032258,0.112903225806452
"E02004362",816,1205,708,393,812,423,3232,0.252475247524752,0.372834158415842,0.219059405940594,0.121596534653465,0.251237623762376,0.130878712871287
"E02004363",474,1017,843,191,826,283,3252,0.145756457564576,0.312730627306273,0.259225092250922,0.0587330873308733,0.2539975399754,0.0870233702337023
"E02004364",659,1378,700,327,1051,332,3594,0.183361157484697,0.383416805787423,0.194769059543684,0.0909849749582638,0.29243183082916,0.0923761825264329
"E02004365",736,985,2247,218,767,518,4906,0.15002038320424,0.200774561761109,0.458010599266205,0.0444353852425601,0.156339176518549,0.10558499796168
"E02004366",403,1053,1884,91,962,312,5207,0.077395813328212,0.202227770309199,0.361820626080277,0.0174764739773382,0.184751296331861,0.0599193393508738
"E02004367",390,1047,796,159,888,231,3429,0.113735783027122,0.305336832895888,0.232137649460484,0.0463692038495188,0.258967629046369,0.0673665791776028
"E02004368",553,464,99,155,309,398,2921,0.18931872646354,0.158849709003766,0.0338925025676138,0.0530640191715166,0.105785689832249,0.136254707292023
"E02004369",848,807,291,280,527,568,3283,0.258300335059397,0.245811757538836,0.0886384404508072,0.0852878464818763,0.16052391105696,0.173012488577521
"E02004370",639,589,180,188,401,451,3299,0.193695059108821,0.178538951197333,0.054561988481358,0.0569869657471961,0.121551985450136,0.136708093361625
"E02004371",646,644,617,220,424,426,2705,0.238817005545287,0.238077634011091,0.228096118299445,0.0813308687615527,0.156746765249538,0.157486136783734
"E02004372",547,482,772,119,363,428,3214,0.170192906036092,0.149968886123211,0.24019912881145,0.037025513378967,0.112943372744244,0.133167392657125
"E02004373",613,767,688,204,563,409,3190,0.192163009404389,0.240438871473354,0.215673981191223,0.0639498432601881,0.176489028213166,0.128213166144201
"E02004374",706,577,1726,151,426,555,3200,0.220625,0.1803125,0.539375,0.0471875,0.133125,0.1734375
"E02004375",754,612,2269,155,457,599,4070,0.185257985257985,0.15036855036855,0.557493857493857,0.0380835380835381,0.112285012285012,0.147174447174447
"E02004376",634,254,2986,32,222,602,4442,0.142728500675371,0.0571814497973886,0.672219720846466,0.00720396217919856,0.04997748761819,0.135524538496173
"E02004377",876,1034,995,308,726,568,4417,0.198324654743038,0.234095539959248,0.225266017659045,0.0697305863708399,0.164364953588408,0.128594068372198
"E02004378",604,488,4196,24,464,580,6504,0.0928659286592866,0.0750307503075031,0.645141451414514,0.003690036900369,0.0713407134071341,0.0891758917589176
"E02004379",635,482,471,204,278,431,2571,0.246985608712563,0.187475690392843,0.183197199533256,0.0793465577596266,0.108129132633217,0.167639050952937
"E02004380",678,650,506,257,393,421,3281,0.206644315757391,0.198110332215788,0.154221274001829,0.0783297775068577,0.11978055470893,0.128314538250533
"E02004381",705,747,868,212,535,493,4012,0.175722831505484,0.186191425722832,0.216350947158524,0.0528414755732802,0.133349950149551,0.122881355932203
"E02004382",557,592,409,222,370,335,2410,0.231120331950207,0.245643153526971,0.169709543568465,0.0921161825726141,0.153526970954357,0.139004149377593
"E02004383",472,643,618,182,461,290,2408,0.196013289036545,0.26702657807309,0.256644518272425,0.0755813953488372,0.191445182724252,0.120431893687708
"E02004384",741,944,129,341,603,400,2651,0.279517163334591,0.356092040739344,0.048660882685779,0.128630705394191,0.227461335345153,0.1508864579404
"E02004385",817,857,114,304,553,513,3034,0.26928147659855,0.28246539222149,0.037574159525379,0.100197758734344,0.182267633487146,0.169083717864206
"E02004386",534,677,454,212,465,322,2734,0.195318215069495,0.247622531089978,0.166057059253841,0.077542062911485,0.170080468178493,0.11777615215801
"E02004387",486,474,376,168,306,318,2361,0.20584498094028,0.200762388818297,0.159254553155443,0.071156289707751,0.129606099110546,0.134688691232529
"E02004388",608,604,82,253,351,355,3318,0.183242917420133,0.18203737191079,0.024713682941531,0.0762507534659433,0.105786618444846,0.106992163954189
"E02004389",929,846,146,339,507,590,3180,0.292138364779874,0.266037735849057,0.0459119496855346,0.106603773584906,0.159433962264151,0.185534591194969
"E02004390",791,681,87,315,366,476,2986,0.264902880107167,0.228064300066979,0.0291359678499665,0.10549229738781,0.122572002679169,0.159410582719357
"E02004391",588,913,576,220,693,368,3242,0.181369524984577,0.28161628624306,0.177668106107341,0.067859346082665,0.213756940160395,0.113510178901912
"E02004392",727,500,585,190,310,537,2982,0.243796109993293,0.16767270288397,0.196177062374245,0.0637156270959088,0.103957075788062,0.180080482897384
"E02004393",606,518,352,202,316,404,2792,0.217048710601719,0.185530085959885,0.126074498567335,0.0723495702005731,0.113180515759312,0.144699140401146
"E02004394",603,466,579,192,274,411,2453,0.24582144313086,0.189971463514064,0.236037505095801,0.0782715042804729,0.111699959233592,0.167549938850387
"E02004395",853,773,757,272,501,581,3769,0.226319978774211,0.20509418944017,0.200849031573362,0.0721676837357389,0.132926505704431,0.154152295038472
"E02004396",772,680,392,283,397,489,3113,0.247992290395117,0.218438805011243,0.125923546418246,0.0909090909090909,0.127529714102152,0.157083199486026
"E02004397",726,610,509,239,371,487,3013,0.240955857948888,0.202456023896449,0.168934616661135,0.0793229339528709,0.123133089943578,0.161632923996017
"E02004398",681,943,490,253,690,428,4088,0.166585127201566,0.230675146771037,0.11986301369863,0.0618884540117417,0.168786692759296,0.104696673189824
"E02004399",683,806,187,267,539,416,3343,0.204307508226144,0.241100807657792,0.0559377804367335,0.07986838169309,0.161232425964702,0.124439126533054
"E02004400",1149,997,236,409,588,740,4249,0.270416568604378,0.234643445516592,0.0555424805836667,0.0962579430454225,0.13838550247117,0.174158625558955
"E02004401",736,1070,322,299,771,437,3345,0.220029895366218,0.319880418535127,0.0962630792227205,0.0893871449925262,0.230493273542601,0.130642750373692
"E02004402",891,1331,2280,264,1067,627,5681,0.156838584756205,0.234289737722232,0.40133779264214,0.0464706917796163,0.187819045942616,0.110367892976589
"E02004403",508,609,410,182,427,326,2055,0.247201946472019,0.296350364963504,0.199513381995134,0.0885644768856448,0.207785888077859,0.158637469586375
"E02004404",491,410,632,169,241,322,1942,0.252832131822863,0.211122554067971,0.325437693099897,0.0870236869207003,0.124098867147271,0.165808444902163
"E02004405",390,427,145,138,289,252,2194,0.177757520510483,0.194621695533273,0.0660893345487694,0.0628988149498633,0.131722880583409,0.11485870556062
"E02004406",566,549,303,208,341,358,2482,0.228041901692184,0.221192586623691,0.122078968573731,0.0838033843674456,0.137389202256245,0.144238517324738
"E02004407",628,607,643,216,391,412,2732,0.2298682284041,0.222181551976574,0.235358711566618,0.0790629575402635,0.14311859443631,0.150805270863836
"E02004408",589,664,191,218,446,371,2980,0.197651006711409,0.222818791946309,0.0640939597315436,0.0731543624161074,0.149664429530201,0.124496644295302
"E02004409",481,408,513,182,226,299,1627,0.295636140135218,0.250768285187462,0.315304240934235,0.111862323294407,0.138905961893055,0.183773816840811
"E02004410",621,510,534,226,284,395,2479,0.250504235578862,0.205728116175877,0.215409439290036,0.09116579265833,0.114562323517547,0.159338442920532
"E02004411",713,769,215,267,502,446,3066,0.232550554468363,0.250815394651011,0.0701239399869537,0.0870841487279843,0.163731245923027,0.145466405740378
"E02004412",676,639,126,234,405,442,3097,0.21827575072651,0.206328705198579,0.0406845334194382,0.0755569906360995,0.13077171456248,0.14271876009041
"E02004413",624,591,358,240,351,384,2601,0.239907727797001,0.22722029988466,0.13763936947328,0.0922722029988466,0.134948096885813,0.147635524798155
"E02004414",460,379,278,120,259,340,2743,0.16769959897922,0.138169886985053,0.101348888078746,0.04374772147284,0.0944221655122129,0.12395187750638
"E02004415",466,373,388,165,208,301,2271,0.20519594892118,0.164244826067812,0.170849845882871,0.0726552179656539,0.0915896081021576,0.132540730955526
"E02004416",567,474,445,209,265,358,2180,0.260091743119266,0.21743119266055,0.204128440366972,0.0958715596330275,0.121559633027523,0.164220183486239
"E02004417",489,563,205,199,364,290,2630,0.185931558935361,0.214068441064639,0.0779467680608365,0.0756653992395437,0.138403041825095,0.110266159695817
"E02004418",333,387,102,111,276,222,2210,0.150678733031674,0.175113122171946,0.0461538461538462,0.0502262443438914,0.124886877828054,0.100452488687783
"E02004419",367,572,123,165,407,202,2786,0.13173007896626,0.205312275664034,0.0441493180186648,0.0592246949030869,0.146087580760948,0.072505384063173
"E02004420",770,868,572,340,528,430,5297,0.145365301113838,0.163866339437417,0.107985652255994,0.0641872758164999,0.0996790636209175,0.0811780252973381
"E02004421",840,1004,241,387,617,453,3533,0.237758279082932,0.284177752618172,0.0682139824511746,0.109538635720351,0.174639116897821,0.128219643362581
"E02004422",643,775,322,248,527,395,4124,0.155916585838991,0.187924345295829,0.0780795344325897,0.0601357904946654,0.127788554801164,0.0957807953443259
"E02004423",730,879,214,329,550,401,2925,0.24957264957265,0.300512820512821,0.0731623931623932,0.112478632478632,0.188034188034188,0.137094017094017
"E02004424",534,563,184,225,338,309,1874,0.284951974386339,0.30042689434365,0.0981856990394877,0.120064034151547,0.180362860192102,0.164887940234792
"E02004425",630,527,235,183,344,447,2571,0.245040840140023,0.204978607545702,0.0914041229093738,0.0711785297549592,0.133800077790743,0.173862310385064
"E02004426",627,639,430,234,405,393,2845,0.220386643233743,0.224604569420035,0.151142355008787,0.0822495606326889,0.142355008787346,0.138137082601054
"E02004427",577,552,386,205,347,372,2644,0.218229954614221,0.208774583963691,0.145990922844176,0.0775340393343419,0.131240544629349,0.140695915279879
"E02004428",414,409,452,109,300,305,2456,0.1685667752443,0.166530944625407,0.184039087947883,0.0443811074918567,0.12214983713355,0.124185667752443
"E02004429",537,515,577,203,312,334,2144,0.250466417910448,0.240205223880597,0.269123134328358,0.0946828358208955,0.145522388059701,0.155783582089552
"E02004430",556,403,390,138,265,418,2305,0.241214750542299,0.174837310195228,0.169197396963124,0.0598698481561822,0.114967462039046,0.181344902386117
"E02004431",571,360,172,104,256,467,3409,0.167497799941332,0.105602816075095,0.0504546787914344,0.030507480199472,0.0750953358756234,0.13699031974186
"E02004432",464,310,509,134,176,330,1864,0.248927038626609,0.166309012875536,0.273068669527897,0.0718884120171674,0.0944206008583691,0.177038626609442
"E02004433",635,418,191,170,248,465,3210,0.197819314641745,0.130218068535826,0.0595015576323988,0.0529595015576324,0.0772585669781932,0.144859813084112
"E02004434",686,556,193,169,387,517,2874,0.238691718858733,0.193458594293667,0.0671537926235212,0.0588030619345859,0.134655532359081,0.179888656924148
"E02004435",442,709,248,207,502,235,3389,0.130421953378578,0.209206255532605,0.0731779285925052,0.0610799645913249,0.148126290941281,0.0693419887872529
"E02004436",492,691,55,240,451,252,2743,0.179365658038644,0.251913962814437,0.020051039008385,0.0874954429456799,0.164418519868757,0.0918702150929639
"E02004437",524,549,180,181,368,343,3480,0.150574712643678,0.157758620689655,0.0517241379310345,0.0520114942528736,0.105747126436782,0.0985632183908046
"E02004438",413,901,114,238,663,175,3370,0.122551928783383,0.267359050445104,0.0338278931750742,0.0706231454005935,0.19673590504451,0.0519287833827893
"E02004439",500,1078,92,368,710,132,2809,0.177999288002848,0.38376646493414,0.032751868992524,0.131007475970096,0.252758988964044,0.0469918120327519
"E02004440",421,1090,154,265,825,156,3024,0.139219576719577,0.360449735449735,0.0509259259259259,0.0876322751322751,0.27281746031746,0.0515873015873016
"E02004441",480,702,261,194,508,286,2774,0.173035328046143,0.253064167267484,0.0940879596250901,0.0699351117519827,0.183129055515501,0.10310021629416
"E02004442",292,584,144,107,477,185,2753,0.106066109698511,0.212132219397021,0.0523065746458409,0.0388666908826735,0.173265528514348,0.0671994188158373
"E02004443",431,912,184,238,674,193,4003,0.107669248063952,0.227829128153885,0.0459655258556083,0.0594554084436673,0.168373719710217,0.0482138396202848
"E02004444",500,360,151,94,266,406,2627,0.190331176246669,0.137038446897602,0.0574800152264941,0.0357822611343738,0.101256185763228,0.154548915112295
"E02004445",499,833,216,175,658,324,2870,0.173867595818815,0.290243902439024,0.0752613240418119,0.0609756097560976,0.229268292682927,0.112891986062718
"E02004446",566,345,342,161,184,405,2143,0.264115725618292,0.160989267382175,0.159589360709286,0.0751283247783481,0.0858609426038264,0.188987400839944
"E02004447",458,274,485,114,160,344,1766,0.259343148357871,0.15515288788222,0.274631936579841,0.0645526613816535,0.0906002265005662,0.194790486976217
"E02004448",452,367,364,122,245,330,2645,0.170888468809074,0.13875236294896,0.137618147448015,0.046124763705104,0.0926275992438563,0.12476370510397
"E02004449",530,551,762,144,407,386,3508,0.151083238312429,0.157069555302166,0.217217787913341,0.0410490307867731,0.116020524515393,0.110034207525656
"E02004450",445,334,288,141,193,304,1881,0.236576289207868,0.177565124933546,0.15311004784689,0.0749601275917065,0.102604997341839,0.161616161616162
"E02004451",607,475,401,164,311,443,3451,0.175891046073602,0.137641263401912,0.116198203419299,0.0475224572587656,0.0901188061431469,0.128368588814836
"E02004452",487,512,279,174,338,313,3205,0.15195007800312,0.159750390015601,0.0870514820592824,0.0542901716068643,0.105460218408736,0.0976599063962559
"E02004453",339,399,130,97,302,242,2792,0.121418338108883,0.142908309455587,0.0465616045845272,0.0347421203438395,0.108166189111748,0.086676217765043
"E02004454",574,578,946,159,419,415,4582,0.125272806634657,0.126145787865561,0.206460061108686,0.0347010039284155,0.0914447839371453,0.0905718027062418
"E02004455",338,408,241,126,282,212,2375,0.142315789473684,0.171789473684211,0.101473684210526,0.0530526315789474,0.118736842105263,0.0892631578947368
"E02004456",523,670,505,153,517,370,3810,0.137270341207349,0.175853018372703,0.13254593175853,0.0401574803149606,0.135695538057743,0.0971128608923885
"E02004457",461,546,290,152,394,309,3649,0.126335982460948,0.149630035626199,0.0794738284461496,0.0416552480131543,0.107974787613045,0.0846807344477939
"E02004458",355,223,84,54,169,301,2803,0.126650017838031,0.079557616839101,0.0299678915447735,0.0192650731359258,0.0602925437031752,0.107384944702105
"E02004459",658,513,543,173,340,485,3902,0.168631471040492,0.131471040492055,0.139159405433111,0.0443362378267555,0.0871348026652998,0.124295233213737
"E02004460",482,607,288,202,405,280,3428,0.140606767794632,0.177071178529755,0.0840140023337223,0.058926487747958,0.118144690781797,0.0816802800466744
"E02004461",358,417,61,131,286,227,1687,0.212211025489034,0.247184350918791,0.036158861885003,0.0776526378186129,0.169531713100178,0.134558387670421
"E02004462",592,573,356,182,391,410,5244,0.112890922959573,0.109267734553776,0.0678871090770404,0.0347063310450038,0.0745614035087719,0.078184591914569
"E02004463",528,472,299,158,314,370,2974,0.177538668459987,0.158708809683927,0.10053799596503,0.0531271015467384,0.105581708137189,0.124411566913248
"E02004464",759,650,409,288,362,471,2546,0.298114689709348,0.255302435192459,0.160644147682639,0.11311861743912,0.142183817753339,0.184996072270228
"E02004465",442,515,602,163,352,279,2251,0.196357174589072,0.228787205686362,0.26743669480231,0.0724122612172368,0.156374944469125,0.123944913371835
"E02004466",632,785,569,336,449,296,2774,0.227829848594088,0.282984859408796,0.205118961788032,0.1211247296323,0.161860129776496,0.106705118961788
"E02004467",507,672,715,193,479,314,2777,0.182571119913576,0.24198775657184,0.257472092185812,0.0694994598487576,0.172488296723082,0.113071660064818
"E02004468",768,1001,867,294,707,474,3411,0.225153913808267,0.293462327763119,0.254177660510114,0.0861917326297273,0.207270595133392,0.13896218117854
"E02004469",512,578,781,179,399,333,2307,0.221933246640659,0.250541829215431,0.338534893801474,0.0775899436497616,0.17295188556567,0.144343302990897
"E02004470",656,700,1870,157,543,499,6509,0.100783530496236,0.107543401444154,0.287294515286526,0.0241204486096175,0.0834229528345368,0.0766630818866185
"E02004471",625,827,766,224,603,401,3903,0.160133230848066,0.21188829105816,0.196259287727389,0.0573917499359467,0.154496541122214,0.102741480912119
"E02004472",564,475,443,165,310,399,1995,0.282706766917293,0.238095238095238,0.222055137844612,0.0827067669172932,0.155388471177945,0.2
"E02004473",663,739,382,325,414,338,2162,0.306660499537465,0.341813135985199,0.176688251618871,0.150323774283071,0.191489361702128,0.156336725254394
"E02004474",590,391,886,146,245,444,2339,0.252244548952544,0.167165455322788,0.378794356562634,0.0624198375374092,0.104745617785378,0.189824711415135
"E02004475",597,413,564,164,249,433,1856,0.321659482758621,0.222521551724138,0.303879310344828,0.0883620689655172,0.134159482758621,0.233297413793103
"E02004476",622,536,661,210,326,412,2245,0.27706013363029,0.238752783964365,0.294432071269488,0.0935412026726058,0.145211581291759,0.183518930957684
"E02004477",513,389,928,140,249,373,1811,0.283268912203203,0.214798453892877,0.512424075096632,0.0773053561568194,0.137493097736057,0.205963556046383
"E02004478",480,433,970,98,335,382,2594,0.185042405551272,0.16692367000771,0.373939861218196,0.0377794911333847,0.129144178874325,0.147262914417887
"E02004479",659,564,897,199,365,460,2447,0.269309358398038,0.230486309767062,0.36657131181038,0.0813240702901512,0.149162239476911,0.187985288107887
"E02004480",607,624,101,260,364,347,2020,0.30049504950495,0.308910891089109,0.05,0.128712871287129,0.18019801980198,0.171782178217822
"E02004481",692,616,252,273,343,419,2322,0.29801894918174,0.265288544358312,0.108527131782946,0.117571059431525,0.147717484926787,0.180447889750215
"E02004482",711,955,260,329,626,382,2613,0.272101033295063,0.365480290853425,0.0995024875621891,0.125908916953693,0.239571373899732,0.14619211634137
"E02004483",646,574,369,235,339,411,2416,0.267384105960265,0.237582781456954,0.15273178807947,0.0972682119205298,0.140314569536424,0.170115894039735
"E02004484",748,734,204,294,440,454,2641,0.283226050738357,0.277925028398334,0.0772434683831882,0.111321469140477,0.166603559257857,0.17190458159788
"E02004485",422,302,334,118,184,304,4139,0.101956994443102,0.0729644841749215,0.0806958202464363,0.028509301763711,0.0444551824112104,0.0734476926793912
"E02004486",539,433,664,135,298,404,2721,0.198088937890481,0.159132671811834,0.244027930907755,0.0496141124586549,0.109518559353179,0.148474825431827
"E02004487",429,437,317,143,294,286,2615,0.164053537284895,0.167112810707457,0.121223709369025,0.0546845124282983,0.112428298279159,0.109369024856597
"E02004488",556,929,118,276,653,280,3682,0.151004888647474,0.252308527973927,0.0320478001086366,0.0749592612710483,0.177349266702879,0.0760456273764259
"E02004489",424,324,197,106,218,318,3061,0.138516824567135,0.105847762169226,0.0643580529238811,0.0346292061417837,0.071218556027442,0.103887618425351
"E02004490",376,431,550,87,344,289,3206,0.117280099812851,0.134435433562071,0.171553337492202,0.0271366188396756,0.107298814722396,0.0901434809731753
"E02004491",489,728,236,238,490,251,2215,0.220767494356659,0.328668171557562,0.106546275395034,0.10744920993228,0.221218961625282,0.113318284424379
"E02004492",710,351,410,100,251,610,3509,0.202336848104873,0.10002849814762,0.116842405243659,0.0284981476204047,0.0715303505272157,0.173838700484469
"E02004493",665,514,865,142,372,523,4160,0.159855769230769,0.123557692307692,0.207932692307692,0.0341346153846154,0.0894230769230769,0.125721153846154
"E02004495",556,589,552,212,377,344,2613,0.212782242632989,0.225411404515882,0.211251435132032,0.081132797550708,0.144278606965174,0.131649445082281
"E02004496",427,303,1113,106,197,321,2577,0.16569654637175,0.117578579743888,0.431897555296857,0.0411331005044626,0.0764454792394257,0.124563445867288
"E02004497",518,484,412,148,336,370,2490,0.208032128514056,0.194377510040161,0.165461847389558,0.0594377510040161,0.134939759036145,0.14859437751004
"E02004498",527,620,659,191,429,336,3900,0.135128205128205,0.158974358974359,0.168974358974359,0.048974358974359,0.11,0.0861538461538462
"E02004499",412,682,189,270,412,142,1695,0.24306784660767,0.4023598820059,0.111504424778761,0.15929203539823,0.24306784660767,0.0837758112094395
"E02004500",541,639,415,205,434,336,2886,0.187456687456687,0.221413721413721,0.143797643797644,0.071032571032571,0.15038115038115,0.116424116424116
"E02004501",421,546,411,188,358,233,2109,0.199620673304884,0.258890469416785,0.194879089615932,0.0891417733522997,0.169748696064486,0.110478899952584
"E02004502",409,360,501,147,213,262,2124,0.19256120527307,0.169491525423729,0.235875706214689,0.0692090395480226,0.100282485875706,0.123352165725047
"E02004503",527,651,141,202,449,325,2461,0.214140593254774,0.264526615197074,0.0572937830150345,0.082080455099553,0.182446160097521,0.132060138155221
"E02004504",595,215,4,82,133,513,2500,0.238,0.086,0.0016,0.0328,0.0532,0.2052
"E02004505",394,289,416,125,164,269,2081,0.189332051898126,0.138875540605478,0.199903892359443,0.0600672753483902,0.0788082652570879,0.129264776549736
"E02004506",515,382,359,161,221,354,2153,0.239201114723641,0.177426846261031,0.166744078030655,0.0747793776126335,0.102647468648398,0.164421737111008
"E02004507",684,208,29,72,136,612,3764,0.181721572794899,0.0552603613177471,0.00770456960680128,0.0191285866099894,0.0361317747077577,0.16259298618491
"E02004508",379,387,235,116,271,263,2068,0.183268858800774,0.187137330754352,0.113636363636364,0.0560928433268859,0.131044487427466,0.127176015473888
"E02004512",654,783,1067,169,614,485,6293,0.103924996027332,0.124423963133641,0.16955347211187,0.0268552359764818,0.0975687271571588,0.0770697600508501
"E02004513",516,931,118,233,698,283,4980,0.103614457831325,0.186947791164659,0.0236947791164659,0.0467871485943775,0.140160642570281,0.0568273092369478
"E02004514",403,500,272,149,351,254,1971,0.204464738711314,0.253678335870117,0.138001014713343,0.0755961440892948,0.178082191780822,0.128868594622019
"E02004515",513,499,301,179,320,334,3252,0.157749077490775,0.153444034440344,0.0925584255842558,0.0550430504305043,0.0984009840098401,0.102706027060271
"E02004516",642,1331,1598,272,1059,370,5875,0.109276595744681,0.226553191489362,0.272,0.0462978723404255,0.180255319148936,0.0629787234042553
"E02004517",553,404,113,136,268,417,3391,0.163078737835447,0.119138897080507,0.03332350339133,0.0401061633736361,0.0790327337068711,0.122972574461811
"E02004518",381,651,677,175,476,206,3358,0.113460393091126,0.193865396069089,0.201608100059559,0.0521143537820131,0.141751042287076,0.0613460393091126
"E02004519",533,568,85,221,347,312,2133,0.249882794186592,0.26629160806376,0.0398499765588373,0.103609939052977,0.162681669010783,0.146272855133615
"E02004520",313,377,135,97,280,216,3926,0.0797249108507387,0.0960264900662252,0.0343861436576668,0.0247070809984717,0.0713194090677534,0.0550178298522669
"E02004521",566,660,412,158,502,408,3834,0.147626499739176,0.172143974960876,0.107459572248305,0.0412102243088159,0.130933750652061,0.10641627543036
"E02004522",569,644,373,231,413,338,2761,0.206084751901485,0.233248822890257,0.135095979717494,0.0836653386454183,0.149583484244839,0.122419413256067
"E02004523",449,617,207,177,440,272,3742,0.119989310529129,0.164885088188135,0.055318011758418,0.0473009086050241,0.117584179583111,0.0726884019241048
"E02004524",509,356,310,127,229,382,2306,0.220728534258456,0.154379878577624,0.134431916738942,0.0550737207285343,0.0993061578490893,0.165654813529922
"E02004525",583,607,271,233,374,350,2973,0.196098217288934,0.204170871173898,0.0911537167843929,0.0783720147998655,0.125798856374033,0.117726202489068
"E02004526",626,575,203,208,367,418,2710,0.2309963099631,0.212177121771218,0.0749077490774908,0.0767527675276753,0.135424354243542,0.154243542435424
"E02004527",573,513,477,148,365,425,3412,0.167936694021102,0.150351699882767,0.139800703399766,0.0433763188745604,0.106975381008206,0.124560375146542
"E02004528",551,610,528,231,379,320,2440,0.225819672131148,0.25,0.216393442622951,0.094672131147541,0.155327868852459,0.131147540983607
"E02004529",447,331,507,127,204,320,2214,0.20189701897019,0.149503161698284,0.2289972899729,0.0573622402890696,0.0921409214092141,0.14453477868112
"E02004530",440,440,439,160,280,280,2377,0.185107278081615,0.185107278081615,0.184686579722339,0.0673117374842238,0.117795540597392,0.117795540597392
"E02004531",320,516,622,114,402,206,2495,0.128256513026052,0.206813627254509,0.249298597194389,0.0456913827655311,0.161122244488978,0.082565130260521
"E02004532",402,571,505,144,427,258,2476,0.162358642972536,0.230613893376414,0.203957996768982,0.0581583198707593,0.172455573505654,0.104200323101777
"E02004533",498,635,352,188,447,310,2373,0.209860935524652,0.267593763168984,0.148335440370839,0.0792246101980615,0.188369152970923,0.130636325326591
"E02004534",506,588,502,167,421,339,3052,0.165792922673657,0.192660550458716,0.164482306684142,0.0547182175622543,0.137942332896461,0.111074705111402
"E02004535",305,302,468,68,234,237,2230,0.13677130044843,0.13542600896861,0.209865470852018,0.0304932735426009,0.104932735426009,0.10627802690583
"E02004536",368,417,582,122,295,246,1933,0.190377651319193,0.215726849456803,0.301086394205898,0.0631143300569064,0.152612519399897,0.127263321262287
"E02004537",563,770,620,198,572,365,3379,0.166617342408997,0.22787807043504,0.18348623853211,0.0585972181118674,0.169280852323173,0.108020124297129
"E02004538",471,588,1076,143,445,328,3257,0.144611605772183,0.18053423395763,0.330365366902057,0.0439054344488793,0.13662879950875,0.100706171323304
"E02004539",451,580,759,156,424,295,2715,0.166114180478821,0.213627992633518,0.279558011049724,0.0574585635359116,0.156169429097606,0.10865561694291
"E02004540",355,427,716,115,312,240,1986,0.178751258811682,0.215005035246727,0.360523665659617,0.0579053373615307,0.157099697885196,0.120845921450151
"E02004541",597,820,1556,154,666,443,4141,0.14416807534412,0.198019801980198,0.375754648635595,0.0371890847621347,0.160830717218063,0.106978990581985
"E02004542",397,569,581,182,387,215,2031,0.195470211718365,0.280157557853274,0.286065977351059,0.0896110290497292,0.190546528803545,0.105859182668636
"E02004543",426,680,484,220,460,206,2424,0.175742574257426,0.280528052805281,0.1996699669967,0.0907590759075908,0.18976897689769,0.084983498349835
"E02004544",505,482,563,116,366,389,5692,0.0887210119465917,0.0846802529866479,0.0989107519325369,0.0203794799718904,0.0643007730147575,0.0683415319747013
"E02004545",449,924,667,136,788,313,3933,0.114162217137046,0.234935163996949,0.169590643274854,0.0345792016272565,0.200355962369692,0.079583015509789
"E02004546",488,1004,184,192,812,296,4647,0.105013987518829,0.216053367764149,0.0395954379169357,0.0413169786959329,0.174736389068216,0.0636970088228965
"E02004547",412,958,292,173,785,239,4126,0.0998545807077072,0.232186136694135,0.0707707222491517,0.0419292292777508,0.190256907416384,0.0579253514299564
"E02004548",373,168,0,56,112,317,2962,0.12592842673869,0.0567184334908845,0,0.0189061444969615,0.037812288993923,0.107022282241729
"E02004549",626,917,401,209,708,417,3808,0.164390756302521,0.240808823529412,0.105304621848739,0.0548844537815126,0.185924369747899,0.109506302521008
"E02004550",360,1062,69,150,912,210,3807,0.0945626477541371,0.278959810874705,0.0181245074862096,0.0394011032308905,0.239558707643814,0.0551615445232467
"E02004551",450,864,437,158,706,292,3805,0.11826544021025,0.227069645203679,0.11484888304862,0.0415243101182654,0.185545335085414,0.0767411300919842
"E02004552",402,824,99,161,663,241,2510,0.160159362549801,0.328286852589641,0.0394422310756972,0.0641434262948207,0.264143426294821,0.0960159362549801
"E02004553",375,710,98,164,546,211,3229,0.116135026323939,0.219882316506658,0.0303499535459895,0.0507897181790028,0.169092598327656,0.0653453081449365
"E02004554",495,891,218,205,686,290,2918,0.169636737491432,0.305346127484578,0.0747087045921864,0.0702535983550377,0.235092529129541,0.0993831391363948
"E02004555",488,377,382,154,223,334,1909,0.255631220534311,0.197485594552122,0.200104766893662,0.0806705081194343,0.116815086432687,0.174960712414877
"E02004556",522,422,321,166,256,356,2384,0.218959731543624,0.177013422818792,0.134647651006711,0.0696308724832215,0.10738255033557,0.149328859060403
"E02004557",464,410,280,124,286,340,2926,0.158578263841422,0.140123034859877,0.0956937799043062,0.0423786739576213,0.0977443609022556,0.1161995898838
"E02004558",468,430,756,100,330,368,3086,0.151652624756967,0.139338950097213,0.2449773169151,0.0324044069993519,0.106934543097861,0.119248217757615
"E02004559",443,461,220,121,340,322,2910,0.152233676975945,0.158419243986254,0.0756013745704467,0.0415807560137457,0.116838487972509,0.110652920962199
"E02004560",542,458,367,156,302,386,2922,0.1854893908282,0.156741957563313,0.125598904859685,0.053388090349076,0.103353867214237,0.132101300479124
"E02004561",652,490,267,191,299,461,3048,0.213910761154856,0.160761154855643,0.0875984251968504,0.0626640419947507,0.0980971128608924,0.151246719160105
"E02004562",541,619,617,160,459,381,3712,0.145743534482759,0.166756465517241,0.166217672413793,0.0431034482758621,0.123653017241379,0.102640086206897
"E02004563",419,434,254,168,266,251,1946,0.215313463514902,0.223021582733813,0.130524152106886,0.0863309352517986,0.136690647482014,0.128982528263104
"E02004564",524,356,531,132,224,392,2284,0.229422066549912,0.155866900175131,0.232486865148862,0.0577933450087566,0.0980735551663748,0.171628721541156
"E02004566",303,258,455,81,177,222,2117,0.143127066603684,0.121870571563533,0.214926783183751,0.0382616910722721,0.0836088804912612,0.104865375531412
"E02004567",574,492,632,183,309,391,2278,0.251975417032485,0.215978928884987,0.277436347673398,0.0803336259877085,0.135645302897278,0.171641791044776
"E02004568",497,315,501,103,212,394,3336,0.148980815347722,0.0944244604316547,0.150179856115108,0.0308752997601918,0.0635491606714628,0.11810551558753
"E02004569",623,433,709,156,277,467,3275,0.190229007633588,0.132213740458015,0.216488549618321,0.0476335877862595,0.0845801526717557,0.142595419847328
"E02004570",533,456,998,124,332,409,2983,0.178679182031512,0.152866242038217,0.334562520952062,0.0415688903788133,0.111297351659403,0.137110291652699
"E02004571",595,521,735,192,329,403,2114,0.281456953642384,0.246452223273415,0.347682119205298,0.0908230842005676,0.155629139072848,0.190633869441816
"E02004572",481,481,673,169,312,312,2756,0.174528301886792,0.174528301886792,0.244194484760522,0.0613207547169811,0.113207547169811,0.113207547169811
"E02004573",518,459,1282,117,342,401,3071,0.168674698795181,0.149462715727776,0.41745359817649,0.0380983393031586,0.111364376424617,0.130576359492022
"E02004574",485,505,468,167,338,318,2807,0.172782329889562,0.17990737442109,0.166726042037763,0.0594941218382615,0.120413252582829,0.1132882080513
"E02004575",769,551,686,193,358,576,4704,0.163477891156463,0.117134353741497,0.145833333333333,0.0410289115646258,0.0761054421768707,0.122448979591837
"E02004576",606,481,258,182,299,424,2973,0.203834510595358,0.161789438277834,0.0867810292633703,0.0612176252943155,0.100571812983518,0.142616885301043
"E02004577",351,323,235,121,202,230,2272,0.154489436619718,0.142165492957746,0.103433098591549,0.0532570422535211,0.0889084507042254,0.101232394366197
"E02004578",725,1111,824,268,843,457,4130,0.175544794188862,0.269007263922518,0.199515738498789,0.0648910411622276,0.204116222760291,0.110653753026634
"E02004579",587,446,366,199,247,388,2672,0.219685628742515,0.166916167664671,0.136976047904192,0.0744760479041916,0.092440119760479,0.145209580838323
"E02004580",1409,1053,359,466,587,943,5317,0.264999059620087,0.198044009779951,0.0675192777882264,0.0876434079368065,0.110400601843145,0.17735565168328
"E02004581",624,527,254,222,305,402,3077,0.202794930126747,0.171270718232044,0.0825479363015925,0.0721481962950926,0.0991225219369516,0.130646733831654
"E02004582",679,548,178,242,306,437,2857,0.237661883094155,0.191809590479524,0.0623031151557578,0.0847042352117606,0.107105355267763,0.152957647882394
"E02004583",740,648,891,211,437,529,3500,0.211428571428571,0.185142857142857,0.254571428571429,0.0602857142857143,0.124857142857143,0.151142857142857
"E02004584",855,865,274,351,514,504,2640,0.323863636363636,0.327651515151515,0.103787878787879,0.132954545454545,0.19469696969697,0.190909090909091
"E02004585",659,545,152,201,344,458,3399,0.193880553103854,0.160341276846131,0.0447190350102971,0.059135039717564,0.101206237128567,0.13474551338629
"E02004586",750,902,848,239,663,511,3793,0.19773266543633,0.237806485631426,0.223569733720011,0.0630108093857105,0.174795676245716,0.13472185605062
"E02004587",603,597,159,233,364,370,2915,0.206861063464837,0.204802744425386,0.0545454545454545,0.0799313893653516,0.124871355060034,0.126929674099485
"E02004588",619,481,1803,91,390,528,3976,0.155684104627767,0.120975855130785,0.453470824949698,0.022887323943662,0.0980885311871227,0.132796780684105
"E02004589",563,520,705,156,364,407,2829,0.199010250972075,0.183810533757511,0.249204665959703,0.0551431601272534,0.128667373630258,0.143867090844821
"E02004590",1131,574,607,210,364,921,4200,0.269285714285714,0.136666666666667,0.14452380952381,0.05,0.0866666666666667,0.219285714285714
"E02004591",438,319,415,91,228,347,2525,0.173465346534653,0.126336633663366,0.164356435643564,0.036039603960396,0.0902970297029703,0.137425742574257
"E02004592",725,855,654,222,633,503,5608,0.129279600570613,0.152460770328103,0.116619115549215,0.039586305278174,0.112874465049929,0.0896932952924394
"E02004593",468,418,428,140,278,328,2939,0.159237835998639,0.142225246682545,0.145627764545764,0.0476352500850629,0.0945899965974821,0.111602585913576
"E02004594",385,402,298,107,295,278,2501,0.153938424630148,0.160735705717713,0.119152339064374,0.0427828868452619,0.117952818872451,0.111155537784886
"E02004595",731,673,707,233,440,498,5246,0.139344262295082,0.128288219595883,0.134769348074724,0.0444147922226458,0.0838734273732367,0.0949294700724361
"E02004596",436,427,303,171,256,265,3623,0.120342257797405,0.117858128622688,0.0836323488821419,0.0471984543196246,0.0706596743030638,0.0731438034777808
"E02004597",343,262,297,60,202,283,4087,0.083924639099584,0.0641057010031808,0.0726694396868118,0.0146806948862246,0.0494250061169562,0.0692439442133594
"E02004598",490,458,374,153,305,337,3503,0.139880102769055,0.130745075649443,0.106765629460462,0.0436768484156437,0.0870682272337996,0.0962032543534114
"E02004599",406,346,357,121,225,285,2241,0.181169120928157,0.154395359214636,0.159303882195448,0.0539937527889335,0.100401606425703,0.127175368139224
"E02004600",415,435,163,155,280,260,1922,0.215920915712799,0.226326742976067,0.0848074921956296,0.0806451612903226,0.145681581685744,0.135275754422477
"E02004601",312,388,215,111,277,201,1996,0.156312625250501,0.19438877755511,0.107715430861723,0.0556112224448898,0.13877755511022,0.100701402805611
"E02004602",452,355,38,96,259,356,2831,0.159660897209467,0.125397386082656,0.0134228187919463,0.033910279053338,0.0914871070293183,0.125750618156129
"E02004603",402,448,1500,82,366,320,3834,0.104851330203443,0.116849243609807,0.391236306729264,0.0213875847678665,0.0954616588419405,0.0834637454355764
"E02004604",438,517,285,148,369,290,3210,0.136448598130841,0.161059190031153,0.088785046728972,0.0461059190031153,0.114953271028037,0.0903426791277259
"E02004605",292,378,410,94,284,198,2164,0.134935304990758,0.174676524953789,0.189463955637708,0.0434380776340111,0.131238447319778,0.0914972273567468
"E02004606",610,680,1130,199,481,411,4608,0.132378472222222,0.147569444444444,0.245225694444444,0.0431857638888889,0.104383680555556,0.0891927083333333
"E02004607",591,638,2706,111,527,480,5573,0.106047012381123,0.114480531132245,0.48555535618159,0.0199174591781805,0.0945630719540642,0.0861295532029428
"E02004608",524,626,3138,80,546,444,6455,0.0811773818745159,0.0969790859798606,0.486134779240899,0.0123934934159566,0.084585592563904,0.0687838884585593
"E02004609",461,386,164,143,243,318,2419,0.190574617610583,0.159570070276974,0.0677966101694915,0.059115336916081,0.100454733360893,0.131459280694502
"E02004610",363,615,1131,103,512,260,3484,0.104190585533869,0.176521239954076,0.324626865671642,0.0295637198622273,0.146957520091848,0.0746268656716418
"E02004611",559,902,980,234,668,325,4146,0.134828750602991,0.217559093101785,0.236372407139411,0.0564399421128799,0.161119150988905,0.078388808490111
"E02004612",652,568,95,204,364,448,3048,0.213910761154856,0.186351706036745,0.0311679790026247,0.0669291338582677,0.119422572178478,0.146981627296588
"E02004613",366,608,460,133,475,233,2152,0.170074349442379,0.282527881040892,0.213754646840149,0.0618029739776952,0.220724907063197,0.108271375464684
"E02004614",314,406,458,119,287,195,1993,0.157551430005018,0.203712995484195,0.22980431510286,0.0597089814350226,0.144004014049172,0.097842448569995
"E02004615",697,510,1026,162,348,535,3612,0.19296788482835,0.141196013289037,0.284053156146179,0.0448504983388704,0.0963455149501661,0.14811738648948
"E02004616",808,554,1027,200,354,608,5084,0.158929976396538,0.108969315499607,0.202006294256491,0.03933910306845,0.0696302124311566,0.119590873328088
"E02004617",699,469,830,153,316,546,3825,0.182745098039216,0.122614379084967,0.216993464052288,0.04,0.0826143790849673,0.142745098039216
"E02004618",707,382,1119,135,247,572,2637,0.268107698141828,0.144861585134623,0.424345847554039,0.0511945392491468,0.0936670458854759,0.216913158892681
"E02004619",654,403,1127,133,270,521,2868,0.228033472803347,0.140516039051604,0.392956764295676,0.046373779637378,0.0941422594142259,0.181659693165969
"E02004620",395,486,212,145,341,250,2775,0.142342342342342,0.175135135135135,0.0763963963963964,0.0522522522522523,0.122882882882883,0.0900900900900901
"E02004621",508,517,990,107,410,401,3212,0.158156911581569,0.160958904109589,0.308219178082192,0.0333125778331258,0.127646326276463,0.124844333748443
"E02004622",401,409,179,119,290,282,3191,0.125665935443435,0.1281729865246,0.0560952679410843,0.037292384832341,0.0908806016922595,0.0883735506110937
"E02004623",521,440,585,116,324,405,3373,0.154461903350133,0.13044767269493,0.173436110287578,0.034390750074118,0.0960569226208123,0.120071153276015
"E02004624",460,337,437,123,214,337,3134,0.146777281429483,0.107530312699426,0.139438417358009,0.0392469687300574,0.0682833439693682,0.107530312699426
"E02004625",738,492,1094,153,339,585,4122,0.179039301310044,0.119359534206696,0.265405143134401,0.037117903930131,0.0822416302765648,0.141921397379913
"E02004626",719,508,730,187,321,532,2845,0.252724077328647,0.178558875219684,0.256590509666081,0.0657293497363796,0.112829525483304,0.186994727592267
"E02004627",367,305,337,100,205,267,2761,0.132922854038392,0.110467222021007,0.122057225642883,0.0362187613183629,0.074248460702644,0.096704092720029
"E02004628",533,461,646,161,300,372,2433,0.219071105630908,0.189478010686395,0.265515824085491,0.0661734484175915,0.123304562268804,0.152897657213317
"E02004629",762,837,1281,245,592,517,4560,0.167105263157895,0.183552631578947,0.280921052631579,0.0537280701754386,0.129824561403509,0.113377192982456
"E02004630",518,347,818,142,205,376,2192,0.236313868613139,0.158302919708029,0.373175182481752,0.0647810218978102,0.093521897810219,0.171532846715328
"E02004631",418,316,641,130,186,288,1787,0.233911583659765,0.176832680470062,0.358701734750979,0.0727476217123671,0.104085058757694,0.161163961947398
"E02004632",615,555,617,171,384,444,4114,0.14948954788527,0.134905201750122,0.149975692756441,0.0415653864851726,0.093339815264949,0.107924161400097
"E02004633",606,603,759,226,377,380,2646,0.229024943310658,0.227891156462585,0.286848072562358,0.0854119425547997,0.142479213907785,0.143613000755858
"E02004634",695,631,609,234,397,461,4706,0.147683807904802,0.134084147896303,0.129409264768381,0.0497237569060773,0.0843603909902252,0.097960050998725
"E02004635",453,529,435,167,362,286,2528,0.179193037974684,0.209256329113924,0.172072784810127,0.0660601265822785,0.143196202531646,0.113132911392405
"E02004636",506,551,82,183,368,323,2172,0.232965009208103,0.253683241252302,0.0377532228360958,0.0842541436464088,0.169429097605893,0.148710865561694
"E02004637",670,655,1182,168,487,502,4394,0.152480655439235,0.149066909421939,0.269003186162949,0.0382339553937187,0.11083295402822,0.114246700045517
"E02004638",363,413,240,128,285,235,1743,0.208261617900172,0.236947791164659,0.137693631669535,0.0734366035570855,0.163511187607573,0.134825014343087
"E02004639",638,487,1936,101,386,537,7453,0.0856031128404669,0.065342814973836,0.259761169998658,0.013551589963773,0.0517912250100631,0.0720515228766939
"E02004640",735,521,1990,148,373,587,3246,0.226432532347505,0.160505237215034,0.613062230437461,0.0455945779420826,0.114910659272951,0.180837954405422
"E02004641",613,534,128,177,357,436,2464,0.248782467532468,0.216720779220779,0.051948051948052,0.0718344155844156,0.144886363636364,0.176948051948052
"E02004642",654,660,198,187,473,467,3830,0.170757180156658,0.172323759791123,0.0516971279373368,0.0488250652741514,0.123498694516971,0.121932114882507
"E02004643",586,662,1025,162,500,424,3026,0.193654990085922,0.218770654329147,0.338730998017184,0.053536021150033,0.165234633179114,0.140118968935889
"E02004644",685,677,1229,182,495,503,3562,0.192307692307692,0.190061763054464,0.345030881527232,0.0510948905109489,0.138966872543515,0.141212801796743
"E02004645",759,255,17,94,161,665,2760,0.275,0.0923913043478261,0.00615942028985507,0.0340579710144928,0.0583333333333333,0.240942028985507
"E02004646",773,470,188,188,282,585,4230,0.18274231678487,0.111111111111111,0.0444444444444444,0.0444444444444444,0.0666666666666667,0.138297872340426
"E02004647",395,407,112,124,283,271,2116,0.186672967863894,0.19234404536862,0.052930056710775,0.0586011342155009,0.133742911153119,0.128071833648393
"E02004648",465,359,74,147,212,318,1692,0.274822695035461,0.212174940898345,0.0437352245862884,0.0868794326241135,0.125295508274232,0.187943262411348
"E02004649",466,203,12,69,134,397,2634,0.176917236142749,0.0770690964312832,0.00455580865603645,0.0261958997722096,0.0508731966590737,0.150721336370539
"E02004650",506,400,35,186,214,320,5650,0.0895575221238938,0.0707964601769911,0.00619469026548673,0.0329203539823009,0.0378761061946903,0.0566371681415929
"E02004651",499,375,322,139,236,360,4356,0.11455463728191,0.0860881542699724,0.073921028466483,0.0319100091827365,0.054178145087236,0.0826446280991736
"E02004652",654,405,871,157,248,497,2170,0.301382488479263,0.186635944700461,0.401382488479263,0.0723502304147465,0.114285714285714,0.229032258064516
"E02004653",458,305,533,114,191,344,3117,0.146936156560796,0.0978504972730189,0.170997754250882,0.0365736284889317,0.0612768687840873,0.110362528071864
"E02004654",765,836,706,258,578,507,3942,0.194063926940639,0.212075088787418,0.179096905124302,0.0654490106544901,0.146626078132927,0.128614916286149
"E02004655",509,460,392,144,316,365,2891,0.176063645797302,0.159114493254929,0.135593220338983,0.0498097544102387,0.10930473884469,0.126253891387063
"E02004656",888,680,1308,213,467,675,4685,0.189541088580576,0.145144076840982,0.279188900747065,0.0454642475987193,0.0996798292422625,0.144076840981857
"E02004657",661,436,767,165,271,496,2155,0.306728538283063,0.202320185614849,0.355916473317865,0.0765661252900232,0.125754060324826,0.230162412993039
"E02004658",404,276,411,82,194,322,2042,0.197845249755142,0.135161606268364,0.201273261508325,0.0401567091087169,0.0950048971596474,0.157688540646425
"E02004659",489,459,529,165,294,324,2230,0.219282511210762,0.205829596412556,0.237219730941704,0.0739910313901345,0.131838565022422,0.145291479820628
"E02004660",635,410,776,157,253,478,2353,0.269868253293668,0.174245643858904,0.32979175520612,0.0667233319167021,0.107522311942201,0.203144921376966
"E02004661",602,653,261,228,425,374,3372,0.1785290628707,0.193653618030842,0.0774021352313167,0.0676156583629893,0.126037959667853,0.110913404507711
"E02004662",439,390,599,141,249,298,2418,0.181555004135649,0.161290322580645,0.247725392886683,0.0583126550868486,0.102977667493797,0.123242349048801
"E02004663",490,339,631,123,216,367,2518,0.194598888006354,0.134630659253376,0.250595710881652,0.0488482922954726,0.0857823669579031,0.145750595710882
"E02004664",426,617,522,142,475,284,2878,0.148019457956915,0.214384989576095,0.18137595552467,0.0493398193189715,0.165045170257123,0.098679638637943
"E02004665",601,530,788,178,352,423,2826,0.212668082094834,0.187544232130219,0.278839348903043,0.0629865534324133,0.124557678697806,0.14968152866242
"E02004666",647,703,167,225,478,422,4407,0.146811890174722,0.159518947129567,0.0378942591331972,0.0510551395507148,0.108463807578852,0.0957567506240073
"E02004667",702,677,819,187,490,515,4244,0.165409990574929,0.15951932139491,0.192978322337418,0.044062205466541,0.115457115928369,0.121347785108388
"E02004668",696,550,895,204,346,492,3397,0.204886664704151,0.16190756549897,0.263467765675596,0.0600529879305269,0.101854577568443,0.144833676773624
"E02004669",459,350,404,131,219,328,2273,0.201935767707875,0.153981522217334,0.177738671359437,0.0576330840299164,0.0963484381874175,0.144302683677959
"E02004671",394,316,289,119,197,275,2943,0.133876996262317,0.107373428474346,0.0981991165477404,0.0404349303431872,0.0669384981311587,0.0934420659191301
"E02004672",922,780,137,262,518,660,4708,0.195836873406967,0.165675446049278,0.0290994052676296,0.0556499575191164,0.110025488530161,0.14018691588785
"E02004673",368,419,260,139,280,229,3439,0.107007851119511,0.121837743530096,0.0756033730735679,0.0404187263739459,0.08141901715615,0.0665891247455656
"E02004674",553,633,116,188,445,365,5317,0.104006018431446,0.119052097047207,0.0218168139928531,0.0353582847470378,0.0836938123001693,0.0686477336844085
"E02004675",684,529,123,201,328,483,2496,0.274038461538462,0.211939102564103,0.0492788461538462,0.0805288461538462,0.131410256410256,0.193509615384615
"E02004676",640,576,173,204,372,436,2403,0.266333749479817,0.239700374531835,0.071993341656263,0.0848938826466916,0.154806491885144,0.181439866833125
"E02004677",517,472,369,183,289,334,2246,0.230186999109528,0.210151380231523,0.164292074799644,0.0814781834372217,0.128673196794301,0.148708815672306
"E02004678",543,536,392,188,348,355,2484,0.218599033816425,0.215780998389694,0.15780998389694,0.0756843800322061,0.140096618357488,0.142914653784219
"E02004679",557,428,328,135,293,422,4015,0.138729763387298,0.106600249066002,0.0816936488169365,0.0336239103362391,0.0729763387297634,0.105105853051059
"E02004680",470,316,5,113,203,357,3138,0.149776927979605,0.10070108349267,0.00159337157425112,0.0360101975780752,0.0646908859145953,0.11376673040153
"E02004681",549,539,29,193,346,356,5908,0.0929248476641842,0.0912322274881517,0.00490859851049425,0.0326675693974272,0.0585646580907244,0.0602572782667569
"E02004682",560,446,66,167,279,393,2993,0.187103240895423,0.149014366855997,0.0220514533912462,0.0557968593384564,0.0932175075175409,0.131306381556966
"E02004683",396,455,191,102,353,294,3141,0.126074498567335,0.144858325374085,0.0608086596625279,0.0324737344794651,0.11238459089462,0.0936007640878701
"E02004684",550,383,51,131,252,419,4642,0.118483412322275,0.0825075398535114,0.0109866436880655,0.0282205945713055,0.0542869452822059,0.0902628177509694
"E02004685",444,596,137,117,479,327,4232,0.104914933837429,0.140831758034026,0.0323724007561437,0.0276465028355388,0.113185255198488,0.0772684310018904
"E02004686",532,893,446,258,635,274,3844,0.138397502601457,0.232310093652445,0.116024973985432,0.0671175858480749,0.16519250780437,0.0712799167533819
"E02004687",403,611,77,157,454,246,2499,0.161264505802321,0.244497799119648,0.030812324929972,0.0628251300520208,0.181672669067627,0.0984393757503001
"E02004688",611,712,89,159,553,452,3090,0.197734627831715,0.23042071197411,0.0288025889967638,0.0514563106796116,0.178964401294498,0.146278317152104
"E02004689",461,405,134,140,265,321,1864,0.247317596566524,0.217274678111588,0.0718884120171674,0.0751072961373391,0.142167381974249,0.172210300429185
"E02004690",511,716,63,202,514,309,2583,0.197831978319783,0.277197057684863,0.024390243902439,0.0782036391792489,0.198993418505614,0.119628339140534
"E02004691",580,502,378,195,307,385,2557,0.226828314430974,0.196323816973015,0.147829487680876,0.0762612436448964,0.120062573328119,0.150567070786077
"E02004692",431,446,29,125,321,306,1840,0.234239130434783,0.242391304347826,0.0157608695652174,0.0679347826086956,0.17445652173913,0.166304347826087
"E02004693",515,609,28,180,429,335,2743,0.187750637987605,0.222019686474663,0.010207801676996,0.0656215822092599,0.156398104265403,0.122129055778345
"E02004694",505,488,401,152,336,353,2772,0.182178932178932,0.176046176046176,0.144660894660895,0.0548340548340548,0.121212121212121,0.127344877344877
"E02004695",416,123,2,33,90,383,2679,0.155281821575215,0.0459126539753639,0.000746547219111609,0.0123180291153415,0.0335946248600224,0.142963792459873
"E02004696",414,391,319,129,262,285,3651,0.113393590797042,0.107093946863873,0.0873733223774308,0.0353327855382087,0.0717611613256642,0.0780608052588332
"E02004697",421,373,428,140,233,281,2267,0.185707984119982,0.164534627260697,0.188795765328628,0.0617556241729157,0.102779003087781,0.123952359947067
"E02004698",396,439,302,104,335,292,3184,0.124371859296482,0.137876884422111,0.0948492462311558,0.0326633165829146,0.105213567839196,0.0917085427135678
"E02004699",646,869,341,246,623,400,4161,0.155251141552511,0.208844027877914,0.0819514539774093,0.0591204037490988,0.149723624128815,0.0961307378034126
"E02004700",313,359,153,116,243,197,3006,0.104125083166999,0.119427811044578,0.0508982035928144,0.0385894876912841,0.0808383233532934,0.0655355954757152
"E02004702",516,476,82,145,331,371,2654,0.194423511680482,0.179351921627732,0.0308967596081387,0.0546345139412208,0.124717407686511,0.139788997739261
"E02004703",649,595,369,219,376,430,4012,0.161764705882353,0.148305084745763,0.0919740777666999,0.0545862412761715,0.0937188434695912,0.107178464606181
"E02004704",368,352,268,132,220,236,2324,0.158347676419966,0.151462994836489,0.115318416523236,0.0567986230636833,0.0946643717728055,0.101549053356282
"E02004705",637,737,235,249,488,388,3731,0.170731707317073,0.197534173143929,0.0629857946931118,0.0667381399088716,0.130796033235058,0.103993567408202
"E02004706",568,524,338,173,351,395,2547,0.223007459756576,0.205732234000785,0.13270514330585,0.0679230467216333,0.137809187279152,0.155084413034943
"E02004707",833,857,552,274,583,559,3756,0.221778487752929,0.228168264110756,0.146964856230032,0.0729499467518637,0.155218317358892,0.148828541001065
"E02004708",690,846,422,206,640,484,3913,0.176335292614362,0.216202402248914,0.107845642729364,0.0526450293892154,0.163557372859698,0.123690263225147
"E02004709",559,464,86,198,266,361,2640,0.211742424242424,0.175757575757576,0.0325757575757576,0.075,0.100757575757576,0.136742424242424
"E02004710",501,370,95,135,235,366,2044,0.245107632093933,0.181017612524462,0.0464774951076321,0.0660469667318982,0.114970645792564,0.179060665362035
"E02004712",610,743,56,259,484,351,2500,0.244,0.2972,0.0224,0.1036,0.1936,0.1404
"E02004713",523,774,87,253,521,270,2391,0.218736930154747,0.323713927227102,0.0363864491844417,0.105813467168549,0.217900460058553,0.112923462986198
"E02004714",554,512,45,182,330,372,2728,0.20307917888563,0.187683284457478,0.0164956011730205,0.0667155425219941,0.120967741935484,0.136363636363636
"E02004715",509,893,94,273,620,236,3479,0.146306409887899,0.25668295487209,0.0270192584075884,0.0784708249496982,0.178212129922391,0.0678355849382006
"E02004716",510,698,46,218,480,292,2786,0.183058147882268,0.250538406317301,0.0165111270638909,0.0782483847810481,0.172290021536253,0.10480976310122
"E02004717",494,587,27,159,428,335,5666,0.0871867278503353,0.103600423579245,0.0047652665019414,0.0280621249558772,0.0755382986233675,0.0591246028944582
"E02004718",525,1213,118,331,882,194,4065,0.129151291512915,0.29840098400984,0.0290282902829028,0.0814268142681427,0.216974169741697,0.0477244772447724
"E02004719",583,500,74,167,333,416,3811,0.152978220939386,0.131199160325374,0.0194174757281553,0.0438205195486749,0.087378640776699,0.109157701390711
"E02004720",862,534,101,183,351,679,4181,0.206170772542454,0.127720640994977,0.024156900263095,0.0437694331499641,0.0839512078450132,0.16240133939249
"E02004721",485,194,57,73,121,412,4916,0.0986574450772986,0.0394629780309194,0.0115947925142392,0.0148494711147274,0.024613506916192,0.0838079739625712
"E02004722",511,540,92,181,359,330,2463,0.207470564352416,0.219244823386115,0.0373528217620788,0.073487616727568,0.145757206658546,0.133982947624848
"E02004723",693,862,47,329,533,364,3078,0.225146198830409,0.280051981806368,0.0152696556205328,0.10688758934373,0.173164392462638,0.11825860948668
"E02004724",572,482,80,162,320,410,3586,0.159509202453988,0.134411600669269,0.0223089793641941,0.045175683212493,0.0892359174567764,0.114333519241495
"E02004725",381,483,105,132,351,249,2395,0.159081419624217,0.201670146137787,0.0438413361169102,0.0551148225469729,0.146555323590814,0.103966597077244
"E02004726",365,483,113,136,347,229,2391,0.152655792555416,0.202007528230866,0.0472605604349645,0.0568799665411962,0.14512756168967,0.09577582601422
"E02004727",479,407,54,123,284,356,3271,0.146438398043412,0.124426780800978,0.0165087129318251,0.0376031794558239,0.0868236013451544,0.108835218587588
"E02004728",573,465,36,163,302,410,3429,0.167104111986002,0.135608048993876,0.010498687664042,0.047535724701079,0.0880723242927967,0.119568387284923
"E02004729",460,513,105,166,347,294,2378,0.193439865433137,0.215727502102607,0.0441547518923465,0.0698065601345669,0.14592094196804,0.12363330529857
"E02004730",630,592,111,227,365,403,2566,0.24551831644583,0.230709275136399,0.0432579890880748,0.08846453624318,0.142244738893219,0.15705378020265
"E02004731",574,246,18,77,169,497,2450,0.234285714285714,0.100408163265306,0.0073469387755102,0.0314285714285714,0.0689795918367347,0.202857142857143
"E02004732",581,496,89,174,322,407,3039,0.191181309641329,0.163211582757486,0.029285949325436,0.0572556762092794,0.105955906548207,0.13392563343205
"E02004733",565,447,155,168,279,397,2873,0.196658545074835,0.155586494953011,0.0539505743125653,0.0584754611903933,0.0971110337626175,0.138183083884441
"E02004734",751,951,273,290,661,461,3764,0.19952178533475,0.252656748140276,0.072529224229543,0.0770456960680128,0.175611052072264,0.122476089266738
"E02004735",512,613,105,195,418,317,2176,0.235294117647059,0.281709558823529,0.0482536764705882,0.0896139705882353,0.192095588235294,0.145680147058824
"E02004736",586,721,53,268,453,318,2401,0.244064972927947,0.300291545189504,0.0220741357767597,0.111620158267389,0.188671386922116,0.132444814660558
"E02004737",501,942,228,243,699,258,3098,0.16171723692705,0.304067140090381,0.0735958683021304,0.07843770174306,0.225629438347321,0.0832795351839897
"E02004738",519,703,81,246,457,273,2222,0.233573357335734,0.316381638163816,0.0364536453645365,0.110711071107111,0.205670567056706,0.122862286228623
"E02004739",458,496,60,149,347,309,2161,0.211938917167978,0.229523368810736,0.02776492364646,0.0689495603887089,0.160573808422027,0.142989356779269
"E02004740",526,533,35,199,334,327,2252,0.233570159857904,0.236678507992895,0.0155417406749556,0.0883658969804618,0.148312611012433,0.145204262877442
"E02004741",510,518,71,173,345,337,2315,0.220302375809935,0.223758099352052,0.0306695464362851,0.0747300215982721,0.14902807775378,0.145572354211663
"E02004742",599,556,87,167,389,432,2449,0.244589628419763,0.227031441404655,0.0355247039608003,0.0681910984075133,0.158840342997142,0.17639853001225
"E02004743",510,959,81,279,680,231,2218,0.229936880072137,0.432371505861136,0.0365193868349865,0.125788999098287,0.306582506762849,0.10414788097385
"E02004744",584,421,48,68,353,516,4430,0.131828442437923,0.0950338600451467,0.0108352144469526,0.0153498871331828,0.0796839729119639,0.11647855530474
"E02004745",533,988,202,233,755,300,3552,0.150056306306306,0.278153153153153,0.0568693693693694,0.0655968468468468,0.212556306306306,0.0844594594594595
"E02004746",546,861,78,204,657,342,4370,0.124942791762014,0.197025171624714,0.0178489702517162,0.0466819221967963,0.150343249427918,0.0782608695652174
"E02004747",520,876,90,262,614,258,2463,0.211124644742184,0.355663824604141,0.0365408038976857,0.106374340235485,0.249289484368656,0.104750304506699
"E02004748",500,1015,415,204,811,296,5060,0.0988142292490119,0.200592885375494,0.0820158102766798,0.0403162055335968,0.160276679841897,0.058498023715415
"E02004749",468,717,151,203,514,265,2325,0.201290322580645,0.308387096774194,0.0649462365591398,0.0873118279569892,0.221075268817204,0.113978494623656
"E02004750",546,1174,272,319,855,227,2799,0.195069667738478,0.419435512683101,0.0971775634155055,0.113969274740979,0.305466237942122,0.0811003929974991
"E02004751",580,740,122,226,514,354,2761,0.210068815646505,0.268018833755886,0.0441868888084028,0.0818544005795002,0.186164433176385,0.128214415067005
"E02004752",608,504,134,179,325,429,2099,0.28966174368747,0.240114340161982,0.0638399237732254,0.0852787041448309,0.154835636017151,0.204383039542639
"E02004753",676,887,195,296,591,380,3476,0.194476409666283,0.25517836593786,0.0560989643268124,0.0851553509781358,0.170023014959724,0.109321058688147
"E02004754",427,497,460,144,353,283,2695,0.158441558441558,0.184415584415584,0.170686456400742,0.0534322820037106,0.130983302411874,0.105009276437848
"E02004755",519,522,150,119,403,400,5457,0.0951072017592084,0.0956569543705333,0.0274876305662452,0.0218068535825545,0.0738501007879787,0.0733003481766538
"E02004756",525,426,100,151,275,374,3602,0.145752359800111,0.118267629094947,0.0277623542476402,0.0419211549139367,0.0763464741810106,0.103831204886174
"E02004757",552,639,109,191,448,361,2151,0.256624825662483,0.297071129707113,0.0506741050674105,0.0887959088795909,0.208275220827522,0.167828916782892
"E02004758",519,589,149,167,422,352,3203,0.162035591632844,0.183890103028411,0.0465188885419919,0.052138620043709,0.131751482984702,0.109896971589135
"E02004759",582,640,76,221,419,361,2357,0.246924056003394,0.271531607976241,0.0322443784471786,0.0937632583792957,0.177768349596945,0.153160797624098
"E02004760",457,302,224,96,206,361,4177,0.109408666507062,0.0723006942781901,0.0536270050275317,0.0229830021546565,0.0493176921235336,0.086425664352406
"E02004761",339,323,371,83,240,256,2236,0.151610017889088,0.144454382826476,0.165921288014311,0.0371198568872987,0.107334525939177,0.114490161001789
"E02004764",661,600,129,260,340,401,2732,0.24194729136164,0.219619326500732,0.0472181551976574,0.0951683748169839,0.124450951683748,0.146778916544656
"E02004765",614,388,27,153,235,461,2084,0.294625719769674,0.186180422264875,0.0129558541266795,0.0734165067178503,0.112763915547025,0.221209213051823
"E02004766",397,566,100,174,392,223,2642,0.150264950794852,0.214231642694928,0.0378501135503407,0.0658591975775927,0.148372445117335,0.0844057532172597
"E02004767",340,385,51,87,298,253,1960,0.173469387755102,0.196428571428571,0.0260204081632653,0.0443877551020408,0.152040816326531,0.129081632653061
"E02004768",458,434,75,156,278,302,1799,0.254585881045025,0.24124513618677,0.0416898276820456,0.0867148415786548,0.154530294608116,0.16787103946637
"E02004769",457,318,41,128,190,329,2213,0.206507004066878,0.143696339810212,0.0185268865793041,0.0578400361500226,0.0858563036601898,0.148666967916855
"E02004770",572,476,95,163,313,409,2446,0.233851185609158,0.19460343417825,0.0388389206868356,0.0666394112837285,0.127964022894522,0.167211774325429
"E02004771",586,525,102,154,371,432,3145,0.186327503974563,0.166931637519873,0.0324324324324324,0.048966613672496,0.117965023847377,0.137360890302067
"E02004772",695,964,129,289,675,406,2957,0.235035508961786,0.326006087250592,0.0436252959080149,0.0977341900574907,0.228271897193101,0.137301318904295
"E02004774",789,981,251,320,661,469,4135,0.19081015719468,0.237243047158404,0.0607013301088271,0.0773881499395405,0.159854897218863,0.113422007255139
"E02004775",632,983,278,259,724,373,4468,0.141450313339302,0.220008952551477,0.0622202327663384,0.0579677708146822,0.162041181736795,0.0834825425246195
"E02004776",469,529,110,197,332,272,2163,0.216828478964401,0.244567730004623,0.0508552935737402,0.0910772075820619,0.153490522422561,0.125751271382339
"E02004777",437,587,202,126,461,311,2520,0.173412698412698,0.232936507936508,0.0801587301587302,0.05,0.182936507936508,0.123412698412698
"E02004778",627,756,137,232,524,395,2643,0.237230419977299,0.286038592508513,0.051835035944003,0.0877790389708664,0.198259553537647,0.149451381006432
"E02004779",876,984,588,367,617,509,4037,0.216992816447857,0.243745355461977,0.145652712410206,0.0909090909090909,0.152836264552886,0.126083725538766
"E02004780",431,658,85,216,442,215,1915,0.225065274151436,0.343603133159269,0.0443864229765013,0.112793733681462,0.230809399477807,0.112271540469974
"E02004781",568,319,60,119,200,449,2539,0.223710122095313,0.125640015754234,0.0236313509255612,0.0468688460023631,0.0787711697518708,0.17684127609295
"E02004782",490,784,125,232,552,258,2975,0.164705882352941,0.263529411764706,0.0420168067226891,0.0779831932773109,0.185546218487395,0.0867226890756303
"E02004783",468,508,31,157,351,311,2255,0.207538802660754,0.225277161862528,0.0137472283813747,0.0696230598669623,0.155654101995565,0.137915742793792
"E02004784",366,407,87,154,253,212,1366,0.267935578330893,0.297950219619326,0.0636896046852123,0.112737920937042,0.185212298682284,0.155197657393851
"E02004785",451,610,355,204,406,247,1921,0.234773555439875,0.317542946382093,0.184799583550234,0.106194690265487,0.211348256116606,0.128578865174388
"E02004786",569,549,100,180,369,389,2721,0.209114296214627,0.201764057331863,0.0367511944138184,0.0661521499448732,0.13561190738699,0.142962146269754
"E02004787",642,599,129,214,385,428,2755,0.233030852994555,0.217422867513612,0.0468239564428312,0.0776769509981851,0.139745916515427,0.15535390199637
"E02004788",572,570,193,232,338,340,2073,0.275928605885191,0.274963820549928,0.0931017848528702,0.111915098890497,0.163048721659431,0.164013506994694
"E02004789",718,714,149,295,419,423,3371,0.212993177098784,0.211806585582913,0.0442005339661821,0.0875111242954613,0.124295461287452,0.125482052803322
"E02004790",678,654,287,222,432,456,3367,0.201366201366201,0.194238194238194,0.0852390852390852,0.0659340659340659,0.128304128304128,0.135432135432135
"E02004791",374,353,67,117,236,257,1676,0.223150357995227,0.210620525059666,0.0399761336515513,0.0698090692124105,0.140811455847255,0.153341288782816
"E02004792",718,612,123,257,355,461,2601,0.276047673971549,0.235294117647059,0.0472895040369089,0.0988081507112649,0.136485966935794,0.177239523260284
"E02004793",509,765,186,263,502,246,2523,0.201743955608403,0.30321046373365,0.0737217598097503,0.104240982956797,0.198969480776853,0.0975029726516052
"E02004794",538,647,219,230,417,308,2268,0.237213403880071,0.285273368606702,0.0965608465608466,0.101410934744268,0.183862433862434,0.135802469135802
"E02004795",811,1057,631,322,735,489,4306,0.188341848583372,0.245471435206688,0.146539712029726,0.0747793776126335,0.170692057594055,0.113562470970739
"E02004796",738,630,109,254,376,484,3181,0.232002514932411,0.198050927381327,0.0342659541024835,0.0798491040553285,0.118201823325998,0.152153410877083
"E02004797",602,670,87,201,469,401,3471,0.173437049841544,0.193027945836935,0.0250648228176318,0.0579083837510804,0.135119562085854,0.115528666090464
"E02004798",434,446,74,164,282,270,2591,0.167502894635276,0.172134311076804,0.0285604013894249,0.0632960247008877,0.108838286375917,0.104206869934388
"E02004799",805,1019,136,289,730,516,3655,0.220246238030096,0.278796169630643,0.0372093023255814,0.0790697674418605,0.199726402188782,0.141176470588235
"E02004800",692,759,106,253,506,439,2892,0.239280774550484,0.262448132780083,0.0366528354080221,0.0874827109266943,0.174965421853389,0.15179806362379
"E02004801",579,1081,130,262,819,317,3442,0.168216153399187,0.314061592097618,0.0377687391051714,0.0761185357350378,0.23794305636258,0.0920976176641488
"E02004802",416,476,110,147,329,269,2382,0.174643157010915,0.199832073887489,0.0461796809403862,0.0617128463476071,0.138119227539882,0.112930310663308
"E02004803",259,852,74,91,761,168,2620,0.0988549618320611,0.325190839694657,0.0282442748091603,0.0347328244274809,0.290458015267176,0.0641221374045802
"E02004804",457,657,91,204,453,253,1988,0.229879275653924,0.330482897384306,0.0457746478873239,0.10261569416499,0.227867203219316,0.127263581488934
"E02004805",439,726,253,204,522,235,3114,0.140976236351959,0.233140655105973,0.0812459858702633,0.0655105973025048,0.167630057803468,0.0754656390494541
"E02004806",438,271,61,83,188,355,2617,0.167367214367596,0.103553687428353,0.0233091325945739,0.0317157050057318,0.0718379824226213,0.135651509361865
"E02004807",612,882,366,238,644,374,4039,0.151522654122308,0.218370883882149,0.0906164892300074,0.0589254766031196,0.159445407279029,0.0925971775191879
"E02004808",539,859,973,196,663,343,5259,0.102490967864613,0.163339037839894,0.185016162768587,0.0372694428598593,0.126069594980034,0.0652215250047538
"E02004809",233,170,534,40,130,193,5826,0.039993134225884,0.0291795399931342,0.0916580844490216,0.00686577411603158,0.0223137658771026,0.0331273601098524
"E02004810",378,516,618,130,386,248,3221,0.117354858739522,0.160198696057125,0.191865880161441,0.0403601366035393,0.119838559453586,0.0769947221359826
"E02004811",550,690,824,183,507,367,3143,0.174992045816099,0.219535475660197,0.26216990136812,0.0582246261533567,0.161310849506841,0.116767419662743
"E02004812",375,551,520,140,411,235,2014,0.186196623634558,0.273584905660377,0.258192651439921,0.0695134061569017,0.204071499503476,0.116683217477656
"E02004813",339,436,373,93,343,246,2295,0.147712418300654,0.189978213507625,0.162527233115468,0.0405228758169935,0.149455337690632,0.10718954248366
"E02004814",443,391,201,136,255,307,2236,0.198121645796064,0.174865831842576,0.0898926654740608,0.0608228980322004,0.114042933810376,0.137298747763864
"E02004815",395,814,7,161,653,234,2536,0.155757097791798,0.320977917981073,0.0027602523659306,0.0634858044164038,0.257492113564669,0.0922712933753943
"E02004817",510,730,119,220,510,290,2805,0.181818181818182,0.260249554367201,0.0424242424242424,0.0784313725490196,0.181818181818182,0.103386809269162
"E02004818",634,599,190,198,401,436,3209,0.19756933624182,0.186662511685883,0.0592084761607978,0.0617014646307261,0.124961047055157,0.135867871611094
"E02004819",487,647,109,200,447,287,2848,0.170997191011236,0.227176966292135,0.0382724719101124,0.0702247191011236,0.156952247191011,0.100772471910112
"E02004820",598,568,192,228,340,370,2419,0.247209590739975,0.234807771806532,0.0793716411740389,0.0942538238941711,0.14055394791236,0.152955766845804
"E02004821",420,383,305,129,254,291,1675,0.250746268656716,0.22865671641791,0.182089552238806,0.0770149253731343,0.151641791044776,0.173731343283582
"E02004822",636,768,533,280,488,356,2801,0.227061763655837,0.274187790074973,0.190289182434845,0.099964298464834,0.174223491610139,0.127097465191003
"E02004823",572,703,124,200,503,372,2766,0.206796818510484,0.254157628344179,0.0448300795372379,0.0723065798987708,0.181851048445409,0.134490238611714
"E02004824",382,615,380,151,464,231,2860,0.133566433566434,0.215034965034965,0.132867132867133,0.0527972027972028,0.162237762237762,0.0807692307692308
"E02004825",715,721,152,275,446,440,3501,0.204227363610397,0.205941159668666,0.043416166809483,0.0785489860039989,0.127392173664667,0.125678377606398
"E02004826",378,433,229,162,271,216,3579,0.105616093880972,0.12098351494831,0.0639843531712769,0.0452640402347024,0.0757194747136072,0.0603520536462699
"E02004827",361,63,1,27,36,334,2079,0.173641173641174,0.0303030303030303,0.000481000481000481,0.012987012987013,0.0173160173160173,0.160654160654161
"E02004828",353,332,73,107,225,246,2530,0.139525691699605,0.131225296442688,0.0288537549407115,0.0422924901185771,0.0889328063241107,0.0972332015810277
"E02004829",398,346,258,120,226,278,2206,0.180417044424297,0.156844968268359,0.116953762466002,0.0543970988213962,0.102447869446963,0.126019945602901
"E02004830",378,410,226,125,285,253,2192,0.172445255474453,0.187043795620438,0.103102189781022,0.0570255474452555,0.130018248175182,0.115419708029197
"E02004831",564,681,228,220,461,344,3641,0.154902499313375,0.187036528426257,0.0626201592968965,0.0604229607250755,0.126613567701181,0.0944795385882999
"E02004832",536,542,432,180,362,356,2966,0.180714767363452,0.18273769386379,0.145650708024275,0.0606877950101146,0.122049898853675,0.120026972353338
"E02004833",476,648,260,186,462,290,3479,0.13682092555332,0.186260419660822,0.0747341189997126,0.0534636389767175,0.132796780684105,0.0833572865766025
"E02004834",445,670,357,134,536,311,3285,0.135464231354642,0.203957382039574,0.108675799086758,0.0407914764079148,0.163165905631659,0.0946727549467276
"E02004835",652,1166,1114,258,908,394,5062,0.128802844725405,0.230343737653102,0.220071118135124,0.050967996839194,0.179375740813908,0.077834847886211
"E02004836",295,415,165,110,305,185,2330,0.126609442060086,0.178111587982833,0.0708154506437768,0.0472103004291846,0.130901287553648,0.0793991416309013
"E02004837",505,458,124,142,316,363,2716,0.185935198821797,0.168630338733432,0.0456553755522828,0.0522827687776141,0.116347569955817,0.133652430044183
"E02004838",504,602,348,196,406,308,2997,0.168168168168168,0.200867534200868,0.116116116116116,0.0653987320653987,0.135468802135469,0.102769436102769
"E02004839",519,502,446,190,312,329,2753,0.188521612786052,0.182346531057029,0.162005085361424,0.0690156193243734,0.113330911732655,0.119505993461678
"E02004840",497,578,222,158,420,339,3800,0.130789473684211,0.152105263157895,0.0584210526315789,0.0415789473684211,0.110526315789474,0.0892105263157895
"E02004841",530,486,274,158,328,372,6391,0.0829291190736974,0.0760444374902206,0.0428727898607417,0.0247222656861211,0.0513221718040995,0.0582068533875763
"E02004842",498,329,198,112,217,386,4271,0.116600327792086,0.0770311402481854,0.0463591664715523,0.0262233668929993,0.0508077733551861,0.0903769608990869
"E02004843",407,681,173,255,426,152,1689,0.24097098875074,0.403197158081705,0.10242747187685,0.150976909413854,0.252220248667851,0.0899940793368857
"E02004844",379,378,959,108,270,271,2289,0.165574486675404,0.165137614678899,0.418960244648318,0.0471821756225426,0.117955439056356,0.118392311052862
"E02004845",363,690,527,109,581,254,3617,0.100359413878905,0.190765828034283,0.145700857063865,0.0301354713851258,0.160630356649157,0.0702239424937794
"E02004846",397,410,480,135,275,262,1906,0.208289611752361,0.21511017838405,0.251836306400839,0.0708289611752361,0.144281217208814,0.137460650577125
"E02004847",630,985,406,280,705,350,3876,0.162538699690402,0.254127966976264,0.104747162022704,0.0722394220846233,0.181888544891641,0.0902992776057792
"E02004848",443,682,295,213,469,230,2184,0.202838827838828,0.312271062271062,0.13507326007326,0.0975274725274725,0.21474358974359,0.105311355311355
"E02004849",335,327,262,104,223,231,2256,0.148492907801418,0.144946808510638,0.11613475177305,0.0460992907801418,0.0988475177304965,0.102393617021277
"E02004850",498,620,306,214,406,284,2407,0.206896551724138,0.25758205234732,0.127129206481097,0.0889073535521396,0.168674698795181,0.117989198171998
"E02004851",416,440,168,172,268,244,1942,0.214212152420185,0.226570545829042,0.0865087538619979,0.0885684860968074,0.138002059732235,0.125643666323378
"E02004852",573,807,471,267,540,306,2789,0.205449982072427,0.289351021871639,0.168877733954823,0.0957332377196128,0.193617784152026,0.109716744352815
"E02004853",429,578,481,174,404,255,2410,0.178008298755187,0.239834024896266,0.199585062240664,0.0721991701244813,0.167634854771784,0.105809128630705
"E02004854",513,597,718,172,425,341,2742,0.187089715536105,0.217724288840263,0.261852662290299,0.062727935813275,0.154996353026988,0.12436177972283
"E02004855",461,546,698,149,397,312,3294,0.139951426836673,0.165755919854281,0.211900425015179,0.0452337583485124,0.120522161505768,0.0947176684881603
"E02004856",453,368,418,143,225,310,1987,0.227981882234524,0.1852038248616,0.210367388022144,0.0719677906391545,0.113236034222446,0.15601409159537
"E02004857",464,432,688,154,278,310,2495,0.185971943887776,0.17314629258517,0.275751503006012,0.0617234468937876,0.111422845691383,0.124248496993988
"E02004858",442,416,217,140,276,302,1836,0.240740740740741,0.226579520697168,0.118191721132898,0.0762527233115468,0.150326797385621,0.164488017429194
"E02004859",353,353,329,102,251,251,1623,0.217498459642637,0.217498459642637,0.202711028958718,0.0628465804066543,0.154651879235983,0.154651879235983
"E02004860",509,1069,202,266,803,243,2369,0.214858590122415,0.451245251160827,0.0852680455888561,0.112283663993246,0.338961587167581,0.102574926129168
"E02004861",393,321,433,110,211,283,1875,0.2096,0.1712,0.230933333333333,0.0586666666666667,0.112533333333333,0.150933333333333
"E02004862",578,553,216,154,399,424,2636,0.219271623672231,0.209787556904401,0.0819423368740516,0.0584218512898331,0.151365705614568,0.160849772382398
"E02004863",533,527,194,146,381,387,3279,0.16254955779201,0.160719731625496,0.0591643793839585,0.0445257700518451,0.116193961573651,0.118023787740165
"E02004864",427,475,545,136,339,291,2439,0.175071750717507,0.194751947519475,0.223452234522345,0.0557605576055761,0.138991389913899,0.119311193111931
"E02004865",527,466,336,157,309,370,2391,0.220409870347135,0.194897532413216,0.140526976160602,0.0656629025512338,0.129234629861982,0.154746967795901
"E02004866",629,448,51,168,280,461,2651,0.237268955111279,0.168992832893248,0.019238023387401,0.0633723123349679,0.10562052055828,0.173896642776311
"E02004867",455,313,302,102,211,353,2455,0.185336048879837,0.127494908350305,0.123014256619145,0.0415478615071283,0.0859470468431772,0.143788187372709
"E02004868",454,399,144,149,250,305,3292,0.137910085054678,0.121202916160389,0.0437424058323208,0.0452612393681653,0.0759416767922236,0.0926488456865128
"E02004869",424,346,676,101,245,323,2147,0.197484862598975,0.16115510013973,0.314857941313461,0.0470423847228691,0.114112715416861,0.150442477876106
"E02004870",698,727,623,225,502,473,6058,0.115219544404094,0.120006602839221,0.102839220864972,0.0371409706173655,0.0828656322218554,0.0780785737867283
"E02004871",475,356,88,137,219,338,1937,0.245224574083634,0.183789364997419,0.045431078988126,0.0707279297883325,0.113061435209086,0.174496644295302
"E02004872",532,559,134,185,374,347,2466,0.21573398215734,0.226682887266829,0.0543390105433901,0.0750202757502028,0.151662611516626,0.140713706407137
"E02004873",717,586,1209,201,385,516,5050,0.141980198019802,0.116039603960396,0.239405940594059,0.0398019801980198,0.0762376237623762,0.102178217821782
"E02004874",459,419,478,124,295,335,2129,0.215594175669328,0.196806012212306,0.224518553311414,0.0582433067167684,0.138562705495538,0.15735086895256
"E02004875",810,669,289,220,449,590,3771,0.214797136038186,0.177406523468576,0.0766374966852294,0.0583399628745691,0.119066560594007,0.156457173163617
"E02004876",564,695,465,234,461,330,2823,0.199787460148778,0.246191994332271,0.164718384697131,0.0828905419766206,0.16330145235565,0.116896918172157
"E02004877",377,308,544,83,225,294,1836,0.205337690631808,0.167755991285403,0.296296296296296,0.0452069716775599,0.122549019607843,0.160130718954248
"E02004878",417,338,408,124,214,293,3122,0.133568225496477,0.108263933376041,0.130685458039718,0.0397181294042281,0.0685458039718129,0.0938500960922486
"E02004880",465,393,370,114,279,351,3919,0.118652717529982,0.10028068384792,0.0944118397550396,0.0290890533299311,0.0711916305179893,0.089563664200051
"E02004881",369,355,602,116,239,253,3109,0.118687680926343,0.114184625281441,0.193631392730782,0.03731103248633,0.076873592795111,0.0813766484400129
"E02004882",410,565,535,146,419,264,2753,0.148928441699964,0.205230657464584,0.194333454413367,0.0530330548492554,0.152197602615329,0.0958953868507083
"E02004883",281,287,301,82,205,199,1869,0.150347779561263,0.153558052434457,0.161048689138577,0.0438737292669877,0.109684323167469,0.106474050294275
"E02004884",464,421,755,99,322,365,4179,0.111031347212252,0.100741804259392,0.180665230916487,0.0236898779612347,0.0770519262981574,0.087341469251017
"E02004885",434,500,171,153,347,281,2898,0.14975845410628,0.172532781228433,0.0590062111801242,0.0527950310559006,0.119737750172533,0.0969634230503796
"E02004886",322,285,461,87,198,235,1902,0.169295478443743,0.149842271293375,0.242376445846477,0.0457413249211356,0.10410094637224,0.123554153522608
"E02004887",505,448,487,161,287,344,2354,0.214528462192014,0.190314358538658,0.206881903143585,0.0683942225998301,0.121920135938828,0.146134239592184
"E02004888",408,599,412,141,458,267,3187,0.128020081581425,0.187951051145278,0.129275180420458,0.0442422340759335,0.143708817069344,0.0837778475054911
"E02004889",554,784,824,184,600,370,3866,0.143300569063632,0.202793585100879,0.213140196585618,0.0475944128297982,0.155199172271081,0.0957061562338334
"E02004890",465,753,419,159,594,306,3353,0.138681777512675,0.22457500745601,0.124962719952282,0.0474202206978825,0.177154786758127,0.0912615568147927
"E02004891",413,474,787,106,368,307,2754,0.149963689179375,0.172113289760349,0.285766158315178,0.0384894698620189,0.13362381989833,0.111474219317357
"E02004892",318,462,229,122,340,196,2260,0.14070796460177,0.204424778761062,0.101327433628319,0.0539823008849558,0.150442477876106,0.0867256637168142
"E02004893",324,202,330,66,136,258,2081,0.155694377703027,0.0970687169629986,0.15857760691975,0.03171552138395,0.0653531955790485,0.123978856319077
"E02004894",484,582,761,155,427,329,4598,0.105263157894737,0.126576772509787,0.165506742061766,0.0337103088299261,0.0928664636798608,0.0715528490648108
"E02004895",464,431,507,112,319,352,2656,0.174698795180723,0.162274096385542,0.190888554216867,0.0421686746987952,0.120105421686747,0.132530120481928
"E02004896",596,686,999,224,462,372,2914,0.204529855868222,0.23541523678792,0.342827728208648,0.0768702814001373,0.158544955387783,0.127659574468085
"E02004897",386,507,540,137,370,249,1871,0.206306787814003,0.270978086584714,0.288615713522181,0.0732228754676643,0.19775521111705,0.133083912346339
"E02004898",448,904,540,213,691,235,2644,0.169440242057489,0.341906202723147,0.204236006051437,0.0805597579425113,0.261346444780635,0.0888804841149773
"E02004899",323,302,300,117,185,206,1715,0.188338192419825,0.176093294460641,0.174927113702624,0.0682215743440233,0.107871720116618,0.120116618075802
"E02004900",507,727,682,199,528,308,2755,0.184029038112523,0.263883847549909,0.247549909255898,0.0722323049001815,0.191651542649728,0.111796733212341
"E02004901",469,767,451,218,549,251,3583,0.130895897292771,0.214066424783701,0.125872174155735,0.0608428691041027,0.153223555679598,0.0700530281886687
"E02004902",384,749,318,208,541,176,2526,0.152019002375297,0.296516231195566,0.125890736342043,0.0823436262866192,0.214172604908947,0.0696753760886778
"E02004903",395,409,528,150,259,245,2472,0.159789644012945,0.165453074433657,0.213592233009709,0.0606796116504854,0.104773462783172,0.0991100323624595
"E02004904",368,392,142,128,264,240,2322,0.15848406546081,0.168819982773471,0.0611541774332472,0.0551248923341947,0.113695090439276,0.103359173126615
"E02004905",428,611,373,187,424,241,2041,0.209701126898579,0.299363057324841,0.182753552180304,0.0916217540421362,0.207741303282705,0.118079372856443
"E02004906",506,764,460,218,546,288,3577,0.14145932345541,0.213586804584848,0.128599384959463,0.0609449259155717,0.152641878669276,0.0805143975398379
"E02004907",549,773,1078,217,556,332,3923,0.139943920469029,0.197043079276064,0.274789701758858,0.0553148100943156,0.141728269181749,0.0846291103747132
"E02004908",635,1038,627,267,771,368,3776,0.168167372881356,0.27489406779661,0.166048728813559,0.0707097457627119,0.204184322033898,0.0974576271186441
"E02004909",396,439,374,114,325,282,2475,0.16,0.177373737373737,0.151111111111111,0.0460606060606061,0.131313131313131,0.113939393939394
"E02004910",645,612,398,196,416,449,4738,0.136133389615872,0.12916842549599,0.0840016884761503,0.0413676656817222,0.0878007598142676,0.0947657239341494
"E02004911",563,680,207,128,552,435,2994,0.188042752171009,0.227120908483634,0.0691382765531062,0.042752171008684,0.18436873747495,0.145290581162325
"E02004912",836,596,688,181,415,655,4267,0.195922193578627,0.139676587766581,0.161237403327865,0.042418561049918,0.0972580267166628,0.153503632528709
"E02004914",577,251,1215,73,178,504,3095,0.18642972536349,0.0810985460420032,0.392568659127625,0.0235864297253635,0.0575121163166397,0.162843295638126
"E02004915",419,336,169,104,232,315,2227,0.188145487202515,0.150875617422542,0.0758868432869331,0.0466995958688819,0.10417602155366,0.141445891333633
"E02004916",589,432,1222,144,288,445,2663,0.221179121291776,0.162223056702967,0.458880961321817,0.0540743522343222,0.108148704468644,0.167104769057454
"E02004917",366,676,208,134,542,232,2531,0.144606874753062,0.267088107467404,0.0821809561438167,0.0529435005926511,0.214144606874753,0.0916633741604109
"E02004918",523,391,1335,91,300,432,3598,0.145358532518066,0.108671484157865,0.371039466370206,0.0252918287937743,0.0833796553640912,0.120066703724291
"E02004919",556,541,417,191,350,365,3103,0.179181437318724,0.174347405736384,0.134386077989043,0.0615533354817918,0.112794070254592,0.117628101836932
"E02004920",647,597,749,146,451,501,4917,0.131584299369534,0.121415497254423,0.15232865568436,0.0296929021761237,0.0917225950782998,0.101891397193411
"E02004921",492,514,512,146,368,346,2705,0.1818853974122,0.190018484288355,0.189279112754159,0.0539741219963031,0.136044362292052,0.127911275415896
"E02004922",785,546,804,201,345,584,3919,0.200306200561368,0.139321255422302,0.205154376116356,0.0512885940290891,0.0880326613932126,0.149017606532279
"E02004923",840,685,766,213,472,627,4256,0.197368421052632,0.160949248120301,0.179981203007519,0.050046992481203,0.110902255639098,0.147321428571429
"E02004924",489,612,362,219,393,270,2358,0.207379134860051,0.259541984732824,0.153519932145886,0.0928753180661578,0.166666666666667,0.114503816793893
"E02004925",501,656,391,188,468,313,2600,0.192692307692308,0.252307692307692,0.150384615384615,0.0723076923076923,0.18,0.120384615384615
"E02004926",537,719,818,154,565,383,3108,0.172779922779923,0.231338481338481,0.263191763191763,0.0495495495495495,0.181788931788932,0.123230373230373
"E02004927",436,413,369,143,270,293,2224,0.196043165467626,0.185701438848921,0.16591726618705,0.0642985611510791,0.121402877697842,0.131744604316547
"E02004928",446,544,381,175,369,271,2128,0.209586466165414,0.255639097744361,0.179041353383459,0.0822368421052632,0.173402255639098,0.12734962406015
"E02004929",399,428,475,140,288,259,2129,0.187411930483795,0.201033348990136,0.223109441052137,0.0657585720995773,0.135274776890559,0.121653358384218
"E02004930",601,478,313,160,318,441,2432,0.247121710526316,0.196546052631579,0.128700657894737,0.0657894736842105,0.130756578947368,0.181332236842105
"E02004931",535,590,127,200,390,335,2518,0.212470214455917,0.234312946783161,0.0504368546465449,0.079428117553614,0.154884829229547,0.133042096902303
"E02004932",373,331,606,87,244,286,2673,0.139543583988028,0.123830901608679,0.226711560044893,0.0325476992143659,0.0912832023943135,0.106995884773663
"E02004933",417,341,1008,105,236,312,1970,0.211675126903553,0.173096446700508,0.511675126903553,0.0532994923857868,0.119796954314721,0.158375634517766
"E02004934",374,256,1070,46,210,328,3548,0.105411499436302,0.0721533258173619,0.301578354002255,0.0129650507328072,0.0591882750845547,0.0924464487034949
"E02004935",631,370,1939,81,289,550,5207,0.121183022853851,0.0710581908968696,0.372383330132514,0.0155559823314769,0.0555022085653927,0.105627040522374
"E02004936",364,310,760,101,209,263,2032,0.179133858267717,0.15255905511811,0.374015748031496,0.0497047244094488,0.102854330708661,0.129429133858268
"E02004937",462,505,717,166,339,296,2458,0.187957689178194,0.205451586655818,0.291700569568755,0.0675345809601302,0.137917005695688,0.120423108218063
"E02004939",368,508,357,105,403,263,2433,0.151253596383066,0.208795725441841,0.146732429099877,0.0431565967940814,0.16563912864776,0.108096999588985
"E02004940",426,524,530,106,418,320,2930,0.145392491467577,0.178839590443686,0.180887372013652,0.0361774744027304,0.142662116040956,0.109215017064846
"E02004941",566,718,543,184,534,382,3479,0.16269042828399,0.206381144006899,0.156079333141707,0.0528887611382581,0.15349238286864,0.109801667145732
"E02004942",408,424,330,158,266,250,2357,0.173101400084854,0.17988969028426,0.140008485362749,0.0670343657191345,0.112855324565125,0.106067034365719
"E02004943",598,586,352,250,336,348,2593,0.230620902429618,0.225993058233706,0.135750096413421,0.0964134207481681,0.129579637485538,0.13420748168145
"E02004944",429,1086,170,272,814,157,2931,0.146366427840328,0.370522006141249,0.058000682360969,0.0928010917775503,0.277720914363698,0.0535653360627772
"E02004945",630,767,565,187,580,443,4504,0.1398756660746,0.170293072824156,0.12544404973357,0.0415186500888099,0.128774422735346,0.0983570159857904
"E02004946",396,707,174,174,533,222,2187,0.181069958847737,0.323273891175126,0.0795610425240055,0.0795610425240055,0.24371284865112,0.101508916323731
"E02004948",494,854,97,237,617,257,2803,0.176239743132358,0.30467356403853,0.0346057795219408,0.0845522654298965,0.220121298608634,0.0916874777024616
"E02004949",546,892,453,220,672,326,3932,0.138860630722279,0.226856561546287,0.115208545269583,0.0559511698880977,0.170905391658189,0.0829094608341811
"E02004950",402,514,70,149,365,253,2246,0.178984861976848,0.228851291184328,0.031166518254675,0.066340160284951,0.162511130899377,0.112644701691897
"E02004951",321,704,250,129,575,192,4023,0.0797912005965697,0.174993785732041,0.062142679592344,0.0320656226696495,0.142928163062391,0.0477255779269202
"E02004952",476,385,29,105,280,371,2358,0.20186598812553,0.163273960983885,0.0122985581000848,0.044529262086514,0.118744698897371,0.157336726039016
"E02004953",266,526,127,100,426,166,2289,0.116207951070336,0.229794670161643,0.0554827435561381,0.0436871996505024,0.18610747051114,0.072520751419834
"E02004954",365,654,154,149,505,216,2761,0.132198478812025,0.236870699022093,0.0557768924302789,0.0539659543643607,0.182904744657733,0.0782325244476639
"E02004955",361,434,91,135,299,226,2185,0.165217391304348,0.19862700228833,0.0416475972540046,0.0617848970251716,0.136842105263158,0.103432494279176
"E02004956",431,525,612,141,384,290,3350,0.12865671641791,0.156716417910448,0.182686567164179,0.042089552238806,0.114626865671642,0.0865671641791045
"E02004957",456,559,200,187,372,269,3607,0.12642084835043,0.154976434710286,0.0554477405045744,0.0518436373717771,0.103132797338508,0.0745772109786526
"E02004958",407,424,784,142,282,265,2351,0.173117822203318,0.180348787749894,0.333475116971502,0.0603998298596342,0.119948957890259,0.112717992343684
"E02004959",373,393,373,146,247,227,2244,0.166221033868093,0.175133689839572,0.166221033868093,0.0650623885918004,0.110071301247772,0.101158645276292
"E02004960",312,482,467,124,358,188,1783,0.174985978687605,0.270330902972518,0.261918115535614,0.0695457094784072,0.200785193494111,0.105440269209198
"E02004961",371,510,1233,96,414,275,2794,0.132784538296349,0.182534001431639,0.441302791696493,0.0343593414459556,0.148174659985684,0.0984251968503937
"E02004962",434,775,682,140,635,294,2986,0.145344943067649,0.25954454119223,0.228399196249163,0.0468854655056932,0.212659075686537,0.0984594775619558
"E02004963",374,464,483,130,334,244,2224,0.168165467625899,0.20863309352518,0.217176258992806,0.0584532374100719,0.150179856115108,0.109712230215827
"E02004964",366,442,407,121,321,245,1926,0.190031152647975,0.229491173416407,0.211318795430945,0.0628245067497404,0.166666666666667,0.127206645898235
"E02004965",482,672,528,151,521,331,2054,0.234664070107108,0.327166504381694,0.257059396299903,0.0735150925024343,0.25365141187926,0.161148977604674
"E02004966",378,592,350,174,418,204,2059,0.183584264205925,0.287518212724624,0.169985429820301,0.0845070422535211,0.203011170471102,0.0990772219524041
"E02004967",411,376,482,137,239,274,3310,0.12416918429003,0.113595166163142,0.145619335347432,0.0413897280966767,0.0722054380664653,0.0827794561933535
"E02004968",401,518,225,152,366,249,2346,0.170929241261722,0.22080136402387,0.0959079283887468,0.0647911338448423,0.156010230179028,0.10613810741688
"E02004969",383,297,716,91,206,292,2010,0.190547263681592,0.147761194029851,0.356218905472637,0.045273631840796,0.102487562189055,0.145273631840796
"E02004970",420,488,474,172,316,248,2882,0.145732130464955,0.169326856349757,0.164469118667592,0.0596807772380291,0.109646079111728,0.0860513532269257
"E02004971",379,245,1311,55,190,324,3079,0.123091912958753,0.0795712893796687,0.425787593374472,0.0178629425138032,0.0617083468658655,0.10522897044495
"E02004972",341,105,1014,26,79,315,1791,0.190396426577331,0.0586264656616415,0.566164154103853,0.0145170295924065,0.0441094360692351,0.175879396984925
"E02004973",618,237,2264,47,190,571,3663,0.168714168714169,0.0647010647010647,0.618072618072618,0.0128310128310128,0.0518700518700519,0.155883155883156
"E02004974",465,580,749,137,443,328,3460,0.134393063583815,0.167630057803468,0.216473988439306,0.0395953757225434,0.128034682080925,0.0947976878612717
"E02004975",372,291,788,90,201,282,2272,0.163732394366197,0.128080985915493,0.346830985915493,0.039612676056338,0.0884683098591549,0.124119718309859
"E02004976",556,268,1965,55,213,501,5854,0.0949777929620772,0.0457806627946703,0.33566791937137,0.00939528527502562,0.0363853775196447,0.0855825076870516
"E02004977",486,113,1924,25,88,461,3139,0.154826377827334,0.0359987257088245,0.612934055431666,0.00796431984708506,0.0280344058617394,0.146862057980248
"E02004978",458,344,629,83,261,375,4607,0.0994139353158238,0.0746689819839375,0.136531365313653,0.0180160625135663,0.0566529194703712,0.0813978728022574
"E02004979",384,336,1144,71,265,313,2571,0.149358226371062,0.130688448074679,0.444963049397122,0.0276157137300661,0.103072734344613,0.121742512640996
"E02004980",422,331,206,138,193,284,1907,0.221289984268485,0.173571054011536,0.108023072889355,0.0723649711588883,0.101206082852648,0.148925013109596
"E02004981",350,305,447,94,211,256,2940,0.119047619047619,0.103741496598639,0.152040816326531,0.0319727891156463,0.0717687074829932,0.0870748299319728
"E02004982",377,354,156,118,236,259,1964,0.191955193482688,0.180244399185336,0.0794297352342159,0.060081466395112,0.120162932790224,0.131873727087576
"E02004983",450,439,60,146,293,304,2550,0.176470588235294,0.172156862745098,0.0235294117647059,0.0572549019607843,0.114901960784314,0.11921568627451
"E02004984",539,516,25,105,411,434,2801,0.192431274544805,0.184219921456623,0.00892538379150304,0.0374866119243127,0.14673330953231,0.154944662620493
"E02004985",419,477,684,128,349,291,2820,0.148581560283688,0.169148936170213,0.242553191489362,0.0453900709219858,0.123758865248227,0.103191489361702
"E02004986",418,500,142,91,409,327,4657,0.0897573545200773,0.107365256602963,0.0304917328752416,0.0195404767017393,0.087824779901224,0.070216877818338
"E02004987",376,344,61,118,226,258,2837,0.13253436728939,0.121254846669017,0.0215015861825872,0.0415932322876278,0.0796616143813888,0.0909411350017624
"E02004988",277,311,170,59,252,218,3239,0.0855202222908305,0.0960172892868169,0.0524853349799321,0.0182154986106823,0.0778017906761346,0.0673047236801482
"E02004989",501,495,293,158,337,343,4667,0.107349475037497,0.106063852581958,0.0627812299121491,0.0338547246625241,0.0722091279194343,0.0734947503749732
"E02004990",519,538,350,160,378,359,3209,0.1617326269866,0.16765347460268,0.109068245559364,0.0498597693985665,0.117793705204113,0.111872857588034
"E02004991",431,558,192,133,425,298,3776,0.114141949152542,0.147775423728814,0.0508474576271186,0.0352224576271186,0.112552966101695,0.0789194915254237
"E02004992",521,772,178,235,537,286,3321,0.156880457693466,0.232460102378802,0.0535983137609154,0.0707618187292984,0.161698283649503,0.0861186389641674
"E02004994",360,508,545,127,381,233,1823,0.197476686780033,0.278661546900713,0.298957761930883,0.0696653867251783,0.208996160175535,0.127811300054855
"E02004995",421,490,465,179,311,242,1795,0.234540389972145,0.272980501392758,0.259052924791086,0.0997214484679666,0.173259052924791,0.134818941504178
"E02004996",520,613,460,171,442,349,3110,0.167202572347267,0.197106109324759,0.147909967845659,0.054983922829582,0.142122186495177,0.112218649517685
"E02004997",503,517,516,138,379,365,2804,0.179386590584879,0.184379457917261,0.184022824536377,0.0492154065620542,0.135164051355207,0.130171184022825
"E02004998",380,400,168,121,279,259,2156,0.176252319109462,0.185528756957328,0.0779220779220779,0.0561224489795918,0.129406307977737,0.12012987012987
"E02005000",622,806,1171,183,623,439,5833,0.106634664837991,0.13817932453283,0.20075432881879,0.031373221326933,0.106806103205897,0.0752614435110578
"E02005001",593,611,335,216,395,377,3342,0.177438659485338,0.182824655894674,0.100239377618193,0.0646319569120287,0.118192698982645,0.112806702573309
"E02005002",687,817,97,203,614,484,3739,0.183738967638406,0.218507622358919,0.0259427654453062,0.0542925916020326,0.164215030756887,0.129446376036373
"E02005003",345,363,70,98,265,247,3387,0.101860053144376,0.107174490699734,0.0206672571597284,0.0289341600236197,0.0782403306761146,0.0729258931207558
"E02005004",504,456,232,114,342,390,4098,0.12298682284041,0.111273792093704,0.0566129819424109,0.0278184480234261,0.0834553440702782,0.0951683748169839
"E02005005",533,382,405,159,223,374,4030,0.132258064516129,0.0947890818858561,0.100496277915633,0.039454094292804,0.0553349875930521,0.0928039702233251
"E02005006",369,305,254,111,194,258,1952,0.189036885245902,0.15625,0.130122950819672,0.0568647540983607,0.0993852459016393,0.132172131147541
"E02005007",486,320,329,109,211,377,3345,0.145291479820628,0.0956651718983558,0.098355754857997,0.0325859491778774,0.0630792227204783,0.11270553064275
"E02005008",720,622,476,197,425,523,3593,0.200389646534929,0.173114389089897,0.13247982187587,0.0548288338435848,0.118285555246312,0.145560812691344
"E02005009",488,377,366,121,256,367,2330,0.209442060085837,0.161802575107296,0.157081545064378,0.051931330472103,0.109871244635193,0.157510729613734
"E02005010",745,345,2178,86,259,659,4050,0.183950617283951,0.0851851851851852,0.537777777777778,0.0212345679012346,0.0639506172839506,0.162716049382716
"E02005011",547,426,355,159,267,388,2501,0.218712514994002,0.170331867253099,0.141943222710916,0.0635745701719312,0.106757297081168,0.155137944822071
"E02005012",672,622,984,230,392,442,3421,0.196433791289097,0.181818181818182,0.287635194387606,0.0672318035662087,0.114586378251973,0.129201987722888
"E02005013",710,673,589,250,423,460,3133,0.22661985317587,0.214810086179381,0.187998723268433,0.0797957229492499,0.135014363230131,0.14682413022662
"E02005014",742,786,229,316,470,426,2889,0.256836275527864,0.272066458982347,0.0792661820699204,0.109380408445829,0.162686050536518,0.147455867082035
"E02005015",610,520,283,199,321,411,3170,0.192429022082019,0.16403785488959,0.0892744479495268,0.0627760252365931,0.101261829652997,0.129652996845426
"E02005016",642,864,238,321,543,321,3237,0.198331788693234,0.266913809082484,0.0735248687055916,0.0991658943466172,0.167747914735867,0.0991658943466172
"E02005017",779,1144,1024,341,803,438,3618,0.215312327252626,0.316196793808734,0.283029297954671,0.0942509673852957,0.221945826423438,0.12106135986733
"E02005018",587,562,117,219,343,368,3061,0.191767396275727,0.18360013067625,0.0382228030055537,0.0715452466514211,0.112054884024828,0.120222149624306
"E02005019",395,347,365,130,217,265,2206,0.179057116953762,0.157298277425204,0.165457842248413,0.0589301903898459,0.0983680870353581,0.120126926563917
"E02005020",555,580,217,203,377,352,2665,0.208255159474672,0.217636022514071,0.0814258911819887,0.076172607879925,0.141463414634146,0.132082551594747
"E02005021",416,541,223,164,377,252,1933,0.215209518882566,0.279875840662183,0.115364718054837,0.0848422141748577,0.195033626487325,0.130367304707708
"E02005022",553,1119,302,321,798,232,2880,0.192013888888889,0.388541666666667,0.104861111111111,0.111458333333333,0.277083333333333,0.0805555555555556
"E02005023",479,877,552,226,651,253,4663,0.102723568518121,0.188076345700193,0.118378726141969,0.0484666523697191,0.139609693330474,0.0542569161484023
"E02005025",572,935,701,234,701,338,3706,0.154344306529951,0.252293577981651,0.189152725310308,0.0631408526713438,0.189152725310308,0.0912034538586077
"E02005026",477,478,394,157,321,320,2842,0.167839549612949,0.168191414496833,0.138634764250528,0.0552427867698804,0.112948627726953,0.112596762843068
"E02005027",402,357,402,129,228,273,1679,0.239428231089934,0.212626563430613,0.239428231089934,0.0768314472900536,0.13579511614056,0.162596783799881
"E02005028",338,281,90,82,199,256,5062,0.066772026866851,0.0555116554721454,0.0177795337811142,0.0161991307783485,0.0393125246937969,0.0505728960885026
"E02005029",441,324,651,94,230,347,7694,0.0573173901741617,0.0421107356381596,0.0846113854951911,0.0122173121913179,0.0298934234468417,0.0451000779828438
"E02005030",565,369,1690,109,260,456,5108,0.110610806577917,0.072239624119029,0.330853563038371,0.0213390759592796,0.0509005481597494,0.0892717306186374
"E02005031",366,317,762,66,251,300,3373,0.10850874592351,0.0939816187370294,0.225911651348948,0.0195671509042395,0.0744144678327898,0.0889415950192707
"E02005032",710,326,1802,91,235,619,3809,0.186400630086637,0.0855867681806248,0.473090049881859,0.0238907849829352,0.0616959831976897,0.162509845103702
"E02005033",462,373,725,85,288,377,3378,0.136767317939609,0.110420367081113,0.214624037892244,0.0251628182356424,0.0852575488454707,0.111604499703967
"E02005034",402,365,1112,116,249,286,1772,0.22686230248307,0.205981941309255,0.627539503386005,0.0654627539503386,0.140519187358916,0.161399548532731
"E02005035",446,400,726,115,285,331,2338,0.190761334473909,0.171086398631309,0.310521813515825,0.0491873396065013,0.121899059024808,0.141573994867408
"E02005036",306,339,1058,64,275,242,2485,0.123138832997988,0.136418511066398,0.425754527162978,0.0257545271629779,0.110663983903421,0.0973843058350101
"E02005037",407,412,350,153,259,254,1829,0.22252597047567,0.225259704756698,0.191361399671952,0.0836522689994533,0.141607435757244,0.138873701476216
"E02005038",327,381,542,115,266,212,1614,0.202602230483271,0.236059479553903,0.335811648079306,0.0712515489467162,0.164807930607187,0.131350681536555
"E02005039",467,496,516,172,324,295,1950,0.239487179487179,0.254358974358974,0.264615384615385,0.0882051282051282,0.166153846153846,0.151282051282051
"E02005040",440,383,347,143,240,297,1877,0.234416622269579,0.204049014384656,0.1848694725626,0.0761854022376132,0.127863612147043,0.158231220031966
"E02005041",469,376,594,137,239,332,2460,0.190650406504065,0.152845528455285,0.241463414634146,0.0556910569105691,0.0971544715447154,0.134959349593496
"E02005042",659,762,729,216,546,443,3644,0.180845225027442,0.209110867178924,0.200054884742042,0.0592755214050494,0.149835345773875,0.121569703622393
"E02005043",524,625,476,177,448,347,2896,0.180939226519337,0.215814917127072,0.164364640883978,0.0611187845303867,0.154696132596685,0.11982044198895
"E02005044",597,387,1878,90,297,507,3608,0.165465631929047,0.107261640798226,0.520509977827051,0.0249445676274945,0.0823170731707317,0.140521064301552
"E02005045",459,569,237,157,412,302,3142,0.146085295989815,0.181094844048377,0.0754296626352642,0.0499681731381286,0.131126670910248,0.0961171228516868
"E02005046",367,629,181,140,489,227,3443,0.106593087423758,0.182689514957886,0.0525704327621261,0.0406622131861748,0.142027301771711,0.0659308742375835
"E02005047",507,917,379,191,726,316,3143,0.161310849506841,0.291759465478842,0.120585427935094,0.0607699650015908,0.230989500477251,0.10054088450525
"E02005048",460,471,364,138,333,322,2054,0.223953261927945,0.229308666017527,0.177215189873418,0.0671859785783836,0.162122687439143,0.156767283349562
"E02005049",709,625,494,244,381,465,2875,0.246608695652174,0.217391304347826,0.171826086956522,0.0848695652173913,0.132521739130435,0.161739130434783
"E02005050",581,632,326,188,444,393,3361,0.172865218684915,0.188039274025588,0.0969949419815531,0.0559357334126748,0.132103540612913,0.11692948527224
"E02005051",1146,1238,1375,285,953,861,5767,0.198716837177042,0.214669672273279,0.238425524536154,0.0494191087220392,0.16525056355124,0.149297728455003
"E02005052",571,764,1783,117,647,454,4428,0.128952122854562,0.172538392050587,0.402664859981933,0.0264227642276423,0.146115627822945,0.10252935862692
"E02005053",654,785,2029,151,634,503,4140,0.157971014492754,0.189613526570048,0.490096618357488,0.0364734299516908,0.153140096618357,0.121497584541063
"E02005054",474,572,265,175,397,299,2005,0.23640897755611,0.285286783042394,0.13216957605985,0.0872817955112219,0.198004987531172,0.149127182044888
"E02005055",415,505,1128,101,404,314,3817,0.10872412889704,0.132302855645795,0.295520041917736,0.026460571129159,0.105842284516636,0.0822635577678805
"E02005056",534,585,2432,51,534,483,5647,0.0945634850363025,0.103594829112803,0.430671152824509,0.0090313440765008,0.0945634850363025,0.0855321409598017
"E02005057",625,721,1125,195,526,430,3971,0.157391085368925,0.181566356081592,0.283303953664064,0.0491060186351045,0.132460337446487,0.10828506673382
"E02005058",498,300,1450,72,228,426,2731,0.182350787257415,0.109849871841816,0.530941047235445,0.0263639692420359,0.0834859025997803,0.155986818015379
"E02005059",631,410,1871,109,301,522,2998,0.2104736490994,0.136757838559039,0.624082721814543,0.0363575717144763,0.100400266844563,0.174116077384923
"E02005060",404,350,483,121,229,283,2900,0.139310344827586,0.120689655172414,0.166551724137931,0.0417241379310345,0.0789655172413793,0.0975862068965517
"E02005061",481,550,309,153,397,328,2582,0.186289697908598,0.213013168086754,0.119674670797831,0.0592563903950426,0.153756777691712,0.127033307513555
"E02005062",392,546,94,173,373,219,1695,0.231268436578171,0.32212389380531,0.0554572271386431,0.102064896755162,0.220058997050148,0.129203539823009
"E02005063",352,479,199,130,349,222,2388,0.147403685092127,0.200586264656616,0.0833333333333333,0.0544388609715243,0.146147403685092,0.092964824120603
"E02005064",460,406,339,145,261,315,1839,0.250135943447526,0.220772158781947,0.184339314845024,0.078847199564981,0.141924959216966,0.171288743882545
"E02005065",547,742,176,210,532,337,3318,0.164858348402652,0.223628691983122,0.053044002411091,0.0632911392405063,0.160337552742616,0.101567209162146
"E02005066",555,612,305,215,397,340,2073,0.267727930535456,0.295224312590449,0.147129763627593,0.103714423540762,0.191509889049686,0.164013506994694
"E02005067",386,552,239,194,358,192,1548,0.249354005167959,0.356589147286822,0.154392764857881,0.125322997416021,0.231266149870801,0.124031007751938
"E02005068",513,458,202,171,287,342,2178,0.235537190082645,0.210284664830119,0.0927456382001837,0.0785123966942149,0.131772268135905,0.15702479338843
"E02005069",620,772,627,279,493,341,2782,0.222861250898634,0.277498202731848,0.225377426312006,0.100287562904385,0.177210639827462,0.122573687994249
"E02005070",657,601,82,201,400,456,3171,0.207190160832545,0.189530116682435,0.0258593503626616,0.0633869441816462,0.126143172500788,0.143803216650899
"E02005071",580,553,1950,98,455,482,7487,0.0774676105249098,0.0738613596901296,0.260451449178576,0.0130893548817951,0.0607720048083344,0.0643782556431147
"E02005072",543,436,107,150,286,393,2241,0.242302543507363,0.194556001784917,0.0477465417224453,0.0669344042838019,0.127621597501116,0.175368139223561
"E02005073",570,749,1650,144,605,426,5557,0.102573330933957,0.134784955911463,0.296922800071981,0.0259132625517365,0.108871693359726,0.0766600683822206
"E02005074",611,602,260,213,389,398,2586,0.236272235112142,0.232791956689869,0.100541376643465,0.0823665893271462,0.150425367362722,0.153905645784996
"E02005075",499,646,797,165,481,334,3867,0.12904059994828,0.167054564261702,0.206102922161883,0.0426687354538402,0.124385828807861,0.0863718644944401
"E02005076",549,525,917,129,396,420,4049,0.135589034329464,0.12966164485058,0.22647567300568,0.0318597184489998,0.0978019264015806,0.103729315880464
"E02005077",370,586,485,126,460,244,2883,0.128338536246965,0.20326049254249,0.168227540756157,0.0437044745057232,0.159556018036767,0.0846340617412418
"E02005078",565,480,558,146,334,419,3349,0.168707076739325,0.143326366079427,0.166616900567334,0.0435951030158256,0.0997312630636011,0.1251119737235
"E02005079",467,605,349,186,419,281,2944,0.158627717391304,0.205502717391304,0.118546195652174,0.063179347826087,0.142323369565217,0.0954483695652174
"E02005080",603,893,212,202,691,401,5658,0.106574761399788,0.157829621774479,0.0374690703428773,0.0357016613644397,0.122127960410039,0.0708731000353482
"E02005081",423,418,454,136,282,287,2293,0.184474487570868,0.182293938072394,0.197993894461404,0.0593109463584823,0.122982991713912,0.125163541212386
"E02005082",576,450,367,149,301,427,4936,0.116693679092382,0.0911669367909238,0.0743517017828201,0.0301863857374392,0.0609805510534846,0.0865072933549433
"E02005083",407,459,307,136,323,271,2859,0.14235746764603,0.160545645330535,0.107380202868136,0.0475690800979363,0.112976565232599,0.0947883875480937
"E02005084",449,366,404,117,249,332,2813,0.159616068254533,0.130110202630643,0.143618912193388,0.0415926057589762,0.0885175968716673,0.118023462495556
"E02005085",496,441,523,169,272,327,2710,0.183025830258303,0.162730627306273,0.192988929889299,0.0623616236162362,0.100369003690037,0.120664206642066
"E02005086",455,592,231,211,381,244,2510,0.181274900398406,0.235856573705179,0.0920318725099602,0.0840637450199203,0.151792828685259,0.0972111553784861
"E02005087",431,509,454,187,322,244,1977,0.21800708143652,0.257460799190693,0.229640870005058,0.0945877592311583,0.162873039959535,0.123419322205362
"E02005088",543,538,394,141,397,402,3140,0.172929936305732,0.171337579617834,0.125477707006369,0.0449044585987261,0.126433121019108,0.128025477707006
"E02005089",363,515,389,160,355,203,1997,0.181772658988483,0.257886830245368,0.194792188282424,0.0801201802704056,0.177766649974962,0.101652478718077
"E02005090",361,365,164,151,214,210,1468,0.24591280653951,0.248637602179837,0.111716621253406,0.102861035422343,0.145776566757493,0.143051771117166
"E02005091",432,423,581,132,291,300,2093,0.206402293358815,0.202102245580506,0.277591973244147,0.0630673674151935,0.139034878165313,0.143334925943622
"E02005093",440,419,257,166,253,274,1616,0.272277227722772,0.259282178217822,0.159034653465347,0.102722772277228,0.156559405940594,0.169554455445545
"E02005094",567,670,714,205,465,362,3462,0.163778162911612,0.193529751588677,0.206239168110919,0.0592143269786251,0.134315424610052,0.104563835932987
"E02005095",491,598,257,207,391,284,2056,0.238813229571984,0.290856031128405,0.125,0.10068093385214,0.190175097276265,0.138132295719844
"E02005096",628,756,735,213,543,415,3357,0.187071790288948,0.225201072386059,0.218945487042002,0.063449508489723,0.161751563896336,0.123622281799226
"E02005097",571,806,463,237,569,334,2599,0.219699884570989,0.310119276644863,0.178145440554059,0.0911889188149288,0.218930357829935,0.12851096575606
"E02005098",667,783,847,250,533,417,3898,0.171113391482812,0.200872242175475,0.217290918419702,0.0641354540790149,0.13673678809646,0.106977937403797
"E02005099",591,615,738,200,415,391,2537,0.232952305873078,0.242412297989752,0.290894757587702,0.0788332676389436,0.163579030350808,0.154119038234135
"E02005100",627,614,409,216,398,411,3412,0.183763188745604,0.179953106682298,0.119871043376319,0.063305978898007,0.116647127784291,0.120457209847597
"E02005101",508,436,608,154,282,354,2204,0.23049001814882,0.197822141560799,0.275862068965517,0.0698729582577133,0.127949183303085,0.160617059891107
"E02005102",526,464,312,195,269,331,2005,0.262344139650873,0.23142144638404,0.155610972568579,0.0972568578553616,0.134164588528678,0.165087281795511
"E02005103",442,369,54,106,263,336,3687,0.119880661784649,0.100081366965012,0.0146460537021969,0.0287496609709791,0.0713317059940331,0.0911310008136696
"E02005104",523,1104,194,285,819,238,3062,0.170803396472894,0.360548661005879,0.0633572828216852,0.0930764206401045,0.267472240365774,0.077726975832789
"E02005105",892,1172,1110,438,734,454,3317,0.268917696713898,0.353331323485077,0.33463973470003,0.132047030449201,0.221284293035876,0.136870666264697
"E02005106",573,1159,240,303,856,270,3818,0.150078575170246,0.303562074384495,0.0628601361969618,0.0793609219486642,0.22420115243583,0.070717653221582
"E02005107",972,1562,656,461,1101,511,5211,0.186528497409326,0.299750527729802,0.125887545576665,0.0884667050470159,0.211283822682786,0.0980617923623105
"E02005109",657,655,371,258,397,399,2547,0.257950530035336,0.257165292500982,0.145661562622693,0.101295641931684,0.155869650569297,0.156654888103651
"E02005110",597,538,242,221,317,376,2640,0.226136363636364,0.203787878787879,0.0916666666666667,0.0837121212121212,0.120075757575758,0.142424242424242
"E02005111",588,881,815,228,653,360,3674,0.160043549265106,0.239793140990746,0.221829069134458,0.0620577027762656,0.17773543821448,0.0979858464888405
"E02005112",631,609,275,232,377,399,2618,0.241023682200153,0.232620320855615,0.105042016806723,0.0886172650878533,0.144003055767762,0.152406417112299
"E02005113",648,584,243,213,371,435,3005,0.215640599001664,0.194342762063228,0.080865224625624,0.0708818635607321,0.123460898502496,0.144758735440932
"E02005114",591,665,292,231,434,360,2470,0.239271255060729,0.269230769230769,0.118218623481781,0.0935222672064777,0.175708502024292,0.145748987854251
"E02005115",624,331,2005,96,235,528,2707,0.230513483561138,0.122275581824898,0.74067233099372,0.0354636128555597,0.0868119689693388,0.195049870705578
"E02005116",501,370,518,106,264,395,2605,0.19232245681382,0.142034548944338,0.198848368522073,0.0406909788867562,0.101343570057582,0.151631477927063
"E02005117",552,389,229,160,229,392,2231,0.247422680412371,0.174361272971762,0.102644554011654,0.0717167189601076,0.102644554011654,0.175705961452264
"E02005118",600,529,363,179,350,421,3712,0.161637931034483,0.142510775862069,0.0977909482758621,0.0482219827586207,0.0942887931034483,0.113415948275862
"E02005119",477,394,419,166,228,311,2424,0.196782178217822,0.162541254125413,0.172854785478548,0.0684818481848185,0.0940594059405941,0.128300330033003
"E02005120",595,551,238,226,325,369,2535,0.234714003944773,0.217357001972387,0.0938856015779093,0.0891518737672584,0.128205128205128,0.145562130177515
"E02005121",693,485,133,140,345,553,4578,0.151376146788991,0.105941459152468,0.0290519877675841,0.0305810397553517,0.0753604193971166,0.120795107033639
"E02005122",506,455,339,174,281,332,2296,0.220383275261324,0.198170731707317,0.147648083623693,0.0757839721254355,0.122386759581882,0.144599303135889
"E02005123",582,659,482,220,439,362,4635,0.125566343042071,0.14217907227616,0.103991370010787,0.0474649406688242,0.0947141316073355,0.078101402373247
"E02005124",568,756,1114,159,597,409,4342,0.130815292491939,0.174113311837863,0.256563795485951,0.0366190695532013,0.137494242284661,0.0941962229387379
"E02005125",533,730,181,213,517,320,3012,0.176958831341301,0.242363877822045,0.0600929614873838,0.0707171314741036,0.171646746347942,0.106241699867198
"E02005126",541,573,554,165,408,376,2596,0.208397534668721,0.220724191063174,0.213405238828968,0.0635593220338983,0.157164869029276,0.144838212634823
"E02005127",455,501,346,174,327,281,2924,0.155608755129959,0.171340629274966,0.118331053351573,0.0595075239398085,0.111833105335157,0.0961012311901505
"E02005128",635,553,431,192,361,443,3665,0.173260572987722,0.150886766712142,0.117598908594816,0.052387448840382,0.0984993178717599,0.12087312414734
"E02005129",752,769,1361,197,572,555,4667,0.161131347760874,0.164773944718234,0.291622026998072,0.0422112706235269,0.122562674094708,0.118920077137347
"E02005130",656,530,799,187,343,469,3302,0.198667474258025,0.160508782556027,0.241974560872199,0.0566323440339188,0.103876438522108,0.142035130224107
"E02005131",425,362,471,148,214,277,1849,0.229853975121687,0.195781503515414,0.254732287723094,0.0800432666306111,0.115738236884803,0.149810708491076
"E02005132",781,512,3762,86,426,695,6717,0.116272145302963,0.0762245049873455,0.560071460473426,0.0128033348220932,0.0634211701652523,0.103468810480869
"E02005133",771,913,477,308,605,463,3517,0.219220926926358,0.259596246801251,0.135626954791015,0.0875746374751208,0.17202160932613,0.131646289451237
"E02005134",577,452,2253,108,344,469,4303,0.13409249360911,0.105042993260516,0.523588194283058,0.0250987683011852,0.0799442249593307,0.108993725307925
"E02005135",561,505,1081,178,327,383,3076,0.182379713914174,0.164174252275683,0.351430429128739,0.0578673602080624,0.10630689206762,0.124512353706112
"E02005136",547,646,443,212,434,335,2639,0.207275483137552,0.244789693065555,0.167866616142478,0.0803334596438045,0.164456233421751,0.126942023493748
"E02005137",482,588,292,163,425,319,3156,0.152724968314322,0.186311787072243,0.0925221799746515,0.0516476552598226,0.134664131812421,0.101077313054499
"E02005138",656,764,1173,217,547,439,4168,0.157389635316699,0.183301343570058,0.281429942418426,0.052063339731286,0.131238003838772,0.105326295585413
"E02005139",802,1077,494,324,753,478,3545,0.2262341325811,0.303808180535966,0.13935119887165,0.0913963328631876,0.212411847672779,0.134837799717913
"E02005140",647,795,747,220,575,427,3059,0.211507028440667,0.259888852566198,0.244197450147107,0.071918927754168,0.18796992481203,0.139588100686499
"E02005141",598,541,1406,167,374,431,3457,0.172982354642754,0.156494070002893,0.406711021116575,0.0483077813132774,0.108186288689615,0.124674573329476
"E02005142",583,658,252,240,418,343,3026,0.192663582286847,0.217448777263714,0.0832782551222736,0.0793126239259749,0.13813615333774,0.113350958360872
"E02005143",551,585,1104,165,420,386,3105,0.177455716586151,0.188405797101449,0.355555555555556,0.0531400966183575,0.135265700483092,0.124315619967794
"E02005144",462,710,267,205,505,257,3702,0.124797406807131,0.191788222582388,0.0721231766612642,0.05537547271745,0.136412749864938,0.0694219340896813
"E02005145",467,487,524,177,310,290,3527,0.132407144882336,0.138077686419053,0.148568188261979,0.0501842925999433,0.0878933938191097,0.082222852282393
"E02005146",523,411,1790,89,322,434,3140,0.16656050955414,0.130891719745223,0.570063694267516,0.028343949044586,0.102547770700637,0.138216560509554
"E02005147",694,472,2832,60,412,634,6030,0.115091210613599,0.0782752902155887,0.469651741293532,0.00995024875621891,0.0683250414593698,0.10514096185738
"E02005148",592,634,354,228,406,364,2944,0.201086956521739,0.215353260869565,0.120244565217391,0.077445652173913,0.137907608695652,0.123641304347826
"E02005149",630,621,683,205,416,425,4288,0.146921641791045,0.14482276119403,0.15928171641791,0.0478078358208955,0.0970149253731343,0.0991138059701493
"E02005150",684,699,746,224,475,460,4557,0.15009874917709,0.15339038841343,0.163704191353961,0.0491551459293395,0.10423524248409,0.100943603247751
"E02005151",645,786,242,230,556,415,3724,0.173200859291085,0.211063372717508,0.064983888292159,0.0617615467239527,0.149301825993555,0.111439312567132
"E02005153",499,592,309,196,396,303,3207,0.155597131275335,0.18459619582164,0.0963517305893358,0.0611163080760836,0.123479887745557,0.0944808231992516
"E02005154",711,619,785,223,396,488,3533,0.201245400509482,0.175205208038494,0.222190772714407,0.0631191621851118,0.112086045853382,0.13812623832437
"E02005155",305,257,348,86,171,219,4694,0.0649765658287175,0.0547507456327226,0.0741371964209629,0.0183212611844908,0.0364294844482318,0.0466553046442267
"E02005156",421,398,447,148,250,273,2025,0.207901234567901,0.196543209876543,0.220740740740741,0.0730864197530864,0.123456790123457,0.134814814814815
"E02005157",367,354,136,104,250,263,1746,0.210194730813288,0.202749140893471,0.0778923253150057,0.0595647193585338,0.143184421534937,0.150630011454754
"E02005158",444,505,260,157,348,287,1934,0.229576008273009,0.261116856256463,0.134436401240951,0.0811789038262668,0.179937952430196,0.148397104446743
"E02005159",485,524,144,167,357,318,2171,0.223399355135882,0.24136342699217,0.0663288807001382,0.0769230769230769,0.164440350069093,0.146476278212805
"E02005160",591,493,1300,119,374,472,5179,0.114114693956362,0.0951921220312802,0.251013709210272,0.0229774087661711,0.0722147132651091,0.0911372851901912
"E02005161",572,412,1030,127,285,445,2967,0.192787327266599,0.138860802157061,0.347152005392653,0.042804179305696,0.096056622851365,0.149983147960903
"E02005162",555,665,424,189,476,366,4092,0.135630498533724,0.162512218963832,0.103616813294233,0.0461876832844575,0.116324535679374,0.0894428152492669
"E02005163",506,514,913,159,355,347,2597,0.194840200231036,0.197920677705044,0.351559491721217,0.0612244897959184,0.136696187909126,0.133615710435117
"E02005164",561,594,727,153,441,408,3592,0.156180400890869,0.165367483296214,0.20239420935412,0.0425946547884187,0.122772828507795,0.11358574610245
"E02005165",547,607,475,206,401,341,2413,0.226688769167012,0.251554082055533,0.196850393700787,0.0853709075839204,0.166183174471612,0.141317861583092
"E02005166",422,382,268,100,282,322,2562,0.164715066354411,0.149102263856362,0.104605776736924,0.039032006245121,0.110070257611241,0.12568306010929
"E02005167",496,483,664,157,326,339,2241,0.221329763498438,0.215528781793842,0.296296296296296,0.070058009817046,0.145470771976796,0.151271753681392
"E02005168",537,375,1411,107,268,430,3095,0.173505654281099,0.121163166397415,0.455896607431341,0.0345718901453958,0.0865912762520194,0.138933764135703
"E02005169",567,366,2612,56,310,511,5768,0.0983009708737864,0.0634535367545076,0.452843273231623,0.00970873786407767,0.05374479889043,0.0885922330097087
"E02005170",648,592,1494,161,431,487,4039,0.16043575142362,0.146570933399356,0.369893538004457,0.0398613518197574,0.106709581579599,0.120574399603862
"E02005171",333,398,601,90,308,243,2443,0.136307818256242,0.162914449447401,0.246009005321326,0.0368399508800655,0.126074498567335,0.0994678673761768
"E02005172",647,496,723,189,307,458,2566,0.252143413873733,0.193296960249415,0.281761496492595,0.073655494933749,0.119641465315666,0.178487918939984
"E02005173",622,554,1246,149,405,473,3665,0.169713506139154,0.151159618008186,0.339972714870396,0.0406548431105048,0.110504774897681,0.129058663028649
"E02005174",547,464,404,158,306,389,2492,0.219502407704655,0.186195826645265,0.162118780096308,0.0634028892455859,0.122792937399679,0.156099518459069
"E02005175",637,461,605,168,293,469,2813,0.226448631354426,0.163881976537504,0.215072875933167,0.0597227159616068,0.104159260575898,0.166725915392819
"E02005176",514,684,689,159,525,355,2872,0.178969359331476,0.238161559888579,0.239902506963788,0.0553621169916435,0.182799442896936,0.123607242339833
"E02005177",444,782,1209,147,635,297,2509,0.176962933439617,0.311677959346353,0.481865284974093,0.0585890793144679,0.253088880031885,0.118373854125149
"E02005178",617,1001,2480,145,856,472,4255,0.145005875440658,0.235252643948296,0.582843713278496,0.0340775558166862,0.20117508813161,0.110928319623972
"E02005179",701,731,1965,161,570,540,4241,0.165291204904504,0.172365008252771,0.463334119311483,0.0379627446356991,0.134402263617071,0.127328460268805
"E02005180",353,429,284,118,311,235,2251,0.156819191470458,0.190581963571746,0.126166148378498,0.0524211461572634,0.138160817414482,0.104398045313194
"E02005181",438,685,1375,156,529,282,3245,0.13497688751926,0.211093990755008,0.423728813559322,0.0480739599383667,0.163020030816641,0.0869029275808937
"E02005182",466,805,1659,156,649,310,3216,0.144900497512438,0.250310945273632,0.515858208955224,0.0485074626865672,0.201803482587065,0.0963930348258707
"E02005183",350,572,121,104,468,246,2385,0.146750524109015,0.239832285115304,0.0507337526205451,0.0436058700209644,0.19622641509434,0.10314465408805
"E02005184",325,299,494,89,210,236,1613,0.201487910725356,0.185368877867328,0.306261624302542,0.0551766893986361,0.130192188468692,0.14631122132672
"E02005185",816,955,1829,227,728,589,4955,0.16468213925328,0.192734611503532,0.36912209889001,0.0458123107971746,0.146922300706357,0.118869828456105
"E02005186",288,344,471,69,275,219,2111,0.136428233064898,0.162955945049739,0.223117006158219,0.0326859308384652,0.130270014211274,0.103742302226433
"E02005189",357,316,27,93,223,264,2462,0.145004061738424,0.128350934199838,0.0109666937449228,0.0377741673436231,0.0905767668562145,0.107229894394801
"E02005190",359,451,656,127,324,232,1792,0.200334821428571,0.251674107142857,0.366071428571429,0.0708705357142857,0.180803571428571,0.129464285714286
"E02005191",515,421,41,159,262,356,3039,0.169463639355051,0.138532411977624,0.0134912800263244,0.052319842053307,0.0862125699243172,0.117143797301744
"E02005192",345,471,232,136,335,209,3044,0.113337713534823,0.15473061760841,0.076215505913272,0.0446780551905388,0.110052562417871,0.0686596583442838
"E02005193",466,510,78,141,369,325,2615,0.178202676864245,0.195028680688337,0.0298279158699809,0.0539196940726577,0.141108986615679,0.124282982791587
"E02005194",466,880,209,234,646,232,3078,0.151397011046134,0.285899935022742,0.0679012345679012,0.0760233918128655,0.209876543209877,0.0753736192332684
"E02005195",373,563,291,171,392,202,1909,0.195390256678889,0.294918805657412,0.152435830277632,0.0895756940806705,0.205343111576742,0.105814562598219
"E02005196",410,513,27,175,338,235,4484,0.0914362176628011,0.114406779661017,0.006021409455843,0.0390276538804639,0.0753791257805531,0.0524085637823372
"E02005197",382,747,264,159,588,223,2995,0.12754590984975,0.249415692821369,0.0881469115191987,0.0530884808013356,0.196327212020033,0.074457429048414
"E02005198",564,1084,352,277,807,287,4128,0.136627906976744,0.262596899224806,0.0852713178294574,0.0671027131782946,0.195494186046512,0.0695251937984496
"E02005199",468,583,211,214,369,254,2265,0.206622516556291,0.257395143487859,0.0931567328918322,0.0944812362030905,0.162913907284768,0.112141280353201
"E02005200",403,495,87,132,363,271,3469,0.116171807437302,0.142692418564428,0.0250792735658691,0.0380513116171807,0.104641106947247,0.0781204958201211
"E02005201",453,706,154,207,499,246,2685,0.168715083798883,0.262942271880819,0.0573556797020484,0.0770949720670391,0.18584729981378,0.0916201117318436
"E02005202",562,820,589,229,591,333,3183,0.176562990889098,0.257618598806158,0.185045554508325,0.0719447062519636,0.185673892554194,0.104618284637135
"E02005203",422,566,192,171,395,251,2928,0.144125683060109,0.193306010928962,0.0655737704918033,0.0584016393442623,0.134904371584699,0.085724043715847
"E02005204",683,938,412,274,664,409,4711,0.144979834430057,0.199108469539376,0.0874548928040756,0.0581617490978561,0.14094672044152,0.0868180853322012
"E02005205",336,399,132,121,278,215,2083,0.161305808929429,0.191550648103697,0.0633701392222756,0.0580892942870859,0.133461353816611,0.103216514642343
"E02005206",499,788,56,232,556,267,3165,0.157661927330174,0.248973143759874,0.0176935229067931,0.0733017377567141,0.17567140600316,0.0843601895734597
"E02005207",635,979,69,288,691,347,3594,0.176683361157485,0.272398441847524,0.0191986644407346,0.0801335559265442,0.192264885920979,0.0965498052309404
"E02005208",962,2672,740,594,2078,368,6244,0.154067905188981,0.427930813581038,0.118513773222293,0.0951313260730301,0.332799487508008,0.0589365791159513
"E02005209",597,718,151,232,486,365,3655,0.163337893296854,0.196443228454172,0.041313269493844,0.0634746922024624,0.13296853625171,0.0998632010943912
"E02005210",727,1649,250,402,1247,325,4253,0.170938161297907,0.387726310839407,0.0587820362097343,0.0945215142252528,0.293204796614155,0.0764166470726546
"E02005211",784,1042,715,310,732,474,4003,0.195853110167374,0.260304771421434,0.178616037971521,0.0774419185610792,0.182862852860355,0.118411191606295
"E02005212",724,1342,1742,324,1018,400,4194,0.172627563185503,0.31998092513114,0.415355269432523,0.0772532188841202,0.24272770624702,0.0953743443013829
"E02005213",762,941,1237,230,711,532,4077,0.186902133922001,0.230806965906304,0.303409369634535,0.0564140299239637,0.17439293598234,0.130488103998038
"E02005214",600,608,1216,162,446,438,2562,0.234192037470726,0.237314597970336,0.474629195940671,0.063231850117096,0.17408274785324,0.17096018735363
"E02005215",968,1103,2441,294,809,674,5108,0.189506656225529,0.215935787000783,0.477877838684417,0.057556773688332,0.158379013312451,0.131949882537197
"E02005216",411,540,801,144,396,267,2146,0.191519105312209,0.251630941286114,0.373252562907735,0.0671015843429636,0.18452935694315,0.124417520969245
"E02005217",872,1007,2293,246,761,626,4686,0.186086214255228,0.214895433205292,0.489329918907384,0.0524967989756722,0.16239863422962,0.133589415279556
"E02005218",610,651,1341,180,471,430,3075,0.198373983739837,0.211707317073171,0.43609756097561,0.0585365853658537,0.153170731707317,0.139837398373984
"E02005219",574,686,1166,185,501,389,3222,0.178150217256363,0.212911235257604,0.361887026691496,0.0574177529484792,0.155493482309125,0.120732464307883
"E02005220",417,490,480,153,337,264,1886,0.221102863202545,0.259809119830329,0.254506892895016,0.0811240721102863,0.178685047720042,0.139978791092259
"E02005221",650,676,1022,205,471,445,3640,0.178571428571429,0.185714285714286,0.280769230769231,0.0563186813186813,0.129395604395604,0.122252747252747
"E02005222",437,288,673,117,171,320,2069,0.211213146447559,0.139197680038666,0.325277912034799,0.0565490575157081,0.0826486225229579,0.154664088931851
"E02005223",560,709,216,263,446,297,2246,0.2493321460374,0.315672306322351,0.0961709706144256,0.117097061442565,0.198575244879786,0.132235084594835
"E02005224",490,936,276,257,679,233,2287,0.214254481853957,0.409269785745518,0.120682116309576,0.112374289462178,0.296895496283341,0.10188019239178
"E02005225",388,305,320,120,185,268,2061,0.188258127122756,0.14798641436196,0.155264434740417,0.0582241630276565,0.0897622513343037,0.130033964095099
"E02005226",873,1087,1505,351,736,522,3765,0.231872509960159,0.28871181938911,0.399734395750332,0.0932270916334661,0.195484727755644,0.138645418326693
"E02005228",470,817,219,261,556,209,1879,0.250133049494412,0.434805747738159,0.116551357104843,0.138903672166046,0.295902075572113,0.111229377328366
"E02005229",802,1109,1614,317,792,485,3418,0.234640140433002,0.324458747805734,0.472205968402575,0.0927442949093037,0.231714452896431,0.141895845523698
"E02005230",565,558,40,196,362,369,2657,0.212645841174257,0.21001129092962,0.015054572826496,0.0737674068498306,0.136243884079789,0.138878434324426
"E02005231",522,570,873,166,404,356,3577,0.145932345540956,0.159351411797596,0.244059267542633,0.0464076041375454,0.11294380766005,0.0995247414034107
"E02005233",357,425,558,106,319,251,3086,0.115683732987686,0.137718729747246,0.180816591056384,0.034348671419313,0.103370058327933,0.0813350615683733
"E02005234",526,278,1455,70,208,456,4028,0.130585898709037,0.0690168818272095,0.361221449851043,0.0173783515392254,0.0516385302879841,0.113207547169811
"E02005235",614,403,1605,106,297,508,2283,0.268944371441086,0.176522120017521,0.703022339027595,0.0464301357862462,0.130091984231275,0.22251423565484
"E02005236",943,1178,405,410,768,533,4708,0.200297366185217,0.250212404418012,0.0860237892948173,0.0870858113848768,0.163126593033135,0.11321155480034
"E02005237",580,586,1014,145,441,435,3968,0.14616935483871,0.147681451612903,0.25554435483871,0.0365423387096774,0.111139112903226,0.109627016129032
"E02005238",376,479,338,146,333,230,1933,0.194516295913088,0.247801345059493,0.174857734092085,0.0755302638385929,0.1722710812209,0.118986032074496
"E02005239",411,317,560,124,193,287,2540,0.161811023622047,0.124803149606299,0.220472440944882,0.0488188976377953,0.0759842519685039,0.112992125984252
"E02005240",504,284,954,85,199,419,2084,0.241842610364683,0.136276391554703,0.457773512476008,0.0407869481765835,0.095489443378119,0.2010556621881
"E02005241",540,261,1333,73,188,467,2138,0.252572497661366,0.122076707202993,0.623479887745557,0.0341440598690365,0.087932647333957,0.218428437792329
"E02005242",569,340,1032,92,248,477,2289,0.248580166011359,0.148536478811708,0.450851900393185,0.0401922236784622,0.108344255133246,0.208387942332896
"E02005245",435,360,1064,92,268,343,2318,0.187661777394305,0.155306298533218,0.459016393442623,0.0396893874029336,0.115616911130285,0.147972389991372
"E02005246",440,391,1232,76,315,364,2504,0.175718849840256,0.156150159744409,0.492012779552716,0.0303514376996805,0.125798722044728,0.145367412140575
"E02005247",700,693,1358,196,497,504,3587,0.195149149707276,0.193197658210204,0.378589350432116,0.0546417619180374,0.138555896292166,0.140507387789239
"E02005248",423,668,1230,119,549,304,2776,0.152377521613833,0.240634005763689,0.443083573487032,0.0428674351585014,0.197766570605187,0.109510086455331
"E02005249",807,1087,2435,225,862,582,4321,0.186762323536218,0.25156213839389,0.563526961351539,0.0520712797963434,0.199490858597547,0.134691043739875
"E02005250",456,901,1467,167,734,289,2775,0.164324324324324,0.324684684684685,0.528648648648649,0.0601801801801802,0.264504504504505,0.104144144144144
"E02005251",352,728,324,159,569,193,2287,0.153913423699169,0.318320944468736,0.141670310450372,0.0695233930913861,0.24879755137735,0.0843900306077831
"E02005252",604,1048,1197,246,802,358,3417,0.176763242610477,0.306701785191689,0.350307287093942,0.0719929762949956,0.234708808896693,0.104770266315481
"E02005253",305,438,226,113,325,192,3105,0.0982286634460548,0.141062801932367,0.0727858293075684,0.0363929146537842,0.104669887278583,0.0618357487922705
"E02005254",393,467,183,163,304,230,5063,0.0776219632628876,0.0922378036737112,0.036144578313253,0.0321943511751926,0.0600434524985187,0.045427612087695
"E02005255",611,754,44,242,512,369,2799,0.218292247231154,0.269381922115041,0.015719899964273,0.0864594498035012,0.18292247231154,0.131832797427653
"E02005256",273,271,18,69,202,204,2142,0.127450980392157,0.126517273576097,0.00840336134453781,0.0322128851540616,0.0943043884220355,0.0952380952380952
"E02005257",403,324,17,97,227,306,2897,0.139109423541595,0.111839834311357,0.00586813945460822,0.0334829133586469,0.0783569209527097,0.105626510182948
"E02005258",517,912,188,247,665,270,2612,0.197932618683002,0.349157733537519,0.0719754977029096,0.0945635528330781,0.254594180704441,0.103369065849923
"E02005259",471,615,62,152,463,319,3537,0.133163698049194,0.173876166242578,0.0175289793610404,0.0429742719819056,0.130901894260673,0.0901894260672887
"E02005260",381,560,47,170,390,211,1931,0.197307094769549,0.290005178663905,0.0243397203521491,0.0880372863801139,0.201967892283791,0.109269808389436
"E02005261",542,492,73,158,334,384,3955,0.137041719342604,0.124399494310999,0.0184576485461441,0.0399494310998736,0.0844500632111252,0.0970922882427307
"E02005262",232,301,60,61,240,171,3539,0.0655552415936705,0.085052274653857,0.0169539417914665,0.017236507487991,0.0678157671658661,0.0483187341056796
"E02005263",452,1179,703,244,935,208,2811,0.16079686944148,0.419423692636073,0.250088936321594,0.0868018498754892,0.332621842760583,0.0739950195659907
"E02005264",820,2053,697,464,1589,356,5539,0.148041162664741,0.370644520671601,0.12583498826503,0.0837696335078534,0.286874887163748,0.0642715291568875
"E02005265",707,1100,267,276,824,431,4329,0.163317163317163,0.254100254100254,0.0616770616770617,0.0637560637560638,0.19034419034419,0.0995610995610996
"E02005266",449,1010,455,188,822,261,3818,0.117600838135149,0.264536406495547,0.119172341540073,0.0492404400209534,0.215295966474594,0.0683603981141959
"E02005267",229,540,275,109,431,120,3086,0.0742060920285159,0.1749837977965,0.0891121192482178,0.0353208036292936,0.139662994167207,0.0388852883992223
"E02005268",370,796,272,161,635,209,3127,0.118324272465622,0.254557083466581,0.0869843300287816,0.051487048289095,0.203070035177486,0.066837224176527
"E02005269",465,1184,1110,171,1013,294,5982,0.0777331995987964,0.197927114677365,0.18555667001003,0.0285857572718154,0.16934135740555,0.0491474423269809
"E02005270",439,355,882,119,236,320,2145,0.204662004662005,0.165501165501166,0.411188811188811,0.0554778554778555,0.11002331002331,0.149184149184149
"E02005271",426,666,860,153,513,273,3412,0.124853458382181,0.195193434935522,0.252051582649472,0.044841735052755,0.150351699882767,0.0800117233294256
"E02005272",396,697,779,155,542,241,3433,0.115351004951937,0.203029420332071,0.226915234488785,0.0451500145645208,0.15787940576755,0.0702009903874163
"E02005273",335,355,534,96,259,239,2213,0.151378219611387,0.160415725259828,0.241301400813376,0.0433800271125169,0.117035698147311,0.10799819249887
"E02005274",443,521,773,150,371,293,2773,0.159754778218536,0.187883159033538,0.278759466282005,0.0540930400288496,0.133790119004688,0.105661738189686
"E02005275",415,404,466,150,254,265,2314,0.179343128781331,0.174589455488332,0.201382886776145,0.0648228176318064,0.109766637856526,0.114520311149525
"E02005276",414,663,406,181,482,233,3437,0.120453884201338,0.19290078556881,0.118126272912424,0.0526622054116963,0.140238580157114,0.0677916787896421
"E02005277",590,814,438,271,543,319,2513,0.234779148428173,0.32391563867887,0.174293672900915,0.107839235972941,0.216076402705929,0.126939912455233
"E02005278",597,410,1032,114,296,483,2680,0.222761194029851,0.152985074626866,0.385074626865672,0.0425373134328358,0.11044776119403,0.180223880597015
"E02005279",863,627,1804,181,446,682,3975,0.217106918238994,0.157735849056604,0.453836477987421,0.0455345911949686,0.112201257861635,0.171572327044025
"E02005280",806,718,1342,182,536,624,4364,0.184692942254812,0.164527956003666,0.307516040329972,0.041704857928506,0.12282309807516,0.142988084326306
"E02005281",761,721,1551,190,531,571,3626,0.209873138444567,0.198841698841699,0.427744070601213,0.0523993381136238,0.146442360728075,0.157473800330943
"E02005284",368,478,348,145,333,223,1924,0.191268191268191,0.248440748440748,0.180873180873181,0.0753638253638254,0.173076923076923,0.115904365904366
"E02005285",490,466,810,152,314,338,2188,0.223948811700183,0.212979890310786,0.370201096892139,0.0694698354661792,0.143510054844607,0.154478976234004
"E02005286",552,438,909,142,296,410,2946,0.187372708757637,0.14867617107943,0.308553971486762,0.0482009504412763,0.100475220638153,0.139171758316361
"E02005287",264,572,27,170,402,94,1447,0.182446440912232,0.395300621976503,0.0186592950932965,0.117484450587422,0.277816171389081,0.06496199032481
"E02005288",460,518,314,186,332,274,1939,0.237235688499226,0.267148014440433,0.161939143888602,0.0959257349149046,0.171222279525529,0.141309953584322
"E02005289",385,474,32,163,311,222,1750,0.22,0.270857142857143,0.0182857142857143,0.0931428571428571,0.177714285714286,0.126857142857143
"E02005290",374,501,225,151,350,223,2306,0.162185602775369,0.217259323503903,0.0975715524718127,0.0654813529921943,0.151777970511709,0.0967042497831743
"E02005291",350,592,115,166,426,184,1935,0.180878552971576,0.30594315245478,0.0594315245478036,0.0857881136950904,0.22015503875969,0.0950904392764858
"E02005292",334,356,63,104,252,230,2144,0.155783582089552,0.166044776119403,0.029384328358209,0.0485074626865672,0.117537313432836,0.107276119402985
"E02005293",319,499,130,139,360,180,1991,0.160220994475138,0.250627825213461,0.0652938221998995,0.0698141637368157,0.180813661476645,0.0904068307383225
"E02005294",351,414,207,120,294,231,2833,0.123896929050477,0.14613483939287,0.0730674196964349,0.0423579244617014,0.103776914931168,0.0815390045887752
"E02005295",421,595,89,200,395,221,2552,0.164968652037618,0.233150470219436,0.0348746081504702,0.0783699059561129,0.154780564263323,0.0865987460815047
"E02005296",375,464,83,162,302,213,1777,0.211029825548678,0.261114237478897,0.0467079347214406,0.0911648846370287,0.169949352841868,0.119864940911649
"E02005297",553,614,124,225,389,328,2472,0.223705501618123,0.248381877022654,0.0501618122977346,0.0910194174757282,0.157362459546926,0.132686084142395
"E02005298",446,486,205,161,325,285,3158,0.141228625712476,0.153894870170994,0.064914502849905,0.0509816339455351,0.102913236225459,0.0902469917669411
"E02005299",370,650,137,158,492,212,3110,0.118971061093248,0.209003215434084,0.0440514469453376,0.0508038585209003,0.158199356913183,0.0681672025723473
"E02005300",261,232,45,93,139,168,1805,0.144598337950139,0.128531855955679,0.0249307479224377,0.0515235457063712,0.0770083102493075,0.0930747922437673
"E02005301",434,472,94,138,334,296,2244,0.193404634581105,0.210338680926916,0.0418894830659537,0.0614973262032086,0.148841354723708,0.131907308377897
"E02005302",314,449,54,139,310,175,2760,0.113768115942029,0.16268115942029,0.0195652173913043,0.0503623188405797,0.11231884057971,0.0634057971014493
"E02005303",325,378,93,120,258,205,2666,0.121905476369092,0.14178544636159,0.0348837209302326,0.0450112528132033,0.0967741935483871,0.076894223555889
"E02005304",493,603,121,215,388,278,2975,0.165714285714286,0.202689075630252,0.040672268907563,0.0722689075630252,0.130420168067227,0.0934453781512605
"E02005305",413,575,127,183,392,230,2574,0.16045066045066,0.223387723387723,0.0493395493395493,0.0710955710955711,0.152292152292152,0.0893550893550894
"E02005306",472,618,306,225,393,247,2408,0.196013289036545,0.256644518272425,0.127076411960133,0.0934385382059801,0.163205980066445,0.102574750830565
"E02005307",478,742,234,214,528,264,3738,0.127875869448903,0.198501872659176,0.0626003210272873,0.0572498662386303,0.141252006420546,0.0706260032102729
"E02005308",465,580,239,192,388,273,1919,0.242313705054716,0.302240750390829,0.124544033350703,0.100052110474205,0.202188639916623,0.142261594580511
"E02005309",549,707,190,185,522,364,2903,0.189114708921805,0.24354116431278,0.0654495349638305,0.0637271787805718,0.179813985532208,0.125387530141233
"E02005310",437,803,460,190,613,247,3515,0.124324324324324,0.228449502133713,0.130867709815078,0.0540540540540541,0.174395448079659,0.0702702702702703
"E02005311",366,449,368,135,314,231,1830,0.2,0.245355191256831,0.201092896174863,0.0737704918032787,0.171584699453552,0.126229508196721
"E02005312",284,384,15,76,308,208,2460,0.115447154471545,0.15609756097561,0.00609756097560976,0.0308943089430894,0.12520325203252,0.0845528455284553
"E02005313",384,652,31,100,552,284,3998,0.096048024012006,0.163081540770385,0.00775387693846923,0.0250125062531266,0.138069034517259,0.0710355177588794
"E02005314",367,724,275,130,594,237,2917,0.125814192663696,0.248200205690778,0.0942749400068564,0.0445663352759685,0.20363387041481,0.0812478573877271
"E02005315",581,658,254,244,414,337,2420,0.240082644628099,0.271900826446281,0.10495867768595,0.100826446280992,0.171074380165289,0.139256198347107
"E02005316",291,179,54,46,133,245,2850,0.102105263157895,0.0628070175438596,0.0189473684210526,0.016140350877193,0.0466666666666667,0.0859649122807018
"E02005317",369,661,89,100,561,269,3518,0.104889141557703,0.1878908470722,0.0252984650369528,0.0284252416145537,0.159465605457646,0.0764638999431495
"E02005318",443,441,276,116,325,327,2602,0.170253651037663,0.169485011529593,0.106072252113759,0.0445810914681015,0.124903920061491,0.125672559569562
"E02005319",786,2020,713,474,1546,312,4618,0.170203551320918,0.437418796015591,0.154395842355998,0.102641836292767,0.334776959722824,0.0675617150281507
"E02005320",307,608,32,157,451,150,1729,0.177559282822441,0.351648351648352,0.0185078079814922,0.0908039329091961,0.260844418739156,0.0867553499132447
"E02005321",411,542,31,160,382,251,2106,0.195156695156695,0.257359924026591,0.0147198480531814,0.0759734093067426,0.181386514719848,0.119183285849953
"E02005322",894,896,148,348,548,546,3792,0.235759493670886,0.236286919831224,0.0390295358649789,0.0917721518987342,0.144514767932489,0.143987341772152
"E02005323",418,620,47,166,454,252,2843,0.147027787548364,0.218079493492789,0.0165318325712276,0.0583890256771017,0.159690467815688,0.0886387618712628
"E02005324",311,369,368,110,259,201,2579,0.120589375727026,0.143078712679333,0.1426909654905,0.0426521907716169,0.100426521907716,0.0779371849554091
"E02005325",593,572,199,212,360,381,3530,0.167988668555241,0.162039660056657,0.0563739376770538,0.060056657223796,0.101983002832861,0.107932011331445
"E02005326",720,1529,130,410,1119,310,3546,0.203045685279188,0.431190073322053,0.0366610265087422,0.115623237450649,0.315566835871404,0.0874224478285392
"E02005327",349,383,231,159,224,190,2014,0.173286991062562,0.190168818272095,0.114697120158888,0.0789473684210526,0.111221449851043,0.0943396226415094
"E02005328",590,651,26,209,442,381,3002,0.19653564290473,0.216855429713524,0.00866089273817455,0.069620253164557,0.147235176548967,0.126915389740173
"E02005329",661,1055,73,322,733,339,3901,0.169443732376314,0.270443476031787,0.0187131504742374,0.0825429377082799,0.187900538323507,0.0869007946680338
"E02005330",672,785,46,283,502,389,2781,0.241639697950378,0.282272563825962,0.0165408126573175,0.101761956130888,0.180510607695074,0.139877741819489
"E02005331",592,957,132,307,650,285,4019,0.147300323463548,0.238118935058472,0.0328439910425479,0.0763871609853197,0.161731774073153,0.0709131624782284
"E02005332",658,859,36,317,542,341,2756,0.238751814223512,0.311683599419448,0.0130624092888244,0.115021770682148,0.1966618287373,0.123730043541364
"E02005334",311,263,329,88,175,223,1638,0.18986568986569,0.160561660561661,0.200854700854701,0.0537240537240537,0.106837606837607,0.136141636141636
"E02005335",458,306,436,97,209,361,2289,0.200087374399301,0.133682830930537,0.19047619047619,0.0423765836609873,0.09130624726955,0.157710790738314
"E02005336",374,259,277,59,200,315,2609,0.143349942506708,0.0992717516289766,0.106170946722882,0.0226140283633576,0.076657723265619,0.12073591414335
"E02005337",568,553,1109,184,369,384,2862,0.198462613556953,0.193221523410203,0.387491264849755,0.0642907058001398,0.128930817610063,0.134171907756813
"E02005338",616,542,825,139,403,477,4498,0.136949755446865,0.120497999110716,0.183414851044909,0.0309026233881725,0.0895953757225433,0.106047132058693
"E02005339",596,284,372,90,194,506,2779,0.214465635120547,0.102195034184959,0.133861101115509,0.0323857502698813,0.0698092839150774,0.182079884850666
"E02005340",550,513,541,164,349,386,3058,0.179856115107914,0.167756703727927,0.176913015042511,0.0536298234139961,0.114126880313931,0.126226291693918
"E02005341",387,233,172,61,172,326,2535,0.152662721893491,0.0919132149901381,0.0678500986193294,0.0240631163708087,0.0678500986193294,0.128599605522682
"E02005342",364,328,401,110,218,254,2185,0.166590389016018,0.150114416475973,0.183524027459954,0.0503432494279176,0.0997711670480549,0.116247139588101
"E02005343",449,347,334,127,220,322,2461,0.182446160097521,0.140999593661113,0.135717188134905,0.0516050386021942,0.0893945550589191,0.130841121495327
"E02005344",439,261,427,75,186,364,3131,0.140210795273076,0.0833599488981156,0.136378153944427,0.0239540083040562,0.0594059405940594,0.116256786969019
"E02005345",358,367,161,141,226,217,2413,0.148363033568172,0.15209283050145,0.06672192291753,0.0584334852880232,0.0936593452134273,0.0899295482801492
"E02005346",733,444,2083,129,315,604,6338,0.115651625118334,0.0700536446828653,0.328652571789208,0.0203534237929946,0.0497002208898706,0.0952982013253392
"E02005347",663,363,1880,83,280,580,4503,0.147235176548967,0.0806129247168554,0.417499444814568,0.0184321563402176,0.0621807683766378,0.12880302020875
"E02005348",380,334,17,116,218,264,2027,0.18746916625555,0.164775530340405,0.00838677849037987,0.0572274296990627,0.107548100641342,0.130241736556487
"E02005349",463,397,420,108,289,355,3119,0.148445014427701,0.127284386021161,0.134658544405258,0.0346264828470664,0.0926579031740943,0.113818531580635
"E02005350",399,256,446,77,179,322,2520,0.158333333333333,0.101587301587302,0.176984126984127,0.0305555555555556,0.071031746031746,0.127777777777778
"E02005351",392,426,171,113,313,279,2030,0.193103448275862,0.209852216748768,0.0842364532019704,0.0556650246305419,0.154187192118227,0.13743842364532
"E02005352",344,199,496,70,129,274,1957,0.175779253960143,0.101686254471129,0.253449156872764,0.0357690342360756,0.0659172202350537,0.140010219724067
"E02005353",511,425,802,116,309,395,3841,0.13303827128352,0.110648268680031,0.208799791720906,0.0302004686279615,0.0804478000520698,0.102837802655558
"E02005354",491,451,234,127,324,364,3146,0.156071201525747,0.143356643356643,0.0743801652892562,0.040368722186904,0.102987921169739,0.115702479338843
"E02005355",360,220,540,81,139,279,2743,0.13124316441852,0.0802041560335399,0.19686474662778,0.029529711994167,0.0506744440393729,0.101713452424353
"E02005356",349,210,759,61,149,288,2817,0.123890663826766,0.0745473908413206,0.269435569755059,0.0216542421015264,0.0528931487397941,0.10223642172524
"E02005357",473,311,665,108,203,365,3476,0.136075949367089,0.0894706559263521,0.191311852704258,0.0310701956271577,0.0584004602991945,0.105005753739931
"E02005358",593,273,670,83,190,510,4478,0.132425189816883,0.0609647163912461,0.149620366234926,0.0185350602947745,0.0424296560964716,0.113890129522108
"E02005359",343,329,304,114,215,229,2582,0.132842757552285,0.127420604182804,0.117738187451588,0.0441518202943455,0.0832687838884586,0.0886909372579396
"E02005360",375,320,665,109,211,266,1879,0.199574241617882,0.170303352847259,0.35391165513571,0.0580095795635977,0.112293773283662,0.141564662054284
"E02005361",363,234,413,59,175,304,2229,0.162853297442799,0.104979811574697,0.185284881112607,0.0264692687303724,0.0785105428443248,0.136384028712427
"E02005362",345,333,452,98,235,247,2334,0.147814910025707,0.1426735218509,0.193658954584404,0.0419880034275921,0.100685518423308,0.105826906598115
"E02005363",407,354,478,129,225,278,2962,0.137407157326131,0.11951384199865,0.161377447670493,0.0435516542876435,0.0759621877110061,0.0938555030384875
"E02005364",257,249,787,73,176,184,1440,0.178472222222222,0.172916666666667,0.546527777777778,0.0506944444444444,0.122222222222222,0.127777777777778
"E02005365",594,536,655,189,347,405,3136,0.189413265306122,0.170918367346939,0.208864795918367,0.0602678571428571,0.110650510204082,0.129145408163265
"E02005366",311,259,570,69,190,242,2801,0.111031774366298,0.0924669760799714,0.203498750446269,0.0246340592645484,0.0678329168154231,0.0863977151017494
"E02005368",364,256,689,76,180,288,2213,0.164482602801627,0.115680072300045,0.311342069588794,0.0343425214640759,0.0813375508359693,0.130140081337551
"E02005369",524,442,738,140,302,384,4916,0.106590724165989,0.0899104963384866,0.150122050447518,0.0284784377542718,0.0614320585842148,0.0781122864117168
"E02005370",460,332,192,110,222,350,3089,0.148915506636452,0.107478148268048,0.062156037552606,0.0356102298478472,0.0718679184202007,0.113305276788605
"E02005371",551,423,805,129,294,422,3993,0.137991485098923,0.105935386927122,0.20160280490859,0.0323065364387678,0.0736288504883546,0.105684948660155
"E02005372",526,404,680,159,245,367,3138,0.167622689611217,0.12874442319949,0.216698534098152,0.0506692160611855,0.0780752071383047,0.116953473550032
"E02005373",485,438,557,171,267,314,5037,0.0962874727020052,0.0869565217391304,0.110581695453643,0.03394877903514,0.0530077427039905,0.0623386936668652
"E02005374",420,368,788,99,269,321,3220,0.130434782608696,0.114285714285714,0.24472049689441,0.0307453416149068,0.0835403726708075,0.0996894409937888
"E02005375",397,244,626,72,172,325,4074,0.0974472263132057,0.0598919980363279,0.15365733922435,0.0176730486008837,0.0422189494354443,0.079774177712322
"E02005376",491,434,302,119,315,372,3980,0.123366834170854,0.109045226130653,0.0758793969849246,0.0298994974874372,0.0791457286432161,0.0934673366834171
"E02005377",449,353,496,84,269,365,3232,0.138923267326733,0.109220297029703,0.153465346534653,0.025990099009901,0.083230198019802,0.112933168316832
"E02005378",308,220,203,84,136,224,1572,0.195928753180662,0.139949109414758,0.129134860050891,0.0534351145038168,0.0865139949109415,0.142493638676845
"E02005379",329,237,314,90,147,239,2226,0.147798742138365,0.106469002695418,0.141060197663971,0.0404312668463612,0.0660377358490566,0.107367475292004
"E02005380",555,363,563,127,236,428,3109,0.178513991637182,0.116757799935671,0.181087166291412,0.0408491476358958,0.0759086522997749,0.137664844001287
"E02005381",543,350,425,120,230,423,3196,0.169899874843554,0.109511889862328,0.132978723404255,0.0375469336670839,0.0719649561952441,0.132352941176471
"E02005382",647,357,1017,105,252,542,4320,0.149768518518519,0.0826388888888889,0.235416666666667,0.0243055555555556,0.0583333333333333,0.125462962962963
"E02005383",589,281,843,111,170,478,3531,0.166808269612008,0.0795808552817899,0.23874256584537,0.0314358538657604,0.0481450014160295,0.135372415746248
"E02005384",380,254,419,88,166,292,2413,0.15748031496063,0.105263157894737,0.173642768338168,0.0364691255698301,0.0687940323249068,0.1210111893908
"E02005385",367,215,377,78,137,289,1988,0.184607645875251,0.108148893360161,0.189637826961771,0.0392354124748491,0.0689134808853119,0.145372233400402
"E02005386",749,222,2083,63,159,686,4210,0.17790973871734,0.0527315914489311,0.494774346793349,0.0149643705463183,0.0377672209026128,0.162945368171021
"E02005387",509,374,333,113,261,396,3931,0.129483591961333,0.0951411854489952,0.0847112693971,0.0287458661918087,0.0663953192571865,0.100737725769524
"E02005388",348,175,892,44,131,304,2573,0.135250680139915,0.0680139914496696,0.346677030703459,0.0171006607073455,0.0509133307423241,0.118150019432569
"E02005389",421,191,320,72,119,349,2266,0.185789938217123,0.0842894969108561,0.141218005295675,0.0317740511915269,0.0525154457193292,0.154015887025596
"E02005390",601,397,479,141,256,460,3593,0.167269691065962,0.110492624547732,0.133314778736432,0.0392429724464236,0.0712496521013081,0.128026718619538
"E02005391",614,400,986,131,269,483,3559,0.1725203708907,0.112391121101433,0.277044113515032,0.0368080921607193,0.0755830289407137,0.13571227872998
"E02005392",585,356,704,123,233,462,3632,0.161068281938326,0.0980176211453744,0.193832599118943,0.0338656387665198,0.0641519823788546,0.127202643171806
"E02005393",500,324,750,100,224,400,3038,0.164581961816985,0.106649111257406,0.246872942725477,0.032916392363397,0.0737327188940092,0.131665569453588
"E02005394",505,405,505,118,287,387,3985,0.1267252195734,0.101631116687578,0.1267252195734,0.0296110414052698,0.0720200752823087,0.0971141781681305
"E02005395",611,507,660,191,316,420,3274,0.18662186927306,0.154856444715944,0.201588271227856,0.0583384239462431,0.0965180207697007,0.128283445326817
"E02005396",510,311,1076,98,213,412,2594,0.196607555898227,0.119892058596762,0.414803392444102,0.0377794911333847,0.082112567463377,0.158828064764842
"E02005397",623,396,665,125,271,498,4089,0.152359990217657,0.0968451944240646,0.162631450232331,0.0305698214722426,0.066275372951822,0.121790168745415
"E02005398",449,298,733,87,211,362,2792,0.160816618911175,0.106733524355301,0.262535816618911,0.0311604584527221,0.0755730659025788,0.129656160458453
"E02005399",381,226,364,55,171,326,3869,0.0984750581545619,0.0584130266218661,0.0940811579219437,0.0142155595761179,0.0441974670457483,0.084259498578444
"E02005400",373,264,399,95,169,278,1945,0.191773778920308,0.13573264781491,0.205141388174807,0.0488431876606684,0.0868894601542416,0.14293059125964
"E02005401",393,201,447,65,136,328,2197,0.178880291306327,0.0914883932635412,0.20345926263086,0.029585798816568,0.0619025944469731,0.149294492489759
"E02005402",361,335,238,82,253,279,2508,0.143939393939394,0.133572567783094,0.094896331738437,0.032695374800638,0.100877192982456,0.111244019138756
"E02005403",441,350,393,106,244,335,2303,0.191489361702128,0.151975683890578,0.170646982197134,0.0460269214068606,0.105948762483717,0.145462440295267
"E02005404",666,281,585,105,176,561,3517,0.189365936878021,0.07989764003412,0.166334944555018,0.0298549900483367,0.0500426499857833,0.159510946829684
"E02005405",611,326,122,103,223,508,2892,0.211272475795297,0.112724757952974,0.0421853388658368,0.0356154910096819,0.0771092669432918,0.175656984785615
"E02005406",431,343,1310,67,276,364,3290,0.131003039513678,0.104255319148936,0.398176291793313,0.0203647416413374,0.0838905775075988,0.11063829787234
"E02005407",498,253,654,77,176,421,4659,0.106889890534449,0.0543034986048508,0.140373470701867,0.0165271517493024,0.0377763468555484,0.090362738785147
"E02005408",542,322,457,97,225,445,3038,0.178406846609612,0.105990783410138,0.150427913100724,0.0319289005924951,0.0740618828176432,0.146477946017117
"E02005409",694,537,963,131,406,563,4693,0.147879821010015,0.114425740464522,0.205199232900064,0.0279139143405071,0.0865118261240145,0.119965906669508
"E02005412",549,569,424,183,386,366,3172,0.173076923076923,0.17938209331652,0.133669609079445,0.0576923076923077,0.121689785624212,0.115384615384615
"E02005414",510,432,612,136,296,374,3182,0.160276555625393,0.135763670647392,0.192331866750471,0.0427404148334381,0.0930232558139535,0.117536140791955
"E02005415",594,424,1343,110,314,484,3332,0.178271308523409,0.127250900360144,0.403061224489796,0.0330132052821128,0.0942376950780312,0.145258103241297
"E02005416",633,439,167,160,279,473,3044,0.207950065703022,0.144218134034166,0.054862023653088,0.0525624178712221,0.0916557161629435,0.1553876478318
"E02005417",498,305,433,113,192,385,2570,0.193774319066148,0.118677042801556,0.168482490272374,0.0439688715953307,0.0747081712062257,0.149805447470817
"E02005418",611,616,1176,154,462,457,4950,0.123434343434343,0.124444444444444,0.237575757575758,0.0311111111111111,0.0933333333333333,0.0923232323232323
"E02005419",604,390,1919,112,278,492,4364,0.138405132905591,0.0893675527039413,0.439734188817599,0.0256645279560037,0.0637030247479377,0.112740604949588
"E02005420",479,343,376,92,251,387,3585,0.133612273361227,0.095676429567643,0.104881450488145,0.0256624825662483,0.0700139470013947,0.107949790794979
"E02005422",441,266,446,105,161,336,2690,0.163940520446097,0.0988847583643123,0.165799256505576,0.0390334572490706,0.0598513011152416,0.124907063197026
"E02005423",589,499,556,173,326,416,4337,0.135808162324187,0.115056490661748,0.128199216047959,0.0398893244178003,0.0751671662439474,0.0959188379063869
"E02005424",812,642,535,244,398,568,3626,0.223938223938224,0.177054605626034,0.147545504688362,0.0672917815774959,0.109762824048538,0.156646442360728
"E02005425",490,349,444,118,231,372,2371,0.206663854913539,0.147195276254745,0.187262758329819,0.0497680303669338,0.0974272458878111,0.156895824546605
"E02005426",522,369,390,122,247,400,4899,0.106552357624005,0.0753214941824862,0.0796080832823025,0.024903041437028,0.0504184527454583,0.0816493161869769
"E02005427",515,290,1437,67,223,448,3406,0.151203758073987,0.085143863769818,0.42190252495596,0.0196711685261304,0.0654726952436876,0.131532589547857
"E02005428",765,659,537,216,443,549,3883,0.197012619108936,0.169714138552665,0.13829513262941,0.0556270924542879,0.114087046098378,0.141385526654648
"E02005429",551,454,312,152,302,399,3064,0.179830287206266,0.148172323759791,0.101827676240209,0.0496083550913838,0.0985639686684073,0.130221932114883
"E02005430",550,331,621,132,199,418,2652,0.207390648567119,0.124811463046757,0.234162895927602,0.0497737556561086,0.0750377073906486,0.157616892911011
"E02005431",622,456,958,144,312,478,3594,0.173066221480245,0.126878130217028,0.266555370061213,0.0400667779632721,0.0868113522537563,0.132999443516973
"E02005432",640,486,970,176,310,464,2984,0.214477211796247,0.162868632707775,0.325067024128686,0.0589812332439678,0.103887399463807,0.155495978552279
"E02005433",728,485,326,200,285,528,3317,0.219475429605065,0.14621646065722,0.0982815797407296,0.0602954476936991,0.0859210129635213,0.159179981911366
"E02005434",469,294,675,68,226,401,3642,0.128775398132894,0.0807248764415156,0.185337726523888,0.0186710598572213,0.0620538165842943,0.110104338275673
"E02005435",527,491,249,145,346,382,3528,0.14937641723356,0.139172335600907,0.070578231292517,0.0410997732426304,0.0980725623582766,0.10827664399093
"E02005436",565,383,624,126,257,439,3395,0.166421207658321,0.112812960235641,0.18379970544919,0.0371134020618557,0.075699558173785,0.129307805596465
"E02005437",667,915,1024,183,732,484,3529,0.189005383961462,0.259280249362426,0.29016718617172,0.0518560498724851,0.20742419948994,0.137149334088977
"E02005438",543,483,112,168,315,375,3342,0.162477558348294,0.144524236983842,0.0335128665469779,0.0502692998204668,0.0942549371633752,0.112208258527828
"E02005439",696,462,413,158,304,538,4800,0.145,0.09625,0.0860416666666667,0.0329166666666667,0.0633333333333333,0.112083333333333
"E02005440",487,331,537,127,204,360,2196,0.221766848816029,0.150728597449909,0.244535519125683,0.0578324225865209,0.092896174863388,0.163934426229508
"E02005441",660,440,731,173,267,487,3054,0.216110019646365,0.14407334643091,0.239358218729535,0.0566470203012443,0.087426326129666,0.159462999345121
"E02005442",190,171,250,43,128,147,2512,0.0756369426751592,0.0680732484076433,0.0995222929936306,0.0171178343949045,0.0509554140127389,0.0585191082802548
"E02005443",389,180,112,62,118,327,3045,0.127750410509031,0.0591133004926108,0.0367816091954023,0.0203612479474548,0.038752052545156,0.107389162561576
"E02005444",881,624,2214,156,468,725,5778,0.152474904811353,0.107995846313603,0.383177570093458,0.0269989615784008,0.0809968847352025,0.125475943232953
"E02005445",675,326,1935,73,253,602,5222,0.129260819609345,0.0624281884335504,0.370547682880123,0.0139793182688625,0.0484488701646879,0.115281501340483
"E02005446",486,162,1814,25,137,461,3678,0.132137030995106,0.0440456769983687,0.493202827623709,0.00679717237629146,0.0372485046220772,0.125339858618815
"E02005447",637,231,2603,44,187,593,4082,0.156050955414013,0.0565899069083782,0.637677609015189,0.0107790298873101,0.0458108770210681,0.145271925526703
"E02005448",395,358,56,92,266,303,2770,0.142599277978339,0.129241877256318,0.0202166064981949,0.0332129963898917,0.096028880866426,0.109386281588448
"E02005449",459,284,1207,79,205,380,3256,0.140970515970516,0.0872235872235872,0.370700245700246,0.0242628992628993,0.062960687960688,0.116707616707617
"E02005450",631,342,37,115,227,516,2912,0.21668956043956,0.117445054945055,0.012706043956044,0.0394917582417582,0.0779532967032967,0.177197802197802
"E02005451",416,253,789,76,177,340,3025,0.137520661157025,0.0836363636363636,0.260826446280992,0.0251239669421488,0.0585123966942149,0.112396694214876
"E02005452",633,476,251,185,291,448,3507,0.180496150556031,0.135728542914172,0.0715711434274309,0.0527516395779869,0.0829769033361848,0.127744510978044
"E02005453",620,333,326,120,213,500,3617,0.171412773016312,0.092065247442632,0.0901299419408349,0.0331766657450926,0.0588885816975394,0.138236107271219
"E02005455",714,395,411,152,243,562,5596,0.12759113652609,0.0705861329521087,0.073445318084346,0.0271622587562545,0.0434238741958542,0.100428877769836
"E02005456",633,381,255,111,270,522,4690,0.134968017057569,0.0812366737739872,0.0543710021321962,0.0236673773987207,0.0575692963752665,0.111300639658849
"E02005457",509,251,355,81,170,428,3163,0.160923174201707,0.079355042680999,0.112235219728106,0.02560859943092,0.053746443250079,0.135314574770787
"E02005458",436,216,476,86,130,350,2496,0.174679487179487,0.0865384615384615,0.190705128205128,0.0344551282051282,0.0520833333333333,0.140224358974359
"E02005459",598,326,627,103,223,495,3391,0.176349159539959,0.0961368327926865,0.184901209082866,0.0303745207903273,0.0657623120023592,0.145974638749631
"E02005460",336,206,191,53,153,283,2589,0.129779837775203,0.0795674005407493,0.0737736577829278,0.0204712244109695,0.0590961761297798,0.109308613364233
"E02005461",494,230,483,90,140,404,2251,0.219458018658374,0.10217681030653,0.214571301643714,0.0399822301199467,0.0621945801865837,0.179475788538427
"E02005462",624,350,773,73,277,551,4683,0.133247918001281,0.0747384155455904,0.16506512919069,0.0155882980995089,0.0591501174460816,0.117659619901772
"E02005463",429,240,153,74,166,355,3523,0.121771217712177,0.0681237581606585,0.0434288958274198,0.0210048254328697,0.0471189327277888,0.100766392279307
"E02005464",601,348,540,124,224,477,3295,0.182397572078907,0.105614567526555,0.163884673748103,0.0376327769347496,0.0679817905918058,0.144764795144158
"E02005465",627,425,561,147,278,480,3580,0.175139664804469,0.118715083798883,0.156703910614525,0.0410614525139665,0.0776536312849162,0.134078212290503
"E02005466",502,267,409,102,165,400,2437,0.205990972507181,0.109560935576529,0.167829298317604,0.04185473943373,0.0677061961427985,0.164136233073451
"E02005467",544,282,474,87,195,457,3453,0.157544164494642,0.0816681146828844,0.137271937445699,0.0251954821894005,0.0564726324934839,0.132348682305242
"E02005468",529,308,414,129,179,400,3008,0.175864361702128,0.102393617021277,0.137632978723404,0.0428856382978723,0.0595079787234043,0.132978723404255
"E02005469",490,352,399,122,230,368,3095,0.158319870759289,0.11373182552504,0.12891760904685,0.0394184168012924,0.074313408723748,0.118901453957997
"E02005470",612,310,999,53,257,559,5330,0.114821763602251,0.0581613508442777,0.187429643527205,0.0099437148217636,0.0482176360225141,0.104878048780488
"E02005471",699,520,551,172,348,527,3721,0.187852727761354,0.13974737973663,0.148078473528621,0.0462241332975007,0.0935232464391293,0.141628594463854
"E02005472",792,483,951,160,323,632,4181,0.189428366419517,0.115522602248266,0.227457546041617,0.0382683568524276,0.0772542453958383,0.151160009567089
"E02005473",482,375,421,109,266,373,3706,0.130059363194819,0.101187263896384,0.113599568267674,0.0294117647058824,0.0717754991905019,0.100647598488937
"E02005474",539,286,463,119,167,420,2847,0.189322093431682,0.100456621004566,0.162627327010889,0.0417983842641377,0.0586582367404285,0.147523709167545
"E02005475",391,272,367,82,190,309,3061,0.127736033975825,0.088859849722313,0.119895459000327,0.0267886311662855,0.0620712185560274,0.100947402809539
"E02005476",436,223,503,79,144,357,2698,0.161601186063751,0.0826538176426983,0.186434395848777,0.0292809488510007,0.0533728687916976,0.13232023721275
"E02005477",500,351,435,98,253,402,3655,0.136798905608755,0.0960328317373461,0.119015047879617,0.026812585499316,0.0692202462380301,0.109986320109439
"E02005478",565,455,717,119,336,446,4555,0.12403951701427,0.0998902305159166,0.157409440175631,0.0261251372118551,0.0737650933040615,0.0979143798024149
"E02005479",520,297,438,98,199,422,3982,0.130587644399799,0.074585635359116,0.109994977398292,0.0246107483676544,0.0499748869914616,0.105976896032145
"E02005480",339,322,260,95,227,244,3439,0.0985751671997674,0.0936318697295725,0.0756033730735679,0.0276243093922652,0.0660075603373074,0.0709508578075022
"E02005481",914,375,2041,109,266,805,5910,0.154653130287648,0.0634517766497462,0.345346869712352,0.0184433164128596,0.0450084602368866,0.136209813874789
"E02005482",645,360,620,129,231,516,3690,0.17479674796748,0.0975609756097561,0.168021680216802,0.0349593495934959,0.0626016260162602,0.139837398373984
"E02005483",588,240,606,86,154,502,3174,0.185255198487713,0.0756143667296786,0.190926275992439,0.0270951480781348,0.0485192186515438,0.158160050409578
"E02005484",541,306,607,125,181,416,3049,0.177435224663824,0.10036077402427,0.199081666120039,0.0409970482125287,0.0593637258117416,0.136438176451295
"E02005485",419,205,307,64,141,355,3917,0.106969619606842,0.0523359714066888,0.0783763083992852,0.0163390349757467,0.035996936430942,0.0906305846310952
"E02005486",399,311,462,62,249,337,4477,0.0891221800312709,0.0694661603752513,0.103194103194103,0.0138485593031048,0.0556176010721465,0.0752736207281662
"E02005487",517,228,460,72,156,445,2970,0.174074074074074,0.0767676767676768,0.154882154882155,0.0242424242424242,0.0525252525252525,0.14983164983165
"E02005488",400,309,230,97,212,303,2760,0.144927536231884,0.11195652173913,0.0833333333333333,0.0351449275362319,0.0768115942028986,0.109782608695652
"E02005489",385,300,192,81,219,304,2682,0.143549589858315,0.111856823266219,0.0715883668903803,0.0302013422818792,0.08165548098434,0.113348247576435
"E02005490",469,498,934,126,372,343,4521,0.103738111037381,0.110152621101526,0.206591462065915,0.0278699402786994,0.0822826808228268,0.0758681707586817
"E02005491",772,491,1245,129,362,643,5580,0.138351254480287,0.0879928315412186,0.223118279569892,0.0231182795698925,0.0648745519713262,0.115232974910394
"E02005492",603,583,801,156,427,447,3738,0.16131621187801,0.155965757089353,0.214285714285714,0.0417335473515249,0.114232209737828,0.119582664526485
"E02005493",494,398,527,124,274,370,3695,0.133694181326116,0.107713125845737,0.142625169147497,0.0335588633288227,0.0741542625169147,0.100135317997294
"E02005494",630,539,972,145,394,485,4271,0.147506438773121,0.126199953172559,0.22758136267853,0.033949894638258,0.0922500585343011,0.113556544134863
"E02005495",1050,593,3294,153,440,897,6011,0.174679753784728,0.0986524704708035,0.547995341873232,0.0254533355514889,0.0731991349193146,0.149226418233239
"E02005496",458,288,686,89,199,369,2429,0.188554960889255,0.118567311650885,0.282420749279539,0.0366405928365583,0.0819267188143269,0.151914368052697
"E02005497",304,292,49,86,206,218,3633,0.0836774015964767,0.0803743462703,0.0134874759152216,0.0236718965042664,0.0567024497660336,0.0600055050922103
"E02005498",408,292,452,83,209,325,2425,0.168247422680412,0.120412371134021,0.18639175257732,0.0342268041237113,0.0861855670103093,0.134020618556701
"E02005499",467,279,260,79,200,388,3220,0.145031055900621,0.0866459627329193,0.0807453416149068,0.0245341614906832,0.062111801242236,0.120496894409938
"E02005500",376,224,314,63,161,313,3165,0.118799368088468,0.0707740916271722,0.0992101105845182,0.0199052132701422,0.05086887835703,0.0988941548183254
"E02005501",482,326,224,119,207,363,3347,0.144009560800717,0.0974006573050493,0.0669256050194204,0.0355542276665671,0.0618464296384822,0.10845533313415
"E02005502",566,363,319,131,232,435,3567,0.158676759181385,0.101766190075694,0.0894308943089431,0.0367255396691898,0.0650406504065041,0.121951219512195
"E02005503",608,276,575,131,145,477,2912,0.208791208791209,0.0947802197802198,0.197458791208791,0.0449862637362637,0.049793956043956,0.163804945054945
"E02005504",758,395,708,177,218,581,3340,0.226946107784431,0.118263473053892,0.211976047904192,0.0529940119760479,0.0652694610778443,0.173952095808383
"E02005505",450,266,296,100,166,350,2770,0.162454873646209,0.096028880866426,0.106859205776173,0.036101083032491,0.059927797833935,0.126353790613718
"E02005506",532,273,272,131,142,401,2518,0.211278792692613,0.108419380460683,0.108022239872915,0.0520254169976172,0.0563939634630659,0.159253375694996
"E02005507",794,472,485,188,284,606,4930,0.16105476673428,0.0957403651115619,0.0983772819472617,0.0381338742393509,0.057606490872211,0.122920892494929
"E02005508",501,250,435,107,143,394,2501,0.20031987205118,0.0999600159936026,0.173930427828868,0.0427828868452619,0.0571771291483407,0.157536985205918
"E02005509",584,446,460,165,281,419,4235,0.137898465171192,0.105312868949233,0.1086186540732,0.038961038961039,0.0663518299881936,0.0989374262101535
"E02005510",533,352,438,146,206,387,2677,0.199103474038102,0.131490474411655,0.163615988046321,0.0545386626821068,0.076951811729548,0.144564811355996
"E02005511",623,406,309,145,261,478,3896,0.159907597535934,0.104209445585216,0.0793121149897331,0.037217659137577,0.0669917864476386,0.122689938398357
"E02005512",491,312,466,115,197,376,3420,0.143567251461988,0.0912280701754386,0.13625730994152,0.033625730994152,0.0576023391812866,0.109941520467836
"E02005513",714,414,332,163,251,551,4681,0.152531510361034,0.0884426404614399,0.0709250160222175,0.0348216193121128,0.0536210211493271,0.117709891048921
"E02005514",671,384,443,186,198,485,2821,0.23785891527827,0.136121942573555,0.157036511875222,0.0659340659340659,0.0701878766394895,0.171924849344204
"E02005515",419,261,367,109,152,310,2149,0.194974406700791,0.121451838064216,0.170777105630526,0.0507212657049791,0.0707305723592369,0.144253140995812
"E02005516",544,297,523,124,173,420,2580,0.210852713178295,0.115116279069767,0.202713178294574,0.048062015503876,0.0670542635658915,0.162790697674419
"E02005517",362,310,109,117,193,245,2168,0.166974169741697,0.142988929889299,0.0502767527675277,0.0539667896678967,0.0890221402214022,0.113007380073801
"E02005518",683,532,385,209,323,474,4065,0.168019680196802,0.130873308733087,0.0947109471094711,0.0514145141451414,0.0794587945879459,0.116605166051661
"E02005519",468,439,216,181,258,287,3065,0.152691680261011,0.143230016313214,0.0704730831973899,0.0590538336052202,0.0841761827079935,0.0936378466557912
"E02005520",490,316,486,99,217,391,3300,0.148484848484848,0.0957575757575758,0.147272727272727,0.03,0.0657575757575758,0.118484848484848
"E02005521",688,417,886,147,270,541,3093,0.222437762689945,0.134820562560621,0.286453281603621,0.0475266731328807,0.0872938894277401,0.174911089557064
"E02005522",387,263,428,102,161,285,1783,0.217049915872126,0.147504206393718,0.240044868199663,0.0572069545709478,0.0902972518227706,0.159842961301178
"E02005523",456,235,225,97,138,359,2769,0.164680390032503,0.0848681834597328,0.0812567713976165,0.035030697002528,0.0498374864572048,0.129649693029975
"E02005524",373,269,148,98,171,275,1760,0.211931818181818,0.152840909090909,0.0840909090909091,0.0556818181818182,0.0971590909090909,0.15625
"E02005525",797,220,47,117,103,680,3037,0.262430029634508,0.0724399078037537,0.0154757984853474,0.038524860059269,0.0339150477444847,0.223905169575239
"E02005526",367,162,79,60,102,307,1963,0.186958736627611,0.0825267447784004,0.0402445236882323,0.0305654610290372,0.0519612837493632,0.156393275598574
"E02005527",580,402,413,146,256,434,3711,0.156292104554029,0.108326596604689,0.1112907572083,0.03934249528429,0.0689841013203988,0.116949609269739
"E02005528",617,435,185,171,264,446,3102,0.198903932946486,0.140232108317215,0.059638942617666,0.0551257253384913,0.0851063829787234,0.143778207607995
"E02005529",460,431,94,144,287,316,1734,0.265282583621684,0.248558246828143,0.0542099192618224,0.0830449826989619,0.165513264129181,0.182237600922722
"E02005530",403,467,309,166,301,237,1975,0.204050632911392,0.236455696202532,0.156455696202532,0.0840506329113924,0.152405063291139,0.12
"E02005531",359,359,196,120,239,239,1622,0.221331689272503,0.221331689272503,0.120838471023428,0.0739827373612824,0.147348951911221,0.147348951911221
"E02005532",568,431,192,181,250,387,3952,0.143724696356275,0.109058704453441,0.048582995951417,0.0457995951417004,0.0632591093117409,0.0979251012145749
"E02005533",621,440,424,157,283,464,3106,0.199935608499678,0.141661300708307,0.13650998068255,0.0505473277527366,0.0911139729555699,0.149388280746941
"E02005534",537,537,277,165,372,372,2386,0.225062866722548,0.225062866722548,0.116093880972339,0.0691533948030176,0.155909471919531,0.155909471919531
"E02005535",502,256,296,90,166,412,2463,0.203816483962647,0.103938286642306,0.120178643930166,0.0365408038976857,0.0673974827446204,0.167275680064961
"E02005536",470,400,318,150,250,320,2466,0.190592051905921,0.16220600162206,0.128953771289538,0.0608272506082725,0.101378751013788,0.129764801297648
"E02005537",547,298,379,134,164,413,2418,0.226220016542597,0.123242349048801,0.156741108354012,0.0554177005789909,0.0678246484698098,0.170802315963606
"E02005538",1022,690,766,261,429,761,4873,0.209727067514878,0.141596552431767,0.157192694438744,0.053560435050277,0.0880361173814898,0.156166632464601
"E02005539",721,380,510,178,202,543,2979,0.242027526015441,0.127559583752937,0.171198388721047,0.0597515944947969,0.0678079892581403,0.182275931520645
"E02005540",827,462,434,196,266,631,3260,0.253680981595092,0.141717791411043,0.133128834355828,0.0601226993865031,0.0815950920245399,0.193558282208589
"E02005541",451,377,875,133,244,318,2100,0.214761904761905,0.17952380952381,0.416666666666667,0.0633333333333333,0.116190476190476,0.151428571428571
"E02005542",526,308,1927,82,226,444,3644,0.144346871569704,0.0845225027442371,0.528814489571899,0.0225027442371021,0.062019758507135,0.121844127332602
"E02005543",636,324,2325,83,241,553,4670,0.136188436830835,0.0693790149892934,0.497858672376874,0.0177730192719486,0.0516059957173448,0.118415417558887
"E02005544",454,220,1291,64,156,390,2818,0.1611071682044,0.078069552874379,0.458126330731015,0.0227111426543648,0.0553584102200142,0.138396025550035
"E02005545",445,265,34,108,157,337,1863,0.238862050456253,0.142243692968331,0.0182501341921632,0.0579710144927536,0.084272678475577,0.1808910359635
"E02005546",446,420,769,124,296,322,3138,0.142128744423199,0.133843212237094,0.245060548119822,0.0395156150414277,0.094327597195666,0.102613129381772
"E02005547",615,393,1442,133,260,482,3288,0.187043795620438,0.119525547445255,0.438564476885645,0.0404501216545012,0.0790754257907543,0.146593673965937
"E02005548",329,376,147,83,293,246,2185,0.150572082379863,0.1720823798627,0.0672768878718535,0.0379862700228833,0.134096109839817,0.112585812356979
"E02005549",441,405,255,165,240,276,1614,0.273234200743494,0.25092936802974,0.157992565055762,0.102230483271375,0.148698884758364,0.171003717472119
"E02005550",547,290,106,113,177,434,3317,0.164908049442267,0.0874283991558637,0.0319565872776605,0.03406692794694,0.0533614712089237,0.130841121495327
"E02005551",597,423,901,132,291,465,3711,0.160873080032336,0.113985448666128,0.24279170035031,0.0355699272433306,0.0784155214227971,0.125303152789006
"E02005552",807,510,1239,183,327,624,4336,0.186116236162362,0.117619926199262,0.285747232472325,0.0422047970479705,0.0754151291512915,0.143911439114391
"E02005553",828,505,836,177,328,651,4112,0.20136186770428,0.122811284046693,0.203307392996109,0.0430447470817121,0.0797665369649805,0.158317120622568
"E02005554",683,307,735,128,179,555,2979,0.229271567640148,0.103054716347768,0.246727089627392,0.0429674387378315,0.0600872776099362,0.186304128902316
"E02005555",499,301,163,136,165,363,2075,0.240481927710843,0.145060240963855,0.0785542168674699,0.0655421686746988,0.0795180722891566,0.174939759036145
"E02005556",586,432,156,175,257,411,2406,0.243557772236076,0.179551122194514,0.0648379052369077,0.072734829592685,0.106816292601829,0.170822942643392
"E02005557",378,282,770,88,194,290,3212,0.117683686176837,0.0877957658779577,0.23972602739726,0.0273972602739726,0.0603985056039851,0.0902864259028643
"E02005558",614,473,461,179,294,435,2567,0.239189715621348,0.184261784183872,0.179587066614725,0.0697312037397741,0.114530580444098,0.169458511881574
"E02005559",494,392,887,127,265,367,2761,0.178920680912713,0.141977544367983,0.321260412893879,0.0459978268743209,0.0959797174936617,0.132922854038392
"E02005560",575,414,166,113,301,462,3730,0.154155495978552,0.110991957104558,0.0445040214477212,0.0302949061662198,0.0806970509383378,0.123860589812332
"E02005561",769,603,1764,179,424,590,6011,0.127932124438529,0.100316087173515,0.293461986358343,0.0297787389785393,0.0705373481949759,0.09815338545999
"E02005562",612,435,586,155,280,457,2809,0.217871128515486,0.154859380562478,0.208615165539338,0.0551797792808829,0.0996796012815949,0.162691349234603
"E02005563",577,353,476,139,214,438,2727,0.211587825449212,0.129446277961129,0.174550788412175,0.050971763843051,0.0784745141180785,0.160616061606161
"E02005564",716,448,546,159,289,557,3477,0.205924647684786,0.128846706931263,0.157031924072476,0.0457290767903365,0.0831176301409261,0.160195570894449
"E02005565",643,436,484,208,228,435,2744,0.23432944606414,0.158892128279883,0.176384839650146,0.075801749271137,0.0830903790087464,0.158527696793003
"E02005566",816,507,955,184,323,632,3873,0.210689388071263,0.130906274206042,0.246578879421637,0.0475083914278337,0.0833978827782081,0.163180996643429
"E02005567",696,502,470,146,356,550,5096,0.136577708006279,0.0985086342229199,0.0922291993720565,0.0286499215070644,0.0698587127158556,0.107927786499215
"E02005568",663,373,870,166,207,497,2897,0.22885743872972,0.12875388332758,0.30031066620642,0.0573006558508802,0.0714532274767,0.17155678287884
"E02005569",775,462,679,222,240,553,3205,0.241809672386895,0.14414976599064,0.21185647425897,0.0692667706708268,0.0748829953198128,0.172542901716069
"E02005570",641,521,793,138,383,503,3500,0.183142857142857,0.148857142857143,0.226571428571429,0.0394285714285714,0.109428571428571,0.143714285714286
"E02005571",614,383,1144,140,243,474,3352,0.183174224343675,0.114260143198091,0.341288782816229,0.0417661097852029,0.0724940334128878,0.141408114558473
"E02005572",701,395,1388,136,259,565,4166,0.168266922707633,0.0948151704272684,0.333173307729237,0.0326452232357177,0.0621699471915506,0.135621699471916
"E02005573",552,314,642,114,200,438,3375,0.163555555555556,0.093037037037037,0.190222222222222,0.0337777777777778,0.0592592592592593,0.129777777777778
"E02005574",599,423,790,155,268,444,2896,0.206837016574586,0.146063535911602,0.272790055248619,0.0535220994475138,0.0925414364640884,0.153314917127072
"E02005575",541,286,861,105,181,436,2640,0.204924242424242,0.108333333333333,0.326136363636364,0.0397727272727273,0.0685606060606061,0.165151515151515
"E02005576",587,358,698,128,230,459,2996,0.195927903871829,0.119492656875834,0.232977303070761,0.0427236315086782,0.0767690253671562,0.153204272363151
"E02005577",596,270,795,112,158,484,2530,0.235573122529644,0.106719367588933,0.314229249011858,0.0442687747035573,0.0624505928853755,0.191304347826087
"E02005578",577,308,865,110,198,467,2575,0.224077669902913,0.119611650485437,0.335922330097087,0.0427184466019417,0.0768932038834951,0.181359223300971
"E02005580",603,355,505,122,233,481,3389,0.177928592505164,0.104750663912659,0.149011507819416,0.0359988197108292,0.0687518442018294,0.141929772794335
"E02005581",667,353,702,130,223,537,2723,0.244950422328314,0.129636430407639,0.257803892765332,0.0477414616232097,0.0818949687844289,0.197208960705105
"E02005582",756,428,526,204,224,552,3092,0.244501940491591,0.138421733505821,0.170116429495472,0.0659767141009056,0.0724450194049159,0.178525226390686
"E02005583",819,493,703,183,310,636,3581,0.228707065065624,0.137671041608489,0.196313878804803,0.0511030438425021,0.0865679977659872,0.177604021223122
"E02005584",830,778,567,239,539,591,4573,0.181500109337415,0.170129018150011,0.123988628908813,0.0522632844959545,0.117865733654056,0.129236824841461
"E02005585",686,535,1260,156,379,530,4567,0.150208014013576,0.117144733961025,0.27589227063718,0.0341580906503175,0.0829866433107073,0.116049923363258
"E02005586",896,744,2983,205,539,691,5141,0.174285158529469,0.144718926278934,0.580237307916748,0.0398755106010504,0.104843415677884,0.134409647928419
"E02005587",583,457,483,162,295,421,3278,0.177852348993289,0.13941427699817,0.147345942647956,0.0494203782794387,0.0899938987187309,0.12843197071385
"E02005588",693,461,153,145,316,548,4892,0.141659852820932,0.0942354865085854,0.0312755519215045,0.0296402289452167,0.0645952575633688,0.112019623875715
"E02005589",756,556,846,169,387,587,4634,0.163141993957704,0.119982736296936,0.18256365990505,0.0364695727233492,0.0835131635735865,0.126672421234355
"E02005592",717,589,3088,123,466,594,4148,0.172854387656702,0.141996142719383,0.744455159112825,0.0296528447444552,0.112343297974928,0.143201542912247
"E02005593",390,324,293,95,229,295,2615,0.149139579349904,0.123900573613767,0.112045889101338,0.0363288718929254,0.0875717017208413,0.112810707456979
"E02005594",636,787,2371,175,612,461,5582,0.113937656753852,0.140988892869939,0.424758151200287,0.0313507703332139,0.109638122536725,0.0825868864206378
"E02005595",632,624,535,196,428,436,3362,0.187983343248067,0.185603807257585,0.159131469363474,0.0582986317668055,0.127305175490779,0.129684711481261
"E02005596",685,561,832,131,430,554,3950,0.173417721518987,0.142025316455696,0.210632911392405,0.0331645569620253,0.108860759493671,0.140253164556962
"E02005598",471,332,356,116,216,355,5009,0.0940307446596127,0.066280694749451,0.0710720702735077,0.0231583150329407,0.0431223797165103,0.070872429626672
"E02005599",417,278,148,108,170,309,3024,0.137896825396825,0.0919312169312169,0.0489417989417989,0.0357142857142857,0.0562169312169312,0.10218253968254
"E02005600",370,252,375,85,167,285,1983,0.186585980837115,0.127080181543116,0.18910741301059,0.0428643469490671,0.0842158345940494,0.143721633888048
"E02005601",479,265,337,96,169,383,2273,0.21073471183458,0.116586009678839,0.148262208534976,0.042234931808183,0.0743510778706555,0.168499780026397
"E02005602",759,431,577,175,256,584,4847,0.156591706210027,0.088920982050753,0.119042706828966,0.0361048070971735,0.0528161749535795,0.120486899112853
"E02005603",445,408,320,125,283,320,5590,0.0796064400715563,0.0729874776386404,0.0572450805008945,0.0223613595706619,0.0506261180679785,0.0572450805008945
"E02005604",538,295,514,113,182,425,3024,0.177910052910053,0.0975529100529101,0.169973544973545,0.0373677248677249,0.0601851851851852,0.140542328042328
"E02005605",661,394,428,178,216,483,3470,0.190489913544669,0.113544668587896,0.123342939481268,0.0512968299711816,0.0622478386167147,0.139193083573487
"E02005606",488,326,579,154,172,334,1967,0.248093543467209,0.165734621250635,0.294356888662938,0.0782918149466192,0.0874428063040163,0.16980172852059
"E02005607",822,426,374,198,228,624,3788,0.217001055966209,0.112460401267159,0.0987328405491024,0.0522703273495248,0.0601900739176346,0.164730728616684
"E02005608",565,374,571,156,218,409,2664,0.212087087087087,0.14039039039039,0.214339339339339,0.0585585585585586,0.0818318318318318,0.153528528528529
"E02005609",554,304,508,140,164,414,3167,0.174928954846858,0.0959898958004421,0.160404167982318,0.0442058730659931,0.051784022734449,0.130723081780865
"E02005610",613,336,450,150,186,463,2576,0.237965838509317,0.130434782608696,0.174689440993789,0.0582298136645963,0.0722049689440994,0.179736024844721
"E02005611",763,462,498,169,293,594,4680,0.163034188034188,0.0987179487179487,0.106410256410256,0.0361111111111111,0.0626068376068376,0.126923076923077
"E02005612",311,230,426,54,176,257,2547,0.122104436592069,0.0903023164507263,0.167255594817432,0.0212014134275618,0.0691009030231645,0.100903023164507
"E02005613",419,625,597,142,483,277,2990,0.140133779264214,0.209030100334448,0.199665551839465,0.0474916387959866,0.161538461538462,0.0926421404682274
"E02005614",323,248,767,56,192,267,6517,0.0495626822157434,0.0380543194721498,0.117692189657818,0.00859291084854995,0.0294614086235998,0.0409697713671935
"E02005615",407,550,51,139,411,268,2991,0.136074891340689,0.183884988298228,0.0170511534603811,0.0464727515880976,0.13741223671013,0.0896021397525911
"E02005616",227,262,246,61,201,166,2064,0.109980620155039,0.126937984496124,0.119186046511628,0.0295542635658915,0.0973837209302326,0.0804263565891473
"E02005617",535,740,43,189,551,346,3777,0.141646809637278,0.195922689965581,0.0113846968493513,0.0500397140587768,0.145882975906804,0.0916070955785015
"E02005619",422,196,611,65,131,357,2154,0.195914577530176,0.0909935004642526,0.283658310120706,0.0301764159702878,0.0608170844939647,0.165738161559889
"E02005620",439,315,546,109,206,330,2530,0.173517786561265,0.124505928853755,0.215810276679842,0.0430830039525692,0.0814229249011858,0.130434782608696
"E02005621",511,232,395,78,154,433,2764,0.184876989869754,0.0839363241678727,0.142908827785818,0.0282199710564399,0.0557163531114327,0.156657018813314
"E02005622",526,293,817,91,202,435,3322,0.158338350391331,0.0881998795906081,0.245936183022276,0.0273931366646598,0.0608067429259482,0.130945213726671
"E02005623",482,328,602,116,212,366,5468,0.0881492318946598,0.0599853694220922,0.110095098756401,0.0212143379663497,0.0387710314557425,0.0669348939283102
"E02005624",436,281,32,62,219,374,4533,0.0961835429075667,0.0619898521950143,0.00705934259872049,0.013677476285021,0.0483123759099934,0.0825060666225458
"E02005625",529,373,313,114,259,415,3515,0.15049786628734,0.106116642958748,0.0890469416785206,0.0324324324324324,0.0736842105263158,0.118065433854908
"E02005626",393,345,34,98,247,295,2559,0.153575615474795,0.134818288393904,0.0132864400156311,0.0382962094568191,0.0965220789370848,0.115279406017976
"E02005627",405,244,580,73,171,332,2894,0.139944713199724,0.0843123704215619,0.200414651002073,0.025224602626123,0.0590877677954388,0.114720110573601
"E02005628",518,262,690,82,180,436,2900,0.178620689655172,0.0903448275862069,0.237931034482759,0.0282758620689655,0.0620689655172414,0.150344827586207
"E02005629",349,207,667,65,142,284,2329,0.149849720910262,0.0888793473593817,0.286389008158008,0.0279089738085015,0.0609703735508802,0.12194074710176
"E02005630",580,322,894,104,218,476,3904,0.148565573770492,0.0824795081967213,0.228995901639344,0.0266393442622951,0.0558401639344262,0.121926229508197
"E02005631",536,317,873,94,223,442,4259,0.125851138764968,0.0744306175158488,0.204977694294435,0.0220709086640056,0.0523597088518432,0.103780230100963
"E02005632",348,203,574,64,139,284,2251,0.154597956463794,0.0901821412705464,0.254997778764993,0.0284318080852954,0.061750333185251,0.126166148378498
"E02005633",598,324,540,123,201,475,3865,0.154721862871928,0.0838292367399741,0.139715394566624,0.0318240620957309,0.0520051746442432,0.122897800776197
"E02005634",495,256,711,73,183,422,3778,0.131021704605611,0.0677607199576496,0.188194812069878,0.0193223928004235,0.048438327157226,0.111699311805188
"E02005635",395,323,459,96,227,299,3293,0.119951412086244,0.0980868508958397,0.139386577588825,0.0291527482538718,0.0689341026419678,0.0907986638323717
"E02005636",652,477,707,181,296,471,4545,0.143454345434543,0.104950495049505,0.155555555555556,0.0398239823982398,0.0651265126512651,0.103630363036304
"E02005637",641,271,1666,75,196,566,4726,0.135632670334321,0.0573423614049937,0.352517985611511,0.0158696572154041,0.0414727041895895,0.119763013118917
"E02005638",545,381,115,126,255,419,2870,0.189895470383275,0.132752613240418,0.0400696864111498,0.0439024390243902,0.0888501742160279,0.145993031358885
"E02005639",334,227,656,64,163,270,2096,0.159351145038168,0.108301526717557,0.312977099236641,0.0305343511450382,0.0777671755725191,0.12881679389313
"E02005640",414,304,773,86,218,328,4322,0.0957889865802869,0.0703378065710319,0.178852383155946,0.019898195279963,0.0504396112910689,0.0758907913003239
"E02005641",440,313,920,97,216,343,3628,0.121278941565601,0.0862734288864388,0.253583241455347,0.0267364939360529,0.0595369349503859,0.094542447629548
"E02005642",490,280,735,83,197,407,2706,0.181079083518108,0.103473762010347,0.271618625277162,0.0306725794530673,0.0728011825572801,0.150406504065041
"E02005643",511,433,828,133,300,378,3030,0.168646864686469,0.142904290429043,0.273267326732673,0.0438943894389439,0.099009900990099,0.124752475247525
"E02005644",742,187,2880,42,145,700,4520,0.164159292035398,0.0413716814159292,0.63716814159292,0.00929203539823009,0.0320796460176991,0.154867256637168
"E02005645",783,443,1605,117,326,666,5884,0.133072739632903,0.0752889191026513,0.272773623385452,0.0198844323589395,0.0554044867437118,0.113188307273963
"E02005646",489,392,128,163,229,326,1884,0.259554140127389,0.208067940552017,0.0679405520169851,0.0865180467091295,0.121549893842887,0.173036093418259
"E02005647",405,382,462,134,248,271,2770,0.146209386281588,0.137906137184116,0.166787003610108,0.0483754512635379,0.0895306859205776,0.0978339350180505
"E02005648",416,303,102,112,191,304,3684,0.112920738327904,0.0822475570032573,0.0276872964169381,0.0304017372421281,0.0518458197611292,0.0825190010857763
"E02005650",396,476,188,163,313,233,2535,0.156213017751479,0.187771203155819,0.0741617357001972,0.0642998027613412,0.123471400394477,0.0919132149901381
"E02005651",500,470,90,178,292,322,2105,0.237529691211401,0.223277909738717,0.0427553444180523,0.0845605700712589,0.138717339667458,0.152969121140143
"E02005652",429,411,313,119,292,310,2198,0.195177434030937,0.186988171064604,0.142402183803458,0.054140127388535,0.132848043676069,0.141037306642402
"E02005653",524,471,16,138,333,386,3088,0.169689119170984,0.152525906735751,0.00518134715025907,0.0446891191709845,0.107836787564767,0.125
"E02005654",497,445,12,126,319,371,3072,0.161783854166667,0.144856770833333,0.00390625,0.041015625,0.103841145833333,0.120768229166667
"E02005655",415,397,268,119,278,296,2110,0.196682464454976,0.188151658767773,0.127014218009479,0.0563981042654028,0.13175355450237,0.140284360189573
"E02005656",275,422,30,91,331,184,2175,0.126436781609195,0.194022988505747,0.0137931034482759,0.0418390804597701,0.152183908045977,0.0845977011494253
"E02005657",429,400,613,129,271,300,2338,0.183490162532079,0.171086398631309,0.262189905902481,0.0551753635585971,0.115911035072712,0.128314798973482
"E02005658",418,415,1090,104,311,314,2974,0.140551445864156,0.139542703429724,0.366509751176866,0.034969737726967,0.104572965702757,0.105581708137189
"E02005659",376,410,531,125,285,251,1962,0.191641182466871,0.208970438328237,0.270642201834862,0.063710499490316,0.14525993883792,0.127930682976555
"E02005660",350,291,71,83,208,267,2125,0.164705882352941,0.136941176470588,0.0334117647058824,0.0390588235294118,0.0978823529411765,0.125647058823529
"E02005661",342,242,753,60,182,282,2461,0.138967899227956,0.0983340105648111,0.305973181633482,0.024380333197887,0.073953677366924,0.114587566030069
"E02005662",456,363,1068,113,250,343,2245,0.203118040089087,0.161692650334076,0.475723830734967,0.0503340757238307,0.111358574610245,0.152783964365256
"E02005663",372,176,68,64,112,308,1753,0.212207644038791,0.100399315459213,0.0387906446092413,0.0365088419851683,0.0638904734740445,0.175698802053622
"E02005664",416,284,1532,67,217,349,2724,0.152716593245228,0.104258443465492,0.562408223201175,0.0245961820851689,0.079662261380323,0.128120411160059
"E02005665",482,278,54,91,187,391,2740,0.175912408759124,0.101459854014599,0.0197080291970803,0.0332116788321168,0.0682481751824817,0.142700729927007
"E02005666",405,553,373,90,463,315,3445,0.117561683599419,0.160522496371553,0.108272859216255,0.0261248185776488,0.134397677793904,0.0914368650217707
"E02005667",391,358,53,95,263,296,2535,0.154240631163708,0.141222879684418,0.0209072978303748,0.0374753451676529,0.103747534516765,0.116765285996055
"E02005668",444,341,317,115,226,329,2122,0.20923656927427,0.160697455230914,0.149387370405278,0.0541941564561734,0.106503298774741,0.155042412818096
"E02005669",368,291,215,95,196,273,1680,0.219047619047619,0.173214285714286,0.12797619047619,0.056547619047619,0.116666666666667,0.1625
"E02005670",470,498,1884,44,454,426,5734,0.0819672131147541,0.0868503662364841,0.328566445762121,0.00767352633414719,0.0791768399023369,0.0742936867806069
"E02005671",523,134,2323,24,110,499,3397,0.153959375919929,0.0394465705033853,0.683838681189285,0.0070650574035914,0.0323815130997939,0.146894318516338
"E02005672",493,154,2591,32,122,461,4419,0.111563702195067,0.0348495134645847,0.586331749264539,0.00724145734329034,0.0276080561212944,0.104322244851776
"E02005673",452,299,1336,98,201,354,3421,0.132125109617071,0.0874013446360713,0.390529085062847,0.0286465945629933,0.058754750073078,0.103478515054078
"E02005674",479,565,1281,88,477,391,4633,0.103388733002374,0.121951219512195,0.276494711849773,0.0189941722426074,0.102957047269588,0.0843945607597669
"E02005675",349,228,7,55,173,294,2428,0.143739703459638,0.0939044481054366,0.0028830313014827,0.0226523887973641,0.0712520593080725,0.121087314662273
"E02005676",328,280,566,87,193,241,2155,0.152204176334107,0.129930394431555,0.262645011600928,0.0403712296983759,0.0895591647331787,0.111832946635731
"E02005677",445,313,976,87,226,358,4063,0.109524981540733,0.0770366724095496,0.240216588727541,0.0214127492000984,0.0556239232094511,0.088112232340635
"E02005679",729,199,5,78,121,651,2973,0.245206861755802,0.0669357551294988,0.00168180289270098,0.0262361251261352,0.0406996300033636,0.218970736629667
"E02005680",307,182,115,58,124,249,2742,0.111962071480671,0.0663749088256747,0.0419401896425966,0.0211524434719183,0.0452224653537564,0.0908096280087527
"E02005681",498,390,448,150,240,348,2962,0.168129642133693,0.131667792032411,0.151249155975692,0.0506414584740041,0.0810263335584065,0.117488183659689
"E02005682",376,287,619,100,187,276,2432,0.154605263157895,0.118009868421053,0.254523026315789,0.0411184210526316,0.0768914473684211,0.113486842105263
"E02005683",568,551,533,182,369,386,4800,0.118333333333333,0.114791666666667,0.111041666666667,0.0379166666666667,0.076875,0.0804166666666667
"E02005684",609,319,692,126,193,483,2941,0.207072424345461,0.108466507990479,0.235294117647059,0.0428425705542333,0.0656239374362462,0.164229853791227
"E02005685",486,302,361,105,197,381,4829,0.100641954856078,0.0625388279146821,0.0747566784013253,0.0217436322219921,0.04079519569269,0.0788983226340857
"E02005686",575,341,612,130,211,445,2620,0.219465648854962,0.130152671755725,0.233587786259542,0.049618320610687,0.0805343511450382,0.169847328244275
"E02005687",435,246,571,103,143,332,2349,0.185185185185185,0.104725415070243,0.243082162622393,0.0438484461472967,0.0608769689229459,0.141336739037888
"E02005688",452,467,423,138,329,314,3115,0.145104333868379,0.14991974317817,0.135794542536116,0.0443017656500803,0.10561797752809,0.100802568218299
"E02005689",406,253,90,86,167,320,3554,0.114237478897017,0.0711873944850872,0.0253235790658413,0.024198086662915,0.0469893078221722,0.0900393922341024
"E02005690",326,189,422,55,134,271,2480,0.131451612903226,0.0762096774193548,0.170161290322581,0.0221774193548387,0.0540322580645161,0.109274193548387
"E02005691",490,359,612,111,248,379,2266,0.216240070609003,0.158428949691086,0.270079435127979,0.0489849955869373,0.109443954104148,0.167255075022065
"E02005692",381,289,631,86,203,295,3765,0.101195219123506,0.0767596281540505,0.167596281540505,0.0228419654714475,0.0539176626826029,0.0783532536520584
"E02005693",398,284,130,103,181,295,2645,0.15047258979206,0.107372400756144,0.0491493383742911,0.0389413988657845,0.0684310018903592,0.111531190926276
"E02005694",445,253,162,96,157,349,2340,0.19017094017094,0.108119658119658,0.0692307692307692,0.041025641025641,0.0670940170940171,0.149145299145299
"E02005695",472,162,1755,42,120,430,4815,0.0980269989615784,0.0336448598130841,0.364485981308411,0.00872274143302181,0.0249221183800623,0.0893042575285566
"E02005696",329,323,35,89,234,240,2334,0.140959725792631,0.138389031705227,0.0149957155098543,0.0381319622964867,0.10025706940874,0.102827763496144
"E02005697",372,312,1150,54,258,318,3588,0.103678929765886,0.0869565217391304,0.320512820512821,0.0150501672240803,0.0719063545150502,0.088628762541806
"E02005698",288,252,235,79,173,209,1831,0.157291097760786,0.137629710540688,0.128345166575642,0.0431458219552157,0.0944838885854724,0.114145275805571
"E02005699",339,224,132,65,159,274,2826,0.119957537154989,0.0792639773531493,0.0467091295116773,0.0230007077140835,0.0562632696390658,0.0969568294409059
"E02005700",484,388,719,118,270,366,3580,0.135195530726257,0.108379888268156,0.200837988826816,0.0329608938547486,0.0754189944134078,0.102234636871508
"E02005701",604,486,949,136,350,468,3791,0.159324716433659,0.128198364547613,0.250329728303878,0.0358744394618834,0.0923239250857294,0.123450276971775
"E02005702",395,415,694,84,331,311,3257,0.121277249002149,0.12741786920479,0.213079521031624,0.02579060485109,0.1016272643537,0.0954866441510593
"E02005703",340,393,672,87,306,253,3087,0.110139293812763,0.127308066083576,0.217687074829932,0.0281827016520894,0.0991253644314869,0.0819565921606738
"E02005704",637,684,1042,159,525,478,5477,0.116304546284462,0.124885886434179,0.190250136936279,0.0290304911447873,0.095855395289392,0.087274055139675
"E02005705",580,353,1132,111,242,469,3303,0.175597941265516,0.106872540115047,0.342718740538904,0.033605812897366,0.0732667272176809,0.14199212836815
"E02005706",489,664,822,105,559,384,4105,0.119123020706456,0.161753958587089,0.200243605359318,0.02557856272838,0.136175395858709,0.0935444579780755
"E02005707",550,492,707,135,357,415,2761,0.199203187250996,0.178196305686346,0.256066642520826,0.0488953277797899,0.129300977906556,0.150307859471206
"E02005708",1051,898,1762,249,649,802,5917,0.177623795842488,0.151766097684637,0.297786040223086,0.0420821362176779,0.10968396146696,0.13554165962481
"E02005709",266,307,236,48,259,218,2872,0.0926183844011142,0.106894150417827,0.0821727019498607,0.0167130919220056,0.0901810584958217,0.0759052924791086
"E02005710",666,811,1382,191,620,475,4522,0.147279964617426,0.179345422379478,0.30561698363556,0.0422379478107032,0.137107474568775,0.105042016806723
"E02005711",334,332,110,81,251,253,2781,0.120100683207479,0.11938151743977,0.0395541172240201,0.029126213592233,0.0902553038475369,0.0909744696152463
"E02005712",271,447,215,95,352,176,4023,0.0673626646781009,0.111111111111111,0.0534427044494159,0.0236142182450907,0.0874968928660204,0.0437484464330102
"E02005713",240,289,17,83,206,157,1709,0.140433001755413,0.169104739613809,0.00994733762434172,0.0485664131070802,0.120538326506729,0.0918665886483324
"E02005715",396,524,114,124,400,272,4391,0.0901844682304714,0.119335003416078,0.0259621953996812,0.0282395809610567,0.0910954224550216,0.0619448872694147
"E02005717",409,436,191,124,312,285,2687,0.152214365463342,0.162262746557499,0.0710829921845925,0.0461481205805731,0.116114625976926,0.106066244882769
"E02005718",328,572,120,134,438,194,2102,0.15604186489058,0.272121788772598,0.0570884871550904,0.0637488106565176,0.20837297811608,0.0922930542340628
"E02005719",365,480,198,111,369,254,3296,0.110740291262136,0.145631067961165,0.0600728155339806,0.0336771844660194,0.111953883495146,0.0770631067961165
"E02005720",530,688,252,189,499,341,4276,0.123947614593078,0.16089803554724,0.058933582787652,0.044200187090739,0.116697848456501,0.0797474275023386
"E02005721",212,258,439,65,193,147,2398,0.0884070058381985,0.107589658048374,0.183069224353628,0.0271059216013344,0.0804837364470392,0.0613010842368641
"E02005722",468,336,848,110,226,358,3982,0.117528879959819,0.084379708689101,0.212958312405826,0.0276243093922652,0.0567553992968358,0.089904570567554
"E02005723",288,453,331,102,351,186,2621,0.109881724532621,0.172834795879435,0.126287676459367,0.0389164441053033,0.133918351774132,0.0709652804273178
"E02005724",183,286,74,63,223,120,1891,0.0967741935483871,0.151242728714966,0.0391327340031729,0.0333157059756742,0.117927022739291,0.0634584875727129
"E02005725",302,355,135,89,266,213,2659,0.113576532531027,0.133508837908988,0.0507709665287702,0.0334712297856337,0.100037608123355,0.080105302745393
"E02005726",402,437,331,135,302,267,2371,0.169548713622944,0.18431041754534,0.139603542808941,0.0569380008435259,0.127372416701814,0.112610712779418
"E02005727",528,275,1108,82,193,446,2559,0.206330597889801,0.107463853067605,0.432981633450567,0.0320437670965221,0.0754200859710824,0.174286830793279
"E02005728",533,356,1079,97,259,436,2434,0.2189811010682,0.146261298274445,0.443303204601479,0.0398520953163517,0.106409202958094,0.179129005751849
"E02005729",306,347,602,92,255,214,1872,0.163461538461538,0.185363247863248,0.321581196581197,0.0491452991452991,0.136217948717949,0.114316239316239
"E02005730",683,663,1277,163,500,520,5047,0.135327917574797,0.131365167426194,0.25302159698831,0.0322964137111155,0.0990687537150783,0.103031503863681
"E02005731",365,601,323,128,473,237,3334,0.109478104379124,0.180263947210558,0.096880623875225,0.0383923215356929,0.141871625674865,0.0710857828434313
"E02005733",641,381,1380,122,259,519,3192,0.200814536340852,0.119360902255639,0.432330827067669,0.0382205513784461,0.081140350877193,0.162593984962406
"E02005734",382,442,345,111,331,271,2340,0.163247863247863,0.188888888888889,0.147435897435897,0.0474358974358974,0.141452991452991,0.115811965811966
"E02005735",648,911,255,251,660,397,3631,0.178463233269072,0.250895070228587,0.07022858716607,0.0691269622693473,0.18176810795924,0.109336270999725
"E02005736",475,353,71,116,237,359,3918,0.121235324144972,0.090096988259316,0.0181214905564063,0.0296069423175089,0.060490045941807,0.091628381827463
"E02005739",420,749,221,170,579,250,3212,0.130759651307597,0.23318804483188,0.0688044831880448,0.0529265255292653,0.180261519302615,0.0778331257783313
"E02005740",503,950,452,195,755,308,4018,0.125186660029866,0.236436037829766,0.112493777999004,0.0485316077650572,0.187904430064709,0.0766550522648084
"E02005741",290,340,145,68,272,222,3049,0.0951131518530666,0.111511971138078,0.0475565759265333,0.0223023942276156,0.0892095769104624,0.072810757625451
"E02005742",552,342,1075,107,235,445,3008,0.183510638297872,0.113696808510638,0.357380319148936,0.0355718085106383,0.078125,0.147938829787234
"E02005744",542,420,1125,103,317,439,3139,0.172666454284804,0.133800573431029,0.358394393118828,0.0328129977699904,0.100987575661039,0.139853456514814
"E02005746",437,534,630,145,389,292,2969,0.147187605254294,0.17985853822836,0.212192657460424,0.0488379925900977,0.131020545638262,0.0983496126641967
"E02005747",483,365,1198,73,292,410,3154,0.153138871274572,0.11572606214331,0.379835129993659,0.023145212428662,0.0925808497146481,0.12999365884591
"E02005748",504,364,1211,99,265,405,2918,0.172721041809459,0.124742974640164,0.415010281014393,0.0339273474982865,0.090815627141878,0.138793694311172
"E02005749",651,581,1154,171,410,480,3544,0.183690744920993,0.163939051918736,0.325620767494357,0.0482505643340858,0.11568848758465,0.135440180586907
"E02005750",442,681,643,113,568,329,3255,0.1357910906298,0.209216589861751,0.197542242703533,0.034715821812596,0.174500768049155,0.101075268817204
"E02005751",582,479,695,142,337,440,3076,0.189206762028609,0.155721716514954,0.22594278283485,0.0461638491547464,0.109557867360208,0.143042912873862
"E02005752",418,376,902,98,278,320,3077,0.135846603834904,0.122196945076373,0.293142671433214,0.0318492037699057,0.0903477413064673,0.103997400064998
"E02005754",429,483,381,148,335,281,2604,0.164746543778802,0.185483870967742,0.1463133640553,0.0568356374807988,0.128648233486943,0.107910906298003
"E02005755",381,282,456,80,202,301,3008,0.126662234042553,0.09375,0.151595744680851,0.0265957446808511,0.0671542553191489,0.100066489361702
"E02005756",350,251,593,86,165,264,2503,0.13983220135837,0.100279664402717,0.23691570115861,0.034358769476628,0.0659208949260887,0.105473431881742
"E02005757",573,443,1092,116,327,457,3791,0.151147454497494,0.116855710894223,0.288050646267476,0.0305987865998417,0.0862569242943814,0.120548667897652
"E02005758",433,561,563,112,449,321,4272,0.101357677902622,0.131320224719101,0.131788389513109,0.0262172284644195,0.105102996254682,0.0751404494382023
"E02005759",546,510,760,158,352,388,4303,0.126888217522659,0.118521961422264,0.176620962119452,0.0367185684406228,0.0818033929816407,0.0901696490820358
"E02005760",368,197,560,54,143,314,2384,0.154362416107383,0.0826342281879195,0.23489932885906,0.0226510067114094,0.0599832214765101,0.131711409395973
"E02005761",356,229,768,56,173,300,2029,0.175455889600789,0.112863479546575,0.378511582060128,0.027599802858551,0.0852636766880237,0.147856086742238
"E02005762",392,204,559,58,146,334,2589,0.151409810737737,0.0787949015063731,0.21591348010815,0.02240247199691,0.0563924295094631,0.129007338740827
"E02005763",367,271,609,71,200,296,2461,0.149126371393742,0.110117838277123,0.247460381958553,0.028850060950833,0.0812677773262901,0.120276310442909
"E02005764",721,488,728,136,352,585,4008,0.179890219560878,0.121756487025948,0.181636726546906,0.0339321357285429,0.0878243512974052,0.145958083832335
"E02005765",425,302,438,106,196,319,3320,0.128012048192771,0.0909638554216868,0.131927710843373,0.0319277108433735,0.0590361445783133,0.0960843373493976
"E02005766",434,274,925,90,184,344,2334,0.185946872322194,0.117395029991431,0.396315338474722,0.038560411311054,0.078834618680377,0.14738646101114
"E02005767",406,348,467,124,224,282,2677,0.151662308554352,0.129996264475159,0.174449010085917,0.0463205080313784,0.0836757564437803,0.105341800522973
"E02005768",328,336,299,82,254,246,2912,0.112637362637363,0.115384615384615,0.102678571428571,0.0281593406593407,0.0872252747252747,0.084478021978022
"E02005769",491,549,622,154,395,337,2891,0.169837426496022,0.189899688689035,0.215150466966448,0.0532687651331719,0.136630923555863,0.11656866136285
"E02005770",748,562,759,216,346,532,3033,0.246620507748104,0.185295087372239,0.25024727992087,0.0712166172106825,0.114078470161556,0.175403890537422
"E02005771",560,566,182,153,413,407,2976,0.188172043010753,0.190188172043011,0.0611559139784946,0.0514112903225806,0.13877688172043,0.136760752688172
"E02005772",382,390,220,136,254,246,2088,0.182950191570881,0.186781609195402,0.10536398467433,0.0651340996168582,0.121647509578544,0.117816091954023
"E02005773",713,512,1546,145,367,568,4459,0.159901323166629,0.114823951558645,0.346714509979816,0.032518501906257,0.0823054496523884,0.127382821260372
"E02005774",705,570,871,179,391,526,3404,0.20710928319624,0.167450058754407,0.255875440658049,0.0525851938895417,0.114864864864865,0.154524089306698
"E02005775",928,441,2920,89,352,839,6006,0.154512154512155,0.0734265734265734,0.486180486180486,0.0148185148185148,0.0586080586080586,0.13969363969364
"E02005776",513,336,707,131,205,382,3407,0.150572351041972,0.0986204872321691,0.207513941884356,0.0384502494863516,0.0601702377458174,0.112122101555621
"E02005777",534,718,135,209,509,325,2512,0.212579617834395,0.285828025477707,0.0537420382165605,0.0832006369426752,0.202627388535032,0.12937898089172
"E02005778",416,344,711,126,218,290,2190,0.189954337899543,0.157077625570776,0.324657534246575,0.0575342465753425,0.0995433789954338,0.132420091324201
"E02005779",600,474,1775,74,400,526,4026,0.14903129657228,0.117734724292101,0.440884252359662,0.0183805265772479,0.0993541977148535,0.130650769995032
"E02005780",733,810,519,231,579,502,3969,0.184681279919375,0.204081632653061,0.130763416477702,0.0582010582010582,0.145880574452003,0.126480221718317
"E02005781",408,534,431,166,368,242,2082,0.195965417867435,0.256484149855908,0.207012487992315,0.079731027857829,0.176753121998079,0.116234390009606
"E02005782",549,442,969,128,314,421,2702,0.203182827535159,0.163582531458179,0.358623242042931,0.0473723168023686,0.116210214655811,0.155810510732791
"E02005783",427,757,870,147,610,280,3257,0.131102241326374,0.232422474669942,0.26711697881486,0.0451335584894074,0.187288916180534,0.0859686828369665
"E02005784",249,237,290,59,178,190,2000,0.1245,0.1185,0.145,0.0295,0.089,0.095
"E02005785",342,447,169,79,368,263,4948,0.0691188358932902,0.0903395311236863,0.0341552142279709,0.0159660468876314,0.074373484236055,0.0531527890056589
"E02005786",652,290,1677,94,196,558,2875,0.226782608695652,0.100869565217391,0.583304347826087,0.032695652173913,0.0681739130434783,0.194086956521739
"E02005787",646,495,1157,133,362,513,3634,0.177765547605944,0.13621353880022,0.318381948266373,0.0365987892129884,0.0996147495872317,0.141166758392955
"E02005788",708,303,1076,122,181,586,2915,0.242881646655232,0.103945111492281,0.369125214408233,0.041852487135506,0.0620926243567753,0.201029159519726
"E02005789",1060,567,1133,236,331,824,4716,0.224766751484309,0.120229007633588,0.240245971162002,0.0500424088210348,0.070186598812553,0.174724342663274
"E02005790",566,384,1005,126,258,440,2853,0.19838766211006,0.13459516298633,0.352260778128286,0.0441640378548896,0.0904311251314406,0.15422362425517
"E02005791",691,475,889,166,309,525,2880,0.239930555555556,0.164930555555556,0.308680555555556,0.0576388888888889,0.107291666666667,0.182291666666667
"E02005794",788,524,1127,190,334,598,3478,0.226566992524439,0.15066129959747,0.324036802760207,0.0546290971822887,0.0960322024151811,0.171937895342151
"E02005795",601,516,1146,131,385,470,4112,0.146157587548638,0.125486381322957,0.278696498054475,0.0318579766536965,0.0936284046692607,0.114299610894942
"E02005796",811,389,1399,152,237,659,2984,0.271782841823056,0.130361930294906,0.468833780160858,0.0509383378016086,0.0794235924932976,0.220844504021448
"E02005797",610,389,742,130,259,480,3164,0.192793931731985,0.122945638432364,0.234513274336283,0.0410872313527181,0.081858407079646,0.151706700379267
"E02005798",929,614,1060,250,364,679,3340,0.27814371257485,0.183832335329341,0.317365269461078,0.0748502994011976,0.108982035928144,0.203293413173653
"E02005799",739,702,337,264,438,475,3326,0.222188815393867,0.211064341551413,0.101322910402886,0.079374624173181,0.131689717378232,0.142814191220686
"E02005800",866,390,2608,97,293,769,4840,0.178925619834711,0.0805785123966942,0.538842975206612,0.0200413223140496,0.0605371900826446,0.158884297520661
"E02005801",304,467,303,110,357,194,2039,0.149092692496322,0.229033840117705,0.148602256007847,0.0539480137322217,0.175085826385483,0.0951446787641
"E02005802",918,224,2590,64,160,854,3378,0.271758436944938,0.0663114268798105,0.766725873297809,0.0189461219656602,0.0473653049141504,0.252812314979278
"E02005803",699,504,1198,141,363,558,4152,0.168352601156069,0.121387283236994,0.288535645472062,0.0339595375722543,0.0874277456647399,0.134393063583815
"E02005804",683,364,3613,79,285,604,5951,0.114770626785414,0.061166190556209,0.607124852965888,0.0132750798185179,0.0478911107376911,0.101495546966896
"E02005805",746,524,191,193,331,553,3371,0.221299317709878,0.155443488579057,0.0566597448828241,0.0572530406407594,0.0981904479382972,0.164046277069119
"E02005806",419,371,71,132,239,287,3040,0.137828947368421,0.122039473684211,0.0233552631578947,0.043421052631579,0.0786184210526316,0.0944078947368421
"E02005807",653,367,511,172,195,481,2452,0.2663132137031,0.149673735725938,0.208401305057096,0.0701468189233279,0.0795269168026101,0.196166394779772
"E02005808",1240,817,1180,337,480,903,6150,0.201626016260163,0.132845528455285,0.191869918699187,0.0547967479674797,0.0780487804878049,0.146829268292683
"E02005809",464,473,406,125,348,339,2577,0.180054326736515,0.183546759798215,0.157547535894451,0.0485060147458285,0.135040745052387,0.131548311990687
"E02005810",502,325,658,98,227,404,3274,0.153329260843005,0.0992669517409896,0.200977397678681,0.0299328039095907,0.0693341478313989,0.123396456933415
"E02005811",583,431,430,165,266,418,3363,0.173357121617603,0.128159381504609,0.127862027951234,0.0490633363068689,0.0790960451977401,0.124293785310734
"E02005812",448,424,325,118,306,330,4459,0.100470957613815,0.0950885848845033,0.0728862973760933,0.0264633325857816,0.0686252522987217,0.0740076250280332
"E02005813",558,408,1300,103,305,455,6152,0.090702210663199,0.0663198959687906,0.211313394018205,0.016742522756827,0.0495773732119636,0.0739596879063719
"E02005814",378,302,329,107,195,271,2458,0.153783563873068,0.12286411716843,0.133848657445077,0.0435313262815297,0.0793327908868999,0.110252237591538
"E02005815",470,404,153,146,258,324,2673,0.17583239805462,0.151141040029929,0.0572390572390572,0.0546202768424991,0.0965207631874299,0.121212121212121
"E02005816",466,370,393,116,254,350,2888,0.161357340720222,0.128116343490305,0.136080332409972,0.0401662049861496,0.0879501385041551,0.121191135734072
"E02005817",434,393,285,154,239,280,2713,0.159970512347954,0.14485809067453,0.105049760412827,0.0567637301879838,0.0880943604865463,0.103206782159971
"E02005818",503,419,407,153,266,350,2914,0.172614962251201,0.14378860672615,0.139670555936857,0.0525051475634866,0.091283459162663,0.120109814687714
"E02005819",360,276,581,74,202,286,2704,0.133136094674556,0.10207100591716,0.214866863905325,0.0273668639053254,0.0747041420118343,0.105769230769231
"E02005820",365,301,381,89,212,276,1838,0.198585418933623,0.163764961915125,0.207290533188248,0.0484221980413493,0.115342763873776,0.150163220892274
"E02005821",409,238,472,67,171,342,2886,0.141718641718642,0.0824670824670825,0.163548163548164,0.0232155232155232,0.0592515592515593,0.118503118503119
"E02005822",779,400,1428,120,280,659,4325,0.180115606936416,0.092485549132948,0.330173410404624,0.0277456647398844,0.0647398843930636,0.152369942196532
"E02005823",481,375,537,88,287,393,3625,0.132689655172414,0.103448275862069,0.148137931034483,0.0242758620689655,0.0791724137931035,0.108413793103448
"E02005824",504,448,750,101,347,403,3443,0.146383967470229,0.13011908219576,0.217833284925937,0.0293348823700261,0.100784199825733,0.117049085100203
"E02005825",409,233,687,65,168,344,2821,0.144984048209855,0.0825948245303084,0.243530662885502,0.0230414746543779,0.0595533498759305,0.121942573555477
"E02005826",378,227,682,67,160,311,2866,0.131891137473831,0.0792044661549197,0.237962316817865,0.02337752965806,0.0558269364968597,0.108513607815771
"E02005827",592,377,469,126,251,466,3354,0.176505664877758,0.112403100775194,0.139833035181872,0.037567084078712,0.0748360166964818,0.138938580799046
"E02005828",420,333,615,103,230,317,2764,0.151953690303907,0.120477568740955,0.222503617945007,0.0372648335745297,0.0832127351664255,0.114688856729378
"E02005829",339,291,486,97,194,242,2423,0.139909203466777,0.120099050763516,0.200577796120512,0.0400330169211721,0.0800660338423442,0.0998761865456046
"E02005830",332,224,757,65,159,267,1969,0.168613509395632,0.113763331640427,0.384459116302692,0.0330116810563738,0.0807516505840528,0.135601828339259
"E02005831",363,366,329,102,264,261,4106,0.0884072089624939,0.089137847053093,0.0801266439357038,0.0248416950803702,0.0642961519727228,0.0635655138821237
"E02005832",767,335,1705,104,231,663,4251,0.180428134556575,0.0788049870618678,0.401082098329805,0.0244648318042813,0.0543401552575865,0.155963302752294
"E02005833",404,292,434,86,206,318,2259,0.17884019477645,0.129260734838424,0.192120407259849,0.0380699424524126,0.0911907923860115,0.140770252324037
"E02005834",350,287,263,88,199,262,3956,0.0884732052578362,0.0725480283114257,0.0664812942366026,0.0222446916076845,0.0503033367037412,0.0662285136501517
"E02005835",704,532,466,205,327,499,5049,0.139433551198257,0.105367399485047,0.0922955040602099,0.0406020994256288,0.0647653000594177,0.0988314517726282
"E02005836",546,335,739,116,219,430,3335,0.163718140929535,0.100449775112444,0.221589205397301,0.0347826086956522,0.0656671664167916,0.128935532233883
"E02005837",448,259,498,105,154,343,2540,0.176377952755906,0.101968503937008,0.196062992125984,0.0413385826771654,0.0606299212598425,0.13503937007874
"E02005838",529,487,330,151,336,378,3664,0.144377729257642,0.132914847161572,0.0900655021834061,0.0412117903930131,0.091703056768559,0.103165938864629
"E02005839",376,290,350,96,194,280,3094,0.121525533290239,0.0937297996121526,0.113122171945701,0.0310277957336781,0.0627020038784745,0.0904977375565611
"E02005840",371,260,342,65,195,306,3543,0.104713519616145,0.0733841377363816,0.0965283657917019,0.0183460344340954,0.0550381033022862,0.0863674851820491
"E02005842",486,346,1035,93,253,393,3952,0.122975708502024,0.0875506072874494,0.261892712550607,0.0235323886639676,0.0640182186234818,0.0994433198380567
"E02005843",381,368,516,91,277,290,3404,0.11192714453584,0.108108108108108,0.151586368977673,0.0267332549941246,0.0813748531139836,0.0851938895417156
"E02005844",437,356,1041,95,261,342,3950,0.110632911392405,0.090126582278481,0.263544303797468,0.0240506329113924,0.0660759493670886,0.0865822784810127
"E02005846",562,307,1123,59,248,503,3644,0.154226125137212,0.0842480790340285,0.308177826564215,0.0161909989023052,0.0680570801317234,0.138035126234907
"E02005847",441,261,655,60,201,381,2808,0.157051282051282,0.092948717948718,0.233262108262108,0.0213675213675214,0.0715811965811966,0.135683760683761
"E02005848",454,319,350,110,209,344,2190,0.207305936073059,0.145662100456621,0.159817351598174,0.0502283105022831,0.0954337899543379,0.157077625570776
"E02005849",727,393,758,173,220,554,3304,0.220036319612591,0.118946731234867,0.229418886198547,0.0523607748184019,0.0665859564164649,0.167675544794189
"E02005850",404,319,716,90,229,314,2204,0.183303085299456,0.144736842105263,0.32486388384755,0.0408348457350272,0.103901996370236,0.142468239564428
"E02005851",363,288,575,84,204,279,2663,0.136312429590687,0.108148704468644,0.215921892602328,0.0315433721366879,0.0766053323319564,0.104769057453999
"E02005852",425,295,498,80,215,345,2846,0.149332396345748,0.103654251581167,0.174982431482783,0.028109627547435,0.0755446240337315,0.121222768798313
"E02005853",494,426,732,126,300,368,3174,0.155639571518589,0.13421550094518,0.23062381852552,0.0396975425330813,0.0945179584120983,0.115942028985507
"E02005856",383,514,676,127,387,256,2223,0.172289698605488,0.231219073324336,0.304093567251462,0.0571300044984255,0.174089068825911,0.115159694107063
"E02005857",361,342,977,83,259,278,2484,0.145330112721417,0.13768115942029,0.393317230273752,0.0334138486312399,0.10426731078905,0.111916264090177
"E02005858",476,359,1396,78,281,398,2752,0.17296511627907,0.130450581395349,0.507267441860465,0.028343023255814,0.102107558139535,0.144622093023256
"E02005859",608,473,1154,143,330,465,3451,0.176180817154448,0.13706172124022,0.334395827296436,0.0414372645609968,0.0956244566792234,0.134743552593451
"E02005860",684,345,1988,77,268,607,4360,0.156880733944954,0.0791284403669725,0.455963302752294,0.0176605504587156,0.0614678899082569,0.139220183486239
"E02005861",308,232,1026,48,184,260,2392,0.12876254180602,0.096989966555184,0.428929765886288,0.020066889632107,0.0769230769230769,0.108695652173913
"E02005862",432,482,493,129,353,303,2702,0.159881569207994,0.178386380458919,0.182457438934123,0.0477424130273871,0.130643967431532,0.112139156180607
"E02005863",365,322,1213,69,253,296,2499,0.146058423369348,0.128851540616246,0.485394157663065,0.0276110444177671,0.101240496198479,0.118447378951581
"E02005864",359,310,582,67,243,292,2513,0.142857142857143,0.123358535614803,0.231595702347791,0.0266613609231994,0.0966971746916037,0.116195781933943
"E02005865",454,438,411,144,294,310,2812,0.161450924608819,0.155761024182077,0.146159317211949,0.0512091038406828,0.104551920341394,0.110241820768137
"E02005866",639,476,453,144,332,495,3354,0.190518783542039,0.141920095408468,0.135062611806798,0.0429338103756708,0.0989862850327967,0.147584973166369
"E02005868",368,382,675,108,274,260,2463,0.149411287048315,0.155095412099066,0.274056029232643,0.0438489646772229,0.111246447421843,0.105562322371092
"E02005869",315,385,727,60,325,255,2336,0.134845890410959,0.164811643835616,0.311215753424658,0.0256849315068493,0.139126712328767,0.10916095890411
"E02005870",466,305,1048,93,212,373,2767,0.168413444163354,0.110227683411637,0.378749548247199,0.033610408384532,0.0766172750271052,0.134803035778822
"E02005871",442,522,142,182,340,260,2435,0.181519507186858,0.214373716632444,0.0583162217659138,0.0747433264887064,0.139630390143737,0.106776180698152
"E02005872",367,327,601,92,235,275,2634,0.139331814730448,0.124145785876993,0.228170083523159,0.0349278663629461,0.0892179195140471,0.104403948367502
"E02005873",568,720,1148,204,516,364,3139,0.180949346925773,0.22937241159605,0.365721567378146,0.0649888499522141,0.164383561643836,0.115960496973558
"E02005874",547,500,1191,132,368,415,3041,0.1798750411049,0.164419598816179,0.391647484380138,0.0434067740874712,0.121012824728708,0.136468267017428
"E02005875",416,401,570,113,288,303,3240,0.128395061728395,0.123765432098765,0.175925925925926,0.0348765432098765,0.0888888888888889,0.0935185185185185
"E02005876",550,398,1048,104,294,446,3145,0.174880763116057,0.126550079491256,0.333227344992051,0.0330683624801272,0.0934817170111288,0.14181240063593
"E02005877",493,456,926,147,309,346,2668,0.184782608695652,0.170914542728636,0.347076461769115,0.0550974512743628,0.115817091454273,0.129685157421289
"E02005878",675,766,1313,163,603,512,4167,0.161987041036717,0.183825293976482,0.315094792416607,0.039116870650348,0.144708423326134,0.122870170386369
"E02005879",703,407,1568,101,306,602,3843,0.182930002602134,0.105906843611762,0.408014571948998,0.0262815508717148,0.0796252927400468,0.156648451730419
"E02005880",331,433,178,123,310,208,2047,0.161700048851979,0.211529066927211,0.0869565217391304,0.0600879335613092,0.151441133365901,0.101612115290669
"E02005881",361,419,288,129,290,232,2502,0.144284572342126,0.167466027178257,0.115107913669065,0.0515587529976019,0.115907274180655,0.0927258193445244
"E02005882",432,482,139,137,345,295,2336,0.184931506849315,0.206335616438356,0.0595034246575342,0.0586472602739726,0.147688356164384,0.126284246575342
"E02005883",409,345,555,93,252,316,3193,0.128092702787347,0.108048856874413,0.173817726276229,0.029126213592233,0.0789226432821798,0.0989664891951143
"E02005884",483,335,563,120,215,363,2061,0.234352256186317,0.162542455118874,0.273168364871422,0.0582241630276565,0.104318292091218,0.176128093158661
"E02005885",504,425,516,134,291,370,3211,0.156960448458424,0.132357521021489,0.160697601993149,0.0417315478044223,0.0906259732170663,0.115228900654002
"E02005886",521,464,373,117,347,404,3873,0.134521043119029,0.119803769687581,0.0963077717531629,0.0302091402013943,0.0895946294861864,0.104311902917635
"E02005887",800,367,2576,88,279,712,5069,0.157822055632275,0.072400868021306,0.508187019135924,0.0173604261195502,0.0550404419017558,0.140461629512724
"E02005888",597,358,1074,125,233,472,3766,0.158523632501328,0.09506107275624,0.28518321826872,0.0331917153478492,0.0618693574083909,0.125331917153478
"E02005889",547,530,222,154,376,393,3430,0.159475218658892,0.154518950437318,0.0647230320699708,0.0448979591836735,0.109620991253644,0.114577259475219
"E02005890",374,391,299,116,275,258,1896,0.197257383966245,0.206223628691983,0.157700421940928,0.0611814345991561,0.145042194092827,0.136075949367089
"E02005891",352,367,183,86,281,266,2821,0.124778447359093,0.130095710740872,0.06487061325771,0.0304856433888692,0.0996100673520028,0.0942928039702233
"E02005892",657,641,535,193,448,464,4919,0.133563732465948,0.13031103882903,0.108761943484448,0.0392356169953243,0.091075421833706,0.0943281154706241
"E02005893",693,516,712,205,311,488,4907,0.141226818830243,0.105155899735072,0.145098838394131,0.0417770531893214,0.063378846545751,0.0994497656409211
"E02005894",449,578,219,153,425,296,4758,0.0943673812526272,0.121479613282892,0.0460277427490542,0.032156368221942,0.08932324506095,0.0622110130306852
"E02005895",539,316,629,104,212,435,2717,0.198380566801619,0.116304747883695,0.231505336768495,0.0382775119617225,0.0780272359219728,0.160103054839897
"E02005896",433,309,548,101,208,332,2758,0.156997824510515,0.112037708484409,0.198694706308919,0.0366207396664249,0.075416968817984,0.12037708484409
"E02005897",494,391,589,129,262,365,3583,0.137873290538655,0.109126430365615,0.164387384873011,0.036003349148758,0.0731230812168574,0.101869941389897
"E02005898",644,682,316,205,477,439,4323,0.148970622253065,0.157760814249364,0.0730973860744853,0.0474207726116123,0.110340041637752,0.101549849641453
"E02005899",786,477,1718,111,366,675,5873,0.133832794142687,0.0812191384301039,0.292525114932743,0.0189000510812191,0.0623190873488847,0.114932743061468
"E02005900",389,317,551,97,220,292,2695,0.144341372912801,0.117625231910946,0.204452690166976,0.0359925788497217,0.0816326530612245,0.10834879406308
"E02005901",517,440,1460,86,354,431,4148,0.124638379942141,0.106075216972035,0.351976856316297,0.0207328833172613,0.0853423336547734,0.103905496624879
"E02005902",472,342,277,102,240,370,3188,0.148055207026349,0.107277289836888,0.0868883312421581,0.0319949811794228,0.0752823086574655,0.116060225846926
"E02005903",623,448,571,133,315,490,3918,0.159009698825932,0.11434405308831,0.145737621235324,0.0339458907605921,0.0803981623277182,0.125063808065339
"E02005904",362,269,397,92,177,270,4007,0.0903419016720739,0.0671325180933367,0.0990766159221363,0.0229598203144497,0.0441726977788869,0.0673820813576242
"E02005905",309,236,447,68,168,241,1795,0.172144846796657,0.131476323119777,0.249025069637883,0.037883008356546,0.0935933147632312,0.134261838440111
"E02005906",369,278,465,107,171,262,2122,0.173892554194156,0.131008482563619,0.219132893496701,0.0504241281809614,0.0805843543826579,0.123468426013195
"E02005907",553,454,210,144,310,409,4531,0.122048112999338,0.100198631648643,0.0463473846832929,0.0317810637828294,0.0684175678658133,0.0902670492165085
"E02005908",482,421,638,118,303,364,3666,0.131478450627387,0.114839061647572,0.174031642116748,0.0321876704855428,0.0826513911620295,0.099290780141844
"E02005909",507,228,1766,53,175,454,2744,0.184766763848396,0.0830903790087464,0.643586005830904,0.0193148688046647,0.0637755102040816,0.165451895043732
"E02005910",861,227,2582,39,188,822,4475,0.192402234636872,0.0507262569832402,0.576983240223464,0.00871508379888268,0.0420111731843575,0.183687150837989
"E02005911",334,351,356,74,277,260,2671,0.125046798951703,0.131411456383377,0.133283414451516,0.0277049794084613,0.103706476974916,0.0973418195432422
"E02005912",461,478,389,108,370,353,3283,0.140420347243375,0.145598537922632,0.118489186719464,0.0328967407858666,0.112701797136765,0.107523606457508
"E02005913",369,374,518,111,263,258,3786,0.0974643423137876,0.0987849973586899,0.136819862651875,0.0293185419968304,0.0694664553618595,0.0681458003169572
"E02005914",469,412,78,157,255,312,2851,0.164503682918274,0.144510698000702,0.0273588214661522,0.0550683970536654,0.0894423009470361,0.109435285864609
"E02005915",333,286,417,99,187,234,1904,0.174894957983193,0.150210084033613,0.219012605042017,0.0519957983193277,0.0982142857142857,0.122899159663866
"E02005916",444,305,824,92,213,352,3553,0.12496481846327,0.0858429496200394,0.231916690121024,0.0258936110329299,0.0599493385871095,0.0990712074303406
"E02005917",313,300,448,94,206,219,2041,0.153356197942185,0.146986771190593,0.219500244977952,0.0460558549730524,0.10093091621754,0.107300342969133
"E02005918",320,293,218,103,190,217,1989,0.16088486676722,0.147310206133736,0.109602815485168,0.0517848164906988,0.0955253896430367,0.109100050276521
"E02005919",387,215,521,75,140,312,2697,0.14349276974416,0.0797182054134223,0.193177604746014,0.0278086763070078,0.0519095291064145,0.115684093437152
"E02005920",433,369,496,119,250,314,3006,0.144045242847638,0.122754491017964,0.165003326679973,0.0395874916833001,0.083166999334664,0.104457751164338
"E02005921",436,274,554,115,159,321,2760,0.157971014492754,0.0992753623188406,0.200724637681159,0.0416666666666667,0.0576086956521739,0.116304347826087
"E02005922",433,392,44,128,264,305,3315,0.130618401206637,0.118250377073906,0.0132730015082956,0.0386123680241327,0.0796380090497738,0.0920060331825038
"E02005923",334,321,308,93,228,241,1872,0.178418803418803,0.171474358974359,0.164529914529915,0.0496794871794872,0.121794871794872,0.128739316239316
"E02005924",753,452,1112,89,363,664,6314,0.119258789990497,0.0715869496357301,0.176116566360469,0.0140956604371239,0.0574912891986063,0.105163129553373
"E02005925",359,283,116,89,194,270,2595,0.138342967244701,0.109055876685934,0.0447013487475915,0.0342967244701349,0.0747591522157996,0.104046242774566
"E02005926",471,449,538,141,308,330,3471,0.135695764909248,0.129357533851916,0.154998559492942,0.0406222990492653,0.0887352348026505,0.0950734658599827
"E02005927",361,448,155,132,316,229,2041,0.17687408133268,0.219500244977952,0.0759431651151396,0.0646741793238609,0.154826065654091,0.112199902008819
"E02005928",443,350,494,123,227,320,3874,0.114352090862158,0.0903458957150232,0.12751677852349,0.0317501290655653,0.0585957666494579,0.0826019617965927
"E02005929",503,279,576,110,169,393,2445,0.205725971370143,0.114110429447853,0.23558282208589,0.0449897750511247,0.069120654396728,0.160736196319018
"E02005930",529,284,714,94,190,435,4070,0.12997542997543,0.0697788697788698,0.175429975429975,0.0230958230958231,0.0466830466830467,0.106879606879607
"E02005931",494,333,529,118,215,376,4314,0.114510894761242,0.0771905424200278,0.12262401483542,0.0273528048215114,0.0498377375985165,0.0871580899397311
"E02005932",364,165,20,47,118,317,2416,0.150662251655629,0.068294701986755,0.00827814569536424,0.019453642384106,0.048841059602649,0.131208609271523
"E02005933",455,442,61,141,301,314,2411,0.188718374118623,0.183326420572377,0.0253007051016176,0.0584819576939029,0.124844462878474,0.13023641642472
"E02005934",432,437,87,120,317,312,2514,0.171837708830549,0.173826571201273,0.0346062052505967,0.0477326968973747,0.126093874303898,0.124105011933174
"E02005935",430,251,257,66,185,364,4097,0.104954845008543,0.0612643397608006,0.0627288259702221,0.0161093483036368,0.0451549914571638,0.088845496704906
"E02005936",571,440,643,150,290,421,4716,0.121077184054283,0.0932994062765055,0.136344359626802,0.0318066157760814,0.0614927905004241,0.0892705682782019
"E02005937",450,540,285,165,375,285,2454,0.183374083129584,0.220048899755501,0.116136919315403,0.0672371638141809,0.15281173594132,0.116136919315403
"E02005938",337,443,156,137,306,200,1752,0.192351598173516,0.252853881278539,0.089041095890411,0.0781963470319635,0.174657534246575,0.114155251141553
"E02005939",463,442,202,137,305,326,2399,0.192997082117549,0.184243434764485,0.0842017507294706,0.0571071279699875,0.127136306794498,0.135889954147561
"E02005940",340,674,540,142,532,198,2677,0.127007844602167,0.251774374299589,0.20171834142697,0.0530444527456108,0.198729921553978,0.0739633918565558
"E02005941",386,492,993,83,409,303,2975,0.129747899159664,0.165378151260504,0.333781512605042,0.0278991596638655,0.137478991596639,0.101848739495798
"E02005942",323,237,858,30,207,293,2396,0.134808013355593,0.098914858096828,0.358096828046745,0.0125208681135225,0.0863939899833055,0.12228714524207
"E02005943",358,534,597,114,420,244,2189,0.163544997715852,0.243947007766103,0.272727272727273,0.05207857469164,0.191868433074463,0.111466423024212
"E02005944",346,307,244,65,242,281,3382,0.102306327616795,0.0907746895328208,0.0721466587817859,0.0192193968066233,0.0715552927261975,0.0830869308101715
"E02005945",494,768,1216,155,613,339,3915,0.126181353767561,0.196168582375479,0.310600255427842,0.0395913154533844,0.156577266922095,0.0865900383141762
"E02005946",454,700,841,168,532,286,3179,0.142812205095942,0.220195029883611,0.264548600188739,0.0528468071720667,0.167348222711545,0.0899653979238754
"E02005947",398,391,985,52,339,346,3190,0.124764890282132,0.122570532915361,0.308777429467085,0.0163009404388715,0.106269592476489,0.10846394984326
"E02005948",461,297,1337,61,236,400,3483,0.132357163364915,0.0852713178294574,0.383864484639678,0.0175136376686764,0.0677576801607809,0.114843525696239
"E02005949",386,556,250,103,453,283,2883,0.133888310787374,0.192854665279223,0.0867152271938953,0.0357266736038848,0.157127991675338,0.0981616371834894
"E02005950",747,612,2592,113,499,634,4759,0.156965749106955,0.128598445051481,0.544652237865098,0.0237444841353225,0.104853960916159,0.133221264971633
"E02005951",393,357,951,78,279,315,2527,0.155520379897111,0.141274238227147,0.376335575781559,0.0308666402849228,0.110407597942224,0.124653739612188
"E02005953",370,420,1211,93,327,277,2130,0.173708920187793,0.197183098591549,0.568544600938967,0.0436619718309859,0.153521126760563,0.130046948356808
"E02005954",517,893,914,175,718,342,3717,0.139090664514393,0.240247511433952,0.245897228948076,0.0470809792843691,0.193166532149583,0.0920096852300242
"E02005955",536,649,644,131,518,405,4648,0.115318416523236,0.139629948364888,0.13855421686747,0.028184165232358,0.11144578313253,0.0871342512908778
"E02005956",414,347,59,109,238,305,2344,0.176621160409556,0.148037542662116,0.0251706484641638,0.0465017064846416,0.101535836177474,0.130119453924915
"E02005957",307,273,42,99,174,208,2584,0.118808049535604,0.105650154798762,0.0162538699690402,0.038312693498452,0.0673374613003096,0.0804953560371517
"E02005958",436,621,147,221,400,215,1887,0.23105458399576,0.329093799682035,0.0779014308426073,0.117117117117117,0.211976682564918,0.113937466878643
"E02005959",282,295,340,98,197,184,1558,0.181001283697047,0.189345314505777,0.218228498074454,0.0629011553273428,0.126444159178434,0.118100128369705
"E02005960",336,337,325,109,228,227,3008,0.111702127659574,0.112034574468085,0.108045212765957,0.0362367021276596,0.0757978723404255,0.0754654255319149
"E02005961",450,403,467,146,257,304,2110,0.213270142180095,0.190995260663507,0.221327014218009,0.0691943127962085,0.121800947867299,0.144075829383886
"E02005962",579,617,362,233,384,346,3256,0.177825552825553,0.189496314496314,0.111179361179361,0.0715601965601966,0.117936117936118,0.106265356265356
"E02005963",497,530,445,175,355,322,2557,0.1943684004693,0.207274149393821,0.174032068830661,0.0684395776300352,0.138834571763786,0.125928822839265
"E02005964",542,582,409,194,388,348,2717,0.199484725800515,0.214206845785793,0.150533676849466,0.0714022819285977,0.142804563857195,0.128082443871918
"E02005965",496,336,605,132,204,364,2172,0.228360957642726,0.154696132596685,0.278545119705341,0.0607734806629834,0.0939226519337017,0.167587476979742
"E02005966",596,345,5,114,231,482,3547,0.16802932055258,0.0972652946151678,0.00140964195094446,0.0321398364815337,0.0651254581336341,0.135889484071046
"E02005967",372,441,134,143,298,229,3515,0.105832147937411,0.125462304409673,0.038122332859175,0.0406827880512091,0.0847795163584637,0.065149359886202
"E02005968",470,433,386,144,289,326,3230,0.145510835913313,0.13405572755418,0.119504643962848,0.0445820433436533,0.0894736842105263,0.100928792569659
"E02005969",622,631,586,183,448,439,3917,0.158794996170539,0.161092672964003,0.149604288996681,0.0467194281337759,0.114373244830227,0.112075568036763
"E02005970",461,339,177,123,216,338,2172,0.212246777163904,0.156077348066298,0.0814917127071823,0.0566298342541436,0.0994475138121547,0.155616942909761
"E02005971",401,359,129,119,240,282,2055,0.195133819951338,0.174695863746959,0.0627737226277372,0.0579075425790754,0.116788321167883,0.137226277372263
"E02005972",534,578,512,183,395,351,4494,0.118825100133511,0.12861593235425,0.113929684023142,0.0407209612817089,0.0878949710725412,0.0781041388518024
"E02005973",536,590,560,165,425,371,2573,0.208317139525845,0.229304314030315,0.217644772638943,0.0641274776525457,0.165176836377769,0.1441896618733
"E02005974",543,512,872,156,356,387,2797,0.19413657490168,0.183053271362174,0.311762602788702,0.0557740436181623,0.127279227744011,0.138362531283518
"E02005975",551,510,415,186,324,365,2391,0.230447511501464,0.213299874529486,0.173567544960268,0.0777917189460477,0.135508155583438,0.152655792555416
"E02005976",408,319,484,135,184,273,2071,0.197006277160792,0.154031868662482,0.233703524867214,0.0651859005311444,0.0888459681313375,0.131820376629648
"E02005977",380,421,232,153,268,227,1829,0.207763805358119,0.230180426462548,0.126845270639694,0.0836522689994533,0.146528157463095,0.124111536358666
"E02005978",440,456,266,132,324,308,2605,0.168905950095969,0.175047984644914,0.1021113243762,0.0506717850287908,0.124376199616123,0.118234165067179
"E02005979",520,636,667,175,461,345,3591,0.144806460595934,0.177109440267335,0.185742133110554,0.0487329434697856,0.128376496797549,0.0960735171261487
"E02005980",519,517,494,174,343,345,4366,0.118873110398534,0.118415025194686,0.113147045350435,0.0398534127347687,0.0785616124599176,0.0790196976637655
"E02005981",529,539,43,153,386,376,2473,0.213910230489284,0.217953902143146,0.0173877881116053,0.0618681763040841,0.156085725839062,0.1520420541852
"E02005982",391,475,185,137,338,254,1924,0.203222453222453,0.246881496881497,0.0961538461538462,0.0712058212058212,0.175675675675676,0.132016632016632
"E02005983",658,669,835,142,527,516,5138,0.128065395095368,0.130206305955625,0.162514597119502,0.0276372129233165,0.102569093032308,0.100428182172051
"E02005984",482,326,524,137,189,345,3368,0.143111638954869,0.0967933491686461,0.155581947743468,0.0406769596199525,0.0561163895486936,0.102434679334917
"E02005985",467,497,111,138,359,329,2969,0.157292017514315,0.167396429774335,0.0373863253620748,0.046480296396093,0.120916133378242,0.110811721118222
"E02005986",586,582,573,175,407,411,4668,0.125535561268209,0.124678663239075,0.122750642673522,0.0374892887746358,0.0871893744644387,0.0880462724935733
"E02005987",509,452,386,154,298,355,3906,0.130312339989759,0.115719406041987,0.0988223246287762,0.039426523297491,0.0762928827444957,0.0908858166922683
"E02005988",452,568,74,181,387,271,3861,0.117068117068117,0.147112147112147,0.0191660191660192,0.0468790468790469,0.1002331002331,0.0701890701890702
"E02005991",610,602,421,190,412,420,4133,0.147592547786112,0.145656907815146,0.101863053472054,0.0459714493104283,0.0996854585047181,0.101621098475684
"E02005992",636,539,490,197,342,439,5577,0.114039806347499,0.0966469428007889,0.0878608570916263,0.0353236507082661,0.0613232920925229,0.0787161556392326
"E02005993",513,450,605,125,325,388,3238,0.158431130327363,0.138974675725757,0.186843730697962,0.038604076590488,0.100370599135269,0.119827053736875
"E02005994",538,244,831,97,147,441,2400,0.224166666666667,0.101666666666667,0.34625,0.0404166666666667,0.06125,0.18375
"E02005995",488,284,780,102,182,386,2430,0.20082304526749,0.116872427983539,0.320987654320988,0.0419753086419753,0.0748971193415638,0.158847736625514
"E02005996",739,580,916,182,398,557,3615,0.204426002766252,0.160442600276625,0.253388658367911,0.0503457814661134,0.110096818810512,0.154080221300138
"E02005997",411,331,468,110,221,301,2194,0.187329079307201,0.150865998176846,0.21330902461258,0.0501367365542388,0.100729261622607,0.137192342752963
"E02005998",395,335,416,115,220,280,2404,0.164309484193012,0.139351081530782,0.173044925124792,0.0478369384359401,0.0915141430948419,0.116472545757072
"E02005999",398,277,455,103,174,295,2176,0.182904411764706,0.127297794117647,0.209099264705882,0.0473345588235294,0.0799632352941176,0.135569852941176
"E02006000",538,479,488,121,358,417,4114,0.130772970345163,0.1164316966456,0.118619348565873,0.0294117647058824,0.087019931939718,0.10136120563928
"E02006001",307,200,8,72,128,235,2941,0.104386263175791,0.0680040802448147,0.00272016320979259,0.0244814688881333,0.0435226113566814,0.0799047942876573
"E02006002",575,570,527,175,395,400,4696,0.122444633730835,0.121379897785349,0.112223168654174,0.0372657580919932,0.084114139693356,0.0851788756388416
"E02006003",409,376,348,138,238,271,2176,0.187959558823529,0.172794117647059,0.159926470588235,0.0634191176470588,0.109375,0.124540441176471
"E02006004",570,271,941,107,164,463,2987,0.190826916638768,0.0907264814194844,0.315031804486106,0.0358218948778038,0.0549045865416806,0.155005021760964
"E02006005",374,202,61,46,156,328,4357,0.0858388799632775,0.0463621758090429,0.0140004590314437,0.0105577232040395,0.0358044526050034,0.075281156759238
"E02006006",413,398,62,150,248,263,2189,0.188670625856556,0.181818181818182,0.0283234353586112,0.0685244403837369,0.113293741434445,0.120146185472819
"E02006007",399,296,493,93,203,306,2557,0.15604223699648,0.115760657019945,0.192804067266328,0.0363707469691044,0.0793899100508408,0.119671490027376
"E02006008",460,534,490,136,398,324,4380,0.105022831050228,0.121917808219178,0.111872146118721,0.0310502283105023,0.0908675799086758,0.073972602739726
"E02006009",358,509,422,117,392,241,2634,0.135914958238421,0.193242217160213,0.160212604403948,0.0444191343963554,0.148823082763857,0.0914958238420653
"E02006010",810,595,1133,232,363,578,4643,0.174456170579367,0.128149903079905,0.244023260822744,0.0499676933017446,0.0781822097781607,0.124488477277622
"E02006011",429,553,344,169,384,260,2219,0.193330328977017,0.249211356466877,0.155024785939612,0.0761604326273096,0.173050923839567,0.117169896349707
"E02006012",498,311,763,107,204,391,2521,0.197540658468862,0.123363744545815,0.302657675525585,0.0424434748115827,0.0809202697342324,0.155097183657279
"E02006013",673,405,787,177,228,496,2477,0.271699636657247,0.163504238998789,0.317723052079128,0.0714574081550262,0.0920468308437626,0.20024222850222
"E02006014",692,412,899,161,251,531,2926,0.2365003417635,0.140806561859193,0.307245386192755,0.0550239234449761,0.0857826384142174,0.181476418318524
"E02006015",651,410,952,149,261,502,4258,0.152888680131517,0.0962893377172381,0.223579145138563,0.0349929544387036,0.0612963832785345,0.117895725692814
"E02006016",604,446,706,166,280,438,2976,0.202956989247312,0.149865591397849,0.237231182795699,0.0557795698924731,0.0940860215053763,0.147177419354839
"E02006017",488,317,733,116,201,372,2982,0.163648558014755,0.106304493628437,0.245808182427901,0.0389000670690812,0.0674044265593561,0.124748490945674
"E02006018",753,431,769,132,299,621,4601,0.163660073896979,0.0936752879808737,0.16713757878722,0.0286894153444903,0.0649858726363834,0.134970658552489
"E02006019",366,285,445,95,190,271,2437,0.150184653262208,0.116947066064834,0.182601559294214,0.0389823553549446,0.0779647107098892,0.111202297907263
"E02006020",446,307,494,109,198,337,2335,0.191006423982869,0.131477516059957,0.211563169164882,0.0466809421841542,0.084796573875803,0.144325481798715
"E02006021",503,349,699,140,209,363,2992,0.168114973262032,0.116644385026738,0.233622994652406,0.0467914438502674,0.0698529411764706,0.121323529411765
"E02006022",380,245,443,111,134,269,1916,0.198329853862213,0.127870563674322,0.231210855949896,0.0579331941544885,0.069937369519833,0.140396659707724
"E02006023",580,397,600,140,257,440,3810,0.152230971128609,0.104199475065617,0.15748031496063,0.036745406824147,0.0674540682414698,0.115485564304462
"E02006024",590,405,226,154,251,436,3821,0.154409840355928,0.105993195498561,0.059146820204135,0.0403035854488354,0.0656896100497252,0.114106254907092
"E02006025",580,427,1397,127,300,453,4295,0.135040745052387,0.0994179278230501,0.325261932479627,0.029569266589057,0.069848661233993,0.105471478463329
"E02006026",487,276,542,114,162,373,2541,0.191656828020464,0.1086186540732,0.213301849665486,0.0448642266824085,0.063754427390791,0.146792601338056
"E02006027",348,278,499,108,170,240,1758,0.197952218430034,0.158134243458476,0.283845278725825,0.0614334470989761,0.0967007963594994,0.136518771331058
"E02006028",631,440,685,163,277,468,3427,0.184126057776481,0.128392179749052,0.199883279836592,0.0475634665888532,0.0808287131601984,0.136562591187628
"E02006029",342,450,194,133,317,209,2518,0.13582208101668,0.178713264495631,0.0770452740270056,0.0528196981731533,0.125893566322478,0.0830023828435266
"E02006030",260,341,228,87,254,173,2640,0.0984848484848485,0.129166666666667,0.0863636363636364,0.0329545454545455,0.0962121212121212,0.065530303030303
"E02006031",435,331,887,67,264,368,3761,0.115660728529646,0.0880085083754321,0.235841531507578,0.0178144110608881,0.070194097314544,0.0978463174687583
"E02006032",331,470,527,103,367,228,2886,0.114691614691615,0.162855162855163,0.182605682605683,0.0356895356895357,0.127165627165627,0.079002079002079
"E02006033",535,313,1648,62,251,473,4855,0.110195674562307,0.0644696189495366,0.339443872296601,0.0127703398558187,0.0516992790937178,0.0974253347064882
"E02006034",539,537,168,149,388,390,4273,0.126140884624386,0.125672829393868,0.0393166393634449,0.0348701146735315,0.090802714720337,0.0912707699508542
"E02006035",261,313,306,85,228,176,2419,0.107895824720959,0.129392310872261,0.126498553121124,0.0351384869780901,0.0942538238941711,0.072757337742869
"E02006036",351,320,894,75,245,276,3266,0.107470912431108,0.0979791794243723,0.27372933251684,0.0229638701775873,0.0750153092467851,0.0845070422535211
"E02006037",477,496,525,153,343,324,3074,0.155172413793103,0.16135328562134,0.170787247885491,0.049772283669486,0.111581001951854,0.105400130123617
"E02006038",458,449,448,150,299,308,2885,0.158752166377816,0.155632582322357,0.15528596187175,0.0519930675909879,0.103639514731369,0.106759098786828
"E02006039",479,459,483,168,291,311,2873,0.166724678036895,0.159763313609467,0.168116950922381,0.0584754611903933,0.101287852419074,0.108249216846502
"E02006040",568,356,720,142,214,426,2498,0.22738190552442,0.142514011208967,0.288230584467574,0.0568454763811049,0.0856685348278623,0.170536429143315
"E02006041",497,295,653,111,184,386,1960,0.253571428571429,0.150510204081633,0.333163265306122,0.0566326530612245,0.0938775510204082,0.196938775510204
"E02006042",447,329,400,115,214,332,2317,0.192921881743634,0.141993957703928,0.172637030643073,0.0496331463098835,0.092360811394044,0.143288735433751
"E02006043",596,368,812,132,236,464,2430,0.245267489711934,0.151440329218107,0.334156378600823,0.054320987654321,0.097119341563786,0.190946502057613
"E02006044",632,343,898,165,178,467,2104,0.300380228136882,0.163022813688213,0.42680608365019,0.0784220532319392,0.0846007604562738,0.221958174904943
"E02006045",768,698,790,207,491,561,4645,0.165339074273412,0.1502691065662,0.170075349838536,0.0445640473627557,0.105705059203445,0.120775026910657
"E02006046",678,359,686,138,221,540,2893,0.23435879709644,0.124092637400622,0.237124092637401,0.0477013480815762,0.076391289319046,0.186657449014863
"E02006047",582,444,1107,140,304,442,3143,0.185173401209036,0.141266306076997,0.352211263124403,0.044543429844098,0.0967228762328985,0.140629971364938
"E02006048",419,412,670,137,275,282,2224,0.18839928057554,0.185251798561151,0.301258992805755,0.0616007194244604,0.123651079136691,0.126798561151079
"E02006049",452,507,65,194,313,258,2293,0.197121674662015,0.221107719145225,0.028347143480157,0.0846053205407763,0.136502398604448,0.112516354121239
"E02006050",564,404,1239,99,305,465,4047,0.139362490733877,0.0998270323696565,0.306152705707932,0.0244625648628614,0.0753644675067952,0.114899925871016
"E02006051",519,399,709,149,250,370,3211,0.16163189037683,0.124260355029586,0.220803488009966,0.0464029897228278,0.077857365306758,0.115228900654002
"E02006052",496,368,910,133,235,363,2690,0.184386617100372,0.136802973977695,0.338289962825279,0.0494423791821561,0.087360594795539,0.134944237918216
"E02006053",536,569,662,159,410,377,4451,0.120422376993934,0.127836441249157,0.14873062233206,0.0357223095933498,0.0921141316558077,0.0847000674005841
"E02006054",599,536,693,159,377,440,3884,0.154222451081359,0.138002059732235,0.178424304840371,0.0409371781668383,0.0970648815653965,0.113285272914521
"E02006055",513,383,551,131,252,382,3434,0.149388468258591,0.111531741409435,0.16045428072219,0.0381479324403029,0.0733838089691322,0.111240535818288
"E02006056",552,428,828,153,275,399,2756,0.200290275761974,0.155297532656023,0.300435413642961,0.0555152394775036,0.0997822931785196,0.14477503628447
"E02006057",523,550,579,164,386,359,3656,0.143052516411379,0.150437636761488,0.158369803063457,0.0448577680525164,0.105579868708972,0.0981947483588621
"E02006058",473,484,394,145,339,328,2495,0.189579158316633,0.193987975951904,0.157915831663327,0.0581162324649299,0.135871743486974,0.131462925851703
"E02006059",504,305,797,134,171,370,2285,0.220568927789934,0.133479212253829,0.348796498905908,0.0586433260393873,0.074835886214442,0.161925601750547
"E02006060",509,461,665,144,317,365,3558,0.143057897695334,0.129567172568859,0.18690275435638,0.0404721753794266,0.0890949971894323,0.102585722315908
"E02006061",740,593,713,206,387,534,3906,0.189452124935996,0.151817716333845,0.182539682539683,0.0527393753200205,0.0990783410138249,0.136712749615975
"E02006062",842,680,425,291,389,551,3834,0.21961398017736,0.1773604590506,0.110850286906625,0.0758998435054773,0.101460615545123,0.143714136671883
"E02006063",492,357,730,129,228,363,2357,0.208739923631735,0.151463725074247,0.3097157403479,0.0547305897327111,0.0967331353415359,0.154009333899024
"E02006064",736,617,1011,217,400,519,3655,0.201367989056088,0.168809849521204,0.276607387140903,0.0593707250341997,0.109439124487004,0.141997264021888
"E02006065",608,483,540,146,337,462,4375,0.138971428571429,0.1104,0.123428571428571,0.0333714285714286,0.0770285714285714,0.1056
"E02006066",778,554,397,232,322,546,3347,0.232446967433523,0.165521362414102,0.118613683896026,0.0693158051986854,0.0962055572154168,0.163131162234837
"E02006067",635,450,693,197,253,438,2718,0.233627667402502,0.165562913907285,0.254966887417219,0.0724797645327447,0.0930831493745401,0.161147902869757
"E02006068",514,477,452,133,344,381,3478,0.147786083956297,0.137147786083956,0.129959746981024,0.0382403680276021,0.0989074180563542,0.109545715928695
"E02006069",711,568,1290,128,440,583,5412,0.131374722838137,0.104951958610495,0.238359201773836,0.0236511456023651,0.0813008130081301,0.107723577235772
"E02006070",538,436,102,178,258,360,3858,0.139450492483152,0.113011923276309,0.0264385692068429,0.0461378952825298,0.0668740279937792,0.0933125972006221
"E02006071",611,526,511,183,343,428,3390,0.18023598820059,0.155162241887906,0.150737463126844,0.0539823008849558,0.10117994100295,0.126253687315634
"E02006072",823,456,753,209,247,614,3300,0.249393939393939,0.138181818181818,0.228181818181818,0.0633333333333333,0.0748484848484848,0.186060606060606
"E02006073",468,521,497,134,387,334,3695,0.126657645466847,0.141001353179973,0.134506089309878,0.0362652232746955,0.104736129905277,0.0903924221921516
"E02006074",555,494,505,170,324,385,5259,0.105533371363377,0.0939342080243392,0.0960258604297395,0.0323255371743678,0.0616086708499715,0.0732078341890093
"E02006075",449,266,537,103,163,346,1922,0.233610822060354,0.138397502601457,0.27939646201873,0.0535900104058273,0.0848074921956296,0.180020811654527
"E02006076",638,376,834,124,252,514,3460,0.184393063583815,0.108670520231214,0.241040462427746,0.0358381502890173,0.0728323699421965,0.148554913294798
"E02006077",408,316,457,110,206,298,2536,0.160883280757098,0.124605678233438,0.180205047318612,0.0433753943217666,0.0812302839116719,0.117507886435331
"E02006078",405,287,508,98,189,307,2336,0.173373287671233,0.122859589041096,0.217465753424658,0.0419520547945205,0.0809075342465753,0.131421232876712
"E02006079",579,345,545,138,207,441,3442,0.168216153399187,0.100232423009878,0.158338175479372,0.0400929692039512,0.0601394538059268,0.128123184195235
"E02006080",403,227,453,66,161,337,2420,0.166528925619835,0.093801652892562,0.187190082644628,0.0272727272727273,0.0665289256198347,0.139256198347107
"E02006081",441,300,429,125,175,316,2038,0.216388616290481,0.14720314033366,0.210500490677134,0.0613346418056919,0.0858684985279686,0.155053974484789
"E02006082",498,322,495,122,200,376,2753,0.1808935706502,0.116963312749728,0.179803850345078,0.0443152924082819,0.0726480203414457,0.136578278241918
"E02006083",371,250,453,86,164,285,2161,0.171679777880611,0.11568718186025,0.209625173530773,0.039796390559926,0.0758907913003239,0.131883387320685
"E02006084",528,347,774,118,229,410,2808,0.188034188034188,0.123575498575499,0.275641025641026,0.042022792022792,0.0815527065527065,0.146011396011396
"E02006085",455,380,91,143,237,312,2961,0.153664302600473,0.128335021952043,0.0307328605200946,0.0482944951030057,0.0800405268490375,0.105369807497467
"E02006086",374,377,104,139,238,235,2682,0.13944817300522,0.140566741237882,0.0387770320656227,0.0518269947800149,0.0887397464578673,0.0876211782252051
"E02006087",473,263,26,94,169,379,2478,0.190879741727199,0.106133979015335,0.0104923325262308,0.0379338175948345,0.0682001614205004,0.152945924132365
"E02006088",477,492,202,132,360,345,3222,0.14804469273743,0.152700186219739,0.0626939788950962,0.0409683426443203,0.111731843575419,0.10707635009311
"E02006089",612,818,840,252,566,360,3627,0.168734491315136,0.225530741659774,0.231596360628619,0.0694789081885856,0.156051833471188,0.0992555831265509
"E02006090",540,626,261,232,394,308,2706,0.199556541019956,0.231337767923134,0.0964523281596452,0.0857354028085735,0.14560236511456,0.113821138211382
"E02006091",757,502,1242,161,341,596,3713,0.203878265553461,0.135200646377592,0.334500403985995,0.043361163479666,0.0918394828979262,0.160517102073795
"E02006092",388,417,115,153,264,235,2259,0.171757414785303,0.184594953519256,0.0509074811863656,0.0677290836653386,0.116865869853918,0.104028331119965
"E02006093",593,484,793,131,353,462,3401,0.174360482211114,0.142311084975007,0.233166715671861,0.0385180829167892,0.103793002058218,0.135842399294325
"E02006094",479,288,524,119,169,360,2050,0.233658536585366,0.140487804878049,0.255609756097561,0.0580487804878049,0.0824390243902439,0.175609756097561
"E02006095",665,543,823,197,346,468,3498,0.19010863350486,0.155231560891938,0.235277301315037,0.0563178959405375,0.0989136649514008,0.133790737564322
"E02006096",442,447,131,151,296,291,3045,0.145155993431856,0.14679802955665,0.0430213464696223,0.0495894909688013,0.0972085385878489,0.0955665024630542
"E02006097",457,486,582,138,348,319,3077,0.148521286967826,0.157946051348716,0.189145271368216,0.0448488787780306,0.113097172570686,0.103672408189795
"E02006098",545,430,744,162,268,383,2488,0.219051446945338,0.172829581993569,0.29903536977492,0.065112540192926,0.107717041800643,0.153938906752412
"E02006099",403,312,415,102,210,301,2764,0.145803183791606,0.11287988422576,0.150144717800289,0.0369030390738061,0.0759768451519537,0.1089001447178
"E02006100",428,484,536,141,343,287,3119,0.137223469060596,0.155177941647964,0.171849951907663,0.0452067970503366,0.109971144597627,0.0920166720102597
"E02006101",417,269,716,84,185,333,2154,0.193593314763231,0.124883936861653,0.332404828226555,0.0389972144846797,0.0858867223769731,0.154596100278552
"E02006102",412,463,94,113,350,299,2761,0.149221296631655,0.16769286490402,0.0340456356392611,0.0409272002897501,0.12676566461427,0.108294096341905
"E02006103",488,455,575,153,302,335,2619,0.186330660557465,0.17373043146239,0.21954944635357,0.0584192439862543,0.115311187476136,0.12791141657121
"E02006104",606,461,150,139,322,467,4232,0.143194706994329,0.108931947069943,0.0354442344045369,0.0328449905482042,0.0760869565217391,0.110349716446125
"E02006105",777,515,1973,139,376,638,5504,0.141170058139535,0.0935683139534884,0.358466569767442,0.0252543604651163,0.0683139534883721,0.115915697674419
"E02006106",434,457,228,137,320,297,3895,0.111424903722721,0.117329910141207,0.0585365853658537,0.0351732991014121,0.0821566110397946,0.0762516046213094
"E02006107",467,656,162,149,507,318,3499,0.133466704772792,0.187482137753644,0.0462989425550157,0.0425835953129466,0.144898542440697,0.0908831094598457
"E02006108",587,716,1213,154,562,433,5020,0.116932270916335,0.142629482071713,0.241633466135458,0.0306772908366534,0.11195219123506,0.0862549800796813
"E02006109",577,681,306,216,465,361,3084,0.187094682230869,0.220817120622568,0.0992217898832685,0.0700389105058366,0.150778210116732,0.117055771725032
"E02006110",596,527,688,142,385,454,4741,0.125711875131829,0.111157983547775,0.145117063910567,0.0299514870280532,0.0812064965197216,0.0957603881037756
"E02006111",697,695,623,250,445,447,3953,0.176321780925879,0.175815836073868,0.157601821401467,0.0632431065013914,0.112572729572477,0.113078674424488
"E02006112",554,398,599,139,259,415,2737,0.202411399342346,0.145414687614176,0.218852758494702,0.0507855316039459,0.0946291560102302,0.1516258677384
"E02006113",601,681,1105,188,493,413,3359,0.178922298303066,0.202738910389997,0.328966954450729,0.055969038404287,0.14676987198571,0.122953259898779
"E02006114",654,606,684,233,373,421,2849,0.22955422955423,0.212706212706213,0.24008424008424,0.0817830817830818,0.130923130923131,0.147771147771148
"E02006115",646,617,748,205,412,441,3338,0.193529059316956,0.184841222288796,0.224086279209107,0.0614140203714799,0.123427201917316,0.132115038945476
"E02006116",784,516,1179,209,307,575,3270,0.239755351681957,0.157798165137615,0.360550458715596,0.063914373088685,0.0938837920489297,0.175840978593272
"E02006117",687,495,1053,196,299,491,2689,0.255485310524359,0.184083302342878,0.391595388620305,0.0728895500185943,0.111193752324284,0.182595760505764
"E02006118",467,465,137,184,281,283,2139,0.218326320710612,0.217391304347826,0.0640486208508649,0.0860215053763441,0.131369798971482,0.132304815334268
"E02006119",602,457,423,135,322,467,3198,0.188242651657286,0.142901813633521,0.132270168855535,0.0422138836772983,0.100687929956223,0.146028767979987
"E02006120",638,499,342,176,323,462,3425,0.186277372262774,0.145693430656934,0.0998540145985402,0.0513868613138686,0.0943065693430657,0.134890510948905
"E02006121",395,300,190,115,185,280,2488,0.158762057877814,0.120578778135048,0.0763665594855305,0.0462218649517685,0.0743569131832797,0.112540192926045
"E02006122",446,288,611,92,196,354,3103,0.143731872381566,0.0928134063809217,0.196906219787303,0.02964872703835,0.0631646793425717,0.114083145343216
"E02006123",444,315,219,103,212,341,2179,0.203763194125746,0.144561725562184,0.100504818724185,0.0472693896282698,0.0972923359339146,0.156493804497476
"E02006124",389,261,677,83,178,306,2882,0.134975711311589,0.0905621096460791,0.234906315058987,0.0287994448299792,0.0617626648160999,0.10617626648161
"E02006125",560,408,552,141,267,419,3013,0.185861267839363,0.135413209425821,0.183206106870229,0.0467972120809824,0.088615997344839,0.13906405575838
"E02006126",429,472,471,136,336,293,2687,0.159657610718273,0.175660588016375,0.175288425753629,0.0506140677335318,0.125046520282843,0.109043542984741
"E02006127",416,159,4,60,99,356,1964,0.211812627291242,0.0809572301425662,0.00203665987780041,0.0305498981670061,0.0504073319755601,0.181262729124236
"E02006128",570,466,664,142,324,428,3400,0.167647058823529,0.137058823529412,0.195294117647059,0.0417647058823529,0.0952941176470588,0.125882352941176
"E02006129",551,451,868,165,286,386,4079,0.135082127972542,0.110566315273351,0.212797254228978,0.0404510909536651,0.0701152243196862,0.0946310370188772
"E02006130",554,585,196,191,394,363,3257,0.170095179613141,0.179613140927234,0.0601780779858766,0.0586429229352165,0.120970217992017,0.111452256677924
"E02006131",531,281,580,113,168,418,2666,0.199174793698425,0.105401350337584,0.217554388597149,0.0423855963990998,0.0630157539384846,0.156789197299325
"E02006132",319,317,112,122,195,197,2531,0.126037139470565,0.125246937969182,0.0442512840774397,0.048202291584354,0.0770446463848281,0.077834847886211
"E02006133",429,276,606,78,198,351,3160,0.135759493670886,0.0873417721518987,0.191772151898734,0.0246835443037975,0.0626582278481013,0.111075949367089
"E02006134",522,431,689,144,287,378,4029,0.129560685033507,0.106974435343758,0.171010176222388,0.035740878629933,0.0712335567138248,0.0938198064035741
"E02006135",487,325,154,132,193,355,2332,0.208833619210978,0.139365351629503,0.0660377358490566,0.0566037735849057,0.0827615780445969,0.152229845626072
"E02006136",508,351,534,132,219,376,2495,0.203607214428858,0.140681362725451,0.214028056112224,0.0529058116232465,0.0877755511022044,0.150701402805611
"E02006137",488,371,1182,109,262,379,3570,0.136694677871148,0.103921568627451,0.33109243697479,0.0305322128851541,0.0733893557422969,0.106162464985994
"E02006138",339,249,1003,54,195,285,3179,0.106637307329349,0.0783265177728846,0.315508021390374,0.0169864737338786,0.061340044039006,0.0896508335954703
"E02006139",345,234,1466,37,197,308,3707,0.0930671702185055,0.0631238198003777,0.395468033450229,0.00998111680604262,0.053142702994335,0.0830860534124629
"E02006140",445,276,778,83,193,362,3135,0.141945773524721,0.0880382775119617,0.248165869218501,0.0264752791068581,0.0615629984051037,0.115470494417863
"E02006141",619,305,2370,54,251,565,5350,0.115700934579439,0.0570093457943925,0.442990654205607,0.0100934579439252,0.0469158878504673,0.105607476635514
"E02006142",269,147,282,40,107,229,1545,0.17411003236246,0.0951456310679612,0.18252427184466,0.0258899676375405,0.0692556634304207,0.148220064724919
"E02006143",394,377,282,85,292,309,4209,0.0936089332382989,0.0895699691138038,0.0669992872416251,0.0201948206224756,0.0693751484913281,0.0734141126158232
"E02006144",407,354,736,91,263,316,3609,0.112773621501801,0.0980881130507066,0.203934607924633,0.0252147409254641,0.0728733721252424,0.0875588805763369
"E02006145",343,249,360,82,167,261,1948,0.176078028747433,0.12782340862423,0.184804928131417,0.0420944558521561,0.0857289527720739,0.133983572895277
"E02006146",470,362,276,144,218,326,3162,0.148640101201771,0.114484503478811,0.0872865275142315,0.0455407969639469,0.068943706514864,0.103099304237824
"E02006147",376,384,343,83,301,293,3386,0.111045481393975,0.113408151210868,0.101299468399291,0.0245126993502658,0.0888954518606025,0.0865327820437094
"E02006148",353,430,258,109,321,244,2001,0.176411794102949,0.214892553723138,0.128935532233883,0.0544727636181909,0.160419790104948,0.121939030484758
"E02006149",450,580,405,139,441,311,4816,0.0934385382059801,0.120431893687708,0.0840946843853821,0.0288621262458472,0.0915697674418605,0.0645764119601329
"E02006150",687,702,170,212,490,475,3718,0.184776761699839,0.188811188811189,0.0457235072619688,0.0570199031737493,0.131791285637439,0.127756858526089
"E02006151",462,435,496,145,290,317,3190,0.144827586206897,0.136363636363636,0.155485893416928,0.0454545454545455,0.0909090909090909,0.0993730407523511
"E02006152",477,615,511,161,454,316,4677,0.101988454137267,0.131494547787043,0.109258071413299,0.0344237759247381,0.0970707718623049,0.0675646782125294
"E02006153",495,381,458,146,235,349,3537,0.139949109414758,0.107718405428329,0.129488266892847,0.0412779191405146,0.0664404862878145,0.0986711902742437
"E02006154",609,631,296,211,420,398,2617,0.232709209017959,0.241115781429117,0.113106610622851,0.080626671761559,0.160489109667558,0.1520825372564
"E02006155",349,451,219,148,303,201,1940,0.179896907216495,0.232474226804124,0.112886597938144,0.0762886597938144,0.156185567010309,0.10360824742268
"E02006156",502,510,491,181,329,321,2272,0.220950704225352,0.224471830985915,0.216109154929577,0.0796654929577465,0.144806338028169,0.141285211267606
"E02006157",373,376,588,111,265,262,2280,0.16359649122807,0.164912280701754,0.257894736842105,0.0486842105263158,0.116228070175439,0.114912280701754
"E02006158",473,444,380,134,310,339,2209,0.214124038026256,0.200995925758262,0.172023540063377,0.0606609325486646,0.140334993209597,0.153463105477592
"E02006159",362,504,219,124,380,238,1949,0.185736275012827,0.258594150846588,0.112365315546434,0.0636223704463828,0.194971780400205,0.122113904566444
"E02006160",508,497,495,164,333,344,2963,0.171447856901789,0.167735403307459,0.167060411744853,0.0553493081336483,0.11238609517381,0.11609854876814
"E02006161",407,222,109,94,128,313,1777,0.229037703995498,0.124929656724817,0.0613393359594823,0.0528981429375352,0.0720315137872819,0.176139561057963
"E02006162",533,505,948,152,353,381,2615,0.203824091778203,0.193116634799235,0.362523900573614,0.0581261950286807,0.134990439770554,0.145697896749522
"E02006163",377,391,232,161,230,216,2356,0.160016977928693,0.165959252971138,0.098471986417657,0.0683361629881155,0.0976230899830221,0.0916808149405773
"E02006164",530,492,597,223,269,307,2845,0.186291739894552,0.172934973637961,0.209841827768014,0.0783831282952548,0.0945518453427065,0.107908611599297
"E02006165",542,741,924,207,534,335,3081,0.175916910094125,0.240506329113924,0.299902629016553,0.0671859785783836,0.17332035053554,0.108730931515742
"E02006166",407,732,691,190,542,217,2173,0.187298665439485,0.336861481822365,0.317993557294064,0.087436723423838,0.249424758398527,0.0998619420156466
"E02006167",412,492,454,142,350,270,4038,0.102030708271421,0.12184249628529,0.112431896978702,0.0351659237246161,0.0866765725606736,0.0668647845468053
"E02006168",547,635,1523,159,476,388,4501,0.121528549211286,0.141079760053321,0.338369251277494,0.0353254832259498,0.105754276827372,0.0862030659853366
"E02006169",298,345,391,91,254,207,2195,0.135763097949886,0.157175398633257,0.178132118451025,0.0414578587699317,0.115717539863326,0.0943052391799544
"E02006170",323,258,310,82,176,241,1709,0.188999414862493,0.150965476887068,0.181392627267408,0.0479812755997659,0.102984201287303,0.141018139262727
"E02006171",557,667,361,233,434,324,3122,0.178411274823831,0.213645099295324,0.115631005765535,0.0746316463805253,0.139013452914798,0.103779628443306
"E02006172",642,571,102,192,379,450,2915,0.220240137221269,0.195883361921098,0.034991423670669,0.0658662092624357,0.130017152658662,0.154373927958834
"E02006173",506,405,373,159,246,347,2404,0.210482529118136,0.16846921797005,0.155158069883527,0.0661397670549085,0.102329450915141,0.144342762063228
"E02006174",684,582,337,223,359,461,3613,0.189316357597564,0.161084970938278,0.093274287295876,0.0617215610296153,0.0993634099086632,0.127594796567949
"E02006175",373,227,356,85,142,288,2134,0.174789128397376,0.106373008434864,0.166822867853796,0.0398313027179007,0.0665417057169635,0.134957825679475
"E02006176",567,428,531,178,250,389,2366,0.239644970414201,0.180896027049873,0.224429416737109,0.0752324598478445,0.105663567202029,0.164412510566357
"E02006177",564,568,426,194,374,370,2821,0.19992910315491,0.201347040056717,0.151010280042538,0.0687699397376817,0.132577100319036,0.131159163417228
"E02006178",530,535,270,185,350,345,2262,0.234305923961096,0.236516357206012,0.119363395225464,0.0817860300618921,0.15473032714412,0.152519893899204
"E02006179",398,352,148,113,239,285,1842,0.216069489685125,0.191096634093377,0.0803474484256243,0.0613463626492942,0.129750271444083,0.154723127035831
"E02006180",408,368,453,102,266,306,2182,0.18698441796517,0.16865261228231,0.207607699358387,0.0467461044912924,0.121906507791017,0.140238313473877
"E02006181",436,417,224,154,263,282,2025,0.215308641975309,0.205925925925926,0.110617283950617,0.0760493827160494,0.129876543209877,0.139259259259259
"E02006182",373,451,405,124,327,249,2037,0.183112420225822,0.221404025527737,0.198821796759941,0.0608738340697104,0.160530191458027,0.122238586156112
"E02006185",569,529,313,163,366,406,2666,0.213428357089272,0.198424606151538,0.117404351087772,0.0611402850712678,0.13728432108027,0.152288072018005
"E02006186",734,659,511,245,414,489,3573,0.205429610971173,0.184438846907361,0.143017072488105,0.068569829275119,0.115869017632242,0.136859781696054
"E02006187",447,380,446,122,258,325,2388,0.187185929648241,0.159128978224456,0.186767169179229,0.0510887772194305,0.108040201005025,0.136097152428811
"E02006188",381,342,192,142,200,239,1720,0.221511627906977,0.198837209302326,0.111627906976744,0.0825581395348837,0.116279069767442,0.138953488372093
"E02006189",497,539,469,189,350,308,2224,0.223471223021583,0.242356115107914,0.210881294964029,0.0849820143884892,0.157374100719424,0.138489208633094
"E02006190",513,743,785,139,604,374,4861,0.105533840773503,0.152849207981897,0.161489405472125,0.0285949393128986,0.124254268668998,0.0769389014606048
"E02006191",491,291,208,124,167,367,2352,0.208758503401361,0.123724489795918,0.0884353741496599,0.0527210884353742,0.0710034013605442,0.156037414965986
"E02006192",555,364,613,143,221,412,3073,0.180605271721445,0.118451025056948,0.199479336153596,0.0465343312723723,0.0719166937845753,0.134070940449073
"E02006193",481,488,265,182,306,299,3097,0.155311591863093,0.157571843719729,0.0855666774297707,0.0587665482725218,0.098805295447207,0.0965450435905715
"E02006194",396,386,392,128,258,268,2999,0.132044014671557,0.128709569856619,0.130710236745582,0.0426808936312104,0.0860286762254085,0.0893631210403468
"E02006195",520,361,399,127,234,393,2806,0.185317177476835,0.128652886671418,0.142195295794726,0.0452601568068425,0.0833927298645759,0.140057020669993
"E02006196",326,366,746,81,285,245,2905,0.112220309810671,0.125989672977625,0.256798623063683,0.0278829604130809,0.0981067125645439,0.0843373493975904
"E02006197",579,287,2002,69,218,510,5511,0.10506260206859,0.052077662856106,0.363273453093812,0.0125204137180185,0.0395572491380875,0.0925421883505716
"E02006198",440,346,413,119,227,321,2915,0.150943396226415,0.118696397941681,0.141680960548885,0.0408233276157804,0.0778730703259005,0.110120068610635
"E02006199",514,319,529,122,197,392,3177,0.161787850173119,0.100409191060749,0.166509285489455,0.0384010072395342,0.062008183821215,0.123386842933585
"E02006200",493,398,118,100,298,393,3088,0.159650259067358,0.128886010362694,0.0382124352331606,0.0323834196891192,0.0965025906735751,0.127266839378238
"E02006201",761,809,304,308,501,453,3416,0.222775175644028,0.236826697892272,0.0889929742388759,0.0901639344262295,0.146662763466042,0.132611241217799
"E02006202",595,401,500,153,248,442,2790,0.21326164874552,0.143727598566308,0.17921146953405,0.0548387096774194,0.0888888888888889,0.1584229390681
"E02006203",414,336,302,95,241,319,2678,0.154592979835698,0.125466766243465,0.11277072442121,0.0354742345033607,0.0899925317401046,0.119118745332338
"E02006204",502,465,587,150,315,352,2568,0.195482866043614,0.18107476635514,0.228582554517134,0.058411214953271,0.122663551401869,0.137071651090343
"E02006205",526,351,410,156,195,370,2009,0.261821801891488,0.174713787954206,0.204081632653061,0.0776505724240916,0.0970632155301145,0.184171229467397
"E02006206",412,546,396,124,422,288,2938,0.140231449965963,0.185840707964602,0.134785568413887,0.0422055820285909,0.143635125936011,0.0980258679373724
"E02006207",424,486,233,177,309,247,1746,0.242840778923253,0.278350515463918,0.133447880870561,0.101374570446735,0.176975945017182,0.141466208476518
"E02006208",766,678,1746,229,449,537,3698,0.207138994050838,0.183342347214711,0.472147106544078,0.0619253650621958,0.121416982152515,0.145213628988643
"E02006209",664,806,388,281,525,383,3182,0.208673790069139,0.253299811439346,0.12193588937775,0.0883092394720302,0.164990571967316,0.120364550597109
"E02006210",381,199,758,64,135,317,1652,0.230629539951574,0.12046004842615,0.458837772397094,0.0387409200968523,0.0817191283292978,0.191888619854722
"E02006211",442,468,362,196,272,246,1716,0.257575757575758,0.272727272727273,0.210955710955711,0.114219114219114,0.158508158508158,0.143356643356643
"E02006212",538,530,286,213,317,325,2077,0.259027443428021,0.255175734232065,0.137698603755416,0.102551757342321,0.152623976889745,0.156475686085701
"E02006213",488,438,702,150,288,338,2302,0.211989574283232,0.190269331016507,0.304952215464813,0.0651607298001738,0.125108601216334,0.146828844483058
"E02006214",477,322,548,123,199,354,2296,0.207752613240418,0.140243902439024,0.238675958188153,0.0535714285714286,0.0866724738675958,0.15418118466899
"E02006215",559,489,443,180,309,379,2391,0.23379339188624,0.204516938519448,0.185278126306985,0.0752823086574655,0.129234629861982,0.158511083228775
"E02006216",491,394,357,165,229,326,2420,0.202892561983471,0.162809917355372,0.147520661157025,0.0681818181818182,0.0946280991735537,0.134710743801653
"E02006217",422,478,248,154,324,268,3237,0.130367624343528,0.147667593450726,0.0766141489033055,0.0475749150447946,0.100092678405931,0.0827927092987334
"E02006218",427,722,749,79,643,348,4460,0.0957399103139013,0.161883408071749,0.167937219730942,0.0177130044843049,0.144170403587444,0.0780269058295964
"E02006219",447,478,235,139,339,308,2953,0.151371486623772,0.161869285472401,0.0795800880460549,0.0470707754825601,0.114798509989841,0.104300711141212
"E02006220",354,386,644,99,287,255,2181,0.162310866574966,0.176983035304906,0.29527739569005,0.0453920220082531,0.131591013296653,0.116918844566713
"E02006221",423,212,294,46,166,377,1997,0.211817726589885,0.106159238858287,0.14722083124687,0.0230345518277416,0.0831246870305458,0.188783174762143
"E02006222",372,414,334,123,291,249,2055,0.181021897810219,0.201459854014599,0.162530413625304,0.0598540145985401,0.141605839416058,0.121167883211679
"E02006223",418,563,14,172,391,246,2133,0.195968120018753,0.263947491795593,0.00656352555086732,0.0806375996249414,0.183309892170652,0.115330520393812
"E02006224",451,387,30,128,259,323,2265,0.199116997792494,0.170860927152318,0.0132450331125828,0.0565121412803532,0.114348785871965,0.142604856512141
"E02006225",372,313,275,109,204,263,2082,0.178674351585014,0.150336215177714,0.132084534101825,0.0523535062439962,0.0979827089337176,0.126320845341018
"E02006226",425,379,450,111,268,314,3256,0.130528255528256,0.116400491400491,0.138206388206388,0.0340909090909091,0.0823095823095823,0.0964373464373464
"E02006227",497,290,488,128,162,369,2480,0.200403225806452,0.116935483870968,0.196774193548387,0.0516129032258065,0.0653225806451613,0.148790322580645
"E02006228",476,336,397,133,203,343,2104,0.226235741444867,0.159695817490494,0.188688212927757,0.063212927756654,0.0964828897338403,0.163022813688213
"E02006229",438,320,391,111,209,327,2406,0.182044887780549,0.133000831255195,0.162510390689942,0.0461346633416459,0.0868661679135495,0.135910224438903
"E02006230",597,476,615,152,324,445,4139,0.144237738584199,0.115003624063784,0.148586615124426,0.0367238463396956,0.0782797777240879,0.107513892244504
"E02006231",528,405,340,112,293,416,3129,0.168744007670182,0.129434324065197,0.108660914030042,0.0357941834451902,0.0936401406200064,0.132949824224992
"E02006232",467,301,285,117,184,350,2450,0.190612244897959,0.122857142857143,0.116326530612245,0.0477551020408163,0.0751020408163265,0.142857142857143
"E02006233",826,665,1100,182,483,644,5226,0.158055874473785,0.12724837351703,0.210486031381554,0.0348258706467662,0.0924225028702641,0.123230003827019
"E02006234",556,458,217,192,266,364,3399,0.163577522800824,0.13474551338629,0.0638423065607532,0.0564872021182701,0.07825831126802,0.107090320682554
"E02006235",605,360,563,146,214,459,2629,0.230125523012552,0.136934195511601,0.214149866869532,0.0555344237352606,0.0813997717763408,0.174591099277292
"E02006236",676,461,505,170,291,506,3491,0.193640790604411,0.132053852764251,0.144657691205958,0.048696648524778,0.0833572042394729,0.144944142079633
"E02006237",643,360,616,142,218,501,2660,0.241729323308271,0.135338345864662,0.231578947368421,0.0533834586466165,0.0819548872180451,0.188345864661654
"E02006238",1031,638,459,297,341,734,4167,0.247420206383489,0.15310775137989,0.110151187904968,0.0712742980561555,0.0818334533237341,0.176145908327334
"E02006239",750,341,215,162,179,588,2869,0.261415127222029,0.118856744510282,0.0749390031369815,0.0564656674799582,0.0623910770303242,0.20494945974207
"E02006240",723,443,320,192,251,531,4457,0.162216737715952,0.099394211352928,0.0717971729863137,0.0430783037917882,0.0563159075611398,0.119138433924164
"E02006241",681,610,319,211,399,470,3910,0.174168797953964,0.156010230179028,0.0815856777493606,0.0539641943734015,0.102046035805627,0.120204603580563
"E02006242",572,393,376,185,208,387,5127,0.111566218061244,0.0766530134581627,0.0733372342500488,0.0360834796177102,0.0405695338404525,0.0754827384435342
"E02006243",571,741,749,190,551,381,4550,0.125494505494505,0.162857142857143,0.164615384615385,0.0417582417582418,0.121098901098901,0.0837362637362637
"E02006245",425,396,88,148,248,277,2647,0.160559123536079,0.149603324518323,0.0332451832262939,0.0559123536078579,0.0936909709104647,0.104646769928221
"E02006246",445,522,269,169,353,276,2074,0.214561234329797,0.25168756027001,0.12970106075217,0.0814850530376085,0.170202507232401,0.133076181292189
"E02006247",439,439,869,144,295,295,3449,0.127283270513192,0.127283270513192,0.251957089011308,0.0417512322412293,0.0855320382719629,0.0855320382719629
"E02006248",437,508,598,155,353,282,2601,0.1680123029604,0.195309496347559,0.229911572472126,0.0595924644367551,0.135717031910804,0.108419838523645
"E02006249",507,385,1439,107,278,400,3451,0.146913937988989,0.111561866125761,0.416980585337583,0.0310055056505361,0.0805563604752246,0.115908432338453
"E02006250",588,389,2548,99,290,489,4686,0.125480153649168,0.0830132309005548,0.543747332479727,0.0211267605633803,0.0618864703371746,0.104353393085787
"E02006251",587,452,2228,105,347,482,6351,0.0924263895449536,0.0711698945048024,0.350810895921902,0.0165328294756731,0.0546370650291293,0.0758935600692804
"E02006252",465,478,1374,123,355,342,3827,0.121505095374967,0.124902012019859,0.359027959237,0.0321400574862817,0.0927619545335772,0.0893650378886857
"E02006253",496,618,373,196,422,300,2315,0.214254859611231,0.26695464362851,0.161123110151188,0.0846652267818574,0.182289416846652,0.129589632829374
"E02006254",492,486,798,115,371,377,4319,0.113915258161611,0.112526047696226,0.184764991896272,0.0266265339198889,0.0858995137763371,0.0872887242417226
"E02006255",372,367,1227,101,266,271,3634,0.102366538249862,0.100990643918547,0.337644468904788,0.0277930654925702,0.0731975784259769,0.0745734727572922
"E02006256",507,572,1135,113,459,394,4573,0.110868139077192,0.125082003061448,0.248195932648152,0.0247102558495517,0.100371747211896,0.0861578832276405
"E02006257",399,488,30,144,344,255,2502,0.15947242206235,0.195043964828137,0.0119904076738609,0.0575539568345324,0.137490007993605,0.101918465227818
"E02006258",299,286,446,77,209,222,3344,0.0894138755980861,0.0855263157894737,0.133373205741627,0.0230263157894737,0.0625,0.0663875598086124
"E02006259",419,629,58,170,459,249,2989,0.140180662428906,0.210438273670124,0.0194044831047173,0.0568752091000335,0.15356306457009,0.0833054533288725
"E02006260",467,436,617,131,305,336,2988,0.156291834002677,0.145917001338688,0.206492637215529,0.0438420348058902,0.102074966532798,0.112449799196787
"E02006261",509,303,532,122,181,387,2733,0.186242224661544,0.110867178924259,0.19465788510794,0.0446395901939261,0.066227588730333,0.141602634467618
"E02006262",675,291,474,141,150,534,3065,0.220228384991843,0.0949429037520391,0.154649265905383,0.0460032626427406,0.0489396411092985,0.174225122349103
"E02006263",381,250,476,81,169,300,2602,0.146425826287471,0.0960799385088393,0.18293620292083,0.031129900076864,0.0649500384319754,0.115295926210607
"E02006264",596,253,315,96,157,500,4026,0.148037754595132,0.0628415300546448,0.0782414307004471,0.0238450074515648,0.03899652260308,0.124192747143567
"E02006265",534,319,299,136,183,398,2913,0.183316168898043,0.109509097150704,0.102643323034672,0.0466872639890148,0.062821833161689,0.136628904909028
"E02006266",536,321,417,103,218,433,3709,0.144513345915341,0.0865462388784039,0.112429226206525,0.0277702884874629,0.058775950390941,0.116743057427878
"E02006267",553,322,539,121,201,432,2667,0.207349081364829,0.120734908136483,0.202099737532808,0.0453693288338958,0.0753655793025872,0.161979752530934
"E02006268",354,278,235,93,185,261,2440,0.145081967213115,0.113934426229508,0.0963114754098361,0.0381147540983607,0.0758196721311475,0.106967213114754
"E02006269",435,313,190,126,187,309,2974,0.146267652992603,0.105245460659045,0.0638870208473436,0.0423671822461332,0.0628782784129119,0.103900470746469
"E02006270",588,431,732,117,314,471,5660,0.103886925795053,0.0761484098939929,0.129328621908127,0.0206713780918728,0.0554770318021201,0.0832155477031802
"E02006271",401,288,350,100,188,301,3746,0.107047517351842,0.0768820074746396,0.0934329951948745,0.0266951414842499,0.0501868659903897,0.0803523758675921
"E02006272",439,309,344,111,198,328,2764,0.158827785817656,0.111794500723589,0.124457308248915,0.0401591895803184,0.0716353111432706,0.118668596237337
"E02006273",507,279,270,110,169,397,2151,0.235704323570432,0.129707112970711,0.125523012552301,0.0511390051139005,0.0785681078568108,0.184565318456532
"E02006274",439,278,431,75,203,364,2134,0.205716963448922,0.130271790065604,0.201968134957826,0.03514526710403,0.0951265229615745,0.170571696344892
"E02006275",345,243,218,84,159,261,2584,0.133513931888545,0.0940402476780186,0.0843653250773994,0.0325077399380805,0.0615325077399381,0.101006191950464
"E02006276",444,303,333,110,193,334,3504,0.126712328767123,0.086472602739726,0.0950342465753425,0.0313926940639269,0.0550799086757991,0.0953196347031963
"E02006277",424,171,3,51,120,373,3037,0.139611458676325,0.0563055647020086,0.000987816924596642,0.0167928877181429,0.0395126769838657,0.122818570958182
"E02006278",571,335,1338,82,253,489,5082,0.112357339630067,0.0659189295552932,0.263282172373081,0.0161353797717434,0.0497835497835498,0.0962219598583235
"E02006279",585,489,609,176,313,409,3150,0.185714285714286,0.155238095238095,0.193333333333333,0.0558730158730159,0.0993650793650794,0.12984126984127
"E02006280",748,414,467,199,215,549,3095,0.241680129240711,0.133764135702746,0.150888529886914,0.064297253634895,0.0694668820678514,0.177382875605816
"E02006281",528,498,610,141,357,387,3506,0.150598973188819,0.142042213348545,0.173987450085568,0.0402167712492869,0.101825442099258,0.110382201939532
"E02006282",461,317,420,118,199,343,2149,0.214518380642159,0.14751046998604,0.195439739413681,0.0549092601209865,0.0926012098650535,0.159609120521173
"E02006283",498,385,481,167,218,331,2644,0.188350983358548,0.145612708018154,0.181921331316188,0.0631618759455371,0.0824508320726172,0.125189107413011
"E02006284",431,305,308,103,202,328,2885,0.149393414211438,0.105719237435009,0.106759098786828,0.0357019064124783,0.0700173310225303,0.11369150779896
"E02006285",432,272,50,40,232,392,2674,0.161555721765146,0.101720269259536,0.018698578908003,0.0149588631264024,0.0867614061331339,0.146596858638743
"E02006286",807,620,481,204,416,603,4000,0.20175,0.155,0.12025,0.051,0.104,0.15075
"E02006287",596,335,799,141,194,455,2742,0.217359591539023,0.12217359591539,0.291393143690737,0.0514223194748359,0.0707512764405543,0.165937272064187
"E02006288",494,361,834,107,254,387,3564,0.138608305274972,0.101290684624018,0.234006734006734,0.0300224466891134,0.0712682379349046,0.108585858585859
"E02006289",604,480,724,121,359,483,4127,0.146353283256603,0.116307244972135,0.175430094499637,0.0293191180033923,0.0869881269687424,0.117034165253211
"E02006290",766,678,1090,202,476,564,4505,0.170033296337403,0.150499445061043,0.241953385127636,0.0448390677025527,0.105660377358491,0.12519422863485
"E02006291",399,304,467,97,207,302,3220,0.123913043478261,0.0944099378881988,0.145031055900621,0.0301242236024845,0.0642857142857143,0.0937888198757764
"E02006292",407,276,488,109,167,298,2228,0.182675044883303,0.123877917414722,0.21903052064632,0.0489228007181329,0.0749551166965889,0.133752244165171
"E02006293",849,400,797,142,258,707,4236,0.20042492917847,0.0944287063267233,0.188149197355996,0.0335221907459868,0.0609065155807365,0.166902738432483
"E02006294",553,500,718,151,349,402,3288,0.168187347931873,0.152068126520681,0.218369829683698,0.0459245742092457,0.106143552311436,0.122262773722628
"E02006295",569,353,127,138,215,431,3166,0.179722046746684,0.111497157296273,0.040113708149084,0.0435881238155401,0.0679090334807328,0.136133922931143
"E02006296",586,362,139,140,222,446,4337,0.135116439935439,0.0834678349089232,0.0320498040119899,0.0322803781415725,0.0511874567673507,0.102836061793867
"E02006297",455,239,178,94,145,361,2228,0.204219030520646,0.107271095152603,0.0798922800718133,0.0421903052064632,0.06508078994614,0.162028725314183
"E02006298",651,451,292,163,288,488,3223,0.201985727582997,0.139931740614334,0.0905988209742476,0.0505739993794601,0.0893577412348743,0.151411728203537
"E02006299",636,574,373,193,381,443,3018,0.210735586481113,0.190192180251822,0.123591782637508,0.0639496355202121,0.12624254473161,0.146785950960901
"E02006300",562,417,342,133,284,429,3527,0.159342217181741,0.118230791040544,0.0969662602778565,0.0377091012191664,0.0805216898213779,0.121633115962574
"E02006301",562,441,1285,96,345,466,3229,0.174047692784144,0.136574790956953,0.397956023536699,0.0297305667389285,0.106844224218024,0.144317126045215
"E02006302",598,459,593,189,270,409,2469,0.242203321182665,0.185905224787363,0.240178209801539,0.0765492102065614,0.109356014580802,0.165654110976104
"E02006303",406,299,243,82,217,324,3330,0.121921921921922,0.0897897897897898,0.072972972972973,0.0246246246246246,0.0651651651651652,0.0972972972972973
"E02006304",570,487,231,166,321,404,3230,0.176470588235294,0.15077399380805,0.0715170278637771,0.0513931888544892,0.0993808049535604,0.125077399380805
"E02006305",841,576,3272,139,437,702,4826,0.174264401160381,0.119353501864898,0.677994198093659,0.0288023207625363,0.0905511811023622,0.145462080397845
"E02006306",606,456,1036,140,316,466,2974,0.203765971755212,0.153328850033625,0.348352387357095,0.047074646940148,0.106254203093477,0.156691324815064
"E02006307",586,489,345,188,301,398,2195,0.266970387243736,0.222779043280182,0.157175398633257,0.0856492027334852,0.137129840546697,0.181321184510251
"E02006308",675,371,2764,77,294,598,4602,0.146675358539765,0.0806171229900043,0.600608431116906,0.0167318557149066,0.0638852672750978,0.129943502824859
"E02006309",424,391,601,107,284,317,2515,0.168588469184891,0.155467196819085,0.2389662027833,0.042544731610338,0.112922465208748,0.126043737574553
"E02006310",511,354,200,127,227,384,2773,0.184276956364948,0.127659574468085,0.0721240533717995,0.0457987738910927,0.0818608005769924,0.138478182473855
"E02006311",657,434,1185,124,310,533,3714,0.176898222940226,0.116855142703285,0.319063004846527,0.03338718362951,0.0834679590737749,0.143511039310716
"E02006312",636,339,356,131,208,505,2763,0.230184581976113,0.122692725298588,0.128845457835686,0.0474122330799855,0.075280492218603,0.182772348896127
"E02006313",918,656,741,280,376,638,3868,0.237331954498449,0.169596690796277,0.191571871768356,0.0723888314374354,0.0972078593588418,0.164943123061013
"E02006314",545,374,649,129,245,416,2781,0.195972671700827,0.134483998561668,0.233369291621719,0.04638619201726,0.0880978065444085,0.149586479683567
"E02006315",588,479,959,154,325,434,3184,0.184673366834171,0.150439698492462,0.301193467336683,0.0483668341708543,0.102072864321608,0.136306532663317
"E02006316",659,353,464,146,207,513,3361,0.196072597441238,0.105028265397203,0.138054150550431,0.0434394525438857,0.0615888128533175,0.152633144897352
"E02006317",384,581,513,156,425,228,1884,0.203821656050955,0.308386411889597,0.272292993630573,0.0828025477707006,0.225583864118896,0.121019108280255
"E02006318",412,357,1250,100,257,312,2731,0.150860490662761,0.130721347491761,0.457707799340901,0.0366166239472721,0.0941047235444892,0.114243866715489
"E02006319",412,508,775,156,352,256,2447,0.168369431957499,0.207601144258275,0.31671434409481,0.0637515324887618,0.143849611769514,0.104617899468737
"E02006320",517,485,433,147,338,370,2702,0.191339748334567,0.179496669133975,0.160251665433013,0.0544041450777202,0.125092524056255,0.136935603256847
"E02006321",409,387,945,105,282,304,2138,0.191300280636109,0.181010289990645,0.44200187090739,0.04911131898971,0.131898971000935,0.142188961646398
"E02006322",348,343,795,107,236,241,2084,0.166986564299424,0.164587332053743,0.38147792706334,0.0513435700575816,0.113243761996161,0.115642994241843
"E02006323",413,517,807,128,389,285,3353,0.123173277661795,0.154190277363555,0.240679988070385,0.0381747688637041,0.116015508499851,0.0849985087980913
"E02006324",455,586,564,160,426,295,2331,0.195195195195195,0.251394251394251,0.241956241956242,0.0686400686400686,0.182754182754183,0.126555126555127
"E02006325",460,598,958,186,412,274,2649,0.173650434126085,0.225745564363911,0.36164590411476,0.0702151755379389,0.155530388825972,0.103435258588146
"E02006326",510,627,654,169,458,341,3426,0.148861646234676,0.183012259194396,0.190893169877408,0.0493286631640397,0.133683596030356,0.0995329830706363
"E02006327",384,674,409,124,550,260,2701,0.142169566827101,0.249537208441318,0.15142539800074,0.0459089226212514,0.203628285820067,0.0962606442058497
"E02006328",578,907,1228,178,729,400,4371,0.132235186456189,0.20750400366049,0.280942576069549,0.0407229466941203,0.166781056966369,0.0915122397620682
"E02006329",450,512,728,162,350,288,2848,0.158005617977528,0.179775280898876,0.25561797752809,0.0568820224719101,0.122893258426966,0.101123595505618
"E02006330",705,845,954,320,525,385,3631,0.19416138804737,0.232718259432663,0.262737537868356,0.0881299917378133,0.14458826769485,0.106031396309557
"E02006331",462,539,677,191,348,271,2218,0.208295761947701,0.243011722272317,0.305229936880072,0.0861136158701533,0.156898106402164,0.122182146077547
"E02006332",424,640,223,158,482,266,2654,0.159758854559156,0.241145440844009,0.0840241145440844,0.0595327807083647,0.181612660135644,0.100226073850791
"E02006333",699,835,659,302,533,397,3787,0.184578822286771,0.220491153947716,0.174016371798257,0.0797465011882757,0.14074465275944,0.104832321098495
"E02006334",531,778,356,266,512,265,2919,0.18191161356629,0.266529633436108,0.121959575196985,0.0911270983213429,0.175402535114765,0.0907845152449469
"E02006335",504,604,1107,156,448,348,2521,0.199920666402221,0.239587465291551,0.439111463704879,0.0618802062673542,0.177707259024197,0.138040460134867
"E02006336",327,604,445,143,461,184,1986,0.164652567975831,0.304128902316213,0.224068479355488,0.0720040281973817,0.232124874118832,0.0926485397784491
"E02006337",473,464,1294,134,330,339,2128,0.222274436090226,0.218045112781955,0.608082706766917,0.0629699248120301,0.155075187969925,0.159304511278195
"E02006338",366,287,962,76,211,290,1751,0.209023415191319,0.163906339234723,0.549400342661336,0.0434037692747002,0.120502569960023,0.165619645916619
"E02006339",413,635,410,172,463,241,3660,0.112841530054645,0.173497267759563,0.112021857923497,0.0469945355191257,0.126502732240437,0.0658469945355191
"E02006341",582,883,968,252,631,330,3569,0.163070888203979,0.247408237601569,0.271224432614178,0.0706080134491454,0.176800224152424,0.0924628747548333
"E02006342",471,962,867,214,748,257,4218,0.111664295874822,0.228070175438596,0.205547652916074,0.0507349454717876,0.177335229966809,0.0609293504030346
"E02006343",525,795,673,246,549,279,2494,0.210505212510024,0.318765036086608,0.269847634322374,0.0986367281475541,0.220128307939054,0.11186848436247
"E02006344",558,627,519,219,408,339,2899,0.192480165574336,0.216281476371162,0.17902725077613,0.0755432907899276,0.140738185581235,0.116936874784408
"E02006345",301,373,351,98,275,203,2020,0.149009900990099,0.184653465346535,0.173762376237624,0.0485148514851485,0.136138613861386,0.100495049504951
"E02006346",608,923,386,303,620,305,3192,0.19047619047619,0.289160401002506,0.120927318295739,0.0949248120300752,0.194235588972431,0.0955513784461153
"E02006347",541,640,193,196,444,345,2452,0.220636215334421,0.261011419249592,0.0787112561174551,0.0799347471451876,0.181076672104405,0.140701468189233
"E02006348",623,687,224,221,466,402,2760,0.225724637681159,0.248913043478261,0.0811594202898551,0.0800724637681159,0.168840579710145,0.145652173913043
"E02006349",489,700,394,184,516,305,2806,0.174269422665716,0.249465431218817,0.140413399857448,0.0655737704918033,0.183891660727014,0.108695652173913
"E02006350",308,434,213,126,308,182,2100,0.146666666666667,0.206666666666667,0.101428571428571,0.06,0.146666666666667,0.0866666666666667
"E02006351",588,565,109,173,392,415,2852,0.20617110799439,0.198106591865358,0.038218793828892,0.0606591865357644,0.137447405329593,0.145511921458626
"E02006352",308,736,356,159,577,149,1972,0.156186612576065,0.373225152129817,0.18052738336714,0.0806288032454361,0.292596348884381,0.0755578093306288
"E02006353",390,530,172,161,369,229,2305,0.169197396963124,0.229934924078091,0.0746203904555315,0.0698481561822126,0.160086767895879,0.0993492407809111
"E02006354",602,830,380,217,613,385,3271,0.184041577499236,0.253745032100275,0.116172424335066,0.0663405686334454,0.18740446346683,0.11770100886579
"E02006355",279,664,97,147,517,132,2060,0.135436893203883,0.322330097087379,0.0470873786407767,0.0713592233009709,0.250970873786408,0.0640776699029126
"E02006356",662,1056,2310,157,899,505,6199,0.10679141797064,0.170350056460719,0.372640748507824,0.0253266655912244,0.145023390869495,0.081464752379416
"E02006357",370,588,167,172,416,198,3338,0.110844817255842,0.176153385260635,0.0500299580587178,0.0515278609946076,0.124625524266028,0.0593169562612343
"E02006358",354,696,674,165,531,189,3042,0.116370808678501,0.22879684418146,0.221564760026298,0.0542406311637081,0.174556213017751,0.0621301775147929
"E02006359",350,696,657,146,550,204,2417,0.14480761274307,0.287960281340505,0.271824575920563,0.0604054613156806,0.227554820024824,0.0844021514273893
"E02006360",524,647,701,194,453,330,2672,0.196107784431138,0.242140718562874,0.262350299401198,0.0726047904191617,0.169535928143713,0.123502994011976
"E02006361",338,369,488,133,236,205,1736,0.194700460829493,0.212557603686636,0.28110599078341,0.0766129032258065,0.135944700460829,0.118087557603687
"E02006362",500,614,480,197,417,303,2087,0.239578342117873,0.294202204120747,0.229995208433158,0.0943938667944418,0.199808337326306,0.145184475323431
"E02006363",360,631,435,186,445,174,1829,0.196828868234008,0.344997266265719,0.237834882449426,0.101694915254237,0.243302351011482,0.0951339529797704
"E02006364",467,823,469,190,633,277,3949,0.118257786781464,0.2084071916941,0.118764244112434,0.0481134464421372,0.160293745251963,0.0701443403393264
"E02006365",420,627,464,169,458,251,2552,0.164576802507837,0.245689655172414,0.181818181818182,0.0662225705329154,0.179467084639498,0.0983542319749216
"E02006366",595,712,259,275,437,320,2292,0.259598603839442,0.31064572425829,0.113001745200698,0.119982547993019,0.190663176265271,0.139616055846422
"E02006367",440,614,158,190,424,250,2091,0.210425633668101,0.293639406982305,0.0755619320899091,0.0908656145384983,0.202773792443807,0.119560019129603
"E02006368",389,620,208,195,425,194,1870,0.208021390374332,0.331550802139037,0.111229946524064,0.10427807486631,0.227272727272727,0.103743315508021
"E02006369",419,465,476,163,302,256,1861,0.22514777001612,0.249865663621709,0.255776464266523,0.0875873186458893,0.162278344975819,0.137560451370231
"E02006370",461,565,697,185,380,276,2464,0.187094155844156,0.229301948051948,0.282873376623377,0.0750811688311688,0.154220779220779,0.112012987012987
"E02006371",498,574,789,151,423,347,3065,0.162479608482871,0.187275693311582,0.25742251223491,0.0492659053833605,0.138009787928222,0.113213703099511
"E02006372",473,397,353,151,246,322,2137,0.221338324754328,0.185774450163781,0.165184838558727,0.0706598034627983,0.115114646700983,0.15067852129153
"E02006373",580,527,725,167,360,413,2302,0.251954821894005,0.228931364031277,0.314943527367507,0.0725456125108601,0.156385751520417,0.179409209383145
"E02006374",484,485,386,178,307,306,2131,0.227123416236509,0.227592679493196,0.181135617081183,0.0835288596902863,0.144063819802909,0.143594556546222
"E02006375",407,630,295,200,430,207,2051,0.198439785470502,0.307167235494881,0.143832276938079,0.0975134080936129,0.209653827401268,0.100926377376889
"E02006376",526,735,678,200,535,326,2690,0.195539033457249,0.273234200743494,0.252044609665428,0.0743494423791822,0.198884758364312,0.121189591078067
"E02006377",425,621,126,218,403,207,1854,0.229234088457389,0.33495145631068,0.0679611650485437,0.117583603020496,0.217367853290183,0.111650485436893
"E02006378",523,481,736,168,313,355,2558,0.204456606724003,0.188037529319781,0.287724784988272,0.0656763096168882,0.122361219702893,0.138780297107115
"E02006379",417,512,196,136,376,281,2864,0.145600558659218,0.17877094972067,0.0684357541899441,0.0474860335195531,0.131284916201117,0.0981145251396648
"E02006380",510,601,482,211,390,299,2362,0.215918712955123,0.254445385266723,0.204064352243861,0.0893310753598645,0.165114309906859,0.126587637595258
"E02006381",419,606,318,195,411,224,2340,0.179059829059829,0.258974358974359,0.135897435897436,0.0833333333333333,0.175641025641026,0.0957264957264957
"E02006382",464,615,535,222,393,242,2510,0.184860557768924,0.245019920318725,0.213147410358566,0.0884462151394422,0.156573705179283,0.0964143426294821
"E02006383",687,871,980,265,606,422,3903,0.176018447348194,0.223161670509864,0.251088905969767,0.0678964898795798,0.155265180630284,0.108121957468614
"E02006384",619,972,682,237,735,382,4626,0.133808906182447,0.21011673151751,0.147427583225249,0.0512321660181582,0.158884565499351,0.0825767401642888
"E02006385",540,659,633,170,489,370,5225,0.103349282296651,0.126124401913876,0.121148325358852,0.0325358851674641,0.0935885167464115,0.0708133971291866
"E02006386",584,922,839,269,653,315,3228,0.18091697645601,0.285625774473358,0.259913258983891,0.0833333333333333,0.202292441140025,0.0975836431226766
"E02006387",377,546,385,148,398,229,2361,0.159678102498941,0.231257941550191,0.163066497246929,0.0626853028377806,0.16857263871241,0.0969927996611605
"E02006388",610,800,664,226,574,384,3432,0.177738927738928,0.233100233100233,0.193473193473193,0.0658508158508159,0.167249417249417,0.111888111888112
"E02006389",464,603,256,197,406,267,2405,0.192931392931393,0.250727650727651,0.106444906444906,0.0819126819126819,0.168814968814969,0.111018711018711
"E02006390",662,741,170,276,465,386,4136,0.160058027079304,0.179158607350097,0.0411025145067698,0.0667311411992263,0.11242746615087,0.0933268858800774
"E02006391",505,309,90,134,175,371,2592,0.19483024691358,0.119212962962963,0.0347222222222222,0.0516975308641975,0.0675154320987654,0.143132716049383
"E02006392",677,966,415,260,706,417,4046,0.167325753830944,0.238754325259516,0.102570439940682,0.0642609985170539,0.174493326742462,0.10306475531389
"E02006393",428,512,720,119,393,309,3077,0.139096522586935,0.166395840103997,0.233994150146246,0.0386740331491713,0.127721806954826,0.100422489437764
"E02006394",585,861,675,248,613,337,3983,0.146874215415516,0.216168717047452,0.169470248556365,0.0622646246547828,0.153904092392669,0.0846095907607331
"E02006395",567,527,1016,156,371,411,3366,0.168449197860963,0.156565656565657,0.301841948900772,0.0463458110516934,0.110219845513963,0.122103386809269
"E02006396",318,398,377,148,250,170,1972,0.161257606490872,0.201825557809331,0.191176470588235,0.0750507099391481,0.126774847870183,0.0862068965517241
"E02006397",336,465,282,147,318,189,2400,0.14,0.19375,0.1175,0.06125,0.1325,0.07875
"E02006398",429,694,775,145,549,284,3796,0.113013698630137,0.182824025289779,0.204162276080084,0.0381981032665964,0.144625922023182,0.0748155953635406
"E02006399",658,886,1026,246,640,412,4712,0.139643463497453,0.188030560271647,0.217741935483871,0.0522071307300509,0.135823429541596,0.0874363327674024
"E02006400",385,371,372,119,252,266,2344,0.164249146757679,0.158276450511945,0.158703071672355,0.0507679180887372,0.107508532423208,0.113481228668942
"E02006401",550,965,769,201,764,349,4007,0.137259795358123,0.240828550037435,0.191914150237085,0.0501622161217869,0.190666333915648,0.0870975792363364
"E02006402",698,759,779,280,479,418,2775,0.251531531531532,0.273513513513513,0.280720720720721,0.100900900900901,0.172612612612613,0.150630630630631
"E02006403",482,1120,203,215,905,267,2830,0.170318021201413,0.395759717314488,0.0717314487632509,0.0759717314487632,0.319787985865724,0.0943462897526502
"E02006404",384,591,393,146,445,238,2792,0.137535816618911,0.211676217765043,0.140759312320917,0.0522922636103152,0.159383954154728,0.085243553008596
"E02006405",643,773,1391,219,554,424,4118,0.156143759106362,0.187712481787275,0.33778533268577,0.0531811559009228,0.134531325886353,0.10296260320544
"E02006406",600,820,950,180,640,420,4989,0.120264582080577,0.164361595510122,0.190418921627581,0.0360793746241732,0.128282220885949,0.0841852074564041
"E02006407",637,997,900,268,729,369,3121,0.204101249599487,0.319448894585069,0.288369112463954,0.0858699134892663,0.233578981095803,0.118231336110221
"E02006408",613,926,539,287,639,326,3230,0.189783281733746,0.286687306501548,0.16687306501548,0.0888544891640867,0.197832817337461,0.100928792569659
"E02006409",448,718,374,198,520,250,2416,0.185430463576159,0.297185430463576,0.154801324503311,0.081953642384106,0.21523178807947,0.103476821192053
"E02006410",518,834,679,179,655,339,3394,0.152622274602239,0.24572775486152,0.200058927519151,0.0527401296405421,0.192987625220978,0.0998821449616971
"E02006411",437,651,828,174,477,263,2209,0.197827071072884,0.294703485740154,0.374830239927569,0.0787686736079674,0.215934812132187,0.119058397464916
"E02006412",438,619,605,164,455,274,2842,0.15411681914145,0.21780436312456,0.212878254750176,0.0577058409570725,0.160098522167488,0.0964109781843772
"E02006413",394,651,533,169,482,225,2106,0.187084520417854,0.309116809116809,0.253086419753086,0.0802469135802469,0.228869895536562,0.106837606837607
"E02006414",474,660,429,196,464,278,2018,0.234886025768087,0.327056491575818,0.212586719524281,0.0971258671952428,0.229930624380575,0.137760158572844
"E02006415",527,571,635,171,400,356,2551,0.206585652685221,0.223833790670325,0.248921991375931,0.0670325362602901,0.156801254410035,0.139553116424931
"E02006416",664,664,597,234,430,430,2755,0.241016333938294,0.241016333938294,0.216696914700544,0.0849364791288566,0.156079854809437,0.156079854809437
"E02006417",494,355,243,117,238,377,2492,0.198234349919743,0.142455858747994,0.0975120385232745,0.0469502407704655,0.0955056179775281,0.151284109149278
"E02006418",567,461,141,172,289,395,2102,0.269743101807802,0.219314938154139,0.0670789724072312,0.0818268315889629,0.137488106565176,0.187916270218839
"E02006419",499,650,206,177,473,322,2888,0.172783933518006,0.225069252077562,0.0713296398891967,0.0612880886426593,0.163781163434903,0.111495844875346
"E02006420",490,627,205,163,464,327,2961,0.16548463356974,0.211752786220871,0.0692333671057075,0.055048969942587,0.156703816278284,0.110435663627153
"E02006421",582,586,180,208,378,374,2796,0.208154506437768,0.209585121602289,0.0643776824034335,0.0743919885550787,0.13519313304721,0.13376251788269
"E02006422",435,624,36,200,424,235,1877,0.231752797016516,0.332445391582312,0.0191795418220565,0.106553010122536,0.225892381459776,0.12519978689398
"E02006423",650,1138,387,304,834,346,4314,0.150672229949003,0.263792304126101,0.0897079276773296,0.0704682429299954,0.193324061196106,0.0802039870190079
"E02006424",396,481,176,152,329,244,1779,0.222596964586847,0.270376616076447,0.0989319842608207,0.0854412591343451,0.184935356942102,0.137155705452501
"E02006425",358,726,116,193,533,165,2141,0.167211583372256,0.339093881363849,0.0541802895843064,0.0901447921531994,0.248949089210649,0.0770667912190565
"E02006426",387,462,136,149,313,238,1688,0.229265402843602,0.273696682464455,0.0805687203791469,0.0882701421800948,0.18542654028436,0.140995260663507
"E02006427",341,458,209,129,329,212,2954,0.115436696005416,0.155044008124577,0.0707515233581584,0.0436696005416385,0.111374407582938,0.0717670954637779
"E02006429",534,820,560,244,576,290,3686,0.144872490504612,0.222463374932176,0.151926207270754,0.0661964188822572,0.156266956049919,0.0786760716223549
"E02006430",428,570,557,147,423,281,3099,0.13810906744111,0.183930300096805,0.17973539851565,0.0474346563407551,0.13649564375605,0.090674411100355
"E02006431",705,1202,795,342,860,363,4047,0.174203113417346,0.297010130961206,0.19644180874722,0.0845070422535211,0.212503088707685,0.0896960711638251
"E02006432",396,597,303,204,393,192,1845,0.214634146341463,0.323577235772358,0.164227642276423,0.110569105691057,0.213008130081301,0.104065040650407
"E02006433",668,970,827,301,669,367,3213,0.207905384375973,0.301898537192655,0.25739184562714,0.093681917211329,0.208216619981326,0.114223467164644
"E02006434",369,491,236,155,336,214,1848,0.199675324675325,0.265692640692641,0.127705627705628,0.0838744588744589,0.181818181818182,0.115800865800866
"E02006435",422,437,468,135,302,287,1854,0.227615965480043,0.235706580366775,0.252427184466019,0.0728155339805825,0.162891046386192,0.154800431499461
"E02006436",504,574,370,218,356,286,1940,0.25979381443299,0.295876288659794,0.190721649484536,0.112371134020619,0.183505154639175,0.147422680412371
"E02006437",599,699,420,251,448,348,2543,0.235548564687377,0.274872198191113,0.16515926071569,0.0987023200943767,0.176169878096736,0.136846244593
"E02006438",665,678,324,285,393,380,2469,0.269339813689753,0.27460510328068,0.131227217496962,0.11543134872418,0.159173754556501,0.153908464965573
"E02006439",416,531,264,161,370,255,2227,0.186798383475528,0.238437359676695,0.118545127974854,0.0722945666816345,0.166142792995061,0.114503816793893
"E02006440",560,806,291,237,569,323,2382,0.235096557514694,0.338371116708648,0.122166246851385,0.0994962216624685,0.23887489504618,0.135600335852225
"E02006441",499,726,713,176,550,323,3730,0.133780160857909,0.194638069705094,0.191152815013405,0.0471849865951743,0.14745308310992,0.0865951742627346
"E02006442",430,586,256,182,404,248,1975,0.217721518987342,0.296708860759494,0.129620253164557,0.0921518987341772,0.204556962025316,0.125569620253165
"E02006443",532,636,328,171,465,361,2667,0.199475065616798,0.238470191226097,0.122984626921635,0.0641169853768279,0.174353205849269,0.13535808023997
"E02006444",445,662,185,192,470,253,2267,0.196294662549625,0.292015880017644,0.0816056462284958,0.0846934274371416,0.207322452580503,0.111601235112483
"E02006445",500,725,625,171,554,329,3677,0.13598041881969,0.19717160728855,0.169975523524612,0.046505303236334,0.150666304052216,0.089475115583356
"E02006446",476,630,461,184,446,292,2143,0.222118525431638,0.29398040130658,0.215118992067196,0.0858609426038264,0.208119458702753,0.136257582827811
"E02006447",432,537,256,173,364,259,2191,0.197170241898676,0.245093564582382,0.116841624828845,0.0789593792788681,0.166134185303514,0.118210862619808
"E02006448",452,576,307,198,378,254,2500,0.1808,0.2304,0.1228,0.0792,0.1512,0.1016
"E02006449",430,612,274,184,428,246,2213,0.194306371441482,0.276547672842296,0.123813827383642,0.0831450519656575,0.193402620876638,0.111161319475825
"E02006450",469,489,522,189,300,280,2087,0.224724484906564,0.234307618591279,0.250119789171059,0.0905606133205558,0.143747005270724,0.134163871586009
"E02006451",738,985,428,308,677,430,4489,0.164401871240811,0.219425261750947,0.0953441746491424,0.0686121630652707,0.150813098685676,0.0957897081755402
"E02006453",588,603,567,223,380,365,2949,0.199389623601221,0.204476093591048,0.192268565615463,0.0756188538487623,0.128857239742286,0.123770769752458
"E02006454",452,684,334,212,472,240,2417,0.187008688456765,0.2829954489036,0.13818783616053,0.0877120397186595,0.19528340918494,0.0992966487381051
"E02006455",427,634,265,185,449,242,2361,0.180855569673867,0.26853028377806,0.112240576027107,0.0783566285472257,0.190173655230834,0.102498941126641
"E02006456",565,890,433,249,641,316,2856,0.197829131652661,0.311624649859944,0.151610644257703,0.0871848739495798,0.224439775910364,0.110644257703081
"E02006457",632,841,549,239,602,393,3265,0.193568147013783,0.257580398162328,0.168147013782542,0.0732006125574273,0.1843797856049,0.120367534456355
"E02006458",488,743,350,189,554,299,2879,0.16950329975686,0.258075720736367,0.121569989579715,0.0656477943730462,0.192427926363321,0.103855505383814
"E02006459",570,679,811,189,490,381,4057,0.140497904855805,0.167365048065073,0.199901404979049,0.0465861473995563,0.120778900665516,0.0939117574562485
"E02006460",1004,1057,24,310,747,694,3724,0.269602577873255,0.283834586466165,0.00644468313641246,0.0832438238453276,0.200590762620838,0.186358754027927
"E02006461",499,429,449,134,295,365,2433,0.205096588573777,0.17632552404439,0.184545828195643,0.0550760378133991,0.121249486230991,0.150020550760378
"E02006462",607,713,290,225,488,382,2953,0.205553674229597,0.241449373518456,0.0982052150355571,0.0761937013206908,0.165255672197765,0.129359972908906
"E02006463",587,1176,709,242,934,345,6768,0.0867316784869976,0.173758865248227,0.10475768321513,0.0357565011820331,0.138002364066194,0.0509751773049645
"E02006464",540,686,250,199,487,341,2396,0.225375626043406,0.286310517529215,0.104340567612688,0.0830550918196995,0.203255425709516,0.142320534223706
"E02006465",461,552,267,166,386,295,2177,0.211759301791456,0.253559944878273,0.122645842903078,0.0762517225539734,0.177308222324299,0.135507579237483
"E02006466",555,717,595,176,541,379,3954,0.140364188163885,0.18133535660091,0.15048052604957,0.0445118866970157,0.136823469903895,0.095852301466869
"E02006467",397,457,336,152,305,245,2267,0.17512130569034,0.201588001764446,0.148213498014998,0.0670489633877371,0.134539038376709,0.108072342302603
"E02006468",715,506,621,176,330,539,3641,0.196374622356495,0.138972809667674,0.1705575391376,0.0483383685800604,0.0906344410876133,0.148036253776435
"E02006469",643,585,749,158,427,485,3079,0.208834037025008,0.18999675219227,0.243260798960702,0.0513153621305619,0.138681390061708,0.157518674894446
"E02006470",836,493,1030,150,343,686,4846,0.172513413124226,0.101733388361535,0.212546430045398,0.0309533635988444,0.0707800247626909,0.141560049525382
"E02006471",491,419,434,150,269,341,2089,0.235040689325036,0.200574437529919,0.207754906653901,0.0718046912398277,0.128769746290091,0.163235998085208
"E02006472",597,435,1030,126,309,471,3623,0.164780568589567,0.120066243444659,0.284294783328733,0.0347778084460392,0.0852884349986199,0.130002760143527
"E02006473",780,852,629,280,572,500,3632,0.214757709251101,0.234581497797357,0.17318281938326,0.0770925110132159,0.157488986784141,0.137665198237885
"E02006474",453,254,915,75,179,378,2160,0.209722222222222,0.117592592592593,0.423611111111111,0.0347222222222222,0.0828703703703704,0.175
"E02006475",381,358,656,92,266,289,3863,0.098628009319182,0.0926740874967642,0.169816205022004,0.0238156872896712,0.0688584002070929,0.0748123220295107
"E02006476",409,335,459,118,217,291,3657,0.111840306261963,0.0916051408258135,0.125512715340443,0.0322668854252119,0.0593382554006016,0.0795734208367514
"E02006477",439,215,410,64,151,375,3183,0.137920201068175,0.0675463399308828,0.128809299403079,0.0201068174677977,0.0474395224630851,0.117813383600377
"E02006478",479,304,267,95,209,384,2947,0.162538174414659,0.103155751611809,0.0906006107906345,0.0322361723786902,0.0709195792331184,0.130302002035969
"E02006479",590,192,2120,54,138,536,4208,0.140209125475285,0.0456273764258555,0.503802281368821,0.0128326996197719,0.0327946768060837,0.127376425855513
"E02006480",442,299,768,98,201,344,2541,0.173947264856356,0.117670208579299,0.30224321133412,0.0385674931129477,0.0791027154663518,0.135379771743408
"E02006481",390,245,945,92,153,298,2483,0.157068062827225,0.0986709625453081,0.380587998389046,0.0370519532823198,0.0616190092629883,0.120016109544905
"E02006482",349,311,498,111,200,238,2428,0.143739703459638,0.128088962108731,0.205107084019769,0.0457166392092257,0.0823723228995058,0.0980230642504119
"E02006483",370,203,832,50,153,320,2641,0.140098447557743,0.0768648239303294,0.315032184778493,0.0189322226429383,0.0579326012873911,0.121166224914805
"E02006484",406,232,855,47,185,359,2875,0.141217391304348,0.080695652173913,0.297391304347826,0.0163478260869565,0.0643478260869565,0.124869565217391
"E02006485",435,274,129,98,176,337,1748,0.248855835240275,0.15675057208238,0.0737986270022883,0.0560640732265446,0.100686498855835,0.19279176201373
"E02006486",414,304,477,107,197,307,2271,0.182298546895641,0.133861734918538,0.21003963011889,0.0471158080140907,0.0867459269044474,0.13518273888155
"E02006487",444,301,679,97,204,347,2503,0.177387135437475,0.120255693168198,0.271274470635238,0.038753495805034,0.0815021973631642,0.138633639632441
"E02006488",392,292,337,114,178,278,2023,0.193771626297578,0.144340088976767,0.166584280771132,0.0563519525457242,0.087988136431043,0.137419673751854
"E02006489",459,353,678,116,237,343,3129,0.146692233940556,0.112815596037073,0.216682646212848,0.0370725471396612,0.0757430488974113,0.109619686800895
"E02006490",410,323,381,121,202,289,2497,0.164197036443732,0.129355226271526,0.152583099719664,0.0484581497797357,0.0808970764917901,0.115738886663997
"E02006493",486,458,68,113,345,373,3715,0.130820995962315,0.12328398384926,0.0183041722745626,0.0304172274562584,0.0928667563930013,0.100403768506057
"E02006494",425,243,1120,48,195,377,3674,0.115677735438214,0.0661404463799673,0.304844855743059,0.0130647795318454,0.0530756668481219,0.102612955906369
"E02006495",467,373,385,132,241,335,2390,0.195397489539749,0.156066945606695,0.161087866108787,0.0552301255230126,0.100836820083682,0.140167364016736
"E02006496",493,150,2022,23,127,470,2932,0.168144611186903,0.0511596180081855,0.689631650750341,0.00784447476125512,0.0433151432469304,0.160300136425648
"E02006497",398,263,1260,64,199,334,3344,0.119019138755981,0.0786483253588517,0.376794258373206,0.0191387559808612,0.0595095693779904,0.0998803827751196
"E02006498",588,436,243,134,302,454,4530,0.129801324503311,0.0962472406181015,0.0536423841059603,0.0295805739514349,0.0666666666666667,0.100220750551876
"E02006499",312,175,850,54,121,258,1840,0.169565217391304,0.0951086956521739,0.46195652173913,0.0293478260869565,0.0657608695652174,0.140217391304348
"E02006500",363,246,469,74,172,289,2797,0.129781909188416,0.0879513764747944,0.167679656775116,0.0264569181265642,0.0614944583482302,0.103324991061852
"E02006501",568,448,772,146,302,422,3153,0.180145892800507,0.142086901363781,0.244846178242943,0.0463051062480178,0.0957817951157628,0.13384078655249
"E02006502",739,709,373,222,487,517,3313,0.223060670087534,0.214005433142167,0.11258677935406,0.0670087533957139,0.146996679746453,0.15605191669182
"E02006503",463,351,520,123,228,340,3341,0.138581263094882,0.105058365758755,0.155642023346304,0.0368153247530679,0.0682430410056869,0.101765938341814
"E02006504",372,320,452,119,201,253,1751,0.212450028555111,0.18275271273558,0.258138206739006,0.0679611650485437,0.114791547687036,0.144488863506568
"E02006505",473,379,526,119,260,354,2622,0.180396643783371,0.144546147978642,0.200610221205187,0.0453852021357742,0.099160945842868,0.135011441647597
"E02006506",352,382,318,119,263,233,2178,0.161616161616162,0.175390266299357,0.146005509641873,0.0546372819100092,0.120752984389348,0.106978879706152
"E02006507",546,395,402,113,282,433,4304,0.12685873605948,0.091775092936803,0.0934014869888476,0.0262546468401487,0.0655204460966543,0.100604089219331
"E02006508",603,458,753,146,312,457,4603,0.131001520747339,0.0995003258744297,0.163588963719314,0.0317184444927221,0.0677818813817076,0.0992830762546165
"E02006509",465,359,391,133,226,332,2787,0.166846071044133,0.12881234302117,0.140294223179046,0.0477215644061715,0.0810907786149982,0.119124506637962
"E02006510",406,276,430,98,178,308,2928,0.138661202185792,0.0942622950819672,0.146857923497268,0.0334699453551913,0.060792349726776,0.105191256830601
"E02006511",533,412,539,127,285,406,3988,0.133650952858576,0.103309929789368,0.135155466399198,0.0318455366098295,0.0714643931795386,0.101805416248746
"E02006512",556,591,775,145,446,411,5727,0.0970839881264187,0.103195390256679,0.135323904312904,0.0253186659682207,0.0778767242884582,0.071765322158198
"E02006513",326,344,483,96,248,230,3601,0.0905304082199389,0.0955290197167454,0.13412940849764,0.026659261316301,0.0688697584004443,0.0638711469036379
"E02006514",602,532,1141,138,394,464,4296,0.140130353817505,0.123836126629423,0.265595903165736,0.032122905027933,0.0917132216014898,0.108007448789572
"E02006515",607,359,588,138,221,469,4250,0.142823529411765,0.0844705882352941,0.138352941176471,0.0324705882352941,0.052,0.110352941176471
"E02006516",810,392,833,151,241,659,4212,0.192307692307692,0.0930674264007597,0.197768281101614,0.0358499525166192,0.0572174738841406,0.156457739791073
"E02006517",495,328,604,121,207,374,4360,0.113532110091743,0.0752293577981651,0.138532110091743,0.0277522935779817,0.0474770642201835,0.0857798165137615
"E02006518",622,335,790,137,198,485,4365,0.142497136311569,0.0767468499427262,0.18098510882016,0.0313860252004582,0.045360824742268,0.111111111111111
"E02006519",588,458,1064,131,327,457,3310,0.177643504531722,0.138368580060423,0.321450151057402,0.0395770392749245,0.0987915407854985,0.138066465256798
"E02006520",570,370,339,125,245,445,3134,0.181876196553925,0.118059987236758,0.108168474792597,0.0398851308232291,0.078174856413529,0.141991065730696
"E02006521",545,381,460,137,244,408,2466,0.221005677210057,0.154501216545012,0.186536901865369,0.0555555555555556,0.0989456609894566,0.165450121654501
"E02006522",464,292,610,127,165,337,2091,0.221903395504543,0.139646102343376,0.291726446676231,0.0607364897178384,0.078909612625538,0.161166905786705
"E02006523",750,516,610,193,323,557,3472,0.216013824884793,0.148617511520737,0.175691244239631,0.0555875576036866,0.0930299539170507,0.160426267281106
"E02006524",392,253,172,86,167,306,2082,0.188280499519693,0.121517771373679,0.0826128722382325,0.0413064361191162,0.0802113352545629,0.146974063400576
"E02006525",823,797,2108,165,632,658,6251,0.131658934570469,0.12749960006399,0.337226043832987,0.0263957766757319,0.101103823388258,0.105263157894737
"E02006526",575,700,453,196,504,379,3562,0.1614261650758,0.196518809657496,0.127175743964065,0.0550252667040988,0.141493542953397,0.106400898371701
"E02006527",573,563,1548,130,433,443,4059,0.141167775314117,0.13870411431387,0.381374722838137,0.0320275930032028,0.106676521310668,0.109140182310914
"E02006528",707,764,1767,166,598,541,4944,0.143001618122977,0.15453074433657,0.357402912621359,0.0335760517799353,0.120954692556634,0.109425566343042
"E02006529",650,393,885,88,305,562,5540,0.117328519855596,0.0709386281588448,0.159747292418773,0.015884476534296,0.0550541516245487,0.1014440433213
"E02006530",647,472,601,129,343,518,6504,0.0994772447724477,0.0725707257072571,0.0924046740467405,0.0198339483394834,0.0527367773677737,0.0796432964329643
"E02006531",695,444,1562,97,347,598,4549,0.152780830951858,0.0976038689821939,0.343372169707628,0.021323367773137,0.0762805012090569,0.131457463178721
"E02006532",506,401,388,124,277,382,4642,0.109004739336493,0.0863851788022404,0.0835846617837139,0.026712623869022,0.0596725549332184,0.0822921154674709
"E02006533",500,466,171,159,307,341,3404,0.146886016451234,0.13689776733255,0.050235017626322,0.0467097532314924,0.0901880141010576,0.100176263219741
"E02006534",796,976,171,375,601,421,2605,0.305566218809981,0.374664107485605,0.0656429942418426,0.143953934740883,0.230710172744722,0.161612284069098
"E02006535",606,897,90,343,554,263,2175,0.278620689655172,0.412413793103448,0.0413793103448276,0.157701149425287,0.254712643678161,0.120919540229885
"E02006536",617,702,64,286,416,331,1984,0.310987903225806,0.35383064516129,0.032258064516129,0.144153225806452,0.209677419354839,0.166834677419355
"E02006537",803,1460,341,397,1063,406,3814,0.210540115364447,0.38280020975354,0.0894074462506555,0.104090194022024,0.278710015731515,0.106449921342423
"E02006538",730,1062,505,320,742,410,4163,0.175354311794379,0.255104491952919,0.121306749939947,0.0768676435263032,0.178236848426615,0.0984866682680759
"E02006539",784,885,169,388,497,396,2433,0.322235922729141,0.363748458692972,0.0694615700780929,0.15947390053432,0.204274558158652,0.162762022194821
"E02006540",540,676,123,248,428,292,2328,0.231958762886598,0.290378006872852,0.0528350515463918,0.106529209621993,0.183848797250859,0.125429553264605
"E02006541",727,1141,265,336,805,391,3198,0.227329580988118,0.356785490931832,0.0828642901813633,0.105065666041276,0.251719824890557,0.122263914946842
"E02006542",522,441,597,170,271,352,2453,0.212800652262536,0.179779861394211,0.243375458622095,0.069302894415002,0.110476966979209,0.143497757847534
"E02006543",589,489,212,234,255,355,2200,0.267727272727273,0.222272727272727,0.0963636363636364,0.106363636363636,0.115909090909091,0.161363636363636
"E02006544",810,908,322,354,554,456,4877,0.166085708427312,0.186180028706172,0.0660241952019684,0.0725856059052696,0.113594422800902,0.0935001025220422
"E02006545",548,622,220,185,437,363,4554,0.120333772507686,0.136583223539745,0.0483091787439614,0.0406236275801493,0.095959595959596,0.0797101449275362
"E02006546",787,716,133,284,432,503,4353,0.180794854123593,0.164484263726166,0.0305536411670113,0.0652423615897083,0.0992419021364576,0.115552492533885
"E02006547",415,391,209,161,230,254,3134,0.132418634333121,0.124760689215061,0.0666879387364391,0.0513720485003191,0.0733886407147415,0.0810465858328015
"E02006548",787,689,159,254,435,533,3447,0.228314476356252,0.199883957064114,0.0461270670147955,0.0736872642877865,0.126196692776327,0.154627212068465
"E02006549",690,790,122,325,465,365,2423,0.284770945109369,0.326042096574494,0.0503508047874536,0.134131242261659,0.191910854312835,0.150639702847709
"E02006550",803,947,316,342,605,461,3456,0.232349537037037,0.274016203703704,0.0914351851851852,0.0989583333333333,0.17505787037037,0.133391203703704
"E02006551",773,1273,274,337,936,436,3882,0.199124162802679,0.327923750643998,0.0705821741370428,0.0868109222050489,0.241112828438949,0.11231324059763
"E02006552",601,752,1685,165,587,436,3922,0.153238143804182,0.191738908720041,0.429627740948496,0.0420703722590515,0.149668536460989,0.11116777154513
"E02006553",634,869,139,305,564,329,3574,0.177392277560157,0.243144935646335,0.0388919977616116,0.0853385562395075,0.157806379406827,0.0920537213206491
"E02006554",720,771,102,310,461,410,2649,0.271800679501699,0.291053227633069,0.0385050962627407,0.117025292563231,0.174027935069838,0.154775386938467
"E02006555",625,955,254,259,696,366,2987,0.209240040174088,0.319718781386006,0.0850351523267492,0.086709072648142,0.233009708737864,0.122530967525946
"E02006556",825,1026,179,410,616,415,3893,0.211918828666838,0.263549961469304,0.045979964038017,0.105317236064732,0.158232725404572,0.106601592602106
"E02006557",511,820,133,231,589,280,2900,0.176206896551724,0.282758620689655,0.0458620689655172,0.0796551724137931,0.203103448275862,0.096551724137931
"E02006558",841,1875,1118,364,1511,477,5962,0.141060046964106,0.314491781281449,0.187520966118752,0.0610533378061053,0.253438443475344,0.0800067091580007
"E02006559",801,1030,95,349,681,452,3138,0.255258126195029,0.32823454429573,0.0302740599107712,0.111217335882728,0.217017208413002,0.144040790312301
"E02006560",908,969,131,364,605,544,3645,0.249108367626886,0.265843621399177,0.0359396433470508,0.0998628257887517,0.165980795610425,0.149245541838134
"E02006561",512,631,431,225,406,287,2191,0.233683249657691,0.287996348699224,0.196713829301689,0.102692834322227,0.185303514376997,0.130990415335463
"E02006562",533,513,342,223,290,310,2118,0.251652502360718,0.242209631728045,0.161473087818697,0.105288007554297,0.136921624173749,0.146364494806421
"E02006563",502,525,559,162,363,340,1991,0.252134605725766,0.26368658965344,0.280763435459568,0.0813661476644902,0.18232044198895,0.170768458061276
"E02006564",663,848,495,251,597,412,3399,0.195057369814651,0.249485142689026,0.145631067961165,0.0738452486025302,0.175639894086496,0.121212121212121
"E02006565",785,722,1011,272,450,513,3076,0.25520156046814,0.234720416124837,0.328673602080624,0.0884265279583875,0.14629388816645,0.166775032509753
"E02006566",544,528,547,179,349,365,3238,0.168004941321804,0.163063619518221,0.168931439159975,0.0552810376775788,0.107782581840642,0.112723903644225
"E02006567",528,633,459,211,422,317,2648,0.199395770392749,0.23904833836858,0.17333836858006,0.0796827794561934,0.159365558912387,0.119712990936556
"E02006568",667,1163,494,256,907,411,5984,0.111463903743316,0.194351604278075,0.0825534759358289,0.0427807486631016,0.151570855614973,0.0686831550802139
"E02006569",503,594,267,202,392,301,3083,0.163152773272786,0.192669477781382,0.0866039571845605,0.065520596821278,0.127148880960104,0.0976321764515083
"E02006570",606,1119,704,235,884,371,4680,0.129487179487179,0.239102564102564,0.15042735042735,0.0502136752136752,0.188888888888889,0.0792735042735043
"E02006571",604,657,179,223,434,381,3827,0.157825973347269,0.171674941207212,0.046772929187353,0.0582701855239091,0.113404755683303,0.0995557878233603
"E02006572",629,806,321,229,577,400,4454,0.141221374045802,0.180960933991917,0.0720700493938033,0.0514144589133363,0.129546475078581,0.0898069151324652
"E02006573",972,1253,291,444,809,528,5070,0.191715976331361,0.247140039447732,0.057396449704142,0.0875739644970414,0.15956607495069,0.10414201183432
"E02006574",917,1154,215,382,772,535,4397,0.208551284967023,0.262451671594269,0.0488969752103707,0.0868774164202866,0.175574255173982,0.121673868546736
"E02006575",476,616,78,224,392,252,2195,0.216856492027335,0.280637813211845,0.0355353075170843,0.102050113895216,0.178587699316629,0.114806378132118
"E02006576",580,733,150,224,509,356,3870,0.149870801033592,0.189405684754522,0.0387596899224806,0.0578811369509044,0.131524547803618,0.0919896640826873
"E02006577",466,628,131,204,424,262,2749,0.16951618770462,0.22844670789378,0.0476536922517279,0.0742088032011641,0.154237904692616,0.0953073845034558
"E02006578",595,871,150,283,588,312,4546,0.130884293884734,0.191597008358997,0.032996040475143,0.0622525296964364,0.12934447866256,0.0686317641882974
"E02006579",569,705,131,264,441,305,2619,0.217258495609011,0.269186712485682,0.0500190912562047,0.100801832760596,0.168384879725086,0.116456662848415
"E02006580",639,744,54,251,493,388,2339,0.27319367250962,0.318084651560496,0.023086789226165,0.107310816588286,0.21077383497221,0.165882855921334
"E02006581",649,1127,280,303,824,346,4043,0.16052436309671,0.278753400939896,0.0692555033391046,0.0749443482562454,0.203809052683651,0.085580014840465
"E02006582",427,267,13,79,188,348,2362,0.18077900084674,0.113039796782388,0.00550381033022862,0.0334462320067739,0.0795935647756139,0.147332768839966
"E02006583",680,583,75,187,396,493,2973,0.228725193407333,0.196098217288934,0.0252270433905146,0.0628994281870165,0.133198789101917,0.165825765220316
"E02006584",540,468,39,147,321,393,2010,0.26865671641791,0.232835820895522,0.0194029850746269,0.073134328358209,0.159701492537313,0.195522388059701
"E02006585",549,798,43,308,490,241,2115,0.259574468085106,0.377304964539007,0.0203309692671395,0.145626477541371,0.231678486997636,0.113947990543735
"E02006586",507,624,70,205,419,302,1826,0.277656078860898,0.341730558598028,0.0383351588170865,0.112267250821468,0.229463307776561,0.16538882803943
"E02006587",580,734,52,177,557,403,2993,0.193785499498831,0.245238890745072,0.0173738723688607,0.0591379886401604,0.186100902104911,0.13464751085867
"E02006588",542,631,245,210,421,332,4541,0.119356969830434,0.138956177053512,0.05395287381634,0.0462453204140057,0.0927108566395067,0.0731116494164281
"E02006589",736,773,107,274,499,462,3498,0.210405946255003,0.220983419096627,0.0305889079473985,0.0783304745568897,0.142652944539737,0.132075471698113
"E02006590",586,766,261,217,549,369,3102,0.188910380399742,0.246937459703417,0.0841392649903288,0.0699548678272083,0.176982591876209,0.118955512572534
"E02006591",520,819,187,227,592,293,2848,0.182584269662921,0.287570224719101,0.0656601123595506,0.0797050561797753,0.207865168539326,0.102879213483146
"E02006592",423,537,212,202,335,221,1944,0.217592592592593,0.276234567901235,0.109053497942387,0.103909465020576,0.172325102880658,0.113683127572016
"E02006593",639,1042,491,276,766,363,4953,0.129012719563901,0.210377548960226,0.0991318392893196,0.0557238037552998,0.154653745204926,0.0732889158086008
"E02006594",512,561,49,191,370,321,4215,0.1214709371293,0.133096085409253,0.0116251482799526,0.0453143534994069,0.0877817319098458,0.0761565836298932
"E02006595",469,526,275,187,339,282,2378,0.197224558452481,0.221194280908326,0.115643397813288,0.0786375105130362,0.14255677039529,0.118587047939445
"E02006596",580,487,69,155,332,425,3001,0.193268910363212,0.162279240253249,0.0229923358880373,0.0516494501832722,0.110629790069977,0.14161946017994
"E02006597",514,537,286,166,371,348,4481,0.114706538719036,0.119839321580004,0.0638250390537826,0.0370453023878599,0.0827940191921446,0.0776612363311761
"E02006598",472,408,226,181,227,291,1652,0.285714285714286,0.246973365617433,0.13680387409201,0.10956416464891,0.137409200968523,0.176150121065375
"E02006599",560,586,227,226,360,334,2254,0.248447204968944,0.259982253771074,0.100709849157054,0.100266193433895,0.159716060337178,0.148181011535049
"E02006600",817,984,403,321,663,496,4207,0.194200142619444,0.233895887806038,0.095792726408367,0.0763014024245305,0.157594485381507,0.117898740194913
"E02006601",703,619,351,249,370,454,3042,0.231097961867193,0.203484549638396,0.115384615384615,0.0818540433925049,0.121630506245891,0.149243918474688
"E02006602",519,539,286,184,355,335,2788,0.186154949784792,0.193328550932568,0.102582496413199,0.0659971305595409,0.127331420373027,0.120157819225251
"E02006603",723,780,344,306,474,417,2720,0.265808823529412,0.286764705882353,0.126470588235294,0.1125,0.174264705882353,0.153308823529412
"E02006604",878,1284,460,366,918,512,5590,0.157066189624329,0.229695885509839,0.0822898032200358,0.065474060822898,0.164221824686941,0.0915921288014311
"E02006605",474,590,214,218,372,256,2368,0.200168918918919,0.249155405405405,0.0903716216216216,0.0920608108108108,0.157094594594595,0.108108108108108
"E02006606",698,835,157,333,502,365,2573,0.271278663039254,0.324523902059852,0.0610182666148465,0.129420909444229,0.195102992615624,0.141857753595025
"E02006607",577,646,159,267,379,310,2766,0.208604483007954,0.23355025307303,0.0574837310195228,0.096529284164859,0.137020968908171,0.112075198843095
"E02006608",416,444,158,183,261,233,1903,0.218602207041513,0.233315817130846,0.0830267997898056,0.0961639516552811,0.137151865475565,0.122438255386232
"E02006609",583,599,450,235,364,348,2237,0.260616897630755,0.26776933392937,0.201162270898525,0.105051408135896,0.162717925793473,0.155565489494859
"E02006610",623,607,498,250,357,373,3213,0.193899782135076,0.188920012449424,0.15499533146592,0.0778089013383131,0.111111111111111,0.116090880796763
"E02006611",776,1095,388,367,728,409,3794,0.204533473906168,0.288613600421719,0.102266736953084,0.0967316816025303,0.191881918819188,0.107801792303637
"E02006612",598,1252,437,277,975,321,5978,0.100033456005353,0.209434593509535,0.0731013716962195,0.0463365674138508,0.163098026095684,0.0536968885915022
"E02006613",484,924,131,231,693,253,2828,0.171145685997171,0.326732673267327,0.0463224893917963,0.0816831683168317,0.245049504950495,0.0894625176803395
"E02006614",754,855,508,277,578,477,4975,0.151557788944724,0.171859296482412,0.102110552763819,0.055678391959799,0.116180904522613,0.0958793969849246
"E02006615",415,363,77,127,236,288,2251,0.184362505553088,0.161261661483785,0.0342070191026211,0.0564193691692581,0.104842292314527,0.127943136383829
"E02006616",563,736,158,260,476,303,3513,0.160261884429263,0.209507543410191,0.044975804155992,0.0740108169655565,0.135496726444634,0.0862510674637062
"E02006617",679,1057,398,282,775,397,3839,0.17686897629591,0.275332117738995,0.103672831466528,0.0734566293305548,0.20187548840844,0.103412346965356
"E02006618",361,329,78,105,224,256,1850,0.195135135135135,0.177837837837838,0.0421621621621622,0.0567567567567568,0.121081081081081,0.138378378378378
"E02006619",536,626,495,201,425,335,2993,0.179084530571333,0.209154694286669,0.165385900434347,0.0671566989642499,0.141997995322419,0.111927831607083
"E02006620",748,828,348,294,534,454,3911,0.191255433392994,0.21171055995909,0.088979800562516,0.0751725901304014,0.136537969828688,0.116082843262593
"E02006621",854,767,66,389,378,465,2395,0.356576200417537,0.320250521920668,0.0275574112734864,0.162421711899791,0.157828810020877,0.194154488517745
"E02006622",731,955,240,338,617,393,2671,0.273680269561962,0.357543991014601,0.0898539872706851,0.126544365406215,0.230999625608386,0.147135904155747
"E02006623",795,853,242,347,506,448,3067,0.259210955330942,0.278121943267036,0.0789044669057711,0.113139876100424,0.164982067166612,0.146071079230518
"E02006624",608,887,115,311,576,297,2135,0.284777517564403,0.415456674473068,0.053864168618267,0.145667447306792,0.269789227166276,0.139110070257611
"E02006625",638,1088,370,350,738,288,2602,0.245196003074558,0.418139892390469,0.142198308993082,0.134511913912375,0.283627978478094,0.110684089162183
"E02006626",654,606,140,245,361,409,3798,0.17219589257504,0.15955766192733,0.0368615060558189,0.064507635597683,0.0950500263296472,0.107688256977356
"E02006627",810,1010,203,348,662,462,3525,0.229787234042553,0.286524822695035,0.0575886524822695,0.0987234042553192,0.187801418439716,0.131063829787234
"E02006628",752,1062,1300,267,795,485,3669,0.20496047969474,0.289452166802944,0.354319978195694,0.0727718724448078,0.216680294358136,0.132188607249932
"E02006629",672,888,586,268,620,404,2847,0.236037934668072,0.31190727081138,0.205830698981384,0.0941341763259572,0.217773094485423,0.141903758342114
"E02006630",671,1570,1577,239,1331,432,5233,0.128224727689662,0.30001910949742,0.301356774316835,0.0456716988343207,0.2543474106631,0.0825530288553411
"E02006631",876,685,3083,102,583,774,6457,0.135666718290228,0.106086417841103,0.477466315626452,0.0157968096639306,0.0902896081771721,0.119869908626297
"E02006632",679,1636,550,373,1263,306,3710,0.183018867924528,0.440970350404313,0.148247978436658,0.100539083557951,0.340431266846361,0.0824797843665768
"E02006633",830,1115,142,392,723,438,3164,0.262326169405815,0.352402022756005,0.0448798988621998,0.123893805309735,0.228508217446271,0.138432364096081
"E02006634",544,466,678,161,305,383,2637,0.206295032233599,0.17671596511187,0.257110352673493,0.0610542282897232,0.115661736822146,0.145240803943876
"E02006635",481,506,492,116,390,365,3293,0.146067415730337,0.153659277254783,0.149407834801093,0.0352262374734285,0.118433039781354,0.110841178256909
"E02006636",548,494,550,170,324,378,2640,0.207575757575758,0.187121212121212,0.208333333333333,0.0643939393939394,0.122727272727273,0.143181818181818
"E02006637",471,374,261,100,274,371,4324,0.108926919518964,0.0864939870490287,0.0603607770582794,0.0231267345050879,0.0633672525439408,0.085800185013876
"E02006638",422,436,572,105,331,317,2875,0.146782608695652,0.151652173913043,0.19895652173913,0.0365217391304348,0.115130434782609,0.110260869565217
"E02006639",616,518,613,144,374,472,2596,0.23728813559322,0.199537750385208,0.23613251155624,0.0554699537750385,0.144067796610169,0.181818181818182
"E02006640",602,491,570,172,319,430,2457,0.245014245014245,0.1998371998372,0.231990231990232,0.07000407000407,0.12983312983313,0.175010175010175
"E02006641",542,385,434,130,255,412,2884,0.187933425797503,0.133495145631068,0.150485436893204,0.0450762829403606,0.0884188626907074,0.142857142857143
"E02006642",459,467,410,156,311,303,1920,0.2390625,0.243229166666667,0.213541666666667,0.08125,0.161979166666667,0.1578125
"E02006644",460,391,402,124,267,336,2340,0.196581196581197,0.167094017094017,0.171794871794872,0.052991452991453,0.114102564102564,0.143589743589744
"E02006645",552,296,601,91,205,461,3253,0.169689517368583,0.090992929603443,0.184752536120504,0.0279741776821396,0.0630187519213034,0.141715339686443
"E02006646",360,313,316,114,199,246,2811,0.128068303094984,0.111348274635361,0.112415510494486,0.0405549626467449,0.0707933119886161,0.0875133404482391
"E02006647",397,281,434,101,180,296,1869,0.212413055109684,0.150347779561263,0.232209737827715,0.0540395933654361,0.0963081861958267,0.158373461744248
"E02006648",432,243,490,109,134,323,2339,0.18469431380932,0.103890551517743,0.209491235570757,0.0466011115861479,0.0572894399315947,0.138093202223172
"E02006649",399,437,228,85,352,314,3145,0.126868044515103,0.138950715421304,0.0724960254372019,0.027027027027027,0.111923688394277,0.0998410174880763
"E02006650",596,598,292,189,409,407,4529,0.131596378891588,0.132037977478472,0.0644733936851402,0.0417310664605873,0.0903069110178847,0.0898653124310002
"E02006651",460,283,658,99,184,361,2342,0.196413321947054,0.120836891545687,0.280956447480786,0.0422715627668659,0.0785653287788215,0.154141759180188
"E02006652",556,661,473,149,512,407,3639,0.152789227809838,0.181643308601264,0.129980763946139,0.040945314646881,0.140697993954383,0.111843913162957
"E02006653",589,522,120,156,366,433,3495,0.168526466380544,0.149356223175966,0.0343347639484979,0.0446351931330472,0.104721030042918,0.123891273247496
"E02006654",603,675,556,168,507,435,4845,0.124458204334365,0.139318885448916,0.114757481940144,0.0346749226006192,0.104643962848297,0.0897832817337461
"E02006655",471,331,588,118,213,353,2998,0.157104736490994,0.110406937958639,0.196130753835891,0.0393595730486991,0.07104736490994,0.117745163442295
"E02006656",521,245,59,82,163,439,2309,0.22563880467735,0.106106539627544,0.0255521870939801,0.0355132091814638,0.0705933304460806,0.190125595495886
"E02006657",570,426,256,148,278,422,4716,0.120865139949109,0.0903307888040712,0.0542832909245123,0.0313825275657337,0.0589482612383376,0.0894826123833757
"E02006658",538,441,448,120,321,418,3372,0.159549228944247,0.130782918149466,0.132858837485172,0.0355871886120996,0.0951957295373665,0.123962040332147
"E02006659",470,354,526,112,242,358,3077,0.152746181345466,0.115047123821904,0.170945726356841,0.0363990900227494,0.078648033799155,0.116347091322717
"E02006660",925,560,854,187,373,738,5740,0.161149825783972,0.0975609756097561,0.148780487804878,0.0325783972125436,0.0649825783972125,0.128571428571429
"E02006661",445,306,244,88,218,357,3471,0.128205128205128,0.0881590319792567,0.0702967444540478,0.0253529242293287,0.062806107749928,0.102852203975799
"E02006662",442,418,73,134,284,308,2564,0.172386895475819,0.163026521060842,0.0284711388455538,0.0522620904836193,0.110764430577223,0.1201248049922
"E02006663",474,499,94,147,352,327,4980,0.0951807228915663,0.100200803212851,0.0188755020080321,0.0295180722891566,0.0706827309236948,0.0656626506024096
"E02006664",516,419,244,169,250,347,2048,0.251953125,0.20458984375,0.119140625,0.08251953125,0.1220703125,0.16943359375
"E02006665",540,363,777,117,246,423,2661,0.20293122886133,0.13641488162345,0.291995490417136,0.0439684329199549,0.0924464487034949,0.158962795941375
"E02006666",340,331,45,121,210,219,2225,0.152808988764045,0.14876404494382,0.0202247191011236,0.0543820224719101,0.0943820224719101,0.0984269662921348
"E02006667",297,326,83,74,252,223,3101,0.0957755562721703,0.105127378265076,0.0267655594969365,0.0238632699129313,0.0812641083521445,0.0719122863592389
"E02006668",346,540,106,153,387,193,1837,0.188350571584105,0.293957539466521,0.0577027762656505,0.0832879695155144,0.210669569951007,0.10506260206859
"E02006669",817,699,950,257,442,560,3911,0.208897980056252,0.178726668371261,0.242904627972386,0.0657120940935822,0.113014574277678,0.143185885962669
"E02006670",524,876,609,230,646,294,3160,0.165822784810127,0.277215189873418,0.192721518987342,0.0727848101265823,0.204430379746835,0.0930379746835443
"E02006671",541,851,814,222,629,319,3063,0.176624224616389,0.277832190662749,0.265752530199151,0.0724779627815867,0.205354227881162,0.104146261834802
"E02006672",388,323,186,119,204,269,3730,0.10402144772118,0.0865951742627346,0.0498659517426273,0.0319034852546917,0.0546916890080429,0.0721179624664879
"E02006673",407,431,462,133,298,274,2220,0.183333333333333,0.194144144144144,0.208108108108108,0.0599099099099099,0.134234234234234,0.123423423423423
"E02006674",348,422,204,117,305,231,2282,0.152497808939527,0.184925503943909,0.0893952673093777,0.0512708150744961,0.133654688869413,0.101226993865031
"E02006675",621,408,244,186,222,435,2414,0.257249378624689,0.169014084507042,0.101077050538525,0.0770505385252693,0.091963545981773,0.18019884009942
"E02006676",476,297,723,111,186,365,2389,0.199246546672248,0.124319799079113,0.302637086647133,0.0464629552113855,0.0778568438677271,0.152783591460862
"E02006677",575,475,376,189,286,386,2484,0.231481481481481,0.19122383252818,0.151368760064412,0.0760869565217391,0.115136876006441,0.155394524959742
"E02006678",491,528,180,203,325,288,2400,0.204583333333333,0.22,0.075,0.0845833333333333,0.135416666666667,0.12
"E02006679",548,423,430,150,273,398,4849,0.113012992369561,0.087234481336358,0.0886780779542174,0.0309342132398433,0.0563002680965147,0.0820787791297175
"E02006680",462,477,408,122,355,340,2831,0.163193217944189,0.168491699046273,0.144118685976687,0.0430943129636171,0.125397386082656,0.120098904980572
"E02006681",387,289,487,106,183,281,1971,0.19634703196347,0.146626078132927,0.247082699137494,0.0537798072044647,0.0928462709284627,0.142567224759006
"E02006682",606,472,826,150,322,456,3851,0.157361724227473,0.122565567385095,0.214489742923916,0.0389509218384835,0.0836146455466113,0.11841080238899
"E02006683",303,307,206,86,221,217,2664,0.113738738738739,0.11524024024024,0.0773273273273273,0.0322822822822823,0.082957957957958,0.0814564564564565
"E02006684",404,384,670,113,271,291,3080,0.131168831168831,0.124675324675325,0.217532467532468,0.0366883116883117,0.087987012987013,0.0944805194805195
"E02006685",382,363,378,113,250,269,4007,0.0953331669578238,0.0905914649363614,0.0943349139006738,0.0282006488644871,0.0623908160718742,0.0671325180933367
"E02006686",242,221,101,74,147,168,1393,0.173725771715721,0.158650394831299,0.072505384063173,0.0531227566403446,0.105527638190955,0.120603015075377
"E02006687",430,387,218,139,248,291,2834,0.151729004940014,0.136556104446013,0.0769230769230769,0.0490472829922371,0.0875088214537756,0.102681721947777
"E02006688",390,418,540,125,293,265,1915,0.203655352480418,0.218276762402089,0.281984334203655,0.0652741514360313,0.153002610966057,0.138381201044386
"E02006689",432,326,370,125,201,307,2084,0.207293666026871,0.156429942418426,0.177543186180422,0.0599808061420345,0.0964491362763916,0.147312859884837
"E02006690",472,361,443,116,245,356,2445,0.193047034764826,0.147648261758691,0.18118609406953,0.0474437627811861,0.100204498977505,0.14560327198364
"E02006692",303,233,228,80,153,223,2175,0.139310344827586,0.107126436781609,0.104827586206897,0.0367816091954023,0.0703448275862069,0.102528735632184
"E02006693",423,361,203,138,223,285,2536,0.16679810725552,0.142350157728707,0.0800473186119874,0.054416403785489,0.0879337539432177,0.112381703470032
"E02006694",470,392,536,129,263,341,2731,0.172098132552179,0.143537165873306,0.196265104357378,0.047235444891981,0.0963017209813255,0.124862687660198
"E02006695",532,397,953,150,247,382,2402,0.221482098251457,0.165278934221482,0.396752706078268,0.0624479600333056,0.102830974188177,0.159034138218152
"E02006696",402,478,460,149,329,253,2298,0.174934725848564,0.208006962576153,0.200174064403829,0.0648389904264578,0.143167972149695,0.110095735422106
"E02006697",430,416,721,138,278,292,2149,0.200093066542578,0.193578408562122,0.335504885993485,0.0642159143787808,0.129362494183341,0.135877152163797
"E02006698",375,445,550,141,304,234,1732,0.216512702078522,0.256928406466513,0.317551963048499,0.0814087759815243,0.175519630484988,0.135103926096998
"E02006699",397,434,212,106,328,291,1856,0.213900862068966,0.233836206896552,0.114224137931034,0.0571120689655172,0.176724137931034,0.156788793103448
"E02006700",342,336,422,105,231,237,1712,0.199766355140187,0.196261682242991,0.246495327102804,0.0613317757009346,0.134929906542056,0.138434579439252
"E02006701",417,401,472,133,268,284,2402,0.17360532889259,0.166944213155704,0.196502914238135,0.0553705245628643,0.111573688592839,0.118234804329725
"E02006702",367,457,332,146,311,221,1974,0.185916919959473,0.231509625126646,0.168186423505572,0.0739614994934144,0.157548125633232,0.111955420466059
"E02006703",435,431,447,142,289,293,2407,0.180722891566265,0.179061071873702,0.185708350643955,0.0589945990859992,0.120066472787703,0.121728292480266
"E02006704",400,382,571,125,257,275,2064,0.193798449612403,0.185077519379845,0.276647286821705,0.060562015503876,0.124515503875969,0.133236434108527
"E02006705",431,428,776,133,295,298,2663,0.161847540368006,0.160720991363124,0.291400675929403,0.0499436725497559,0.110777318813368,0.11190386781825
"E02006706",482,533,426,134,399,348,2984,0.161528150134048,0.178619302949062,0.142761394101877,0.0449061662198391,0.133713136729223,0.116621983914209
"E02006707",293,384,224,93,291,200,1885,0.155437665782493,0.203713527851459,0.118832891246684,0.0493368700265252,0.154376657824934,0.106100795755968
"E02006708",463,341,368,104,237,359,3062,0.151208360548661,0.111365120836055,0.12018288700196,0.0339647289353364,0.0774003919007185,0.117243631613325
"E02006709",440,290,372,103,187,337,2529,0.173981810992487,0.114669829972321,0.147093712930012,0.040727560300514,0.073942269671807,0.133254250691973
"E02006710",635,406,716,166,240,469,2897,0.219192267863307,0.140144977562996,0.247152226441146,0.0573006558508802,0.082844321712116,0.161891612012427
"E02006711",576,418,652,146,272,430,2843,0.202602884277172,0.147027787548364,0.229335209285966,0.0513542033063665,0.0956735842419979,0.151248680970805
"E02006712",460,388,579,141,247,319,3071,0.149788342559427,0.12634321068056,0.188537935525887,0.0459133832627809,0.0804298274177792,0.103874959296646
"E02006713",438,400,810,104,296,334,2845,0.153954305799648,0.140597539543058,0.284710017574692,0.0365553602811951,0.104042179261863,0.117398945518453
"E02006714",432,340,492,141,199,291,1944,0.222222222222222,0.174897119341564,0.253086419753086,0.0725308641975309,0.102366255144033,0.149691358024691
"E02006715",461,362,855,95,267,366,3338,0.138106650689035,0.108448172558418,0.256141402037148,0.0284601557819053,0.0799880167765129,0.10964649490713
"E02006716",429,387,238,100,287,329,2757,0.155603917301415,0.140369967355822,0.0863257163583605,0.0362713093942691,0.104098657961552,0.119332607907145
"E02006717",420,283,411,106,177,314,2483,0.169150221506242,0.113975030205397,0.165525573902537,0.0426902939991945,0.0712847362062022,0.126459927507048
"E02006718",455,356,528,109,247,346,2672,0.170284431137725,0.133233532934132,0.197604790419162,0.0407934131736527,0.092440119760479,0.129491017964072
"E02006719",464,374,1231,92,282,372,3317,0.139885438649382,0.112752487187217,0.371118480554718,0.0277359059391016,0.0850165812481158,0.11214953271028
"E02006720",608,451,709,186,265,422,2568,0.236760124610592,0.175623052959502,0.276090342679128,0.0724299065420561,0.103193146417445,0.164330218068536
"E02006721",311,241,119,78,163,233,2138,0.145463049579046,0.112722170252573,0.0556594948550047,0.0364826941066417,0.0762394761459308,0.108980355472404
"E02006722",384,539,32,185,354,199,1826,0.210295728368018,0.295180722891566,0.0175246440306681,0.1013143483023,0.193866374589266,0.108981380065717
"E02006723",268,663,116,84,579,184,3373,0.0794544915505485,0.196560924992588,0.034390750074118,0.0249036466053958,0.171657278387192,0.0545508449451527
"E02006724",648,350,915,105,245,543,2701,0.239911144020733,0.129581636430951,0.338763420955202,0.0388744909292855,0.090707145501666,0.201036653091448
"E02006725",311,445,24,107,338,204,1767,0.176004527447651,0.251839275608376,0.0135823429541596,0.0605546123372949,0.191284663271081,0.115449915110357
"E02006726",385,347,478,93,254,292,2274,0.169305189094107,0.15259454705365,0.210202286719437,0.0408970976253298,0.11169744942832,0.128408091468777
"E02006727",329,401,225,141,260,188,1727,0.190503763752171,0.232194557035321,0.130283729009844,0.081644470179502,0.150550086855819,0.108859293572669
"E02006728",389,393,331,95,298,294,2534,0.153512233622731,0.155090765588003,0.130623520126283,0.0374901341752171,0.117600631412786,0.116022099447514
"E02006729",371,530,51,115,415,256,2149,0.172638436482085,0.24662633783155,0.0237319683573755,0.0535132619823174,0.193113075849232,0.119125174499767
"E02006730",325,400,46,98,302,227,2160,0.150462962962963,0.185185185185185,0.0212962962962963,0.0453703703703704,0.139814814814815,0.105092592592593
"E02006731",387,428,169,131,297,256,2115,0.182978723404255,0.202364066193853,0.0799054373522459,0.0619385342789598,0.140425531914894,0.121040189125296
"E02006732",459,391,315,123,268,336,2168,0.211715867158672,0.180350553505535,0.14529520295203,0.0567343173431734,0.123616236162362,0.154981549815498
"E02006733",315,353,446,87,266,228,1984,0.158770161290323,0.177923387096774,0.224798387096774,0.0438508064516129,0.134072580645161,0.11491935483871
"E02006734",455,391,1021,124,267,331,2727,0.166850018335167,0.143381004767143,0.374404107077374,0.0454712137880455,0.0979097909790979,0.121378804547121
"E02006735",329,513,20,114,399,215,2711,0.121357432681667,0.189229066765031,0.00737735153080044,0.0420509037255625,0.147178163039469,0.0793065289561048
"E02006736",545,275,4,91,184,454,2415,0.225672877846791,0.113871635610766,0.00165631469979296,0.0376811594202899,0.0761904761904762,0.187991718426501
"E02006737",520,403,1158,126,277,394,3101,0.167687842631409,0.129958078039342,0.373427926475331,0.0406320541760722,0.0893260238632699,0.127055788455337
"E02006738",527,564,835,92,472,435,3857,0.13663469017371,0.146227638060669,0.216489499611097,0.0238527352864921,0.122374902774177,0.112781954887218
"E02006739",360,337,421,117,220,243,1639,0.219646125686394,0.205613178767541,0.2568639414277,0.0713849908480781,0.134228187919463,0.148261134838316
"E02006740",541,268,1998,67,201,474,4231,0.127865752777121,0.0633419995272985,0.472228787520681,0.0158354998818246,0.0475064996454739,0.112030252895297
"E02006741",352,124,27,34,90,318,2086,0.168744007670182,0.0594439117929051,0.0129434324065197,0.0162991371045062,0.0431447746883988,0.152444870565676
"E02006742",512,548,999,114,434,398,3682,0.139054861488322,0.148832156436719,0.271319934818034,0.0309614340032591,0.11787072243346,0.108093427485062
"E02006743",375,437,177,116,321,259,2517,0.148986889153754,0.173619388160509,0.0703218116805721,0.0460866110448947,0.127532777115614,0.10290027810886
"E02006744",542,388,1407,87,301,455,3558,0.152332771219786,0.109050028105677,0.395446880269815,0.0244519392917369,0.0845980888139404,0.127880831928049
"E02006745",445,387,891,107,280,338,3136,0.141900510204082,0.123405612244898,0.284119897959184,0.0341198979591837,0.0892857142857143,0.107780612244898
"E02006746",464,335,918,131,204,333,3655,0.126949384404925,0.0916552667578659,0.251162790697674,0.0358413132694938,0.0558139534883721,0.0911080711354309
"E02006747",408,198,9,68,130,340,1949,0.209338122113905,0.10159055926116,0.00461775269368907,0.0348896870189841,0.0667008722421755,0.17444843509492
"E02006748",442,343,579,105,238,337,3214,0.137523335407592,0.106720597386434,0.180149346608587,0.0326695706285003,0.074051026757934,0.104853764779091
"E02006749",415,414,31,136,278,279,2040,0.20343137254902,0.202941176470588,0.0151960784313725,0.0666666666666667,0.136274509803922,0.136764705882353
"E02006750",370,395,329,119,276,251,2467,0.149979732468585,0.160113498175922,0.133360356708553,0.0482367247669234,0.111876773408999,0.101743007701662
"E02006751",421,435,370,126,309,295,2184,0.192765567765568,0.199175824175824,0.169413919413919,0.0576923076923077,0.141483516483516,0.13507326007326
"E02006752",369,278,111,95,183,274,2709,0.136212624584718,0.102620893318568,0.0409745293466224,0.0350682908822444,0.0675526024363234,0.101144333702473
"E02006753",328,327,489,105,222,223,2315,0.141684665226782,0.141252699784017,0.211231101511879,0.0453563714902808,0.0958963282937365,0.0963282937365011
"E02006754",381,230,428,105,125,276,1702,0.22385428907168,0.135135135135135,0.251468860164512,0.0616921269095182,0.0734430082256169,0.162162162162162
"E02006755",352,293,350,120,173,232,1735,0.202881844380403,0.168876080691643,0.201729106628242,0.069164265129683,0.0997118155619597,0.13371757925072
"E02006756",368,238,254,92,146,276,2541,0.144824872097599,0.09366391184573,0.0999606454151909,0.0362062180243998,0.0574576938213302,0.1086186540732
"E02006757",438,290,515,115,175,323,2230,0.196412556053812,0.130044843049327,0.230941704035874,0.0515695067264574,0.07847533632287,0.144843049327354
"E02006758",310,282,400,105,177,205,2398,0.129274395329441,0.117597998331943,0.166805671392827,0.0437864887406172,0.0738115095913261,0.085487906588824
"E02006759",537,464,497,187,277,350,3873,0.138652207591015,0.119803769687581,0.128324296411051,0.048282984766331,0.0715207849212497,0.0903692228246837
"E02006760",455,352,673,115,237,340,3229,0.14091049860638,0.109012078042738,0.20842366057603,0.0356147414060081,0.0733973366367296,0.105295757200372
"E02006761",377,344,1009,65,279,312,3319,0.113588430250075,0.103645676408557,0.304007231093703,0.019584212112082,0.0840614642964748,0.0940042181379934
"E02006762",344,252,457,67,185,277,3001,0.11462845718094,0.0839720093302233,0.152282572475841,0.0223258913695435,0.0616461179606798,0.0923025658113962
"E02006763",349,409,361,133,276,216,3174,0.109955891619408,0.128859483301827,0.113736609955892,0.0419029615626969,0.0869565217391304,0.0680529300567108
"E02006764",362,315,177,99,216,263,2166,0.167128347183749,0.145429362880886,0.0817174515235457,0.0457063711911357,0.0997229916897507,0.121421975992613
"E02006765",418,290,660,88,202,330,2504,0.166932907348243,0.115814696485623,0.263578274760383,0.0351437699680511,0.0806709265175719,0.131789137380192
"E02006766",524,314,660,120,194,404,2408,0.217607973421927,0.130398671096346,0.274086378737542,0.0498338870431894,0.0805647840531561,0.167774086378738
"E02006767",654,512,754,187,325,467,3582,0.182579564489112,0.142936906756002,0.210496929089894,0.0522054718034618,0.0907314349525405,0.13037409268565
"E02006768",404,412,295,139,273,265,2011,0.200895077076082,0.204873197414222,0.146693187468921,0.0691198408751865,0.135753356539035,0.131775236200895
"E02006769",534,377,970,121,256,413,2254,0.236912156166815,0.167258207630878,0.430346051464064,0.0536823425022183,0.11357586512866,0.183229813664596
"E02006770",519,334,940,92,242,427,3952,0.131325910931174,0.0845141700404858,0.237854251012146,0.0232793522267206,0.0612348178137652,0.108046558704453
"E02006771",492,298,482,115,183,377,2251,0.218569524655709,0.132385606397157,0.214127054642381,0.0510884051532652,0.0812972012438916,0.167481119502443
"E02006772",495,314,347,127,187,368,2320,0.213362068965517,0.135344827586207,0.149568965517241,0.0547413793103448,0.0806034482758621,0.158620689655172
"E02006773",742,539,821,153,386,589,3323,0.223292205838098,0.162202828769184,0.24706590430334,0.046042732470659,0.116160096298525,0.177249473367439
"E02006774",709,381,1435,129,252,580,2927,0.242227536727024,0.130167406901264,0.490263067987701,0.044072429108302,0.0860949777929621,0.198155107618722
"E02006775",377,306,248,104,202,273,2443,0.154318460908719,0.125255832992223,0.101514531313958,0.0425706099058535,0.0826852230863692,0.111747851002865
"E02006776",433,358,144,109,249,324,2056,0.210603112840467,0.174124513618677,0.0700389105058366,0.0530155642023346,0.121108949416342,0.157587548638132
"E02006777",540,435,699,167,268,373,2236,0.241502683363148,0.194543828264758,0.312611806797853,0.0746869409660107,0.119856887298748,0.166815742397138
"E02006778",505,440,430,172,268,333,2320,0.217672413793103,0.189655172413793,0.185344827586207,0.0741379310344828,0.11551724137931,0.143534482758621
"E02006779",470,380,559,94,286,376,3154,0.149017121116043,0.120481927710843,0.177235256816741,0.0298034242232086,0.0906785034876347,0.119213696892834
"E02006780",375,336,242,113,223,262,1844,0.203362255965293,0.182212581344902,0.131236442516269,0.0612798264642082,0.120932754880694,0.142082429501085
"E02006781",234,239,336,70,169,164,997,0.234704112337011,0.239719157472417,0.337011033099298,0.0702106318956871,0.16950852557673,0.164493480441324
"E02006782",485,661,843,191,470,294,2546,0.190494893951296,0.25962293794187,0.331107619795758,0.075019638648861,0.184603299293009,0.115475255302435
"E02006783",324,812,364,197,615,127,2197,0.147473827947201,0.369594902139281,0.165680473372781,0.0896677287209832,0.279927173418298,0.0578060992262176
"E02006784",335,555,747,128,427,207,2578,0.129945694336695,0.215283165244375,0.289759503491078,0.0496508921644686,0.165632273079907,0.0802948021722265
"E02006785",408,593,731,148,445,260,2012,0.202783300198807,0.294731610337972,0.363320079522863,0.073558648111332,0.22117296222664,0.129224652087475
"E02006786",342,167,1483,28,139,314,2489,0.137404580152672,0.0670952189634391,0.595821615106468,0.0112494977902772,0.0558457211731619,0.126155082362395
"E02006787",456,162,1596,26,136,430,2380,0.191596638655462,0.0680672268907563,0.670588235294118,0.0109243697478992,0.0571428571428571,0.180672268907563
"E02006788",373,325,1218,83,242,290,2303,0.161962657403387,0.141120277898393,0.52887537993921,0.0360399478940512,0.105080330004342,0.125922709509336
"E02006789",425,443,286,153,290,272,1982,0.214429868819374,0.22351160443996,0.144298688193744,0.0771947527749748,0.146316851664985,0.1372351160444
"E02006790",515,730,439,227,503,288,2400,0.214583333333333,0.304166666666667,0.182916666666667,0.0945833333333333,0.209583333333333,0.12
"E02006791",434,192,1815,38,154,396,3522,0.123225440090857,0.0545144804088586,0.515332197614991,0.0107893242475866,0.043725156161272,0.112436115843271
"E02006792",433,280,2394,25,255,408,4537,0.0954375137756227,0.0617147895084858,0.527661450297553,0.00551024906325766,0.0562045404452281,0.089927264712365
"E02006793",348,601,934,68,533,280,3588,0.096989966555184,0.167502787068004,0.260312151616499,0.0189520624303233,0.148550724637681,0.0780379041248606
"E02006794",323,531,1487,16,515,307,3878,0.0832903558535328,0.136926250644662,0.383445074780815,0.00412583806085611,0.132800412583806,0.0791645177926766
"E02006795",401,166,1616,38,128,363,1994,0.201103309929789,0.0832497492477432,0.810431293881645,0.0190571715145436,0.0641925777331996,0.182046138415246
"E02006796",733,882,879,300,582,433,3235,0.226584234930448,0.272642967542504,0.271715610510046,0.0927357032457496,0.179907264296754,0.133848531684699
"E02006798",286,429,967,57,372,229,4090,0.0699266503667482,0.104889975550122,0.236430317848411,0.0139364303178484,0.0909535452322738,0.0559902200488998
"E02006799",647,748,1299,210,538,437,3341,0.193654594432805,0.22388506435199,0.3888057467824,0.062855432505238,0.161029631846752,0.130799161927567
"E02006800",823,295,2352,76,219,747,4213,0.195347733206741,0.0700213624495609,0.558272015191075,0.0180394018514123,0.0519819605981486,0.177308331355329
"E02006801",122,169,1955,18,151,104,5072,0.0240536277602524,0.033320189274448,0.38544952681388,0.00354889589905363,0.0297712933753943,0.0205047318611987
"E02006802",117,281,1278,7,274,110,4303,0.027190332326284,0.0653032767836393,0.297002091564025,0.00162677201952126,0.0636765047641181,0.0255635603067627
"E02006803",341,347,161,69,278,272,3097,0.110106554730384,0.112043913464643,0.0519857927026154,0.022279625443978,0.0897642880206652,0.0878269292864062
"E02006804",518,392,419,102,290,416,2989,0.173302107728337,0.131147540983607,0.140180662428906,0.0341251254600201,0.0970224155235865,0.139176982268317
"E02006805",408,384,1219,84,300,324,3073,0.132769280833062,0.124959323137,0.396680767979173,0.0273348519362187,0.097624471200781,0.105434428896843
"E02006806",503,391,450,135,256,368,3231,0.155679356236459,0.121015165583411,0.139275766016713,0.0417827298050139,0.0792324357783968,0.113896626431445
"E02006807",475,351,1537,81,270,394,2259,0.210270030987162,0.155378486055777,0.680389552899513,0.0358565737051793,0.119521912350598,0.174413457281983
"E02006808",344,261,1074,57,204,287,2363,0.145577655522641,0.110452814219213,0.454506982649175,0.0241218789674143,0.0863309352517986,0.121455776555226
"E02006809",432,678,839,176,502,256,2131,0.202721726888785,0.318160488033787,0.393711872360394,0.0825903331769123,0.235570154856875,0.120131393711872
"E02006810",420,696,555,177,519,243,3291,0.127620783956244,0.211485870556062,0.168641750227894,0.0537830446672744,0.157702825888788,0.0738377392889699
"E02006811",470,504,171,134,370,336,4081,0.115167851016908,0.123499142367067,0.0419014947316834,0.032835089438863,0.0906640529282039,0.0823327615780446
"E02006812",484,393,92,118,275,366,2789,0.173538902832556,0.140910720688419,0.0329867335962711,0.042309071351739,0.0986016493366798,0.131229831480817
"E02006813",390,292,710,68,224,322,3121,0.12495994873438,0.093559756488305,0.227491188721564,0.0217878884972765,0.0717718679910285,0.103172060237103
"E02006814",401,402,932,102,300,299,2629,0.152529478889312,0.152909851654622,0.354507417268924,0.0387980220616204,0.114111829593001,0.113731456827691
"E02006815",791,367,190,114,253,677,3544,0.223194130925508,0.103555304740406,0.0536117381489842,0.0321670428893905,0.0713882618510158,0.191027088036117
"E02006816",403,397,348,123,274,280,3249,0.124038165589412,0.122191443521083,0.107109879963066,0.0378578024007387,0.0843336411203447,0.0861803631886734
"E02006817",509,252,1395,76,176,433,2781,0.183027687882057,0.0906148867313916,0.501618122977346,0.0273282991729594,0.0632865875584322,0.155699388709097
"E02006818",495,518,819,160,358,335,2337,0.21181001283697,0.221651690201113,0.350449293966624,0.0684638425331622,0.15318784766795,0.143346170303808
"E02006819",596,245,81,55,190,541,2890,0.206228373702422,0.0847750865051903,0.0280276816608997,0.0190311418685121,0.0657439446366782,0.18719723183391
"E02006820",565,487,476,164,323,401,3250,0.173846153846154,0.149846153846154,0.146461538461538,0.0504615384615385,0.0993846153846154,0.123384615384615
"E02006821",417,728,93,198,530,219,2189,0.190497944266788,0.332571950662403,0.0424851530379169,0.0904522613065327,0.24211968935587,0.100045682960256
"E02006822",731,983,166,339,644,392,3391,0.215570628133294,0.289884989678561,0.0489531111766441,0.09997051017399,0.189914479504571,0.115600117959304
"E02006823",619,671,407,219,452,400,2816,0.219815340909091,0.23828125,0.14453125,0.0777698863636364,0.160511363636364,0.142045454545455
"E02006824",759,948,151,356,592,403,3004,0.252663115845539,0.315579227696405,0.0502663115845539,0.118508655126498,0.197070572569907,0.134154460719041
"E02006825",504,339,609,128,211,376,2485,0.202816901408451,0.136418511066398,0.245070422535211,0.0515090543259557,0.0849094567404427,0.151307847082495
"E02006826",740,673,1387,195,478,545,4662,0.158730158730159,0.144358644358644,0.297511797511798,0.0418275418275418,0.102531102531103,0.116902616902617
"E02006827",438,303,1018,84,219,354,3529,0.124114480022669,0.0858600170019836,0.288466987815245,0.0238027769906489,0.0620572400113347,0.10031170303202
"E02006828",379,291,355,91,200,288,2401,0.157850895460225,0.121199500208247,0.147855060391504,0.0379008746355685,0.083298625572678,0.119950020824656
"E02006829",489,506,153,161,345,328,2532,0.193127962085308,0.199842022116904,0.0604265402843602,0.0635860979462875,0.136255924170616,0.129541864139021
"E02006830",428,437,111,134,303,294,2504,0.170926517571885,0.174520766773163,0.0443290734824281,0.0535143769968051,0.121006389776358,0.11741214057508
"E02006831",482,522,59,198,324,284,1876,0.256929637526652,0.278251599147122,0.0314498933901919,0.105543710021322,0.1727078891258,0.151385927505331
"E02006832",382,801,66,209,592,173,1915,0.199477806788512,0.418276762402089,0.0344647519582245,0.109138381201044,0.309138381201044,0.0903394255874674
"E02006833",588,585,837,183,402,405,4471,0.131514202639231,0.130843211809439,0.187206441511966,0.0409304406173116,0.089912771192127,0.090583762021919
"E02006834",486,285,31,85,200,401,3746,0.129738387613454,0.0760811532301121,0.00827549386011746,0.0226908702616124,0.0533902829684997,0.107047517351842
"E02006835",396,286,246,98,188,298,2195,0.180410022779043,0.130296127562642,0.112072892938497,0.0446469248291572,0.0856492027334852,0.135763097949886
"E02006836",538,655,553,226,429,312,2565,0.209746588693957,0.255360623781676,0.215594541910331,0.0881091617933723,0.167251461988304,0.121637426900585
"E02006837",634,1028,922,300,728,334,3602,0.176013325930039,0.285397001665741,0.255968906163243,0.0832870627429206,0.202109938922821,0.0927262631871183
"E02006838",506,558,218,197,361,309,2282,0.221735319894829,0.244522348816827,0.0955302366345311,0.086327782646801,0.158194566170026,0.135407537248028
"E02006839",595,718,512,259,459,336,2806,0.212045616535994,0.255880256593015,0.182466143977192,0.0923022095509622,0.163578047042053,0.119743406985032
"E02006840",900,1226,1170,396,830,504,4167,0.215982721382289,0.294216462682985,0.280777537796976,0.0950323974082073,0.199184065274778,0.120950323974082
"E02006841",210,427,653,45,382,165,4534,0.0463167181296868,0.0941773268636965,0.144022937803264,0.00992501102779003,0.0842523158359065,0.0363917071018968
"E02006842",351,373,1054,76,297,275,2254,0.155723158828749,0.165483584738243,0.467613132209405,0.033717834960071,0.131765749778172,0.122005323868678
"E02006843",60,32,494,1,31,59,9514,0.00630649569056128,0.00336346436829935,0.0519234811856212,0.000105108261509355,0.00325835610678999,0.00620138742905192
"E02006844",259,100,669,10,90,249,5143,0.0503597122302158,0.0194439043359907,0.130079720007778,0.00194439043359907,0.0174995139023916,0.0484153217966168
"E02006845",370,220,80,93,127,277,3922,0.0943396226415094,0.0560938296787353,0.0203977562468129,0.0237123916369199,0.0323814380418154,0.0706272310045895
"E02006846",290,58,5,22,36,268,4336,0.0668819188191882,0.0133763837638376,0.00115313653136531,0.00507380073800738,0.00830258302583026,0.0618081180811808
"E02006847",163,176,3,28,148,135,3673,0.0443778927307378,0.0479172338687721,0.00081677103185407,0.00762319629730466,0.0402940375714675,0.0367546964334332
"E02006848",52,45,0,3,42,49,3855,0.0134889753566796,0.0116731517509728,0,0.000778210116731518,0.0108949416342412,0.0127107652399481
"E02006849",249,374,8,64,310,185,3508,0.0709806157354618,0.106613454960091,0.00228050171037628,0.0182440136830103,0.088369441277081,0.0527366020524515
"E02006850",431,221,1881,55,166,376,5417,0.0795643345024922,0.0407974893852686,0.347240169835702,0.0101532213402252,0.0306442680450434,0.0694111131622669
"E02006851",94,154,970,0,154,94,7595,0.0123765635286373,0.0202764976958525,0.12771560236998,0,0.0202764976958525,0.0123765635286373
"E02006852",954,985,1370,271,714,683,4690,0.203411513859275,0.21002132196162,0.292110874200426,0.0577825159914712,0.152238805970149,0.145628997867804
"E02006853",47,150,183,13,137,34,7545,0.00622929092113983,0.0198807157057654,0.0242544731610338,0.00172299536116634,0.0181577203445991,0.00450629555997349
"E02006854",7,31,95,0,31,7,9171,0.000763275542470832,0.00338022025951368,0.0103587395049613,0,0.00338022025951368,0.000763275542470832
"E02006855",404,566,606,162,404,242,2730,0.147985347985348,0.207326007326007,0.221978021978022,0.0593406593406593,0.147985347985348,0.0886446886446886
"E02006856",722,853,1095,202,651,520,5978,0.120776179324189,0.142689862830378,0.183171629307461,0.0337905654064905,0.108899297423888,0.0869856139176982
"E02006857",488,872,205,250,622,238,3365,0.145022288261516,0.259138187221397,0.0609212481426449,0.0742942050520059,0.184843982169391,0.0707280832095097
"E02006858",313,162,12,45,117,268,3690,0.0848238482384824,0.0439024390243902,0.0032520325203252,0.0121951219512195,0.0317073170731707,0.0726287262872629
"E02006859",193,50,1,8,42,185,2571,0.0750680669000389,0.0194476857253987,0.000388953714507974,0.00311162971606379,0.0163360560093349,0.0719564371839751
"E02006861",1381,537,3101,96,441,1285,5930,0.232883642495784,0.0905564924114671,0.522934232715008,0.0161888701517707,0.0743676222596965,0.216694772344013
"E02006862",265,460,43,111,349,154,2002,0.132367632367632,0.22977022977023,0.0214785214785215,0.0554445554445554,0.174325674325674,0.0769230769230769
"E02006863",163,67,1,30,37,133,4346,0.0375057524160147,0.0154164749194662,0.000230096640589047,0.00690289921767142,0.00851357570179475,0.0306028531983433
"E02006864",457,392,250,124,268,333,2980,0.153355704697987,0.131543624161074,0.0838926174496644,0.0416107382550336,0.0899328859060403,0.111744966442953
"E02006865",380,322,293,119,203,261,2992,0.127005347593583,0.107620320855615,0.097927807486631,0.0397727272727273,0.0678475935828877,0.0872326203208556
"E02006866",302,214,63,77,137,225,3410,0.0885630498533724,0.0627565982404692,0.018475073313783,0.0225806451612903,0.0401759530791789,0.0659824046920821
"E02006867",462,356,174,126,230,336,2783,0.16600790513834,0.127919511318721,0.0625224577793748,0.0452748832195473,0.0826446280991736,0.120733021918793
"E02006868",628,435,983,75,360,553,5469,0.114829036386908,0.0795392210641799,0.179740354726641,0.013713658804169,0.065825562260011,0.101115377582739
"E02006869",405,448,161,119,329,286,3578,0.113191727221912,0.12520961430967,0.0449972051425377,0.0332588038010061,0.0919508105086641,0.0799329234209055
"E02006871",734,1347,185,351,996,383,4055,0.181011097410604,0.332182490752158,0.0456226880394575,0.0865598027127004,0.245622688039457,0.0944512946979038
"E02006872",726,686,1183,201,485,525,4262,0.170342562177382,0.160957297043641,0.277569216330361,0.0471609572970436,0.113796339746598,0.123181604880338
"E02006873",55,160,3,3,157,52,4461,0.0123290741986102,0.0358663976686842,0.000672494956287828,0.000672494956287828,0.0351939027123963,0.0116565792423223
"E02006874",434,304,329,94,210,340,4096,0.10595703125,0.07421875,0.080322265625,0.02294921875,0.05126953125,0.0830078125
"E02006875",100,150,411,9,141,91,8531,0.0117219552221311,0.0175829328331966,0.0481772359629586,0.00105497596999179,0.0165279568632048,0.0106669792521393
"E02006876",335,199,279,69,130,266,4753,0.0704818009678098,0.0418682937092363,0.0586997685672207,0.0145171470650116,0.0273511466442247,0.0559646539027982
"E02006877",349,248,92,78,170,271,4805,0.0726326742976067,0.0516129032258065,0.0191467221644121,0.0162330905306972,0.0353798126951093,0.0563995837669095
"E02006878",163,258,3,46,212,117,6302,0.0258648048238654,0.0409393843224373,0.000476039352586481,0.0072992700729927,0.0336401142494446,0.0185655347508727
"E02006879",512,853,1933,133,720,379,4554,0.112428634167765,0.187307861220905,0.424462011418533,0.0292050944224857,0.158102766798419,0.0832235397452789
"E02006880",470,1282,1713,205,1077,265,4190,0.112171837708831,0.305966587112172,0.408830548926014,0.0489260143198091,0.257040572792363,0.0632458233890215
"E02006881",726,1177,1781,270,907,456,4261,0.170382539310021,0.276226237972307,0.41797700070406,0.0633654071814128,0.212860830790894,0.107017132128608
"E02006882",630,320,1925,86,234,544,2874,0.219206680584551,0.11134307585247,0.669798190675017,0.0299234516353514,0.081419624217119,0.1892832289492
"E02006883",307,1521,439,160,1361,147,3925,0.0782165605095541,0.387515923566879,0.111847133757962,0.0407643312101911,0.346751592356688,0.0374522292993631
"E02006884",1026,1039,2187,206,833,820,5168,0.198529411764706,0.201044891640867,0.423181114551084,0.0398606811145511,0.161184210526316,0.158668730650155
"E02006885",339,2132,611,169,1963,170,5319,0.0637337845459673,0.400827223162249,0.114871216394059,0.0317728896409099,0.369054333521339,0.0319608949050573
"E02006886",884,620,765,176,444,708,6139,0.143997393712331,0.100993647173807,0.124613129174133,0.0286691643590161,0.0723244828147907,0.115328229353315
"E02006887",201,193,917,32,161,169,6711,0.029950827000447,0.0287587542840113,0.136641335121442,0.00476829086574281,0.0239904634182685,0.0251825361347042
"E02006888",378,272,1917,52,220,326,3140,0.120382165605096,0.086624203821656,0.610509554140127,0.0165605095541401,0.0700636942675159,0.103821656050955
"E02006889",176,174,793,35,139,141,2842,0.0619282195636875,0.0612244897959184,0.279028852920479,0.0123152709359606,0.0489092188599578,0.049612948627727
"E02006890",729,362,2796,87,275,642,4141,0.176044433711664,0.0874184979473557,0.675199227239797,0.0210094180149722,0.0664090799323835,0.155035015696692
"E02006891",451,294,419,88,206,363,3420,0.13187134502924,0.0859649122807018,0.122514619883041,0.0257309941520468,0.060233918128655,0.106140350877193
"E02006892",526,307,941,88,219,438,2866,0.183531053733426,0.10711793440335,0.328332170272156,0.0307048150732729,0.0764131193300768,0.152826238660154
"E02006893",387,493,158,114,379,273,3675,0.10530612244898,0.134149659863946,0.0429931972789116,0.0310204081632653,0.10312925170068,0.0742857142857143
"E02006894",756,806,1840,165,641,591,5776,0.130886426592798,0.139542936288089,0.318559556786704,0.0285664819944598,0.110976454293629,0.102319944598338
"E02006895",90,266,39,35,231,55,6406,0.0140493287542929,0.0415235716515766,0.00608804246019357,0.00546362784889166,0.036059943802685,0.00858570090540119
"E02006896",55,82,124,5,77,50,8429,0.0065250919444774,0.00972831889903903,0.0147111163839127,0.000593190176770673,0.00913512872226836,0.00593190176770673
"E02006897",156,612,189,19,593,137,7636,0.0204295442640126,0.0801466736511262,0.0247511786275537,0.00248821372446307,0.0776584599266632,0.0179413305395495
"E02006898",133,258,102,41,217,92,6642,0.0200240891297802,0.038843721770551,0.015356820234869,0.00617283950617284,0.0326708822643782,0.0138512496236073
"E02006899",32,164,429,4,160,28,8141,0.00393072104164108,0.0201449453384105,0.0526962289645007,0.000491340130205134,0.0196536052082054,0.00343938091143594
"E02006900",817,451,2734,124,327,693,4088,0.199853228962818,0.1103228962818,0.668786692759295,0.0303326810176125,0.0799902152641879,0.169520547945205
"E02006902",79,188,399,15,173,64,8296,0.00952266152362584,0.0226615236258438,0.0480954676952748,0.00180810028929605,0.0208534233365477,0.0077145612343298
"E02006903",705,727,230,231,496,474,4441,0.158748029723035,0.163701868948435,0.0517901373564513,0.0520153118666967,0.111686557081738,0.106732717856339
"E02006904",314,175,1061,40,135,274,7555,0.0415618795499669,0.0231634679020516,0.140436796823296,0.00529450694904037,0.0178689609530112,0.0362673726009265
"E02006905",676,312,806,97,215,579,4280,0.157943925233645,0.0728971962616822,0.188317757009346,0.0226635514018692,0.0502336448598131,0.135280373831776
"E02006906",629,572,1163,160,412,469,3733,0.168497187248862,0.153227966782748,0.311545673720868,0.0428609697294401,0.110366997053308,0.125636217519421
"E02006907",277,278,1107,42,236,235,5516,0.0502175489485134,0.0503988397389413,0.200688905003626,0.00761421319796954,0.0427846265409717,0.0426033357505439
"E02006908",481,314,824,72,242,409,3239,0.148502624266749,0.0969435010805804,0.254399506020377,0.0222290830503242,0.0747144180302562,0.126273541216425
"E02006909",598,524,234,142,382,456,4957,0.120637482348194,0.105709098244906,0.0472059713536413,0.0286463586846883,0.0770627395602179,0.0919911236635061
"E02006910",548,584,439,142,442,406,3964,0.13824419778002,0.147325933400605,0.110746720484359,0.0358224016145308,0.111503531786075,0.102421796165489
"E02006912",49,65,919,2,63,47,10482,0.00467468040450296,0.00620110665903454,0.0876741079946575,0.000190803281816447,0.00601030337721809,0.00448387712268651
"E02006913",225,586,361,72,514,153,3747,0.0600480384307446,0.156391780090739,0.0963437416599947,0.0192153722978383,0.137176407792901,0.0408326661329063
"E02006914",58,72,335,3,69,55,3883,0.0149369044553181,0.0185423641514293,0.0862734998712336,0.000772598506309554,0.0177697656451198,0.0141643059490085
"E02006915",255,419,183,64,355,191,3401,0.0749779476624522,0.123199059100265,0.0538077036165834,0.018817994707439,0.104381064392826,0.0561599529550132
"E02006916",73,125,213,14,111,59,5113,0.0142773322902406,0.0244474867983571,0.0416585175044005,0.002738118521416,0.0217093682769411,0.0115392137688246
"E02006917",44,59,90,10,49,34,9312,0.00472508591065292,0.00633591065292096,0.00966494845360825,0.00107388316151203,0.00526202749140894,0.00365120274914089
"E02006918",213,183,893,17,166,196,3509,0.060701054431462,0.0521516101453406,0.254488458250214,0.00484468509546879,0.0473069250498718,0.0558563693359932
"E02006919",366,242,877,56,186,310,4398,0.0832196452933151,0.055025011368804,0.199408822191905,0.0127330604820373,0.0422919508867667,0.0704865848112779
"E02006920",292,201,510,47,154,245,3333,0.0876087608760876,0.0603060306030603,0.153015301530153,0.0141014101410141,0.0462046204620462,0.0735073507350735
"E02006921",172,144,1882,17,127,155,2645,0.0650283553875236,0.0544423440453686,0.711531190926276,0.00642722117202268,0.0480151228733459,0.0586011342155009
"E02006922",926,1057,360,360,697,566,4628,0.200086430423509,0.228392394122731,0.0777873811581677,0.0777873811581677,0.150605012964564,0.122299049265341
"E02006924",651,319,2334,52,267,599,3518,0.185048322910745,0.0906765207504264,0.663445139283684,0.0147811256395679,0.0758953951108584,0.170267197271177
"E02006925",647,521,1723,141,380,506,2774,0.23323720259553,0.187815428983417,0.6211247296323,0.0508291276135544,0.136986301369863,0.182408074981975
"E02006926",336,101,54,35,66,301,2408,0.13953488372093,0.0419435215946844,0.0224252491694352,0.0145348837209302,0.0274086378737542,0.125
"E02006927",360,662,1154,121,541,239,6528,0.0551470588235294,0.10140931372549,0.176776960784314,0.0185355392156863,0.0828737745098039,0.0366115196078431
"E02006928",97,164,714,9,155,88,6569,0.0147663266859492,0.0249657482112955,0.108692342822347,0.00137007154818085,0.0235956766631146,0.0133962551377683
"E02006930",439,173,1841,32,141,407,4775,0.0919371727748691,0.0362303664921466,0.385549738219895,0.00670157068062827,0.0295287958115183,0.0852356020942408
"E02006931",347,395,2186,34,361,313,4528,0.0766342756183746,0.0872349823321555,0.482773851590106,0.00750883392226148,0.079726148409894,0.0691254416961131
"E02006932",146,262,1124,16,246,130,7429,0.0196527123435186,0.0352671961233006,0.151298963521335,0.00215372190065958,0.033113474222641,0.0174989904428591
"E02006933",143,68,316,17,51,126,7144,0.02001679731243,0.00951847704367301,0.0442329227323628,0.00237961926091825,0.00713885778275476,0.0176371780515118
"E02006934",59,102,621,18,84,41,7504,0.00786247334754797,0.013592750533049,0.0827558635394456,0.00239872068230277,0.0111940298507463,0.0054637526652452
"E02006935",417,771,228,132,639,285,3899,0.106950500128238,0.197743011028469,0.0584765324442165,0.0338548345729674,0.163888176455501,0.0730956655552706
"E02006936",257,434,211,115,319,142,2926,0.0878332194121668,0.148325358851675,0.0721120984278879,0.0393028024606972,0.109022556390977,0.0485304169514696
"E02006937",536,595,1635,94,501,442,4785,0.112016718913271,0.124346917450366,0.341692789968652,0.019644723092999,0.104702194357367,0.0923719958202717
"E02006938",247,166,959,26,140,221,4419,0.0558949988685223,0.0375650599683186,0.217017424756732,0.0058836840914234,0.0316813758768952,0.0500113147770989
"E02006939",399,247,1408,52,195,347,6398,0.062363238512035,0.0386058143169741,0.220068771491091,0.00812753985620506,0.030478274460769,0.0542356986558299
"E02006940",460,348,1128,77,271,383,5192,0.088597842835131,0.0670261941448382,0.217257318952234,0.0148305084745763,0.0521956856702619,0.0737673343605547
"E02006941",33,65,789,2,63,31,4321,0.00763712103679704,0.0150428141633881,0.182596621152511,0.000462855820411942,0.0145799583429762,0.0071742652163851
"E02006942",69,151,888,6,145,63,4068,0.0169616519174041,0.0371189773844641,0.218289085545723,0.00147492625368732,0.0356440511307768,0.0154867256637168
"E02006943",265,538,377,111,427,154,3035,0.0873146622734761,0.177265238879736,0.124217462932455,0.0365733113673806,0.140691927512356,0.0507413509060956
"E02006944",389,311,1115,58,253,331,2588,0.150309119010819,0.120170015455951,0.430834621329212,0.0224111282843895,0.097758887171561,0.12789799072643
"E02006945",476,451,562,126,325,350,3121,0.152515219480936,0.144504966356937,0.180070490227491,0.0403716757449535,0.104133290611983,0.112143543735982
"E02006946",396,286,837,54,232,342,2239,0.17686467172845,0.127735596248325,0.373827601607861,0.0241179097811523,0.103617686467173,0.152746761947298
"E02006947",738,757,1037,343,414,395,4616,0.159878682842288,0.163994800693241,0.224653379549393,0.0743067590987868,0.0896880415944541,0.0855719237435009
"E02006948",279,200,958,78,122,201,4222,0.06608242539081,0.0473709142586452,0.22690667929891,0.0184746565608716,0.0288962576977736,0.0476077688299384
"E02006949",431,252,1752,47,205,384,2936,0.146798365122616,0.0858310626702997,0.596730245231608,0.016008174386921,0.0698228882833788,0.130790190735695
"E02006950",253,125,1553,14,111,239,3913,0.0646562739585995,0.0319447993866599,0.396882187579862,0.0035778175313059,0.0283669818553539,0.0610784564272936
"E02006951",240,210,1462,7,203,233,4573,0.0524819593264815,0.0459217144106713,0.319702602230483,0.00153072381368904,0.0443909905969823,0.0509512355127925
"E02006952",130,115,797,9,106,121,4863,0.0267324696689286,0.0236479539378984,0.163890602508739,0.00185070943861814,0.0217972444992803,0.0248817602303105
"E02006953",178,153,99,27,126,151,6382,0.0278909432779693,0.0239736759636478,0.0155123785647133,0.00423064869946725,0.0197430272641805,0.023660294578502
"E02006954",212,303,611,60,243,152,4559,0.0465014257512612,0.0664619434086422,0.134020618556701,0.0131607808729985,0.0533011625356438,0.0333406448782628
"E02006955",73,36,367,4,32,69,6433,0.0113477382247785,0.00559614487797295,0.0570495880615576,0.000621793875330328,0.00497435100264262,0.0107259443494482
"E02006956",239,285,933,59,226,180,4283,0.055802007938361,0.0665421433574597,0.217837964043894,0.013775391081018,0.0527667522764417,0.042026616857343
"E02006957",299,396,589,71,325,228,2777,0.10767014764134,0.142599927979834,0.212099387828592,0.0255671588044653,0.117032769175369,0.0821029888368743
"E02006958",390,360,793,89,271,301,3759,0.103750997605746,0.0957701516360734,0.210960361798351,0.0236765097100293,0.0720936419260442,0.0800744878957169
"E02006959",55,298,374,11,287,44,10356,0.00531093086133642,0.0287755890305137,0.0361143298570877,0.00106218617226728,0.0277134028582464,0.00424874468906914
"E02006960",113,225,230,24,201,89,7547,0.01497283688883,0.0298131707963429,0.0304756857029283,0.00318007155160991,0.026633099244733,0.0117927653372201
"E02006961",129,512,163,18,494,111,4806,0.0268414481897628,0.106533499791927,0.0339159384103204,0.00374531835205993,0.102788181439867,0.0230961298377029
"E02006962",133,65,207,10,55,123,4040,0.0329207920792079,0.0160891089108911,0.0512376237623762,0.00247524752475248,0.0136138613861386,0.0304455445544554
"E02006963",64,30,0,8,22,56,6585,0.00971905846621109,0.00455580865603645,0,0.00121488230827639,0.00334092634776006,0.0085041761579347
"E02006964",101,42,0,13,29,88,2310,0.0437229437229437,0.0181818181818182,0,0.00562770562770563,0.0125541125541126,0.0380952380952381
"E02006965",252,231,587,49,182,203,2700,0.0933333333333333,0.0855555555555556,0.217407407407407,0.0181481481481481,0.0674074074074074,0.0751851851851852
"E02006966",298,395,415,100,295,198,1826,0.163198247535597,0.21631982475356,0.227272727272727,0.0547645125958379,0.161555312157722,0.108433734939759
"E02006967",469,412,171,154,258,315,2125,0.220705882352941,0.193882352941176,0.0804705882352941,0.0724705882352941,0.121411764705882,0.148235294117647
"E02006968",460,917,1877,82,835,378,3761,0.122307896835948,0.24381813347514,0.499069396437118,0.021802712044669,0.222015421430471,0.100505184791279
"E02006969",206,386,1511,29,357,177,4047,0.0509019026439338,0.0953792933036817,0.373362984927107,0.00716580182851495,0.0882134914751668,0.0437361008154188
"E02006970",210,108,1117,12,96,198,2253,0.0932090545938748,0.0479360852197071,0.495783399911229,0.00532623169107856,0.0426098535286285,0.0878828229027963
"E02006971",274,293,1302,39,254,235,2102,0.13035204567079,0.139391056137012,0.619410085632731,0.0185537583254044,0.120837297811608,0.111798287345385
"E02006972",81,72,274,14,58,67,3287,0.02464253118345,0.0219044721630666,0.0833586857316702,0.00425920292059629,0.0176452692424703,0.0203833282628537
"E02006973",92,493,369,13,480,79,3785,0.0243064729194188,0.130250990752972,0.0974900924702774,0.00343461030383091,0.126816380449141,0.0208718626155878
"E02006974",951,919,1231,301,618,650,4356,0.21831955922865,0.210973370064279,0.282598714416896,0.0691000918273646,0.141873278236915,0.149219467401286
"E02006975",222,440,155,63,377,159,3501,0.0634104541559554,0.125678377606398,0.0442730648386175,0.0179948586118252,0.107683518994573,0.0454155955441303
"E02006976",311,535,83,134,401,177,2470,0.125910931174089,0.216599190283401,0.0336032388663968,0.054251012145749,0.162348178137652,0.0716599190283401
"E02006978",330,380,735,81,299,249,4330,0.0762124711316397,0.0877598152424942,0.169745958429561,0.0187066974595843,0.0690531177829099,0.0575057736720554
"E02006979",391,275,750,53,222,338,4323,0.0904464492250752,0.0636132315521628,0.173490631505899,0.0122600046264168,0.051353226925746,0.0781864445986583
"E02006980",521,408,798,167,241,354,1952,0.266905737704918,0.209016393442623,0.408811475409836,0.0855532786885246,0.123463114754098,0.181352459016393
"E02006981",573,368,609,138,230,435,2436,0.235221674876847,0.151067323481117,0.25,0.0566502463054187,0.0944170771756979,0.178571428571429
"E02006982",921,779,182,281,498,640,3927,0.234530175706646,0.198370257193787,0.0463458110516934,0.0715558950853069,0.12681436210848,0.162974280621339
"E02006983",84,328,135,29,299,55,3591,0.0233918128654971,0.0913394597605124,0.037593984962406,0.00807574491785018,0.0832637148426622,0.0153160679476469
"E02006984",112,110,53,33,77,79,4054,0.0276270350271337,0.0271336951159349,0.0130735076467686,0.00814010853478046,0.0189935865811544,0.0194869264923532
"E02006985",590,906,1607,234,672,356,2632,0.224164133738602,0.344224924012158,0.610562310030395,0.0889057750759878,0.25531914893617,0.135258358662614
"E02006986",390,665,1298,154,511,236,2516,0.155007949125596,0.264308426073132,0.515898251192369,0.06120826709062,0.203100158982512,0.0937996820349762
"E02006987",125,224,620,17,207,108,6308,0.0198161065313887,0.0355104629042486,0.098287888395688,0.00269499048826886,0.0328154724159797,0.0171211160431198
"E02006988",335,530,1730,46,484,289,4005,0.083645443196005,0.132334581772784,0.431960049937578,0.0114856429463171,0.120848938826467,0.0721598002496879
"E02006989",502,268,1910,50,218,452,3082,0.162881245944192,0.0869565217391304,0.619727449707982,0.0162232316677482,0.0707332900713822,0.146658014276444
"E02006990",285,426,1453,33,393,252,5003,0.0569658205076954,0.0851489106536078,0.290425744553268,0.00659604237457526,0.0785528682790326,0.0503697781331201
"E02006991",18,4,389,1,3,17,4863,0.00370141887723627,0.000822537528274727,0.0799917746247173,0.000205634382068682,0.000616903146206046,0.00349578449516759
"E02006992",117,141,721,13,128,104,4576,0.0255681818181818,0.0308129370629371,0.157561188811189,0.00284090909090909,0.027972027972028,0.0227272727272727
"E02006993",76,46,314,8,38,68,4597,0.0165325212094844,0.0100065259952143,0.0683054165760278,0.00174026539047205,0.00826626060474222,0.0147922558190124
"E02006994",172,260,570,28,232,144,3835,0.0448500651890482,0.0677966101694915,0.148631029986962,0.00730117340286832,0.0604954367666232,0.0375488917861799
"E02006995",1,0,0,0,0,1,6238,0.000160307790958641,0,0,0,0,0.000160307790958641
"E02006996",184,247,508,75,172,109,5300,0.0347169811320755,0.0466037735849057,0.0958490566037736,0.0141509433962264,0.0324528301886792,0.0205660377358491
"E02006997",83,84,216,11,73,72,4894,0.0169595422966898,0.0171638741315897,0.0441356763383735,0.00224765018389865,0.014916223947691,0.0147118921127912
"E02006998",178,407,338,31,376,147,3821,0.0465846637006019,0.106516618686208,0.088458518712379,0.0081130594085318,0.098403559277676,0.0384716042920701
"E02006999",84,45,49,7,38,77,7163,0.0117269300572386,0.00628228395923496,0.00684070920005584,0.000977244171436549,0.00530503978779841,0.010749685885802
"E02007000",326,653,310,145,508,181,2048,0.1591796875,0.31884765625,0.1513671875,0.07080078125,0.248046875,0.08837890625
"E02007001",484,793,307,213,580,271,2018,0.2398414271556,0.392963330029732,0.15213082259663,0.105550049554014,0.287413280475719,0.134291377601586
"E02007002",623,579,460,184,395,439,3879,0.160608404227894,0.149265274555298,0.118587264758958,0.0474349059035834,0.101830368651714,0.11317349832431
"E02007003",872,978,1690,218,760,654,4814,0.181138346489406,0.20315745741587,0.351059410054009,0.0452845866223515,0.157872870793519,0.135853759867054
"E02007004",417,276,163,56,220,361,2909,0.143348229632176,0.0948779649364043,0.0560330010312822,0.0192506015812994,0.0756273633551049,0.124097628050877
"E02007005",352,193,798,47,146,305,3427,0.102713743799241,0.0563174788444704,0.232856725999416,0.0137146192004669,0.0426028596440035,0.0889991245987744
"E02007006",305,471,401,132,339,173,3570,0.0854341736694678,0.131932773109244,0.112324929971989,0.0369747899159664,0.0949579831932773,0.0484593837535014
"E02007007",235,399,50,111,288,124,2871,0.0818530128874956,0.138975966562173,0.017415534656914,0.038662486938349,0.100313479623824,0.0431905259491466
"E02007008",80,63,136,8,55,72,4997,0.0160096057634581,0.0126075645387232,0.0272163297978787,0.00160096057634581,0.0110066039623774,0.0144086451871123
"E02007009",406,410,1906,63,347,343,4552,0.0891915641476274,0.0900702987697715,0.41871704745167,0.0138400702987698,0.0762302284710018,0.0753514938488576
"E02007010",292,250,207,62,188,230,3592,0.0812917594654788,0.0695991091314031,0.0576280623608018,0.017260579064588,0.0523385300668151,0.0640311804008909
"E02007011",126,104,91,31,73,95,3817,0.0330102174482578,0.0272465286874509,0.0238407126015195,0.00812156143568247,0.0191249672517684,0.0248886560125753
"E02007012",100,41,17,3,38,97,3228,0.0309789343246592,0.0127013630731103,0.00526641883519207,0.000929368029739777,0.0117719950433705,0.0300495662949195
"E02007013",16,1,0,0,1,16,4590,0.00348583877995643,0.000217864923747277,0,0,0.000217864923747277,0.00348583877995643
"E02007014",457,75,3,14,61,443,2706,0.168883961566888,0.0277161862527716,0.00110864745011086,0.00517368810051737,0.0225424981522542,0.163710273466371
"E02007015",184,135,129,47,88,137,5105,0.0360430950048972,0.0264446620959843,0.0252693437806072,0.00920666013712047,0.0172380019588639,0.0268364348677767
"E02007016",241,81,8,20,61,221,3558,0.067734682405846,0.0227655986509275,0.00224845418774592,0.00562113546936481,0.0171444631815627,0.0621135469364812
"E02007017",423,364,956,103,261,320,2343,0.180537772087068,0.155356380708493,0.408023900981647,0.0439607341015792,0.111395646606914,0.136577037985489
"E02007018",431,219,954,38,181,393,2540,0.169685039370079,0.0862204724409449,0.375590551181102,0.0149606299212598,0.071259842519685,0.154724409448819
"E02007019",291,78,1015,15,63,276,3170,0.0917981072555205,0.0246056782334385,0.32018927444795,0.00473186119873817,0.0198738170347003,0.0870662460567823
"E02007020",503,108,2027,31,77,472,2351,0.213951509995746,0.0459378987664823,0.862186303700553,0.0131858783496385,0.0327520204168439,0.200765631646108
"E02007021",361,496,621,103,393,258,2707,0.133357960842261,0.183228666420392,0.229405245659402,0.0380495012929442,0.145179165127447,0.0953084595493166
"E02007022",897,728,1875,185,543,712,5155,0.174005819592629,0.141222114451988,0.36372453928225,0.0358874878758487,0.10533462657614,0.13811833171678
"E02007023",330,379,90,116,263,214,2850,0.115789473684211,0.132982456140351,0.0315789473684211,0.0407017543859649,0.092280701754386,0.0750877192982456
"E02007024",402,309,506,86,223,316,2998,0.134089392928619,0.103068712474983,0.168779186124083,0.028685790527018,0.0743829219479653,0.105403602401601
"E02007025",452,449,104,143,306,309,3253,0.138948662772825,0.138026437134952,0.0319704887795881,0.0439594220719336,0.0940670150630187,0.0949892407008915
"E02007026",160,371,129,50,321,110,3015,0.0530679933665008,0.123051409618574,0.0427860696517413,0.0165837479270315,0.106467661691542,0.0364842454394693
"E02007027",539,408,443,138,270,401,4984,0.10814606741573,0.0818619582664527,0.088884430176565,0.0276886035313002,0.0541733547351525,0.0804574638844302
"E02007028",2,4,5,1,3,1,3291,0.000607718018839259,0.00121543603767852,0.00151929504709815,0.000303859009419629,0.000911577028258888,0.000303859009419629
"E02007029",738,600,1599,156,444,582,4233,0.174344436569809,0.141743444365698,0.377746279234585,0.0368532955350815,0.104890148830617,0.137491141034727
"E02007030",247,151,405,53,98,194,3208,0.0769950124688279,0.047069825436409,0.126246882793017,0.0165211970074813,0.0305486284289277,0.0604738154613466
"E02007031",305,287,299,76,211,229,3022,0.100926538716082,0.0949702183984116,0.0989410986101919,0.0251489080079418,0.0698213103904699,0.0757776307081403
"E02007032",538,267,277,92,175,446,2733,0.196853274789608,0.0976948408342481,0.101353823637029,0.0336626417855836,0.0640321990486645,0.163190633004025
"E02007033",424,263,335,106,157,318,2538,0.167060677698976,0.103624901497242,0.131993695823483,0.0417651694247439,0.061859732072498,0.125295508274232
"E02007034",311,185,35,54,131,257,3641,0.0854160944795386,0.050810216973359,0.00961274375171656,0.0148310903597913,0.0359791266135677,0.0705850041197473
"E02007035",546,476,104,164,312,382,2672,0.204341317365269,0.17814371257485,0.0389221556886228,0.061377245508982,0.116766467065868,0.142964071856287
"E02007038",652,716,2021,143,573,509,5099,0.127868209452834,0.140419690135321,0.396352225926652,0.0280447146499314,0.112374975485389,0.0998234948029025
"E02007039",414,238,1491,62,176,352,2008,0.206175298804781,0.118525896414343,0.742529880478088,0.0308764940239044,0.0876494023904383,0.175298804780877
"E02007040",309,132,1735,19,113,290,2043,0.151248164464024,0.0646108663729809,0.849241311796378,0.00930004894762604,0.0553108174253549,0.141948115516397
"E02007041",806,622,1483,217,405,589,3822,0.210884353741497,0.162742019884877,0.388016745159602,0.0567765567765568,0.10596546310832,0.15410779696494
"E02007042",250,454,250,76,378,174,2776,0.0900576368876081,0.163544668587896,0.0900576368876081,0.0273775216138329,0.136167146974063,0.0626801152737752
"E02007043",217,216,434,48,168,169,2712,0.0800147492625369,0.079646017699115,0.160029498525074,0.0176991150442478,0.0619469026548673,0.0623156342182891
"E02007044",380,251,586,70,181,310,3523,0.107862617087709,0.0712460970763554,0.166335509508941,0.0198694294635254,0.05137666761283,0.0879931876241839
"E02007045",503,374,602,131,243,372,2429,0.207081103334706,0.153972828324413,0.247838616714697,0.053931659118979,0.100041169205434,0.153149444215727
"E02007046",439,719,208,181,538,258,2540,0.172834645669291,0.283070866141732,0.0818897637795276,0.071259842519685,0.211811023622047,0.101574803149606
"E02007047",275,342,173,89,253,186,3407,0.0807161725858527,0.100381567361315,0.0507778103903728,0.0261226885823305,0.0742588787789844,0.0545934840035222
"E02007048",413,261,570,90,171,323,2330,0.17725321888412,0.112017167381974,0.244635193133047,0.0386266094420601,0.0733905579399142,0.13862660944206
"E02007049",128,103,169,29,74,99,4520,0.0283185840707965,0.022787610619469,0.0373893805309735,0.00641592920353982,0.0163716814159292,0.0219026548672566
"E02007050",325,152,48,35,117,290,3705,0.087719298245614,0.041025641025641,0.0129554655870445,0.00944669365721997,0.0315789473684211,0.0782726045883941
"E02007051",157,119,144,20,99,137,4028,0.0389771598808342,0.0295431976166832,0.0357497517378352,0.00496524329692155,0.0245779543197617,0.0340119165839126
"E02007052",539,319,1100,84,235,455,3865,0.139456662354463,0.0825355756791721,0.284605433376455,0.0217335058214748,0.0608020698576973,0.117723156532988
"E02007053",268,186,727,35,151,233,3549,0.0755142293603832,0.0524091293322063,0.204846435615666,0.00986193293885602,0.0425471963933502,0.0656522964215272
"E02007054",201,125,133,52,73,149,3602,0.0558023320377568,0.0347029428095502,0.0369239311493615,0.0144364242087729,0.0202665186007773,0.0413659078289839
"E02007055",488,372,94,158,214,330,2786,0.17516152189519,0.133524766690596,0.0337401292175162,0.0567121320890165,0.0768126346015793,0.118449389806174
"E02007056",186,231,128,71,160,115,3903,0.0476556495003843,0.059185242121445,0.0327952856776838,0.0181911350243403,0.0409941070971048,0.0294645144760441
"E02007057",249,250,228,73,177,176,3154,0.0789473684210526,0.0792644261255549,0.072289156626506,0.023145212428662,0.0561192136968928,0.0558021559923906
"E02007058",1016,1010,4733,153,857,863,6849,0.148342823769893,0.14746678347204,0.691049788290261,0.0223390275952694,0.12512775587677,0.126003796174624
"E02007059",787,858,1770,176,682,611,5340,0.147378277153558,0.160674157303371,0.331460674157303,0.0329588014981273,0.127715355805243,0.114419475655431
"E02007060",377,216,636,66,150,311,3952,0.0953947368421053,0.0546558704453441,0.160931174089069,0.0167004048582996,0.0379554655870445,0.0786943319838057
"E02007061",307,258,665,44,214,263,3712,0.0827047413793103,0.0695043103448276,0.179148706896552,0.0118534482758621,0.0576508620689655,0.0708512931034483
"E02007062",100,113,0,20,93,80,2702,0.0370096225018505,0.041820873427091,0,0.0074019245003701,0.0344189489267209,0.0296076980014804
"E02007063",188,211,0,63,148,125,2505,0.0750499001996008,0.0842315369261477,0,0.0251497005988024,0.0590818363273453,0.0499001996007984
"E02007064",538,749,242,229,520,309,2549,0.211063162024323,0.293840721851707,0.0949391918399372,0.0898391526088662,0.20400156924284,0.121224009415457
"E02007065",223,302,81,101,201,122,3730,0.0597855227882038,0.0809651474530831,0.02171581769437,0.0270777479892761,0.053887399463807,0.0327077747989276
"E02007066",199,116,31,44,72,155,3877,0.0513283466597885,0.0299200412690224,0.007995873097756,0.0113489811710085,0.0185710600980139,0.03997936548878
"E02007067",244,351,314,74,277,170,3079,0.0792465086066905,0.113998051315362,0.101981162715167,0.0240337772003897,0.0899642741149724,0.0552127314063007
"E02007068",270,183,611,60,123,210,3152,0.0856598984771574,0.0580583756345178,0.193845177664975,0.0190355329949239,0.0390228426395939,0.0666243654822335
"E02007069",358,482,490,156,326,202,2046,0.174975562072336,0.235581622678397,0.239491691104594,0.0762463343108504,0.159335288367546,0.0987292277614858
"E02007070",217,187,348,55,132,162,1990,0.109045226130653,0.0939698492462312,0.174874371859296,0.0276381909547739,0.0663316582914573,0.0814070351758794
"E02007071",407,287,527,89,198,318,3775,0.107814569536424,0.0760264900662252,0.139602649006623,0.0235761589403974,0.0524503311258278,0.0842384105960265
"E02007072",62,59,18,11,48,51,4011,0.0154574918972825,0.0147095487409624,0.00448765893792072,0.00274245823984044,0.0119670905011219,0.012715033657442
"E02007073",267,85,1,35,50,232,2818,0.0947480482611781,0.0301632363378282,0.00035486160397445,0.0124201561391057,0.0177430801987225,0.0823278921220724
"E02007074",169,624,273,41,583,128,3969,0.0425799949609473,0.157218442932729,0.0687830687830688,0.0103300579491056,0.146888384983623,0.0322499370118418
"E02007075",94,98,231,8,90,86,4328,0.0217190388170055,0.0226432532347505,0.0533733826247689,0.00184842883548983,0.0207948243992606,0.0198706099815157
"E02007076",138,113,53,39,74,99,3789,0.0364212193190816,0.0298231723409871,0.0139878595935603,0.0102929532858274,0.0195302190551597,0.0261282660332542
"E02007077",94,165,13,49,116,45,3238,0.0290302655960469,0.0509573810994441,0.00401482396541075,0.0151327980234713,0.0358245830759728,0.0138974675725757
"E02007078",328,371,100,99,272,229,2292,0.143106457242583,0.161867364746946,0.043630017452007,0.0431937172774869,0.118673647469459,0.099912739965096
"E02007079",217,329,17,67,262,150,3084,0.0703631647211414,0.106679636835279,0.00551232166018158,0.0217250324254215,0.0849546044098573,0.0486381322957198
"E02007080",46,47,0,5,42,41,3667,0.0125443141532588,0.0128170166348514,0,0.00136351240796291,0.0114535042268885,0.0111808017452959
"E02007081",696,587,2063,156,431,540,3838,0.181344450234497,0.1529442417926,0.537519541427827,0.0406461698801459,0.112298071912454,0.140698280354351
"E02007082",638,446,2306,109,337,529,5457,0.116914055341763,0.081729888216969,0.422576507238409,0.0199743448781382,0.0617555433388309,0.0969397104636247
"E02007083",14,48,112,0,48,14,9228,0.00151712180320763,0.00520156046814044,0.012136974425661,0,0.00520156046814044,0.00151712180320763
"E02007084",151,196,1539,11,185,140,4187,0.0360640076427036,0.0468115595892047,0.367566276570337,0.00262717936470026,0.0441843802245044,0.0334368282780033
"E02007085",711,754,550,214,540,497,4360,0.163073394495413,0.172935779816514,0.126146788990826,0.0490825688073395,0.123853211009174,0.113990825688073
"E02007086",198,291,291,60,231,138,4888,0.0405073649754501,0.0595335515548282,0.0595335515548282,0.0122749590834697,0.0472585924713584,0.0282324058919804
"E02007087",158,143,486,21,122,137,2645,0.0597353497164461,0.0540642722117202,0.183742911153119,0.00793950850661626,0.046124763705104,0.0517958412098299
"E02007088",534,346,616,123,223,411,2641,0.202196137826581,0.131010980689133,0.233244982961,0.0465732677016282,0.0844377129875047,0.155622870124953
"E02007089",213,206,119,35,171,178,2631,0.080957810718358,0.0782972253895857,0.0452299505891296,0.0133029266438616,0.0649942987457241,0.0676548840744964
"E02007090",285,313,337,90,223,195,1978,0.144084934277048,0.158240647118301,0.170374115267947,0.0455005055611729,0.112740141557128,0.0985844287158746
"E02007091",375,260,18,80,180,295,1964,0.190936863543788,0.132382892057026,0.00916496945010183,0.0407331975560081,0.0916496945010183,0.15020366598778
"E02007092",404,403,256,141,262,263,2175,0.185747126436782,0.185287356321839,0.117701149425287,0.0648275862068965,0.120459770114943,0.120919540229885
"E02007093",482,472,503,174,298,308,2538,0.189913317572892,0.185973207249803,0.198187549251379,0.0685579196217494,0.117415287628054,0.121355397951143
"E02007094",445,564,1039,156,408,289,3064,0.14523498694517,0.184073107049608,0.339099216710183,0.0509138381201044,0.133159268929504,0.0943211488250653
"E02007095",168,232,134,59,173,109,5184,0.0324074074074074,0.0447530864197531,0.0258487654320988,0.0113811728395062,0.0333719135802469,0.0210262345679012
"E02007096",230,359,46,111,248,119,1842,0.12486427795874,0.194896851248643,0.0249728555917481,0.0602605863192182,0.134636264929425,0.0646036916395223
"E02007097",532,673,1810,106,567,426,3176,0.167506297229219,0.211901763224181,0.569899244332494,0.033375314861461,0.17852644836272,0.134130982367758
"E02007098",240,714,338,82,632,158,2900,0.0827586206896552,0.246206896551724,0.116551724137931,0.0282758620689655,0.217931034482759,0.0544827586206897
"E02007099",227,301,1207,25,276,202,4556,0.0498244073748903,0.0660667251975417,0.264925373134328,0.00548726953467954,0.0605794556628622,0.0443371378402107
"E02007100",73,137,312,2,135,71,3238,0.022544780728845,0.0423100679431748,0.0963557751698579,0.000617665225447807,0.041692402717727,0.0219271155033972
"E02007101",428,715,1475,123,592,305,3369,0.127040664885723,0.212229148115168,0.437815375482339,0.0365093499554764,0.175719798159691,0.0905313149302464
"E02007102",193,402,475,39,363,154,2625,0.0735238095238095,0.153142857142857,0.180952380952381,0.0148571428571429,0.138285714285714,0.0586666666666667
"E02007103",195,699,230,43,656,152,3123,0.0624399615754083,0.223823246878002,0.0736471341658662,0.0137688120397054,0.210054434838296,0.0486711495357028
"E02007104",225,213,606,33,180,192,2235,0.100671140939597,0.0953020134228188,0.271140939597315,0.0147651006711409,0.0805369127516778,0.0859060402684564
"E02007105",581,692,246,215,477,366,4381,0.132618123716047,0.157954804839078,0.0561515635699612,0.0490755535265921,0.108879251312486,0.0835425701894545
"E02007106",639,580,82,162,418,477,4263,0.149894440534835,0.136054421768707,0.0192352803190242,0.0380014074595355,0.0980530143091719,0.111893033075299
"E02007107",525,591,1089,168,423,357,3305,0.158850226928896,0.178819969742814,0.329500756429652,0.0508320726172466,0.127987897125567,0.108018154311649
"E02007108",179,141,1205,21,120,158,3587,0.0499024254251464,0.0393086144410371,0.335935321996097,0.00585447449121829,0.0334541399498188,0.0440479509339281
"E02007109",212,349,1119,47,302,165,3233,0.0655737704918033,0.10794927312094,0.34611815651098,0.0145375811939375,0.0934116919270028,0.0510361892978658
"E02007110",53,395,949,9,386,44,4219,0.0125622185351979,0.093624081535909,0.224934818677412,0.00213320692107134,0.0914908746148376,0.0104290116141266
"E02007111",44,187,1249,0,187,44,4906,0.00896860986547085,0.0381165919282511,0.254586220953934,0,0.0381165919282511,0.00896860986547085
"E02007112",0,4,10,0,4,0,4934,0,0.000810701256586948,0.00202675314146737,0,0.000810701256586948,0
"E02007113",32,47,170,2,45,30,6622,0.00483237692540018,0.00709755360918152,0.0256720024161885,0.000302023557837511,0.006795530051344,0.00453035336756267
"E02007114",109,271,189,28,243,81,4103,0.0265659273702169,0.0660492322690714,0.0460638557153302,0.00682427492078967,0.0592249573482817,0.0197416524494272
"E02007115",157,195,2756,3,192,154,5146,0.0305091333074232,0.0378935095219588,0.535561601243684,0.000582977069568597,0.0373105324523902,0.0299261562378546
"E02007116",361,550,769,116,434,245,2992,0.120655080213904,0.183823529411765,0.25701871657754,0.0387700534759358,0.145053475935829,0.0818850267379679
"W02000001",781,917,1277,271,646,510,3910,0.199744245524297,0.234526854219949,0.326598465473146,0.069309462915601,0.165217391304348,0.130434782608696
"W02000002",596,536,698,201,335,395,2608,0.228527607361963,0.205521472392638,0.267638036809816,0.0770705521472393,0.128450920245399,0.151457055214724
"W02000003",819,760,1737,183,577,636,5143,0.159245576511764,0.147773672953529,0.337740618316158,0.0355823449348629,0.112191328018666,0.123663231576901
"W02000004",589,611,750,199,412,390,3277,0.179737564845896,0.186451022276472,0.22886786695148,0.060726274031126,0.125724748245346,0.11901129081477
"W02000005",707,752,946,238,514,469,3617,0.195465855681504,0.207907105335914,0.261542714957147,0.0658003870611004,0.142106718274813,0.129665468620404
"W02000006",390,604,343,119,485,271,2963,0.131623354708066,0.203847451906851,0.115761052986838,0.0401619979750253,0.163685453931826,0.0914613567330408
"W02000007",598,794,743,198,596,400,3023,0.197816738339398,0.262652993714853,0.245782335428382,0.0654978498180615,0.197155143896791,0.132318888521336
"W02000008",406,401,407,124,277,282,2337,0.173727000427899,0.171587505348738,0.174154899443731,0.0530594779632007,0.118528027385537,0.120667522464698
"W02000009",624,510,805,170,340,454,3005,0.20765391014975,0.169717138103161,0.267886855241265,0.0565723793677205,0.113144758735441,0.15108153078203
"W02000010",657,447,1383,99,348,558,3497,0.187875321704318,0.12782384901344,0.395481841578496,0.0283099799828424,0.0995138690305977,0.159565341721476
"W02000011",411,620,447,166,454,245,2772,0.148268398268398,0.223665223665224,0.161255411255411,0.0598845598845599,0.163780663780664,0.0883838383838384
"W02000012",469,470,1249,111,359,358,2551,0.183849470795766,0.184241473931791,0.489611916895335,0.0435123480987848,0.140729125833007,0.140337122696982
"W02000013",386,455,708,125,330,261,2064,0.187015503875969,0.220445736434109,0.343023255813953,0.060562015503876,0.159883720930233,0.126453488372093
"W02000014",496,452,1125,134,318,362,2374,0.208930075821398,0.190395956192081,0.473883740522325,0.0564448188711036,0.133951137320977,0.152485256950295
"W02000015",462,530,768,98,432,364,3028,0.152575957727873,0.175033025099075,0.253632760898283,0.0323645970937913,0.142668428005284,0.120211360634082
"W02000016",503,511,911,142,369,361,2137,0.235376696303229,0.239120262049602,0.426298549368273,0.0664482919981282,0.172671970051474,0.168928404305101
"W02000017",560,542,1306,151,391,409,2673,0.209502431724654,0.202768424990647,0.488589599700711,0.056490834268612,0.146277590722035,0.153011597456042
"W02000018",607,510,1525,144,366,463,2395,0.253444676409186,0.21294363256785,0.636743215031315,0.060125260960334,0.152818371607516,0.193319415448852
"W02000019",589,656,1171,178,478,411,2659,0.221511846558857,0.246709289206469,0.440391124482888,0.0669424595712674,0.179766829635201,0.154569386987589
"W02000020",587,493,1126,172,321,415,2332,0.251715265866209,0.211406518010292,0.482847341337907,0.0737564322469983,0.137650085763293,0.177958833619211
"W02000021",623,692,1336,152,540,471,3090,0.201618122977346,0.223948220064725,0.432362459546926,0.0491909385113269,0.174757281553398,0.152427184466019
"W02000022",554,595,844,180,415,374,2415,0.229399585921325,0.246376811594203,0.349482401656315,0.0745341614906832,0.17184265010352,0.154865424430642
"W02000023",631,628,907,234,394,397,2419,0.260851591566763,0.259611409673419,0.374948325754444,0.0967341876808599,0.162877221992559,0.164117403885903
"W02000024",390,277,897,80,197,310,1934,0.201654601861427,0.143226473629783,0.463805584281282,0.0413650465356774,0.101861427094105,0.16028955532575
"W02000025",603,369,1279,116,253,487,2695,0.223747680890538,0.136920222634508,0.474582560296846,0.0430426716141002,0.0938775510204082,0.180705009276438
"W02000026",796,824,1115,253,571,543,3699,0.215193295485266,0.222762908894296,0.301432819680995,0.068396864017302,0.154366044876994,0.146796431467964
"W02000027",865,758,2320,170,588,695,5013,0.172551366447237,0.151206862158388,0.462796728505885,0.0339118292439657,0.117295032914423,0.138639537203271
"W02000028",563,708,385,202,506,361,2781,0.202445163610212,0.254584681769148,0.13843941028407,0.0726357425386552,0.181948939230493,0.129809421071557
"W02000029",542,561,459,206,355,336,2272,0.238556338028169,0.246919014084507,0.202024647887324,0.090669014084507,0.15625,0.147887323943662
"W02000030",609,650,898,156,494,453,2983,0.204156889037881,0.217901441501844,0.30103922225947,0.0522963459604425,0.165605095541401,0.151860543077439
"W02000031",632,548,252,169,379,463,2989,0.211441953830713,0.183338909334226,0.0843091334894614,0.0565406490465038,0.126798260287722,0.154901304784209
"W02000032",653,860,605,265,595,388,3573,0.182759585782256,0.240694094598377,0.169325496781416,0.0741673663588021,0.166526728239575,0.108592219423454
"W02000033",535,361,2027,82,279,453,3535,0.151343705799151,0.102121640735502,0.573408769448373,0.0231966053748232,0.0789250353606789,0.128147100424328
"W02000034",607,581,688,161,420,446,3167,0.191664035364698,0.183454373223871,0.217240290495737,0.050836754025892,0.132617619197979,0.140827281338806
"W02000035",833,754,1175,223,531,610,3696,0.225378787878788,0.204004329004329,0.317911255411255,0.0603354978354978,0.143668831168831,0.16504329004329
"W02000036",1028,754,946,267,487,761,5004,0.205435651478817,0.150679456434852,0.189048760991207,0.0533573141486811,0.0973221422861711,0.152078337330136
"W02000037",578,648,657,180,468,398,2672,0.216317365269461,0.24251497005988,0.245883233532934,0.0673652694610778,0.175149700598802,0.148952095808383
"W02000038",518,462,881,146,316,372,2684,0.192995529061103,0.172131147540984,0.328241430700447,0.0543964232488823,0.117734724292101,0.138599105812221
"W02000039",556,538,1326,149,389,407,3109,0.178835638468961,0.173045995496944,0.426503698938565,0.0479253779350273,0.125120617561917,0.130910260533934
"W02000040",580,424,908,168,256,412,2119,0.273714016045304,0.200094384143464,0.428504011326097,0.0792826805096744,0.12081170363379,0.19443133553563
"W02000041",808,580,1544,192,388,616,3347,0.241410218105766,0.173289512996713,0.461308634598148,0.0573648043023603,0.115924708694353,0.184045413803406
"W02000042",536,643,321,222,421,314,2385,0.224737945492662,0.269601677148847,0.134591194968553,0.0930817610062893,0.176519916142558,0.131656184486373
"W02000043",346,451,611,113,338,233,2015,0.171712158808933,0.223821339950372,0.303225806451613,0.0560794044665012,0.167741935483871,0.115632754342432
"W02000044",447,540,241,179,361,268,1947,0.229583975346687,0.277349768875193,0.123780174627632,0.0919363122752953,0.185413456599897,0.137647663071392
"W02000045",801,813,2621,205,608,596,4936,0.162277147487844,0.164708265802269,0.530996758508914,0.0415316045380875,0.123176661264182,0.120745542949757
"W02000047",272,503,575,105,398,167,1879,0.14475784992017,0.267695582756786,0.306013837147419,0.0558807876530069,0.211814795103779,0.0888770622671634
"W02000049",510,499,632,156,343,354,2489,0.204901566894335,0.200482121333869,0.253917235837686,0.0626757734029731,0.137806347930896,0.142225793491362
"W02000050",437,447,335,138,309,299,2213,0.197469498418437,0.201988251242657,0.151378219611387,0.0623587889742431,0.139629462268414,0.135110709444193
"W02000051",381,372,379,121,251,260,2123,0.17946302402261,0.175223739990579,0.178520960904381,0.0569948186528497,0.11822892133773,0.12246820536976
"W02000052",409,371,1012,73,298,336,2429,0.168382050226431,0.152737752161383,0.416632358995471,0.0300535199670646,0.122684232194319,0.138328530259366
"W02000053",376,362,433,109,253,267,2044,0.183953033268102,0.177103718199609,0.211839530332681,0.0533268101761252,0.123776908023483,0.130626223091977
"W02000054",427,334,623,94,240,333,1914,0.223092998955068,0.174503657262278,0.325496342737722,0.0491118077324974,0.125391849529781,0.173981191222571
"W02000055",414,378,518,101,277,313,2297,0.180235089246844,0.164562472790596,0.225511536787114,0.043970396168916,0.12059207662168,0.136264693077928
"W02000056",440,275,719,92,183,348,1751,0.251284980011422,0.157053112507139,0.410622501427756,0.0525414049114792,0.10451170759566,0.198743575099943
"W02000057",523,342,900,118,224,405,2446,0.213818479149632,0.139820114472608,0.367947669664759,0.0482420278004906,0.0915780866721177,0.165576451349141
"W02000058",385,355,686,110,245,275,2093,0.183946488294314,0.169612995699952,0.327759197324415,0.0525561395126612,0.117056856187291,0.131390348781653
"W02000059",461,518,393,168,350,293,2473,0.186413263243025,0.209462191670036,0.158916295996765,0.0679336837848767,0.14152850788516,0.118479579458148
"W02000060",551,648,717,171,477,380,4043,0.136284936928024,0.160277022013356,0.177343556764779,0.0422953252535246,0.117981696759832,0.0939896116744991
"W02000061",265,481,528,89,392,176,3280,0.0807926829268293,0.146646341463415,0.160975609756098,0.0271341463414634,0.119512195121951,0.0536585365853659
"W02000062",320,303,154,85,218,235,1535,0.208469055374593,0.197394136807818,0.100325732899023,0.0553745928338762,0.142019543973941,0.153094462540717
"W02000063",547,411,785,142,269,405,2580,0.212015503875969,0.159302325581395,0.304263565891473,0.0550387596899225,0.104263565891473,0.156976744186047
"W02000064",282,293,495,84,209,198,2424,0.116336633663366,0.120874587458746,0.204207920792079,0.0346534653465347,0.0862211221122112,0.0816831683168317
"W02000065",407,314,269,106,208,301,2162,0.188251618871415,0.145235892691952,0.124421831637373,0.0490286771507863,0.0962072155411656,0.139222941720629
"W02000066",499,525,1011,122,403,377,4206,0.118640038040894,0.124821683309558,0.24037089871612,0.0290061816452687,0.0958155016642891,0.0896338563956253
"W02000067",321,255,145,90,165,231,1774,0.180947012401353,0.143742953776776,0.0817361894024803,0.0507328072153326,0.0930101465614431,0.13021420518602
"W02000068",283,300,501,98,202,185,1809,0.156440022111664,0.165837479270315,0.276948590381426,0.0541735765616363,0.111663902708679,0.102266445550028
"W02000069",351,220,293,76,144,275,2021,0.17367639782286,0.108857001484414,0.144977733795151,0.0376051459673429,0.0712518555170708,0.136071251855517
"W02000070",561,371,357,131,240,430,3239,0.173201605433776,0.114541525162087,0.110219203457857,0.0404445816610065,0.0740969435010806,0.132757023772769
"W02000071",414,362,196,136,226,278,1919,0.215737363210005,0.188639916623241,0.102136529442418,0.0708702449192288,0.117769671704013,0.144867118290776
"W02000072",599,561,458,189,372,410,4071,0.14713829525915,0.137803979366249,0.112503070498649,0.0464259395725866,0.0913780397936625,0.100712355686564
"W02000073",523,439,522,113,326,410,3744,0.139690170940171,0.117254273504274,0.139423076923077,0.0301816239316239,0.0870726495726496,0.109508547008547
"W02000074",509,511,467,138,373,371,3680,0.138315217391304,0.138858695652174,0.126902173913043,0.0375,0.101358695652174,0.100815217391304
"W02000075",265,225,168,77,148,188,2139,0.123889668069191,0.105189340813464,0.0785413744740533,0.0359981299672744,0.0691912108461898,0.0878915381019168
"W02000076",390,390,575,105,285,285,2413,0.161624533775383,0.161624533775383,0.238292581848322,0.0435142975549109,0.118110236220472,0.118110236220472
"W02000077",291,338,459,77,261,214,1802,0.161487236403996,0.187569367369589,0.254716981132075,0.0427302996670366,0.144839067702553,0.118756936736959
"W02000080",251,274,297,67,207,184,2650,0.0947169811320755,0.103396226415094,0.112075471698113,0.0252830188679245,0.0781132075471698,0.0694339622641509
"W02000081",222,187,181,55,132,167,1771,0.125352907961604,0.105590062111801,0.102202145680407,0.031055900621118,0.0745341614906832,0.0942970073404856
"W02000082",284,306,594,59,247,225,2699,0.10522415709522,0.113375324194146,0.220081511670989,0.0218599481289366,0.0915153760652093,0.0833642089662838
"W02000083",286,293,519,75,218,211,3069,0.0931899641577061,0.0954708374063213,0.16911045943304,0.0244379276637341,0.0710329097425872,0.068752036493972
"W02000085",420,485,725,120,365,300,3209,0.130881894671237,0.151137425989405,0.225927080087255,0.0373948270489249,0.11374259894048,0.0934870676223123
"W02000087",159,140,91,26,114,133,2350,0.0676595744680851,0.0595744680851064,0.0387234042553192,0.011063829787234,0.0485106382978723,0.0565957446808511
"W02000088",392,330,1298,52,278,340,3540,0.110734463276836,0.0932203389830508,0.366666666666667,0.0146892655367232,0.0785310734463277,0.096045197740113
"W02000089",299,343,814,47,296,252,3566,0.0838474481211441,0.0961862030286035,0.228266965787998,0.0131800336511497,0.0830061693774537,0.0706674144699944
"W02000090",268,258,291,75,183,193,1622,0.165228113440197,0.159062885326757,0.17940813810111,0.0462392108508015,0.112823674475956,0.118988902589396
"W02000091",233,284,388,63,221,170,1845,0.126287262872629,0.153929539295393,0.21029810298103,0.0341463414634146,0.119783197831978,0.0921409214092141
"W02000092",236,349,621,72,277,164,2487,0.0948934459187776,0.14032971451548,0.249698431845597,0.0289505428226779,0.111379171692803,0.0659429030960997
"W02000093",283,235,498,65,170,218,2039,0.138793526238352,0.115252574791564,0.244237371260422,0.0318783717508583,0.0833742030407062,0.106915154487494
"W02000094",353,341,555,87,254,266,3061,0.115321790264619,0.11140150277687,0.181313296308396,0.028422084286181,0.0829794184906893,0.0868997059784384
"W02000095",331,248,541,77,171,254,1980,0.167171717171717,0.125252525252525,0.273232323232323,0.0388888888888889,0.0863636363636364,0.128282828282828
"W02000096",404,271,545,97,174,307,2144,0.188432835820896,0.126399253731343,0.25419776119403,0.0452425373134328,0.0811567164179104,0.143190298507463
"W02000097",753,368,1128,133,235,620,3104,0.242590206185567,0.118556701030928,0.36340206185567,0.0428479381443299,0.0757087628865979,0.199742268041237
"W02000098",422,236,357,87,149,335,2050,0.205853658536585,0.115121951219512,0.174146341463415,0.0424390243902439,0.0726829268292683,0.163414634146341
"W02000099",396,327,511,94,233,302,2778,0.142548596112311,0.117710583153348,0.18394528437725,0.0338372930165587,0.0838732901367891,0.108711303095752
"W02000100",530,341,851,119,222,411,2203,0.240581025873808,0.154788924194281,0.386291420789832,0.0540172492056287,0.100771674988652,0.18656377666818
"W02000101",431,219,443,90,129,341,1863,0.231347289318304,0.117552334943639,0.237788513150832,0.0483091787439614,0.0692431561996779,0.183038110574342
"W02000102",496,299,564,122,177,374,2038,0.243375858684985,0.146712463199215,0.276741903827282,0.0598626104023552,0.0868498527968597,0.18351324828263
"W02000103",410,218,413,100,118,310,1900,0.215789473684211,0.114736842105263,0.217368421052632,0.0526315789473684,0.0621052631578947,0.163157894736842
"W02000104",404,356,514,108,248,296,2729,0.148039574935874,0.130450714547453,0.188347379992671,0.0395749358739465,0.0908757786735068,0.108464639061927
"W02000105",261,235,64,64,171,197,2164,0.120609981515712,0.108595194085028,0.0295748613678373,0.0295748613678373,0.0790203327171904,0.0910351201478743
"W02000106",531,356,814,129,227,402,2405,0.220790020790021,0.148024948024948,0.338461538461538,0.0536382536382536,0.0943866943866944,0.167151767151767
"W02000107",805,536,1004,183,353,622,3644,0.220911086717892,0.147091108671789,0.275521405049396,0.0502195389681668,0.0968715697036224,0.170691547749726
"W02000108",590,404,615,149,255,441,2429,0.242898312062577,0.166323589954714,0.253190613421161,0.0613421160971593,0.104981473857555,0.181556195965418
"W02000109",382,460,595,92,368,290,2732,0.139824304538799,0.168374816983895,0.217789165446559,0.0336749633967789,0.134699853587116,0.106149341142021
"W02000110",584,359,940,112,247,472,2527,0.231104075979422,0.142065690542145,0.37198258804907,0.0443213296398892,0.0977443609022556,0.186782746339533
"W02000111",614,413,842,148,265,466,3079,0.199415394608639,0.134134459240013,0.273465410847678,0.0480675544007795,0.0860669048392335,0.15134784020786
"W02000113",576,664,751,146,518,430,3379,0.170464634507251,0.19650784255697,0.222255105060669,0.0432080497188517,0.153299792838118,0.127256584788399
"W02000114",418,458,728,121,337,297,2280,0.183333333333333,0.200877192982456,0.319298245614035,0.0530701754385965,0.14780701754386,0.130263157894737
"W02000116",578,524,723,190,334,388,2562,0.225604996096799,0.204527712724434,0.282201405152225,0.0741608118657299,0.130366900858704,0.151444184231069
"W02000117",695,366,1848,110,256,585,3559,0.19527957291374,0.102837875807811,0.51924697948862,0.0309075583028941,0.0719303175049171,0.164372014610846
"W02000118",372,526,430,137,389,235,2637,0.141069397042093,0.199469093667046,0.163064087978764,0.0519529768676526,0.147516116799393,0.0891164201744407
"W02000120",513,491,953,131,360,382,2700,0.19,0.181851851851852,0.352962962962963,0.0485185185185185,0.133333333333333,0.141481481481481
"W02000122",581,483,1020,165,318,416,2648,0.219410876132931,0.182401812688822,0.385196374622357,0.0623111782477341,0.120090634441088,0.157099697885196
"W02000123",576,498,1033,147,351,429,2794,0.206156048675734,0.178239083750895,0.369720830350752,0.0526127415891195,0.125626342161775,0.153543307086614
"W02000124",938,831,1138,303,528,635,4252,0.220602069614299,0.195437441204139,0.267638758231421,0.0712605832549389,0.1241768579492,0.14934148635936
"W02000125",761,513,1155,185,328,576,3013,0.252572187188848,0.170262197145702,0.383338864918686,0.0614005974112181,0.108861599734484,0.19117158977763
"W02000126",776,564,1223,235,329,541,2954,0.262694651320244,0.190927555856466,0.414014895057549,0.0795531482735274,0.111374407582938,0.183141503046716
"W02000127",875,778,1338,294,484,581,3677,0.237965732934457,0.211585531683438,0.36388360076149,0.0799564862659777,0.13162904541746,0.15800924666848
"W02000128",673,511,871,218,293,455,2698,0.249444032616753,0.189399555226093,0.322831727205337,0.0808005930318755,0.108598962194218,0.168643439584878
"W02000129",512,428,607,179,249,333,2248,0.227758007117438,0.190391459074733,0.270017793594306,0.0796263345195729,0.11076512455516,0.148131672597865
"W02000130",509,727,719,211,516,298,2787,0.182633656261213,0.260853964836742,0.257983494797273,0.0757086472909939,0.185145317545748,0.106925008970219
"W02000131",513,717,303,216,501,297,2704,0.189718934911243,0.265162721893491,0.112056213017751,0.0798816568047337,0.185281065088757,0.109837278106509
"W02000132",537,397,736,152,245,385,2682,0.200223713646532,0.148023862788963,0.274422073079791,0.0566741237882177,0.0913497390007457,0.143549589858315
"W02000133",754,609,573,264,345,490,3176,0.237405541561713,0.191750629722922,0.180415617128463,0.0831234256926952,0.108627204030227,0.154282115869018
"W02000134",642,593,751,229,364,413,2863,0.224240307369892,0.207125392944464,0.262312259867272,0.0799860286412854,0.127139364303178,0.144254278728606
"W02000135",486,570,527,186,384,300,2880,0.16875,0.197916666666667,0.182986111111111,0.0645833333333333,0.133333333333333,0.104166666666667
"W02000136",725,822,584,271,551,454,3512,0.206435079726651,0.234054669703872,0.16628701594533,0.0771640091116173,0.156890660592255,0.129271070615034
"W02000137",504,754,586,227,527,277,2812,0.17923186344239,0.268136557610242,0.208392603129445,0.0807254623044097,0.187411095305832,0.0985064011379801
"W02000138",815,869,1522,277,592,538,4009,0.203292591668745,0.216762284859067,0.379645796956847,0.069094537291095,0.147667747567972,0.13419805437765
"W02000139",554,543,493,203,340,351,3067,0.180632539941311,0.177045973263776,0.160743397456798,0.0661884577763287,0.110857515487447,0.114444082164982
"W02000140",493,419,713,155,264,338,2729,0.180652253572737,0.153536093807255,0.261267863686332,0.0567973616709417,0.0967387321363137,0.123854891901796
"W02000141",511,626,977,172,454,339,3011,0.169711059448688,0.207904350714049,0.324476917967453,0.0571238791099303,0.150780471604118,0.112587180338758
"W02000142",490,426,692,154,272,336,2010,0.243781094527363,0.211940298507463,0.344278606965174,0.0766169154228856,0.135323383084577,0.167164179104478
"W02000143",459,381,859,115,266,344,1839,0.249592169657423,0.207177814029364,0.467101685698749,0.0625339858618815,0.144643828167482,0.187058183795541
"W02000144",730,595,1146,238,357,492,2822,0.258681785967399,0.210843373493976,0.406094968107725,0.0843373493975904,0.126506024096386,0.174344436569809
"W02000145",583,468,1122,167,301,416,2538,0.229708431836091,0.184397163120567,0.442080378250591,0.0657998423955871,0.11859732072498,0.163908589440504
"W02000146",479,402,778,155,247,324,2139,0.223936418887331,0.187938288920056,0.36372136512389,0.072463768115942,0.115474520804114,0.151472650771388
"W02000147",489,597,794,171,426,318,3080,0.158766233766234,0.193831168831169,0.257792207792208,0.0555194805194805,0.138311688311688,0.103246753246753
"W02000148",335,525,336,137,388,198,2087,0.160517489218975,0.251557259223766,0.16099664590321,0.0656444657402971,0.185912793483469,0.0948730234786775
"W02000149",531,573,821,171,402,360,2857,0.185859292964648,0.2005600280014,0.287364368218411,0.0598529926496325,0.140707035351768,0.126006300315016
"W02000151",689,877,1421,270,607,419,3006,0.229208250166334,0.291749833666001,0.47272122421823,0.0898203592814371,0.201929474384564,0.139387890884897
"W02000152",523,599,598,177,422,346,3049,0.17153164972122,0.196457855034438,0.196129878648737,0.0580518202689406,0.138406034765497,0.113479829452279
"W02000153",624,592,826,229,363,395,3030,0.205940594059406,0.195379537953795,0.272607260726073,0.0755775577557756,0.11980198019802,0.13036303630363
"W02000154",475,711,882,184,527,291,2816,0.168678977272727,0.252485795454545,0.313210227272727,0.0653409090909091,0.187144886363636,0.103338068181818
"W02000156",616,763,818,262,501,354,2881,0.213814647691774,0.264838597709129,0.283929191253037,0.0909406456091635,0.173897952099965,0.12287400208261
"W02000157",627,779,863,240,539,387,3384,0.185283687943262,0.230200945626478,0.255023640661939,0.0709219858156028,0.159278959810875,0.11436170212766
"W02000158",294,369,453,102,267,192,1892,0.1553911205074,0.195031712473573,0.239429175475687,0.0539112050739958,0.141120507399577,0.101479915433404
"W02000159",380,503,519,153,350,227,2067,0.183841315916788,0.243347847121432,0.251088534107402,0.0740203193033382,0.169327527818094,0.109820996613449
"W02000160",439,553,344,178,375,261,2208,0.198822463768116,0.250452898550725,0.155797101449275,0.0806159420289855,0.169836956521739,0.11820652173913
"W02000161",294,466,385,133,333,161,1552,0.189432989690722,0.300257731958763,0.248067010309278,0.0856958762886598,0.214561855670103,0.103737113402062
"W02000162",509,784,777,211,573,298,2977,0.170977494121599,0.263352368155862,0.261001007725899,0.0708767215317434,0.192475646624118,0.100100772589856
"W02000163",394,652,664,197,455,197,1894,0.208025343189018,0.344244984160507,0.350580781414995,0.104012671594509,0.240232312565998,0.104012671594509
"W02000164",484,747,1055,207,540,277,2557,0.18928431755964,0.292139225655065,0.412592882283926,0.0809542432538131,0.211184982401251,0.108330074305827
"W02000165",404,672,903,181,491,223,2180,0.185321100917431,0.308256880733945,0.414220183486239,0.0830275229357798,0.225229357798165,0.102293577981651
"W02000166",378,664,457,159,505,219,2812,0.134423897581792,0.236130867709815,0.162517780938834,0.0565433854907539,0.179587482219061,0.0778805120910384
"W02000167",730,1160,2198,292,868,438,4643,0.1572259315098,0.249838466508723,0.473400818436356,0.0628903726039199,0.186948093904803,0.0943355589058798
"W02000168",336,524,633,148,376,188,2277,0.147562582345191,0.230127360562143,0.277997364953887,0.0649978041282389,0.165129556433904,0.0825647782169521
"W02000169",612,850,723,235,615,377,2930,0.208873720136519,0.290102389078498,0.246757679180887,0.0802047781569966,0.209897610921502,0.128668941979522
"W02000170",553,696,305,216,480,337,2775,0.199279279279279,0.250810810810811,0.10990990990991,0.0778378378378378,0.172972972972973,0.121441441441441
"W02000171",437,365,178,125,240,312,2715,0.160957642725599,0.134438305709024,0.0655616942909761,0.0460405156537753,0.0883977900552486,0.114917127071823
"W02000172",495,737,700,214,523,281,3622,0.136664826062949,0.203478741027057,0.193263390392049,0.0590833793484263,0.144395361678631,0.0775814467145224
"W02000173",332,421,244,116,305,216,2404,0.138103161397671,0.175124792013311,0.101497504159734,0.0482529118136439,0.126871880199667,0.0898502495840266
"W02000174",454,759,612,220,539,234,2869,0.158243290345068,0.264552108748693,0.213314743813175,0.076681770651795,0.187870338096898,0.0815615196932729
"W02000175",510,952,1271,200,752,310,2979,0.171198388721047,0.319570325612622,0.426653239342061,0.0671366230278617,0.25243370258476,0.104061765693186
"W02000176",584,774,382,241,533,343,2788,0.209469153515065,0.277618364418938,0.137015781922525,0.086441893830703,0.191176470588235,0.123027259684362
"W02000177",419,483,331,130,353,289,2237,0.18730442556996,0.215914170764417,0.147966025927582,0.0581135449262405,0.157800625838176,0.129190880643719
"W02000178",520,417,70,98,319,422,3299,0.157623522279479,0.126401939981813,0.0212185510760837,0.0297059715065171,0.0966959684752955,0.127917550772961
"W02000179",314,420,416,120,300,194,1992,0.157630522088353,0.210843373493976,0.208835341365462,0.0602409638554217,0.150602409638554,0.0973895582329317
"W02000180",520,673,255,180,493,340,2687,0.19352437662821,0.250465202828433,0.0949013770003722,0.0669892072943803,0.183475995534053,0.12653516933383
"W02000181",366,550,396,133,417,233,2998,0.122081387591728,0.183455637091394,0.132088058705804,0.0443629086057372,0.139092728485657,0.0777184789859907
"W02000182",435,1132,1459,243,889,192,2606,0.166922486569455,0.434382194934766,0.559861857252494,0.0932463545663853,0.341135840368381,0.0736761320030698
"W02000183",576,1514,2197,299,1215,277,4348,0.13247470101196,0.34820607175713,0.505289788408464,0.0687672493100276,0.279438822447102,0.0637074517019319
"W02000184",492,730,340,227,503,265,2394,0.205513784461153,0.304928989139515,0.142021720969089,0.0948203842940685,0.210108604845447,0.110693400167084
"W02000185",368,416,355,131,285,237,1506,0.244355909694555,0.276228419654714,0.235723771580345,0.0869853917662683,0.189243027888446,0.157370517928287
"W02000186",783,903,143,249,654,534,3441,0.227550130775937,0.262423714036617,0.041557686718977,0.0723626852659111,0.190061028770706,0.155187445510026
"W02000188",413,885,1261,191,694,222,3553,0.116239797354348,0.249085280045032,0.354911342527442,0.0537573881227132,0.195327891922319,0.0624824092316352
"W02000189",508,842,234,239,603,269,3213,0.158107687519452,0.262060379707439,0.0728291316526611,0.0743853096794273,0.187675070028011,0.0837223778400249
"W02000191",945,1224,1778,350,874,595,3705,0.255060728744939,0.330364372469636,0.479892037786775,0.0944669365721997,0.235897435897436,0.16059379217274
"W02000192",679,777,1724,173,604,506,6795,0.0999264164827079,0.114348785871965,0.253715967623252,0.0254598969830758,0.0888888888888889,0.0744665194996321
"W02000193",957,1032,2909,274,758,683,4092,0.233870967741935,0.252199413489736,0.710899315738025,0.0669599217986315,0.185239491691105,0.166911045943304
"W02000194",449,823,377,246,577,203,1932,0.2324016563147,0.425983436853002,0.195134575569358,0.127329192546584,0.298654244306418,0.105072463768116
"W02000195",410,578,169,220,358,190,1947,0.210580380071905,0.296866974833077,0.0868002054442732,0.112994350282486,0.183872624550591,0.0975860297894196
"W02000196",598,708,135,246,462,352,2382,0.251049538203191,0.297229219143577,0.0566750629722922,0.103274559193955,0.193954659949622,0.147774979009236
"W02000197",554,610,437,255,355,299,2136,0.25936329588015,0.285580524344569,0.204588014981273,0.11938202247191,0.166198501872659,0.13998127340824
"W02000198",709,1072,887,342,730,367,3142,0.225652450668364,0.341183959261617,0.282304264799491,0.108847867600255,0.232336091661362,0.116804583068109
"W02000200",297,521,525,132,389,165,1822,0.163007683863886,0.285949506037322,0.28814489571899,0.0724478594950604,0.213501646542261,0.0905598243688255
"W02000201",280,551,501,125,426,155,1787,0.156687185226637,0.308337996642417,0.280358142137661,0.0699496362618914,0.238388360380526,0.0867375489647454
"W02000202",549,823,1114,191,632,358,4001,0.137215696075981,0.205698575356161,0.2784303924019,0.0477380654836291,0.157960509872532,0.0894776305923519
"W02000204",293,434,248,106,328,187,1813,0.161610590182019,0.239382239382239,0.136789851075565,0.0584666298952013,0.180915609487038,0.103143960286817
"W02000205",291,361,265,104,257,187,1807,0.16104039845047,0.199778638627559,0.146651909241837,0.0575539568345324,0.142224681793027,0.103486441615938
"W02000206",545,636,1483,124,512,421,3251,0.167640725930483,0.19563211319594,0.456167333128268,0.0381421101199631,0.157490003075977,0.12949861581052
"W02000207",277,335,85,113,222,164,1332,0.207957957957958,0.251501501501502,0.0638138138138138,0.0848348348348348,0.166666666666667,0.123123123123123
"W02000208",458,817,957,178,639,280,3707,0.123550040463987,0.220393849473968,0.258160237388724,0.0480172646344753,0.172376584839493,0.0755327758295117
"W02000210",278,457,253,116,341,162,2168,0.128228782287823,0.210793357933579,0.11669741697417,0.0535055350553506,0.157287822878229,0.0747232472324723
"W02000211",419,838,1283,149,689,270,3295,0.127162367223065,0.254324734446131,0.38937784522003,0.0452200303490137,0.209104704097117,0.0819423368740516
"W02000212",409,546,537,154,392,255,2594,0.157671549730146,0.210485736314572,0.207016191210486,0.0593677717810332,0.151117964533539,0.0983037779491133
"W02000213",391,565,217,152,413,239,1981,0.197375063099445,0.285209490156487,0.109540636042403,0.0767289247854619,0.208480565371025,0.120646138313983
"W02000214",370,445,33,111,334,259,3346,0.110579796772265,0.132994620442319,0.00986252241482367,0.0331739390316796,0.0998206814106396,0.0774058577405858
"W02000215",450,1025,1079,175,850,275,4407,0.10211027910143,0.232584524619923,0.244837758112094,0.0397095529838893,0.192874971636034,0.0624007261175403
"W02000216",404,816,1598,163,653,241,2636,0.153262518968134,0.309559939301973,0.606221547799697,0.0618361153262519,0.247723823975721,0.0914264036418816
"W02000217",280,543,309,125,418,155,2102,0.133206470028544,0.258325404376784,0.147002854424358,0.0594671741198858,0.198858230256898,0.0737392959086584
"W02000218",467,711,1692,148,563,319,2699,0.173027047054465,0.263430900333457,0.626898851426454,0.0548351241200445,0.208595776213412,0.11819192293442
"W02000219",469,673,1341,138,535,331,2575,0.182135922330097,0.261359223300971,0.520776699029126,0.0535922330097087,0.207766990291262,0.128543689320388
"W02000220",503,683,1849,149,534,354,2937,0.171263193735104,0.232550221314266,0.629553966632618,0.0507320394960844,0.181818181818182,0.120531154239019
"W02000221",429,556,1464,135,421,294,2524,0.169968304278922,0.220285261489699,0.580031695721078,0.053486529318542,0.166798732171157,0.11648177496038
"W02000222",368,542,453,159,383,209,1640,0.224390243902439,0.330487804878049,0.276219512195122,0.0969512195121951,0.233536585365854,0.127439024390244
"W02000223",320,455,555,111,344,209,2212,0.144665461121157,0.205696202531646,0.250904159132007,0.0501808318264014,0.155515370705244,0.0944846292947559
"W02000224",337,422,239,117,305,220,2278,0.14793678665496,0.185250219490781,0.104916593503073,0.0513608428446005,0.133889376646181,0.09657594381036
"W02000225",496,662,672,175,487,321,2927,0.169456781687735,0.226170140075162,0.229586607447899,0.0597881790228903,0.166381961052272,0.109668602664845
"W02000226",584,672,391,176,496,408,3087,0.189180434078393,0.217687074829932,0.126660187884678,0.0570132815030774,0.160673793326855,0.132167152575316
"W02000227",323,463,135,130,333,193,2812,0.114864864864865,0.164651493598862,0.0480085348506401,0.0462304409672831,0.118421052631579,0.0686344238975818
"W02000228",336,461,118,128,333,208,3906,0.0860215053763441,0.118023553507424,0.0302099334357399,0.0327700972862263,0.0852534562211982,0.0532514080901178
"W02000229",379,479,70,168,311,211,2189,0.173138419369575,0.2188213796254,0.0319780721790772,0.0767473732297853,0.142074006395614,0.0963910461397899
"W02000230",376,422,170,161,261,215,1616,0.232673267326733,0.261138613861386,0.10519801980198,0.0996287128712871,0.161509900990099,0.133044554455446
"W02000231",569,866,1065,197,669,372,3648,0.155975877192982,0.237390350877193,0.291940789473684,0.0540021929824561,0.183388157894737,0.101973684210526
"W02000232",409,325,39,126,199,283,1883,0.217206585236325,0.172596919808816,0.0207116303770579,0.0669144981412639,0.105682421667552,0.150292087095061
"W02000233",358,303,9,127,176,231,2088,0.171455938697318,0.145114942528736,0.00431034482758621,0.060823754789272,0.0842911877394636,0.110632183908046
"W02000234",352,522,168,145,377,207,3498,0.10062893081761,0.149228130360206,0.0480274442538593,0.0414522584333905,0.107775871926815,0.0591766723842196
"W02000235",929,966,774,339,627,590,3393,0.273798997936929,0.284703801945181,0.228116710875332,0.0999115826702034,0.184792219274978,0.173887415266726
"W02000236",580,683,453,226,457,354,2605,0.222648752399232,0.262188099808061,0.173896353166987,0.0867562380038388,0.175431861804223,0.135892514395393
"W02000237",344,421,314,153,268,191,1866,0.184351554126474,0.22561629153269,0.168274383708467,0.0819935691318328,0.143622722400857,0.102357984994641
"W02000238",457,562,437,189,373,268,2407,0.189862899875364,0.233485666805152,0.181553801412547,0.0785209804736186,0.154964686331533,0.111341919401745
"W02000239",393,449,395,160,289,233,2428,0.161861614497529,0.18492586490939,0.162685337726524,0.0658978583196046,0.119028006589786,0.0959637561779242
"W02000240",471,906,570,212,694,259,2936,0.160422343324251,0.30858310626703,0.194141689373297,0.0722070844686648,0.236376021798365,0.0882152588555858
"W02000241",665,507,1911,93,414,572,4678,0.142154766994442,0.10837964942283,0.408507909362976,0.019880290722531,0.0884993587002993,0.122274476271911
"W02000242",446,733,348,239,494,207,2619,0.170294005345552,0.27987781596029,0.132875143184422,0.0912562046582665,0.188621611302024,0.0790378006872852
"W02000243",486,726,258,195,531,291,3691,0.131671633703603,0.196694662693037,0.0698997561636413,0.0528312110539149,0.143863451639122,0.0788404226496884
"W02000244",577,649,243,207,442,370,3615,0.159612724757953,0.179529737206086,0.0672199170124481,0.0572614107883817,0.122268326417704,0.102351313969571
"W02000245",538,557,658,138,419,400,3203,0.167967530440212,0.17389946924758,0.205432407118327,0.0430846081798314,0.130814861067749,0.124882922260381
"W02000246",285,384,37,127,257,158,1361,0.209404849375459,0.282145481263777,0.0271858927259368,0.0933137398971345,0.188831741366642,0.116091109478325
"W02000247",515,596,308,191,405,324,2951,0.174517112843104,0.201965435445612,0.104371399525585,0.0647238224330735,0.137241613012538,0.10979329041003
"W02000248",875,793,2785,211,582,664,4891,0.178900020445717,0.162134532815375,0.569413207932938,0.0431404620731957,0.11899407074218,0.135759558372521
"W02000249",645,701,1327,170,531,475,3730,0.172922252010724,0.187935656836461,0.355764075067024,0.0455764075067024,0.142359249329759,0.127345844504021
"W02000250",641,872,396,240,632,401,4437,0.144466982195177,0.196529186387199,0.0892494929006085,0.0540906017579446,0.142438584629254,0.0903763804372324
"W02000251",430,669,876,137,532,293,5407,0.0795265396707971,0.123728500092473,0.162012206399112,0.0253375254299982,0.0983909746624746,0.054189014240799
"W02000252",524,617,504,164,453,360,3071,0.170628459785086,0.200911755128623,0.164115923152068,0.0534028003907522,0.14750895473787,0.117225659394334
"W02000253",383,613,1445,127,486,256,2518,0.152104845115171,0.243447180301827,0.573868149324861,0.0504368546465449,0.193010325655282,0.101667990468626
"W02000254",438,608,1269,130,478,308,2785,0.157271095152603,0.218312387791741,0.455655296229802,0.0466786355475763,0.171633752244165,0.110592459605027
"W02000255",387,550,505,137,413,250,2513,0.15399920413848,0.218861918026263,0.200955033824115,0.054516514126542,0.164345403899721,0.0994826900119379
"W02000256",589,894,2502,163,731,426,4228,0.139309366130558,0.211447492904447,0.591769157994324,0.0385525070955535,0.172894985808893,0.100756859035005
"W02000257",517,451,1516,106,345,411,2783,0.185770750988142,0.162055335968379,0.544735896514553,0.0380883938196191,0.12396694214876,0.147682357168523
"W02000258",460,548,1836,122,426,338,2591,0.177537630258587,0.211501350829795,0.70860671555384,0.0470860671555384,0.164415283674257,0.130451563103049
"W02000259",520,472,2037,107,365,413,2656,0.19578313253012,0.177710843373494,0.766942771084337,0.0402861445783133,0.137424698795181,0.155496987951807
"W02000260",381,499,1470,95,404,286,2152,0.177044609665428,0.231877323420074,0.683085501858736,0.0441449814126394,0.187732342007435,0.132899628252788
"W02000261",523,637,2132,133,504,390,2758,0.189630166787527,0.230964467005076,0.773023930384336,0.0482233502538071,0.182741116751269,0.14140681653372
"W02000262",360,405,1420,94,311,266,1901,0.189374013677012,0.213045765386639,0.746975276170437,0.0494476591267754,0.163598106259863,0.139926354550237
"W02000263",340,329,1270,61,268,279,2151,0.158066015806602,0.152952115295212,0.590423059042306,0.0283589028358903,0.124593212459321,0.129707112970711
"W02000264",455,486,1924,94,392,361,2487,0.182951347004423,0.195416164053076,0.77362283876156,0.0377965420184962,0.15761962203458,0.145154804985927
"W02000265",613,759,2095,185,574,428,3210,0.190965732087227,0.236448598130841,0.652647975077882,0.0576323987538941,0.178816199376947,0.133333333333333
"W02000266",535,549,576,151,398,384,2672,0.200224550898204,0.205464071856287,0.215568862275449,0.0565119760479042,0.148952095808383,0.143712574850299
"W02000267",435,644,1942,133,511,302,2417,0.179975175837815,0.266446007447249,0.803475382705834,0.0550268928423666,0.211419114604882,0.124948282995449
"W02000268",606,715,2279,175,540,431,2996,0.202269692923899,0.238651535380507,0.76068090787717,0.058411214953271,0.180240320427236,0.143858477970628
"W02000269",499,651,1812,136,515,363,2801,0.178150660478401,0.232416993930739,0.64691181720814,0.0485540878257765,0.183862906104963,0.129596572652624
"W02000270",399,620,1528,134,486,265,2247,0.177570093457944,0.275923453493547,0.680017801513129,0.0596350689808634,0.216288384512684,0.117935024477081
"W02000271",469,498,918,133,365,336,1960,0.239285714285714,0.254081632653061,0.468367346938776,0.0678571428571429,0.186224489795918,0.171428571428571
"W02000272",623,913,2216,202,711,421,3513,0.177341303729007,0.259891830344435,0.630799886137205,0.0575007116424708,0.202391118701964,0.119840592086536
"W02000273",639,1146,1696,249,897,390,4313,0.148156735450962,0.265708323672618,0.393229770461396,0.0577324368189195,0.207975886853698,0.0904242986320427
"W02000274",482,743,741,170,573,312,3127,0.154141349536297,0.237607930924209,0.236968340262232,0.0543652062679885,0.18324272465622,0.0997761432683083
"W02000275",380,442,520,133,309,247,2137,0.177819372952737,0.206832007487131,0.243331773514272,0.0622367805334581,0.144595226953673,0.115582592419279
"W02000276",318,692,127,149,543,169,2146,0.148182665424045,0.322460391425909,0.0591798695246971,0.0694315004659832,0.253028890959925,0.0787511649580615
"W02000277",426,522,525,135,387,291,2550,0.167058823529412,0.204705882352941,0.205882352941176,0.0529411764705882,0.151764705882353,0.114117647058824
"W02000278",443,429,223,146,283,297,2459,0.180154534363562,0.17446116307442,0.090687271248475,0.0593737291581944,0.115087433916226,0.120780805205368
"W02000279",450,679,209,194,485,256,2761,0.162984425932633,0.245925389351684,0.0756972111553785,0.070264396957624,0.17566099239406,0.0927200289750091
"W02000280",437,606,323,171,435,266,3669,0.119106023439629,0.16516762060507,0.0880348868901608,0.0466067048242028,0.118560915780867,0.0724993186154266
"W02000281",361,535,388,119,416,242,2492,0.144863563402889,0.214686998394864,0.15569823434992,0.047752808988764,0.1669341894061,0.0971107544141252
"W02000282",434,508,395,132,376,302,3582,0.121161362367393,0.141820212171971,0.110273590173088,0.0368509212730318,0.104969290898939,0.0843104410943607
"W02000284",572,926,2012,171,755,401,3963,0.144335099671966,0.23366136765077,0.507696189755236,0.0431491294473883,0.190512238203381,0.101185970224577
"W02000285",475,563,817,177,386,298,2578,0.184251357641583,0.218386346004655,0.316912335143522,0.0686578743211792,0.149728471683476,0.115593483320403
"W02000286",424,788,862,134,654,290,3364,0.126040428061831,0.234244946492271,0.256242568370987,0.039833531510107,0.194411414982164,0.0862068965517241
"W02000287",374,532,1194,110,422,264,2921,0.128038343033208,0.182129407737076,0.40876412187607,0.0376583361862376,0.144471071550839,0.0903800068469702
"W02000288",490,686,1670,139,547,351,3121,0.157000961230375,0.219801345722525,0.535084908683114,0.0445370073694329,0.175264338353092,0.112463953860942
"W02000289",414,460,1125,110,350,304,2944,0.140625,0.15625,0.382133152173913,0.0373641304347826,0.118885869565217,0.103260869565217
"W02000290",491,707,938,146,561,345,3211,0.152911865462473,0.220180629087512,0.292120834630956,0.0454687013391467,0.174711927748365,0.107443164123326
"W02000291",376,453,1583,74,379,302,2503,0.15021973631642,0.180982820615262,0.632441070715142,0.0295645225729125,0.151418298042349,0.120655213743508
"W02000292",264,458,881,92,366,172,2076,0.127167630057803,0.220616570327553,0.424373795761079,0.0443159922928709,0.176300578034682,0.0828516377649326
"W02000293",416,535,1265,120,415,296,2502,0.166266986410871,0.21382893685052,0.505595523581135,0.0479616306954436,0.165867306155076,0.118305355715428
"W02000294",287,445,384,82,363,205,1799,0.159533073929961,0.247359644246804,0.213451917732073,0.0455808782657032,0.201778765981101,0.113952195664258
"W02000295",378,595,618,114,481,264,2874,0.131524008350731,0.207028531663187,0.215031315240084,0.0396659707724426,0.167362560890745,0.0918580375782881
"W02000296",372,772,572,161,611,211,2565,0.145029239766082,0.300974658869396,0.223001949317739,0.0627680311890838,0.238206627680312,0.082261208576998
"W02000297",442,624,323,155,469,287,2581,0.171251452925223,0.241766757070903,0.125145292522278,0.0600542425416505,0.181712514529252,0.111197210383572
"W02000298",352,492,533,112,380,240,2396,0.146911519198664,0.20534223706177,0.22245409015025,0.0467445742904841,0.158597662771285,0.10016694490818
"W02000299",333,532,739,125,407,208,2266,0.146954986760812,0.23477493380406,0.3261253309797,0.0551632833186231,0.179611650485437,0.0917917034421889
"W02000300",382,629,302,117,512,265,2800,0.136428571428571,0.224642857142857,0.107857142857143,0.0417857142857143,0.182857142857143,0.0946428571428571
"W02000301",338,583,382,121,462,217,2679,0.126166480029862,0.217618514371034,0.142590518850317,0.0451661067562523,0.172452407614782,0.0810003732736096
"W02000302",496,562,906,145,417,351,3373,0.147050103765194,0.166617254669434,0.268603616958197,0.0429884375926475,0.123628817076786,0.104061666172547
"W02000303",325,579,1109,113,466,212,2495,0.130260521042084,0.232064128256513,0.444488977955912,0.0452905811623247,0.186773547094188,0.0849699398797595
"W02000304",265,459,1047,96,363,169,1942,0.136457260556128,0.236354273944387,0.53913491246138,0.0494335736354274,0.18692070030896,0.0870236869207003
"W02000305",388,448,177,135,313,253,1982,0.195761856710394,0.226034308779011,0.0893037336024218,0.0681130171543895,0.157921291624622,0.127648839556004
"W02000306",285,561,622,133,428,152,1698,0.167844522968198,0.330388692579505,0.366313309776207,0.0783274440518257,0.25206124852768,0.0895170789163722
"W02000307",395,511,1144,111,400,284,2161,0.182785747339195,0.236464599722351,0.529384544192503,0.0513651087459509,0.1850994909764,0.131420638593244
"W02000308",520,621,570,183,438,337,3065,0.169657422512235,0.202610114192496,0.185970636215334,0.0597063621533442,0.142903752039152,0.109951060358891
"W02000309",352,597,543,136,461,216,2442,0.144144144144144,0.244471744471744,0.222358722358722,0.0556920556920557,0.188779688779689,0.0884520884520884
"W02000310",301,311,352,99,212,202,1670,0.180239520958084,0.18622754491018,0.210778443113772,0.0592814371257485,0.126946107784431,0.120958083832335
"W02000311",538,744,342,216,528,322,3620,0.148618784530387,0.205524861878453,0.094475138121547,0.0596685082872928,0.14585635359116,0.0889502762430939
"W02000312",385,688,331,179,509,206,2384,0.161493288590604,0.288590604026846,0.138842281879195,0.0750838926174497,0.213506711409396,0.0864093959731544
"W02000313",532,587,652,187,400,345,3433,0.154966501602097,0.170987474512089,0.189921351587533,0.0544713078939703,0.116516166618118,0.100495193708127
"W02000314",304,481,330,107,374,197,1849,0.164413196322336,0.260140616549486,0.178474851270957,0.0578691184424013,0.202271498107085,0.106544077879935
"W02000315",285,527,661,108,419,177,1846,0.154387865655471,0.285482123510293,0.35807150595883,0.0585048754062839,0.226977248104009,0.0958829902491874
"W02000316",315,446,397,104,342,211,1975,0.159493670886076,0.225822784810127,0.201012658227848,0.0526582278481013,0.173164556962025,0.106835443037975
"W02000317",313,609,636,117,492,196,2570,0.121789883268482,0.236964980544747,0.247470817120623,0.0455252918287938,0.191439688715953,0.0762645914396887
"W02000318",365,566,922,111,455,254,2641,0.138205225293449,0.214312760318061,0.349110185535782,0.042029534267323,0.172283226050738,0.0961756910261265
"W02000319",440,771,1339,157,614,283,2908,0.15130674002751,0.265130674002751,0.460453920220083,0.0539889958734525,0.211141678129298,0.0973177441540578
"W02000320",437,682,1619,143,539,294,2943,0.148487937478763,0.231736323479443,0.550118926265715,0.0485898742779477,0.183146449201495,0.0998980632008155
"W02000321",645,628,2347,138,490,507,3452,0.186848203939745,0.181923522595597,0.679895712630359,0.0399768250289687,0.141946697566628,0.146871378910776
"W02000322",467,548,1677,103,445,364,2921,0.159876754536118,0.18760698390962,0.574118452584731,0.0352618966107497,0.15234508729887,0.124614857925368
"W02000323",350,452,929,93,359,257,2215,0.158013544018059,0.204063205417607,0.41941309255079,0.0419864559819413,0.162076749435666,0.116027088036117
"W02000324",359,530,585,127,403,232,2328,0.154209621993127,0.22766323024055,0.251288659793814,0.054553264604811,0.173109965635739,0.0996563573883162
"W02000325",389,524,388,124,400,265,2640,0.147348484848485,0.198484848484848,0.146969696969697,0.046969696969697,0.151515151515152,0.100378787878788
"W02000326",507,868,1153,195,673,312,3196,0.158635794743429,0.271589486858573,0.360763454317897,0.0610137672090113,0.210575719649562,0.097622027534418
"W02000327",331,408,126,113,295,218,1767,0.187323146576118,0.230899830220713,0.0713073005093379,0.0639501980758348,0.166949632144878,0.123372948500283
"W02000328",391,775,506,207,568,184,2486,0.15728077232502,0.311745776347546,0.20353982300885,0.083266291230893,0.228479485116653,0.0740144810941271
"W02000329",330,589,249,127,462,203,3128,0.105498721227621,0.188299232736573,0.0796035805626598,0.0406010230179028,0.14769820971867,0.0648976982097187
"W02000330",449,583,257,154,429,295,2599,0.172758753366679,0.224317045017314,0.0988841862254713,0.0592535590611774,0.165063485956137,0.113505194305502
"W02000331",313,332,55,66,266,247,2347,0.133361738389433,0.141457179377929,0.0234341712824883,0.0281210055389859,0.113336173838943,0.105240732850447
"W02000332",288,386,228,91,295,197,3227,0.0892469786179114,0.119615742175395,0.0706538580725132,0.0281995661605206,0.0914161760148745,0.0610474124573908
"W02000333",282,275,50,56,219,226,1729,0.1631000578369,0.159051474840949,0.0289184499710816,0.0323886639676113,0.126662810873337,0.130711393869289
"W02000334",318,206,78,60,146,258,1820,0.174725274725275,0.113186813186813,0.0428571428571429,0.032967032967033,0.0802197802197802,0.141758241758242
"W02000335",315,501,202,153,348,162,2595,0.121387283236994,0.193063583815029,0.0778420038535645,0.0589595375722543,0.134104046242775,0.0624277456647399
"W02000336",513,538,1183,129,409,384,3272,0.156784841075795,0.164425427872861,0.361552567237164,0.0394254278728606,0.125,0.117359413202934
"W02000337",268,546,459,92,454,176,2849,0.0940680940680941,0.191646191646192,0.161109161109161,0.0322920322920323,0.159354159354159,0.0617760617760618
"W02000338",440,499,586,169,330,271,2841,0.154875043998592,0.175642379443858,0.206265399507216,0.0594860964449138,0.116156282998944,0.0953889475536783
"W02000339",550,609,633,170,439,380,4496,0.122330960854093,0.135453736654804,0.140791814946619,0.0378113879003559,0.0976423487544484,0.0845195729537367
"W02000340",477,394,913,154,240,323,2269,0.210224768620538,0.173644777434993,0.402379903040987,0.0678713089466725,0.105773468488321,0.142353459673865
"W02000341",477,514,609,166,348,311,2594,0.183885890516577,0.198149575944487,0.234772552043177,0.063993831919815,0.134155744024672,0.119892058596762
"W02000342",602,525,738,205,320,397,3056,0.196989528795812,0.171793193717277,0.241492146596859,0.0670811518324607,0.104712041884817,0.129908376963351
"W02000343",593,620,428,182,438,411,3878,0.15291387313048,0.159876224858174,0.110366168127901,0.0469314079422383,0.112944816915936,0.105982465188241
"W02000344",377,472,403,146,326,231,3031,0.124381392279776,0.155724183437809,0.132959419333553,0.0481689211481359,0.107555262289673,0.0762124711316397
"W02000345",493,548,163,150,398,343,2836,0.173836389280677,0.193229901269394,0.057475317348378,0.0528913963328632,0.14033850493653,0.120944992947814
"W02000346",320,287,163,88,199,232,2580,0.124031007751938,0.111240310077519,0.0631782945736434,0.0341085271317829,0.0771317829457364,0.089922480620155
"W02000347",517,712,268,230,482,287,2726,0.189655172413793,0.261188554658841,0.0983125458547322,0.0843727072633896,0.176815847395451,0.105282465150404
"W02000348",487,669,79,228,441,259,2474,0.196847210994341,0.270412287793048,0.0319320937752627,0.0921584478577203,0.178253839935327,0.104688763136621
"W02000349",344,244,56,62,182,282,3448,0.0997679814385151,0.0707656612529002,0.0162412993039443,0.0179814385150812,0.052784222737819,0.0817865429234339
"W02000350",406,393,196,149,244,257,4299,0.0944405675738544,0.0914166085136078,0.0455919981391021,0.0346592230751337,0.0567573854384741,0.0597813444987206
"W02000351",287,494,122,127,367,160,2326,0.123387790197764,0.212381771281169,0.0524505588993981,0.0546001719690456,0.157781599312124,0.0687876182287188
"W02000352",412,823,609,210,613,202,2501,0.164734106357457,0.32906837265094,0.243502598960416,0.0839664134346261,0.245101959216313,0.0807676929228309
"W02000353",480,1235,810,280,955,200,2765,0.173598553345389,0.446654611211573,0.292947558770344,0.10126582278481,0.345388788426763,0.0723327305605787
"W02000354",311,512,113,147,365,164,2163,0.143781784558484,0.236708275543227,0.0522422561257513,0.0679611650485437,0.168747110494683,0.0758206195099399
"W02000355",406,570,167,182,388,224,3110,0.130546623794212,0.183279742765273,0.0536977491961415,0.0585209003215434,0.12475884244373,0.0720257234726688
"W02000356",202,212,19,60,152,142,2282,0.0885188431200701,0.0929009640666082,0.00832602979842244,0.0262927256792287,0.0666082383873795,0.0622261174408414
"W02000357",641,1277,1355,330,947,311,3166,0.202463676563487,0.403348073278585,0.427984838913455,0.104232469993683,0.299115603284902,0.0982312065698042
"W02000358",373,700,432,197,503,176,2166,0.172206832871653,0.323176361957525,0.199445983379501,0.0909510618651893,0.232225300092336,0.0812557710064635
"W02000359",572,1488,803,345,1143,227,4925,0.116142131979695,0.302131979695431,0.163045685279188,0.0700507614213198,0.232081218274112,0.0460913705583756
"W02000360",603,873,1896,213,660,390,3566,0.169097027481772,0.244812114413909,0.531688166012339,0.0597307908020191,0.18508132361189,0.109366236679753
"W02000361",599,923,178,310,613,289,4381,0.136726774708971,0.210682492581602,0.0406299931522483,0.0707601004336909,0.139922392147911,0.0659666742752796
"W02000362",327,446,124,125,321,202,2550,0.128235294117647,0.174901960784314,0.0486274509803922,0.0490196078431373,0.125882352941176,0.0792156862745098
"W02000363",214,528,266,112,416,102,2299,0.0930839495432797,0.229665071770335,0.115702479338843,0.0487168334058286,0.180948238364506,0.0443671161374511
"W02000364",328,565,953,115,450,213,4574,0.0717096633143857,0.123524267599475,0.208351552251858,0.025142107564495,0.0983821600349803,0.0465675557498907
"W02000365",306,309,234,81,228,225,3355,0.0912071535022355,0.0921013412816691,0.0697466467958271,0.0241430700447094,0.0679582712369598,0.0670640834575261
"W02000366",310,274,219,88,186,222,2492,0.124398073836276,0.109951845906902,0.0878812199036918,0.0353130016051364,0.0746388443017656,0.0890850722311397
"W02000367",335,547,71,149,398,186,2339,0.143223599828987,0.233860624198375,0.0303548525010688,0.0637024369388628,0.170158187259513,0.079521162890124
"W02000368",397,254,17,87,167,310,1866,0.212754555198285,0.136120042872454,0.00911039657020364,0.0466237942122186,0.0894962486602358,0.166130760986066
"W02000369",367,189,16,58,131,309,3942,0.0930999492643328,0.0479452054794521,0.00405885337392187,0.0147133434804668,0.0332318619989853,0.0783866057838661
"W02000370",496,921,72,284,637,212,1948,0.254620123203285,0.472792607802875,0.0369609856262834,0.145790554414784,0.32700205338809,0.108829568788501
"W02000371",437,750,280,187,563,250,3822,0.114338042909471,0.196232339089482,0.0732600732600733,0.0489272632129775,0.147305075876504,0.065410779696494
"W02000372",324,523,194,127,396,197,2823,0.114771519659936,0.185263903648601,0.0687212185618137,0.044987601842012,0.140276301806589,0.0697839178179242
"W02000373",453,491,98,151,340,302,2435,0.186036960985626,0.201642710472279,0.0402464065708419,0.0620123203285421,0.139630390143737,0.124024640657084
"W02000374",357,703,45,226,477,131,1512,0.236111111111111,0.46494708994709,0.0297619047619048,0.149470899470899,0.31547619047619,0.0866402116402116
"W02000375",369,540,64,146,394,223,2677,0.137840866641763,0.20171834142697,0.0239073589839372,0.0545386626821068,0.147179678744864,0.0833022039596563
"W02000376",371,604,246,161,443,210,2366,0.156804733727811,0.255283178360101,0.103972950126796,0.0680473372781065,0.187235841081995,0.0887573964497041
"W02000377",359,166,40,55,111,304,2738,0.131117604090577,0.0606281957633309,0.014609203798393,0.0200876552227904,0.0405405405405405,0.111029948867787
"W02000378",443,953,172,278,675,165,2344,0.188993174061433,0.406569965870307,0.0733788395904437,0.118600682593857,0.28796928327645,0.0703924914675768
"W02000379",307,170,15,57,113,250,2804,0.109486447931526,0.0606276747503566,0.00534950071326676,0.0203281027104137,0.0402995720399429,0.0891583452211127
"W02000380",355,416,173,132,284,223,2955,0.120135363790186,0.14077834179357,0.0585448392554992,0.0446700507614213,0.0961082910321489,0.0754653130287648
"W02000381",444,693,194,202,491,242,2579,0.172159751841799,0.268708801861187,0.0752229546335789,0.078324932144242,0.190383869716945,0.0938348196975572
"W02000382",291,282,104,68,214,223,2669,0.109029599100787,0.105657549644061,0.0389659048332709,0.0254777070063694,0.080179842637692,0.0835518920944174
"W02000383",446,619,132,183,436,263,2738,0.162892622352082,0.226077428780131,0.0482103725346969,0.0668371073776479,0.159240321402484,0.0960555149744339
"W02000384",295,665,126,169,496,126,1595,0.184952978056426,0.41692789968652,0.0789968652037618,0.105956112852665,0.310971786833856,0.0789968652037618
"W02000385",402,972,117,274,698,128,1911,0.210361067503925,0.508634222919937,0.0612244897959184,0.143380429094715,0.365253793825222,0.0669806384092098
"W02000386",486,1022,443,285,737,201,2309,0.2104807275877,0.442615851017757,0.191857947163274,0.123430056301429,0.319185794716327,0.0870506712862711
"W02000387",411,768,394,236,532,175,1824,0.225328947368421,0.421052631578947,0.216008771929825,0.129385964912281,0.291666666666667,0.0959429824561404
"W02000388",336,663,197,194,469,142,1815,0.185123966942149,0.365289256198347,0.108539944903581,0.106887052341598,0.258402203856749,0.078236914600551
"W02000389",518,825,520,234,591,284,3060,0.169281045751634,0.269607843137255,0.169934640522876,0.0764705882352941,0.193137254901961,0.0928104575163399
"W02000390",329,643,168,182,461,147,1745,0.188538681948424,0.368481375358166,0.0962750716332378,0.104297994269341,0.264183381088825,0.0842406876790831
"W02000391",531,518,1454,136,382,395,2779,0.191075926592299,0.18639798488665,0.523209787693415,0.0489384670744872,0.137459517812163,0.142137459517812
"W02000392",579,939,456,249,690,330,2951,0.196204676380888,0.318197221280922,0.15452389020671,0.0843781768891901,0.233819044391732,0.111826499491698
"W02000393",448,668,135,187,481,261,2867,0.156260899895361,0.232996163236833,0.0470875479595396,0.0652249738402511,0.167771189396582,0.0910359260551099
"W02000394",626,437,2716,103,334,523,3733,0.167693544066434,0.117064023573533,0.727564961157246,0.0275917492633271,0.0894722743102063,0.140101794803107
"W02000395",400,578,1063,125,453,275,2870,0.139372822299652,0.201393728222997,0.370383275261324,0.0435540069686411,0.157839721254355,0.0958188153310105
"W02000396",612,361,2618,77,284,535,3374,0.181387077652638,0.106994665085951,0.775933609958506,0.0228215767634855,0.0841730883224659,0.158565500889152
"W02000397",425,607,229,162,445,263,2484,0.17109500805153,0.244363929146538,0.0921900161030596,0.0652173913043478,0.17914653784219,0.105877616747182
"W02000398",458,468,1916,87,381,371,5362,0.0854158895934353,0.0872808653487505,0.357329354718389,0.0162252890712421,0.0710555762775084,0.0691906005221932
"W02000399",857,650,3623,131,519,726,6543,0.130979672932905,0.0993428091089714,0.553721534464313,0.0200213969127312,0.0793214121962403,0.110958276020174
"W02000400",645,300,2293,73,227,572,3724,0.173200859291085,0.0805585392051558,0.615735767991407,0.0196025778732546,0.0609559613319012,0.15359828141783
"W02000401",412,606,1035,157,449,255,2215,0.186004514672686,0.273589164785553,0.467268623024831,0.0708803611738149,0.202708803611738,0.115124153498871
"W02000402",663,702,2821,134,568,529,5310,0.124858757062147,0.132203389830508,0.531261770244821,0.0252354048964218,0.106967984934087,0.099623352165725
"W02000403",405,752,423,144,608,261,3062,0.13226649248857,0.245591116917048,0.138145003265839,0.0470280862181581,0.19856303069889,0.0852384062704115
"W02000404",463,469,1985,87,382,376,3244,0.142725030826141,0.144574599260173,0.61189889025894,0.0268187422934649,0.117755856966708,0.115906288532676
"W02000405",379,935,74,203,732,176,2856,0.132703081232493,0.327380952380952,0.0259103641456583,0.071078431372549,0.256302521008403,0.061624649859944
"W02000406",626,630,1794,144,486,482,4323,0.144806847096923,0.145732130464955,0.41498959056211,0.0333102012491325,0.112421929215822,0.111496645847791
"W02000407",326,692,265,142,550,184,2426,0.134377576257214,0.285243198680956,0.109233305853256,0.0585325638911789,0.226710634789777,0.0758450123660346
"W02000408",528,542,1824,121,421,407,3530,0.14957507082153,0.153541076487252,0.51671388101983,0.0342776203966006,0.119263456090652,0.115297450424929
"W02000409",315,627,47,152,475,163,2004,0.157185628742515,0.312874251497006,0.0234530938123752,0.0758483033932136,0.237025948103792,0.0813373253493014
"W02000410",553,478,2259,104,374,449,3117,0.177414180301572,0.153352582611485,0.724735322425409,0.0333654154635868,0.119987167147899,0.144048764837985
"W02000411",337,442,135,110,332,227,2367,0.142374313476975,0.18673426277989,0.0570342205323194,0.0464723278411491,0.140261934938741,0.0959019856358259
"W02000412",449,409,993,103,306,346,2551,0.176009408075265,0.160329282634261,0.389259114072913,0.0403763230105841,0.119952959623677,0.135633085064681
"W02000414",581,337,845,141,196,440,2017,0.288051561725335,0.167079821517105,0.418939018344075,0.0699058006941001,0.0971740208230045,0.218145761031235
"W02000415",434,1339,196,219,1120,215,4238,0.102406795658329,0.315950920245399,0.0462482302973101,0.0516753185464842,0.264275601698915,0.0507314771118452
"W02000416",645,854,1107,224,630,421,3646,0.176906198573779,0.234229292375206,0.303620405924301,0.0614371914426769,0.172792100932529,0.115469007131103
"W02000417",612,925,1543,215,710,397,4023,0.152125279642058,0.229927914491673,0.383544618443947,0.0534427044494159,0.176485210042257,0.0986825751926423
"W02000418",930,883,1515,300,583,630,4553,0.20426092686141,0.193938062815726,0.332747638919394,0.0658906215681968,0.128047441247529,0.138370305293213
"W02000419",776,1135,604,315,820,461,4329,0.179256179256179,0.262185262185262,0.13952413952414,0.0727650727650728,0.189420189420189,0.106491106491106
"W02000421",858,696,1395,239,457,619,3877,0.221305132834666,0.179520247614135,0.35981428939902,0.0616456022697962,0.117874645344338,0.15965953056487
"W02000422",152,6,27,2,4,150,5856,0.0259562841530055,0.00102459016393443,0.00461065573770492,0.000341530054644809,0.000683060109289617,0.0256147540983607
"W02000423",289,181,403,49,132,240,6713,0.0430507969611202,0.0269626098614628,0.0600327722329808,0.0072992700729927,0.0196633397884701,0.0357515268881275
"W02000424",307,320,380,92,228,215,2191,0.140118667275217,0.146052031036057,0.173436786855317,0.0419899589228663,0.10406207211319,0.0981287083523505
"W02000425",324,234,422,65,169,259,2112,0.153409090909091,0.110795454545455,0.199810606060606,0.0307765151515152,0.0800189393939394,0.122632575757576
"W02000426",488,461,158,134,327,354,2967,0.164475901584092,0.155375800471857,0.053252443545669,0.0451634647792383,0.110212335692619,0.119312436804853
"W02000427",488,773,1534,132,641,356,4027,0.121182021355848,0.191954308418177,0.380928731065309,0.0327787434814999,0.159175564936677,0.0884032778743482
"W02000428",638,1059,275,309,750,329,2913,0.219018194301407,0.363542739443872,0.0944043940954343,0.106076210092688,0.257466529351184,0.11294198420872
,2690,5009,4497,844,4165,1846,73105,0.0367963887558991,0.0685178852335682,0.0615142603105123,0.0115450379590999,0.0569728472744682,0.0252513507967991
